PICKUP_POSTCODE,No_Jobs,No_trips,total_trips,Latitude,Longitude
000000,474,2681,3155,1.297826,103.808006
000001,100316,1448864,1549180,1.292474,103.856522
000002,2663,7287,9950,1.292474,103.856522
000003,337,1014,1351,1.294563,103.858945
000004,5396,82470,87866,1.292256,103.856295
000005,2472,34459,36931,1.292256,103.856295
000006,103,2882,2985,1.292137,103.856261
000007,8484,1594,10078,1.291927,103.856205
000008,7878,91115,98993,1.307712,103.831766
000009,4190,27248,31438,1.303947,103.831929
000010,152,1346,1498,1.280704,103.851415
000011,224,1856,2080,1.291849,103.844717
000012,23,2064,2087,1.309983,103.864267
000013,33,509,542,1.302108,103.861237
000014,295,3243,3538,1.309809,103.864415
000015,50,330,380,1.309882,103.86437
000016,567,665,1232,1.371711,103.847769
000017,96,19,115,1.309711,103.863973
000018,260,1001,1261,1.33939,103.706496
000019,438,4177,4615,1.265181,103.822883
000021,165,152,317,1.3028,103.834329
000022,124,273,397,1.350543,103.87284
000023,132,948,1080,1.266602,103.809978
000024,2063,202,2265,1.309656,103.863996
000025,300,1942,2242,1.372336,103.893862
000026,59,174,233,1.340105,103.706247
000027,84,515,599,1.350368,103.87301
000028,657,3255,3912,1.350309,103.872993
000029,221,205,426,1.350331,103.873101
000030,113,16,129,1.340293,103.706321
000032,12,10,22,1.310104,103.863962
000033,275,356,631,1.350343,103.872614
000034,205,11028,11233,1.311145,103.881912
000035,158,148,306,1.350255,103.872812
000036,519,1568,2087,1.291526,103.844508
000037,900,279,1179,1.310323,103.863984
000038,41,927,968,1.350347,103.872676
000039,222,8634,8856,1.35038,103.872637
000041,22,239,261,1.310387,103.864041
000042,90,358,448,1.310497,103.864041
000043,45,91,136,1.350176,103.872976
000044,537,39,576,1.350057,103.872942
000045,31,6,37,1.350306,103.87275
000046,7,194,201,1.350065,103.873203
000047,360,219,579,1.350342,103.872671
000048,211,74,285,1.350392,103.872937
000051,160,1147,1307,1.350585,103.871867
000052,70,1483,1553,1.350622,103.871844
000054,56,158,214,1.35036,103.873076
000055,91,707,798,1.350364,103.872993
000058,3,138,141,1.32429,103.941057
000059,58,84,142,1.263738,103.822905
000061,368,606,974,1.350694,103.872025
000062,1,5,6,1.350856,103.872546
000065,0,1,1,1.299509,103.837
000068,4,28,32,1.351027,103.872325
000071,60,81,141,1.264072,103.821909
000075,1,0,1,1.350797,103.871674
000077,4,136,140,1.350832,103.872647
000080,27,374,401,1.350626,103.872738
000081,181,1,182,1.311806,103.879577
000082,3,3,6,1.350529,103.872184
000086,18,116,134,1.350594,103.872014
000087,13,212,225,1.350603,103.871934
000088,6,583,589,1.31139,103.877563
000092,3,0,3,1.299509,103.837
000093,54,20,74,1.263602,103.8226
000097,12,4,16,1.321334,103.885756
000099,14,0,14,1.263677,103.822373
000122,4,220,224,1.294403,103.858152
000123,57,20,77,1.315265,103.853614
000152,7,102,109,1.29118,103.857507
000234,42,23,65,1.265007,103.821366
000263,21,123,144,1.436097,103.838971
000325,17,0,17,1.294013,103.857462
000579,2,56,58,1.3339235,103.8977545
000778,13,12,25,1.373834,103.938047
018906,257,545,802,1.275964,103.849523
018910,51,47,98,1.28046,103.867995
018925,91,1670,1761,1.347825,103.788231
018926,9,226,235,1.347982,103.788212
018927,60,219,279,1.277811,103.850589
018930,1,180,181,1.306344,103.916257
018935,4,1206,1210,1.27845,103.852695
018936,68,16027,16095,1.27845,103.852695
018937,82,15921,16003,1.27845,103.852695
018940,179,2383,2562,1.280112,103.856281
018945,25,1945,1970,1.27309,103.864113
018946,553,1157,1710,1.274173,103.864365
018947,1508,29690,31198,1.270926,103.863409
018948,616,3147,3763,1.274173,103.864365
018950,10,135,145,1.281315,103.868109
018951,1700,88,1788,1.280635,103.87159
018952,1960,1236,3196,1.282091,103.868637
018953,5347,71091,76438,1.281744,103.867383
018954,1,108,109,1.280507,103.867838
018955,8774,440,9214,1.284315,103.859553
018956,8393,2116,10509,1.282275,103.858322
018957,323,31265,31588,1.281333,103.858924
018959,41,1913,1954,1.281333,103.858924
018960,38882,61533,100415,1.278968,103.851237
018961,31907,14728,46635,1.278295,103.850662
018962,104,52,156,1.274696,103.848935
018965,4469,2838,7307,1.280149,103.852006
018966,643,8738,9381,1.280334,103.852221
018968,49,2185,2234,1.280146,103.851374
018969,174,4373,4547,1.282364,103.859305
018970,1496,310685,312181,1.281299,103.858401
018971,5562,277918,283480,1.281526,103.859442
018972,1456,52,1508,1.283949,103.858846
018973,1152,110121,111273,1.28544,103.860033
018974,184,283,467,1.286241,103.859286
018976,142,1592,1734,1.279925,103.869499
018978,4,49,53,1.276274,103.854629
018979,32,69,101,1.321567,103.9212
018980,8614,48169,56783,1.280007,103.855301
018981,31728,47660,79388,1.279637,103.854149
018982,43266,20300,63566,1.28049,103.853496
018983,37360,14336,51696,1.279424,103.854182
018984,416,29144,29560,1.280475,103.853551
018985,4820,12434,17254,1.280886,103.852614
018986,31,1102,1133,1.280885,103.852609
018987,6357,38798,45155,1.280783,103.85265
018988,7608,70,7678,1.270859,103.863253
018989,27306,21891,49197,1.282387,103.852437
018990,124,8,132,1.276274,103.854629
018991,12,13,25,1.276274,103.854629
019191,236,57,293,1.278638,103.862205
019392,4,403,407,1.279531,103.867172
019393,2,19,21,1.278871,103.867972
019395,14,358,372,1.278871,103.867972
019799,11,76,87,1.276362,103.864931
019800,9,620,629,1.283315,103.8729245
029997,42,34,76,1.290268,103.880918
029998,3,36,39,1.290268,103.880918
038970,299,1256,1555,1.299849,103.863521
038975,925,1262,2187,1.291307,103.86391
038980,360,5846,6206,1.286765,103.854068
038981,1031,1853,2884,1.289857,103.85528
038982,8874,42515,51389,1.293346,103.85859
038983,2085,29716,31801,1.295968,103.858967
038985,4735,32457,37192,1.352083,103.819836
038986,4606,62698,67304,1.294611,103.859656
038987,5305,39669,44974,1.295285,103.85852
038988,8457,15506,23963,1.295241,103.859489
038989,4934,23035,27969,1.295556,103.859041
039190,13627,14432,28059,1.293309,103.860354
039192,9939,33380,43319,1.292612,103.86031
039193,108,2616,2724,1.291896,103.860566
039194,337,6193,6530,1.293862,103.860019
039392,146,3590,3736,1.291042,103.856448
039393,14851,20082,34933,1.292009,103.85588
039593,7553,53281,60834,1.292937,103.857002
039594,8185,91739,99924,1.290989,103.857422
039595,5338,58221,63559,1.292001,103.858718
039596,4409,46009,50418,1.291601,103.860166
039597,15,936,951,1.29146,103.861404
039797,4595,45878,50473,1.290653,103.858342
039799,4055,56494,60549,1.352083,103.819836
039800,139,2774,2913,1.28968,103.857852
039801,6,421,427,1.290272,103.859058
039802,5519,57109,62628,1.289825,103.855015
039804,1909,33494,35403,1.28909,103.862314
039805,240,2334,2574,1.28959,103.859028
048416,4872,11611,16483,1.282081,103.848738
048421,48,681,729,1.284184,103.84675
048422,289,239,528,1.283745,103.847478
048423,13347,10817,24164,1.283384,103.846868
048424,8127,6890,15017,1.282132,103.848925
048441,354,5283,5637,1.282983,103.849122
048458,194,10398,10592,1.282951,103.84888
048460,17,193,210,1.282959,103.848884
048462,23,1783,1806,1.28291,103.848863
048464,1782,28640,30422,1.282919,103.848868
048465,1,1099,1100,1.282928,103.848874
048466,13,779,792,1.290903,103.839877
048467,1,649,650,1.282642,103.848686
048468,5,1129,1134,1.282614,103.84867
048470,36,0,36,1.282688,103.848719
048471,3,1,4,1.282653,103.84869
048472,23,376,399,1.282671,103.848707
048473,0,681,681,1.282662,103.848698
048474,11,677,688,1.282469,103.848576
048508,177,3318,3495,1.285611,103.848893
048542,1654,3378,5032,1.281966,103.851059
048543,35,1693,1728,1.282344,103.85092
048544,61,650,711,1.282237,103.85083
048545,27,704,731,1.282183,103.850799
048546,31,2252,2283,1.281739,103.85048
048547,25,962,987,1.281944,103.85094
048580,10251,33699,43950,1.281712,103.851423
048581,2144,9570,11714,1.281304,103.850834
048582,2049,18106,20155,1.280725,103.850442
048583,44801,25454,70255,1.281142,103.851928
048616,16509,17518,34027,1.284479,103.851082
048617,4474,6899,11373,1.283426,103.851155
048618,277,4342,4619,1.284496,103.851421
048619,21323,5307,26630,1.283242,103.850837
048620,240,4131,4371,1.283509,103.852106
048621,467,4943,5410,1.283847,103.852123
048622,691,3719,4410,1.284255,103.85173
048623,3633,16657,20290,1.284542,103.851951
048624,19432,20783,40215,1.285361,103.85054
048625,242,7600,7842,1.283353,103.851483
048658,64,5721,5785,1.285074,103.848305
048659,3000,10760,13760,1.284748,103.847611
048660,70,49,119,1.284855,103.847664
048692,1249,3223,4472,1.284972,103.849975
048693,2521,2865,5386,1.284752,103.849941
048694,50,1017,1067,1.284527,103.849722
048695,230,1775,2005,1.28441,103.849737
048696,73,990,1063,1.28435,103.849584
048738,21,1905,1926,1.283594,103.848767
048744,6,308,314,1.283621,103.848748
048745,2,46,48,1.283678,103.848706
048749,29,197,226,1.283789,103.848631
048752,3,127,130,1.283693,103.848684
048753,2,17,19,1.283704,103.848677
048754,2,87,89,1.283732,103.848651
048755,12,214,226,1.283779,103.848612
048761,52,173,225,1.283605,103.848456
048765,3,0,3,1.263612,103.822475
048767,0,37,37,1.28362,103.848445
048768,1,0,1,1.264073,103.821841
048769,1,0,1,1.283614,103.84845
048771,0,123,123,1.283645,103.848428
048772,46,1959,2005,1.283203,103.84884
048774,0,1018,1018,1.28323,103.848817
048776,0,2,2,1.283237,103.848811
048777,9,7,16,1.283219,103.848822
048778,0,949,949,1.283186,103.848845
048780,3,1,4,1.283203,103.848833
048781,3,0,3,1.283211,103.848827
048782,0,473,473,1.2832,103.848836
048815,510,12325,12835,1.285844,103.849197
048816,20,1292,1312,1.285858,103.849163
048817,14,1266,1280,1.285884,103.849102
048818,11,1129,1140,1.285922,103.849022
048819,21,1004,1025,1.285943,103.848974
048820,32,659,691,1.285972,103.848924
048821,24,764,788,1.285996,103.848882
048822,5,479,484,1.286018,103.848836
048823,32,876,908,1.286046,103.848795
048824,195,730,925,1.286075,103.848738
048825,85,878,963,1.286093,103.848703
048826,90,2252,2342,1.286118,103.848662
048827,69,3202,3271,1.286167,103.848582
048828,28,2158,2186,1.286196,103.848515
048829,121,3206,3327,1.286277,103.848333
048830,36,712,748,1.286297,103.848296
048831,5,694,699,1.28631,103.848266
048832,11,455,466,1.286336,103.848215
048833,13,800,813,1.286357,103.848174
048834,280,816,1096,1.286492,103.847959
048867,5,12,17,1.284516,103.846947
048868,0,2,2,1.284494,103.846992
048869,0,1,1,1.284466,103.847033
048871,1,2,3,1.284417,103.847094
048872,1,2,3,1.284405,103.847111
048873,1,2,3,1.284385,103.847139
048874,1,1,2,1.284372,103.84716
048875,3,2,5,1.284338,103.847211
048876,0,2,2,1.284317,103.847242
048877,7,1,8,1.284297,103.847269
048878,1,1,2,1.28426,103.847337
048879,3,3,6,1.284243,103.847364
048880,1,2,3,1.284225,103.847401
048881,0,3,3,1.284195,103.84745
048882,1,1,2,1.284181,103.847468
048883,3,2,5,1.284149,103.847522
048884,2,1,3,1.284139,103.847546
048885,7,1,8,1.284125,103.847574
048886,4,2,6,1.284108,103.847615
048887,6,2,8,1.284071,103.847675
048888,1,2,3,1.28405,103.847708
048889,6,8,14,1.284006,103.847766
048890,1,15,16,1.283981,103.8478
048891,2,3,5,1.283991,103.847786
048940,7947,4720,12667,1.284013,103.850272
048941,478,10171,10649,1.284513,103.850633
048942,2084,6496,8580,1.284318,103.850605
048943,1076,811,1887,1.282133,103.850408
048944,18,795,813,1.28202,103.850427
048945,5686,4231,9917,1.281704,103.850269
048946,15999,2065,18064,1.281901,103.849939
048979,198,2578,2776,1.283915,103.850606
048980,1776,2320,4096,1.283897,103.850827
049014,433,785,1218,1.287103,103.848802
049015,14,847,861,1.287069,103.848785
049016,9,998,1007,1.287046,103.848768
049017,21,395,416,1.287023,103.84875
049018,13,129,142,1.286971,103.848728
049019,10,92,102,1.286914,103.848722
049020,20,35,55,1.286863,103.848722
049021,0,24,24,1.286828,103.848705
049022,6,18,24,1.286794,103.848699
049023,40,26,66,1.286748,103.848665
049024,0,19,19,1.286694,103.848637
049025,1,49,50,1.286651,103.848608
049026,3,59,62,1.286616,103.84858
049027,18,60,78,1.286593,103.848563
049028,25,232,257,1.286553,103.84854
049030,1,147,148,1.286474,103.848626
049031,6,0,6,1.286487,103.848635
049032,19,34,53,1.28645,103.848618
049033,4,0,4,1.286463,103.848622
049034,23,37,60,1.286481,103.848631
049035,18,93,111,1.28657,103.848681
049036,7,263,270,1.286622,103.848732
049037,1065,605,1670,1.286632,103.848737
049086,1,106,107,1.28488,103.847012
049087,0,62,62,1.284848,103.847069
049088,0,46,46,1.284833,103.847102
049090,0,2,2,1.284742,103.847226
049091,1,12,13,1.284718,103.847297
049092,0,2,2,1.284702,103.84733
049093,0,1,1,1.284679,103.84736
049094,2,0,2,1.284639,103.847424
049096,0,1,1,1.284596,103.847505
049097,1,1,2,1.284553,103.847565
049098,1,1,2,1.28454,103.847593
049099,0,3,3,1.284508,103.84763
049100,3,11,14,1.284489,103.847665
049101,1,17,18,1.284474,103.847695
049102,1,2,3,1.284438,103.847743
049103,1,12,13,1.284414,103.84778
049104,3,4,7,1.284386,103.847826
049105,1,4,5,1.28437,103.847865
049106,1,2,3,1.28434,103.847912
049107,0,2,2,1.284325,103.847937
049108,1,9,10,1.284309,103.847976
049142,59,3139,3198,1.285086,103.848063
049144,45,980,1025,1.285863,103.84815
049145,9437,11355,20792,1.28566,103.847861
049178,9049,41326,50375,1.28633,103.852932
049213,2853,51981,54834,1.285655,103.853889
049215,453,2312,2765,1.287158,103.853587
049246,86,5076,5162,1.282497,103.851439
049247,3485,13675,17160,1.282357,103.851686
049315,20416,6857,27273,1.283028,103.852016
049317,165,3369,3534,1.283529,103.852003
049318,20799,62250,83049,1.284184,103.852536
049319,627,9869,10496,1.284544,103.852803
049320,810,5973,6783,1.28512,103.85288
049321,8012,2746,10758,1.283026,103.852791
049322,2114,10592,12706,1.282939,103.852912
049323,344,7764,8108,1.283966,103.853581
049324,103,3541,3644,1.282863,103.852687
049325,75,9101,9176,1.283079,103.85282
049326,11161,49226,60387,1.282531,103.853582
049327,814,5526,6340,1.28458,103.853953
049357,75,66,141,1.28807,103.848859
049358,94,27,121,1.288041,103.848869
049359,8,6,14,1.288016,103.848881
049360,2,3,5,1.28799,103.848886
049361,3,1,4,1.287974,103.84889
049362,15,1,16,1.287957,103.848892
049363,53,68,121,1.287902,103.848904
049364,13,201,214,1.287867,103.848915
049365,44,250,294,1.287837,103.848916
049366,26,162,188,1.287784,103.848917
049367,5,104,109,1.287755,103.848918
049368,25,220,245,1.287707,103.848918
049369,27,240,267,1.287675,103.848915
049370,52,291,343,1.287598,103.848922
049371,16,261,277,1.287558,103.848918
049372,14,256,270,1.28753,103.848912
049373,10,330,340,1.28747,103.848913
049374,33,1209,1242,1.287417,103.848917
049376,184,1745,1929,1.287299,103.848924
049377,35,3,38,1.287316,103.848925
049378,53,1230,1283,1.287194,103.848929
049379,61,951,1012,1.287153,103.848939
049380,19,956,975,1.287124,103.848944
049381,45,1052,1097,1.287072,103.848959
049382,183,862,1045,1.287028,103.84897
049383,25,604,629,1.286975,103.84899
049384,43,489,532,1.286899,103.849014
049385,55,445,500,1.286878,103.849021
049386,21,406,427,1.286817,103.849046
049387,49,495,544,1.286775,103.849055
049388,6,610,616,1.286726,103.849078
049389,25,598,623,1.286645,103.849098
049390,21,601,622,1.286603,103.849109
049391,20,629,649,1.286571,103.849132
049392,41,732,773,1.286534,103.84916
049393,8,558,566,1.286499,103.84918
049394,24,446,470,1.286454,103.849205
049395,29,469,498,1.28642,103.849226
049396,6,260,266,1.286385,103.849242
049397,16,2310,2326,1.286362,103.849262
049398,169,5810,5979,1.286315,103.849289
049399,35,4798,4833,1.286166,103.849361
049400,25,536,561,1.28612,103.849392
049401,46,289,335,1.286087,103.849426
049402,10,343,353,1.286047,103.84945
049403,41,859,900,1.285987,103.849481
049404,11,1765,1776,1.285943,103.849503
049405,55,2835,2890,1.28588,103.849533
049406,255,6865,7120,1.285835,103.849567
049407,709,10213,10922,1.285718,103.849641
049410,2276,3664,5940,1.2858845,103.849501
049411,1839,3525,5364,1.286051,103.849361
049412,24,296,320,1.286025,103.849254
049413,281,1408,1689,1.286125,103.849321
049415,50,788,838,1.286217,103.849268
049416,26,360,386,1.286243,103.849262
049417,29,294,323,1.286302,103.849216
049418,13,257,270,1.286331,103.849203
049419,17,331,348,1.286357,103.849183
049420,21,275,296,1.286382,103.849172
049421,10,271,281,1.2864,103.849162
049422,13,264,277,1.286383,103.849215
049423,97,355,452,1.286476,103.849119
049426,37,734,771,1.286585,103.849045
049427,4,387,391,1.286609,103.84904
049428,25,382,407,1.286646,103.849034
049429,2,362,364,1.286732,103.849019
049430,24,335,359,1.286727,103.849004
049431,12,294,306,1.286749,103.848998
049432,10,344,354,1.286885,103.849066
049433,254,3158,3412,1.286877,103.848958
049434,34,633,667,1.287293,103.848886
049435,16,508,524,1.287334,103.848886
049436,31,638,669,1.287407,103.848884
049437,20,464,484,1.287438,103.848885
049438,71,600,671,1.287495,103.848881
049439,41,1257,1298,1.287672,103.84888
049441,13,1020,1033,1.287731,103.848872
049442,18,146,164,1.287745,103.848872
049443,27,98,125,1.287685,103.848879
049478,74,2947,3021,1.284479,103.849185
049479,688,8714,9402,1.284783,103.848898
049480,176,4029,4205,1.284512,103.848478
049481,19225,5377,24602,1.283741,103.848941
049482,218,191,409,1.283761,103.848624
049483,6889,5000,11889,1.283276,103.849632
049513,8947,6957,15904,1.285398,103.84953
049514,1043,3342,4385,1.285006,103.849706
049555,255,504,759,1.283912,103.847961
049556,59,277,336,1.283876,103.847936
049557,27,173,200,1.283854,103.847916
049558,47,321,368,1.283839,103.847901
049559,126,1333,1459,1.283821,103.847894
049560,579,376,955,1.283111,103.847655
049561,441,0,441,1.283494,103.847802
049562,51,0,51,1.283501,103.847806
049563,24,0,24,1.283469,103.847783
049564,13,9,22,1.283506,103.847812
049565,19,53,72,1.283511,103.847814
049566,19,0,19,1.283522,103.847817
049567,55,757,812,1.283478,103.847791
049568,104,0,104,1.283486,103.847796
049569,70,560,630,1.283216,103.847687
049570,31,386,417,1.282701,103.848393
049571,9,91,100,1.28319,103.847674
049572,0,26,26,1.283144,103.847654
049573,1,44,45,1.283078,103.847633
049574,7,53,60,1.283043,103.847607
049575,5,158,163,1.283015,103.847591
049576,56,1638,1694,1.282966,103.847573
049586,196,1234,1430,1.283952,103.847851
049587,8,9,17,1.284,103.847888
049588,5,13,18,1.284039,103.847908
049589,5,28,33,1.284056,103.847926
049590,4,5,9,1.284109,103.847957
049591,15,270,285,1.284128,103.847971
049592,5,15,20,1.284168,103.847986
049593,3,83,86,1.28419,103.848008
049594,2,90,92,1.284249,103.848033
049595,45,339,384,1.284303,103.848067
049704,207,1153,1360,1.282482,103.850541
049705,39,3679,3718,1.283041,103.85048
049706,0,72,72,1.282695,103.850478
049708,58,1681,1739,1.282578,103.850517
049709,33,2871,2904,1.282126,103.849686
049710,60,4173,4233,1.282049,103.849582
049711,274,6826,7100,1.282026,103.849453
049712,5126,2505,7631,1.282756,103.849922
049745,107,1880,1987,1.286271,103.849429
049747,1,241,242,1.286339,103.849421
049748,5,164,169,1.286347,103.849436
049816,137,1168,1305,1.285962,103.849989
049817,106,79,185,1.285935,103.849947
049818,24,100,124,1.285914,103.849848
049819,12,50,62,1.286168,103.849927
049820,17,39,56,1.286216,103.849899
049821,12,45,57,1.286257,103.849861
049822,45,52,97,1.286303,103.849835
049823,13,54,67,1.286351,103.849797
049824,8,62,70,1.286395,103.849766
049825,16,65,81,1.286449,103.84973
049826,26,87,113,1.286478,103.849719
049827,23,27,50,1.286555,103.849673
049828,9,61,70,1.28658,103.849668
049829,4,28,32,1.28662,103.849639
049830,2,25,27,1.28666,103.849616
049831,9,34,43,1.28669,103.849589
049832,2,43,45,1.286736,103.849555
049833,192,37,229,1.286756,103.849518
049834,4,22,26,1.286788,103.84948
049835,2,14,16,1.286814,103.849464
049836,1,10,11,1.286872,103.849447
049837,5,3,8,1.28691,103.849426
049838,5,4,9,1.286971,103.849413
049839,13,5,18,1.287026,103.849399
049840,11,6,17,1.287047,103.849392
049841,3,4,7,1.28707,103.849389
049842,6,5,11,1.287155,103.849381
049843,11,11,22,1.287188,103.849375
049844,9,5,14,1.287249,103.849371
049845,1,4,5,1.287282,103.849365
049846,1,5,6,1.28733,103.849354
049847,36,4,40,1.287405,103.849331
049848,5,4,9,1.2875,103.849368
049849,6,1,7,1.287526,103.849366
049850,3,1,4,1.287569,103.849363
049851,3,1,4,1.287636,103.849375
049852,0,2,2,1.287683,103.849383
049853,1,1,2,1.287724,103.849388
049854,2,1,3,1.287747,103.849379
049855,2,1,3,1.2878,103.849383
049856,3,0,3,1.28786,103.849385
049857,7,1,8,1.287881,103.849388
049858,8,2,10,1.287927,103.849396
049859,1,1,2,1.287991,103.849398
049860,7,0,7,1.288044,103.849403
049861,23,2,25,1.288113,103.849399
049862,1,4,5,1.288133,103.849393
049863,1,4,5,1.288167,103.849383
049864,4,2,6,1.288226,103.84938
049865,5,12,17,1.288282,103.849369
049866,19,10,29,1.288321,103.849365
049867,11,4,15,1.288362,103.849352
049868,231,16,247,1.288391,103.849344
049869,51,90,141,1.288423,103.849338
049870,68,1113,1181,1.288485,103.849329
049871,11,688,699,1.288525,103.849291
049872,27,607,634,1.288582,103.849277
049873,136,8197,8333,1.288685,103.849255
049907,774,9299,10073,1.285861,103.852475
049908,1188,21347,22535,1.285576,103.852229
049909,14104,51965,66069,1.285539,103.851667
049910,17793,47530,65323,1.294129,103.808334
049944,4,1089,1093,1.28322,103.848581
049945,1,321,322,1.283212,103.848575
049946,0,311,311,1.283205,103.848573
049947,2,174,176,1.2832,103.848571
049948,14,148,162,1.283236,103.84859
049949,7,2624,2631,1.282888,103.848436
049950,0,18,18,1.282903,103.848387
049951,0,103,103,1.282954,103.848422
049952,3,145,148,1.282921,103.848394
049956,2,0,2,1.282505,103.847813
049957,3,0,3,1.282517,103.847797
049959,5,257,262,1.283106,103.848344
049960,7,147,154,1.283122,103.848359
049961,1,0,1,1.283093,103.848333
049962,2,0,2,1.283086,103.848326
049963,1,49,50,1.283075,103.848323
049964,2,0,2,1.2831,103.848341
049965,29,300,329,1.283357,103.848474
049966,0,159,159,1.282527,103.847785
049967,1,0,1,1.282662,103.848192
050004,264,93,357,1.281804,103.842975
050005,773,1928,2701,1.281201,103.843403
050032,35,2033,2068,1.284987,103.842602
050033,9,2704,2713,1.305997,103.89299
050034,273,2218,2491,1.286181,103.842138
050335,263,117,380,1.282573,103.843098
050336,344,8289,8633,1.282878,103.842565
050531,366,636,1002,1.284196,103.845699
050532,182,280,462,1.284151,103.845978
050533,402,329,731,1.284485,103.845439
050535,55,507,562,1.284574,103.846243
050536,26,473,499,1.284947,103.84561
050538,10,346,356,1.285205,103.845761
051335,152,203,355,1.282612,103.842892
051531,31,1189,1220,1.285321,103.845851
052335,90,75,165,1.282612,103.842892
053034,37,802,839,1.284403,103.84451
058267,141,13902,14043,1.287912,103.845033
058268,4309,17092,21401,1.288219,103.844659
058275,7,3,10,1.288454,103.843518
058276,0,4,4,1.288513,103.843569
058277,9,6,15,1.288554,103.843602
058278,11,348,359,1.288518,103.843327
058279,6,460,466,1.288624,103.843324
058280,9,677,686,1.288696,103.843331
058281,6052,19406,25458,1.288571,103.84587
058282,3949,13538,17487,1.289129,103.844223
058283,275,2332,2607,1.288815,103.843665
058284,11,855,866,1.286105,103.846399
058285,48,3165,3213,1.285885,103.847112
058288,358,14910,15268,1.286008,103.845719
058289,3067,12002,15069,1.285835,103.846177
058326,16,1397,1413,1.283767,103.84575
058327,5,397,402,1.283796,103.845699
058328,6,343,349,1.28383,103.845625
058329,26,399,425,1.28387,103.845557
058330,16,597,613,1.283889,103.845513
058331,16,627,643,1.283907,103.845487
058332,44,618,662,1.283947,103.84542
058333,22,370,392,1.283968,103.845385
058334,75,232,307,1.283996,103.845359
058335,14,273,287,1.28402,103.845309
058336,7,285,292,1.284047,103.845259
058337,10,148,158,1.352083,103.819836
058338,5,267,272,1.284115,103.845154
058339,15,87,102,1.284141,103.845125
058340,5,306,311,1.284093,103.845025
058341,39,908,947,1.284167,103.844889
058345,81,1225,1306,1.284376,103.844772
058348,176,992,1168,1.284442,103.844606
058353,350,1043,1393,1.284521,103.844487
058354,29,2492,2521,1.284584,103.844347
058357,1578,25016,26594,1.285699,103.843661
058358,99,27978,28077,1.285429,103.84363
058359,44,32944,32988,1.285366,103.843699
058360,4273,32110,36383,1.285239,103.843263
058362,259,889,1148,1.284788,103.843931
058400,163,648,811,1.288358,103.848548
058401,5,1088,1093,1.288341,103.848574
058402,4,38,42,1.288435,103.848478
058403,2,135,137,1.288468,103.848443
058404,1,400,401,1.288497,103.848403
058405,8,406,414,1.288534,103.848351
058406,12,119,131,1.28856,103.848331
058407,16,70,86,1.288589,103.848287
058408,4,48,52,1.288623,103.848247
058409,77,1075,1152,1.288637,103.848233
058410,24,927,951,1.288673,103.848174
058411,16,2233,2249,1.288699,103.84814
058412,9,1163,1172,1.288717,103.848125
058413,44,2956,3000,1.288748,103.848086
058414,39,2826,2865,1.288778,103.848018
058415,91,1743,1834,1.28881,103.847986
058416,5195,6961,12156,1.28887,103.848344
058455,1,1,2,1.283158,103.844412
058456,23,0,23,1.283282,103.84433
058459,3,0,3,1.283109,103.844339
058460,4,1,5,1.283216,103.844291
058461,1,1,2,1.28307,103.844322
058462,1,0,1,1.283161,103.844258
058463,1,4,5,1.283023,103.844294
058464,4,0,4,1.28313,103.844238
058465,0,42,42,1.282968,103.844261
058466,0,1,1,1.283066,103.8442
058467,8,497,505,1.2829,103.844227
058468,0,41,41,1.283028,103.844185
058469,11,299,310,1.2828,103.844163
058470,26,960,986,1.282988,103.844159
058471,4,8,12,1.282762,103.84414
058475,3,4,7,1.282622,103.844024
058476,288,39,327,1.282549,103.844038
058479,57,48,105,1.28271,103.844049
058556,37,522,559,1.282394,103.844988
058557,8,129,137,1.28241,103.844961
058558,21,118,139,1.282432,103.844919
058559,61,221,282,1.282456,103.844885
058560,45,157,202,1.28248,103.844842
058561,8,248,256,1.282508,103.844806
058562,127,22,149,1.28253,103.844756
058563,23,77,100,1.282554,103.844705
058564,3,42,45,1.282595,103.844626
058565,7,225,232,1.282683,103.844677
058566,5,55,60,1.282619,103.844581
058567,16,107,123,1.282719,103.844607
058568,210,41,251,1.282646,103.844545
058569,13,199,212,1.282741,103.844568
058570,58,118,176,1.282671,103.844494
058571,49,173,222,1.28275,103.84455
058573,7,165,172,1.282784,103.844492
058575,10,485,495,1.282812,103.844433
058577,12,647,659,1.282776,103.844516
058581,431,861,1292,1.283137,103.843903
058584,26,184,210,1.283032,103.843848
058586,2,116,118,1.283055,103.843791
058588,15,117,132,1.283084,103.84374
058590,1,120,121,1.283107,103.843688
058591,9,245,254,1.283249,103.843758
058592,12,55,67,1.283141,103.843643
058593,17,141,158,1.283274,103.843711
058594,4,70,74,1.283175,103.843592
058595,5,157,162,1.283288,103.843662
058596,7,69,76,1.283187,103.843569
058597,28,123,151,1.283326,103.84361
058598,3,82,85,1.283215,103.843523
058599,1,169,170,1.283364,103.843543
058600,25,68,93,1.283238,103.843489
058601,4,151,155,1.283376,103.84351
058602,4,71,75,1.283261,103.843449
058603,3,234,237,1.283396,103.843475
058604,13,71,84,1.283284,103.843398
058606,1,64,65,1.283284,103.843381
058607,10,465,475,1.283433,103.843411
058608,1,95,96,1.283296,103.843364
058610,7,157,164,1.283324,103.843318
058611,15,886,901,1.283352,103.843265
058613,5,193,198,1.283364,103.843247
058615,19,1623,1642,1.283393,103.843166
058617,34,1703,1737,1.283411,103.84313
058656,149,6493,6642,1.288347,103.848954
058657,90,2901,2991,1.288311,103.848924
058658,59,1216,1275,1.288275,103.848895
058659,85,2830,2915,1.2882,103.848835
058660,129,9518,9647,1.288242,103.848866
058661,578,8077,8655,1.287911,103.848661
058662,5,523,528,1.287902,103.848659
058663,7,331,338,1.287886,103.84865
058664,2,321,323,1.287941,103.848683
058665,16,670,686,1.287827,103.848611
058666,8,739,747,1.287762,103.848569
058667,83,1784,1867,1.288095,103.848744
058668,21,123,144,1.288065,103.848727
058669,12,514,526,1.287691,103.848539
058670,52,1079,1131,1.352083,103.819836
058671,3,395,398,1.287635,103.848506
058672,25,33,58,1.287995,103.848643
058673,18,513,531,1.287591,103.848482
058674,3,61,64,1.287937,103.848601
058675,1,390,391,1.287582,103.848472
058676,30,598,628,1.287914,103.848585
058677,69,432,501,1.287498,103.848434
058678,2,434,436,1.287443,103.848403
058679,61,600,661,1.287833,103.848547
058680,23,502,525,1.287413,103.848381
058681,10,454,464,1.287348,103.848346
058682,42,825,867,1.287638,103.848328
058683,0,483,483,1.287298,103.848315
058684,100,625,725,1.28726,103.848298
058685,21,327,348,1.287582,103.848287
058686,17,431,448,1.287238,103.848292
058687,4,114,118,1.287526,103.848261
058688,5,768,773,1.287171,103.848255
058689,554,196,750,1.287487,103.848239
058690,12,227,239,1.287444,103.848207
058691,0,525,525,1.287108,103.848209
058692,14,178,192,1.287408,103.848183
058693,18,1968,1986,1.287034,103.848164
058694,2,117,119,1.287362,103.848158
058695,30,1327,1357,1.286997,103.848148
058696,29,455,484,1.287315,103.848126
058697,49,761,810,1.286949,103.848124
058698,25,1151,1176,1.287259,103.8481
058699,40,1043,1083,1.2869,103.848101
058700,42,1610,1652,1.287003,103.848093
058701,0,549,549,1.286868,103.84809
058702,40,741,781,1.286959,103.848071
058703,20,660,680,1.286797,103.848043
058704,43,457,500,1.286911,103.848053
058705,5,299,304,1.286816,103.848056
058706,10,318,328,1.286861,103.848024
058707,17,343,360,1.286767,103.84803
058708,31,92,123,1.286817,103.847999
058709,17,183,200,1.286693,103.847986
058710,42,490,532,1.286779,103.847974
058711,14,272,286,1.28666,103.847954
058712,16,332,348,1.286732,103.847945
058713,1,236,237,1.286621,103.847932
058714,9,118,127,1.286699,103.847923
058715,18,1261,1279,1.286569,103.84791
058716,22,730,752,1.286686,103.847698
058722,16,2747,2763,1.284882,103.846983
058723,1,21,22,1.284845,103.846962
058724,3,117,120,1.284777,103.846926
058725,2,163,165,1.284737,103.846891
058726,0,29,29,1.284661,103.84687
058727,540,2251,2791,1.285134,103.846524
058728,0,36,36,1.284599,103.846869
058729,28,949,977,1.284588,103.846836
058747,27,1792,1819,1.283566,103.846048
058748,88,2171,2259,1.283369,103.846119
058749,6,156,162,1.283532,103.846023
058750,20,372,392,1.283349,103.846126
058751,3,101,104,1.283503,103.846012
058752,7,310,317,1.283296,103.846104
058753,2,273,275,1.283474,103.845988
058754,7,537,544,1.283297,103.846045
058756,5,988,993,1.283237,103.846053
058757,7,257,264,1.283396,103.845907
058758,18,900,918,1.283085,103.845979
058759,404,1455,1859,1.283327,103.845864
058760,9,186,195,1.283035,103.845952
058762,3,130,133,1.283006,103.845937
058763,32,1910,1942,1.283181,103.845655
058764,3,111,114,1.282998,103.845919
058766,1,91,92,1.282975,103.845933
058767,25,196,221,1.28311,103.845538
058768,13,115,128,1.282915,103.845886
058770,7,123,130,1.282894,103.845897
058772,3,76,79,1.282859,103.845851
058774,6,357,363,1.282844,103.845857
058775,15,362,377,1.282843,103.845632
058776,114,602,716,1.282759,103.845748
058777,10,141,151,1.282826,103.84562
058778,19,188,207,1.282728,103.845754
058779,8,244,252,1.282803,103.845603
058780,9,555,564,1.282689,103.845731
058781,67,683,750,1.282777,103.845588
058782,11,742,753,1.282631,103.84574
058784,37,928,965,1.282589,103.845716
058786,87,1300,1387,1.282574,103.84567
058788,2,174,176,1.28253,103.845685
058790,15,621,636,1.282497,103.845663
058791,2469,22186,24655,1.282599,103.845376
058792,10,566,576,1.282426,103.845635
058793,62,8,70,1.282426,103.845377
058794,28,342,370,1.282382,103.845607
058796,14,265,279,1.282377,103.845564
058798,53,8425,8478,1.282339,103.845528
058800,84,4462,4546,1.282236,103.845527
058801,52,2345,2397,1.282152,103.845217
058803,20,389,409,1.282116,103.845196
058804,31,536,567,1.282217,103.845478
058805,13,483,496,1.282087,103.845182
058806,25,328,353,1.282181,103.845479
058807,10,272,282,1.282057,103.845163
058808,68,229,297,1.28212,103.84545
058809,7,594,601,1.282023,103.845144
058810,8,233,241,1.282076,103.845401
058811,39,174,213,1.28199,103.845127
058812,17,427,444,1.282071,103.845404
058813,83,1879,1962,1.281949,103.845101
058814,24,183,207,1.281996,103.845383
058815,114,2165,2279,1.281913,103.845078
058816,18,693,711,1.281957,103.845337
058817,71,1126,1197,1.281767,103.844989
058818,25,689,714,1.281913,103.845323
058819,22,704,726,1.28173,103.844963
058820,11,636,647,1.352083,103.819836
058821,13,406,419,1.281689,103.844942
058822,26,733,759,1.281856,103.845301
058823,21,323,344,1.281648,103.844926
058824,39,1167,1206,1.281798,103.845273
058825,17,387,404,1.281619,103.84491
058826,111,510,621,1.281778,103.845235
058827,11,578,589,1.281581,103.844879
058828,15,220,235,1.281722,103.845219
058829,28,621,649,1.281547,103.844871
058830,142,4312,4454,1.281686,103.845169
058831,51,2373,2424,1.281515,103.844844
058832,43,1944,1987,1.281579,103.845161
058833,35,652,687,1.281541,103.845138
058834,2,325,327,1.281475,103.845081
058835,22,278,300,1.281478,103.845085
058836,15,464,479,1.281406,103.845066
058837,6,307,313,1.281372,103.845036
058838,18,543,561,1.281333,103.844994
058839,13,2231,2244,1.281316,103.845
058840,284,2303,2587,1.281621,103.844377
058917,11,1,12,1.281948,103.844867
058918,10,1,11,1.281989,103.8448
058919,4,0,4,1.281995,103.844726
058922,2,1,3,1.282061,103.844656
058923,2,0,2,1.28205,103.844621
058924,4,0,4,1.282125,103.844692
058925,3,0,3,1.282077,103.844584
058926,2,0,2,1.282093,103.8446
058927,1,2,3,1.282104,103.844537
058928,3,0,3,1.282112,103.84457
058929,3,0,3,1.282134,103.844487
058930,4,0,4,1.282125,103.844545
058931,33,0,33,1.282158,103.844438
058932,4,0,4,1.282142,103.844515
058933,1,1,2,1.282182,103.844394
058935,0,1,1,1.282207,103.844356
058936,0,1,1,1.28218,103.844454
058937,1,0,1,1.282227,103.844312
058938,2,1,3,1.282219,103.844383
058939,3,1,4,1.282252,103.844268
058940,10,0,10,1.28224,103.844346
058941,5,0,5,1.282259,103.844255
058942,4,1,5,1.282261,103.84431
058943,4,0,4,1.282278,103.844223
058944,8,1,9,1.282277,103.844284
058945,2,1,3,1.282321,103.844144
058946,13,0,13,1.282334,103.844118
058948,17,0,17,1.282345,103.844103
058950,3,0,3,1.282378,103.844042
058952,4,0,4,1.282385,103.844029
058953,9,28,37,1.282287,103.843895
058954,13,34,47,1.282671,103.84368
058955,1,8,9,1.282685,103.843643
058956,14,31,45,1.282728,103.843572
058957,9,81,90,1.282742,103.843558
058958,9,128,137,1.282763,103.843512
058959,11,214,225,1.282792,103.843468
058960,1,184,185,1.282819,103.843426
058961,8,226,234,1.282843,103.843388
058962,2,327,329,1.282871,103.843347
058963,7,290,297,1.28289,103.843312
058964,9,218,227,1.282914,103.843265
058965,3,362,365,1.282945,103.843217
058966,4,169,173,1.282958,103.843195
058967,23,442,465,1.282988,103.843124
058968,9,333,342,1.283017,103.843096
058969,6,361,367,1.283043,103.843061
058970,3,249,252,1.283175,103.843056
058971,13,228,241,1.283087,103.843022
058972,74,654,728,1.283106,103.842972
059011,8,2,10,1.281652,103.844498
059013,6,0,6,1.281715,103.844404
059014,1,0,1,1.281739,103.844368
059016,0,2,2,1.281779,103.844292
059017,6,0,6,1.281802,103.844249
059018,0,1,1,1.281821,103.844208
059019,3,0,3,1.281844,103.844168
059020,2,2,4,1.281864,103.844129
059024,0,2,2,1.281923,103.844011
059026,2,0,2,1.281954,103.843934
059028,0,1,1,1.282011,103.843841
059029,4,9,13,1.282042,103.843801
059108,2448,25312,27760,1.284095,103.842531
059186,4,6,10,1.283234,103.844937
059187,8,0,8,1.283252,103.844864
059188,2,1,3,1.283273,103.844827
059189,2,0,2,1.283329,103.844724
059190,2,5,7,1.283022,103.844876
059191,1,1,2,1.283352,103.844681
059192,0,2,2,1.283047,103.844841
059194,0,2,2,1.283076,103.844805
059195,0,2,2,1.283389,103.844612
059198,1,0,1,1.283123,103.844734
059199,0,1,1,1.283434,103.844523
059203,0,1,1,1.283476,103.844429
059204,0,1,1,1.283222,103.844563
059205,2,1,3,1.283484,103.84439
059207,1,0,1,1.283507,103.84435
059208,0,1,1,1.283271,103.844493
059209,0,1,1,1.283534,103.844318
059210,1,2,3,1.283224,103.844439
059212,0,1,1,1.283423,103.844144
059216,0,2,2,1.283453,103.844082
059217,1,1,2,1.283652,103.844126
059218,0,1,1,1.283478,103.844048
059220,2,0,2,1.283505,103.843985
059221,0,1,1,1.283701,103.844056
059222,4,0,4,1.283535,103.843948
059223,4,1,5,1.283727,103.844017
059224,1,0,1,1.28357,103.843897
059225,3,0,3,1.283748,103.843985
059228,0,1,1,1.283614,103.843834
059229,1,1,2,1.283803,103.843898
059230,1,2,3,1.283635,103.843802
059231,1,1,2,1.283832,103.843844
059232,0,4,4,1.283663,103.843749
059233,1,5,6,1.283851,103.8438
059235,0,2,2,1.283872,103.843756
059236,2,1,3,1.287179,103.84649
059238,1,2,3,1.283728,103.843646
059239,3,4,7,1.283913,103.843682
059240,5,3,8,1.283758,103.843597
059241,0,9,9,1.283928,103.843647
059242,1,19,20,1.283775,103.843579
059243,1,15,16,1.283965,103.843609
059282,54,602,656,1.286664,103.847207
059284,51,381,432,1.28673,103.84749
059286,6,171,177,1.286802,103.847371
059287,1,69,70,1.286828,103.847322
059288,24,86,110,1.286852,103.847278
059289,0,150,150,1.286872,103.847236
059290,4,142,146,1.28689,103.847195
059291,5,179,184,1.286911,103.847156
059292,0,22,22,1.286931,103.847107
059293,430,39,469,1.286956,103.847069
059294,35,165,200,1.286978,103.847022
059295,51,50,101,1.286998,103.846982
059296,3,154,157,1.287017,103.846939
059297,45,52,97,1.287049,103.846899
059298,10,60,70,1.28708,103.846841
059299,87,61,148,1.287115,103.846782
059300,28,65,93,1.287134,103.846738
059301,36,387,423,1.28715,103.846697
059302,2,27,29,1.287172,103.84666
059303,3,250,253,1.287189,103.846623
059304,220,1501,1721,1.287324,103.846426
059305,5,230,235,1.287179,103.84649
059383,205,8646,8851,1.28902,103.847701
059384,59,4688,4747,1.288962,103.847668
059385,7,573,580,1.28892,103.847648
059386,22,2057,2079,1.288887,103.847618
059387,29,1871,1900,1.288859,103.847575
059388,28,2285,2313,1.288832,103.847557
059389,7,638,645,1.352083,103.819836
059390,43,1538,1581,1.288749,103.847469
059391,47,3670,3717,1.288663,103.847424
059392,2,6,8,1.288639,103.847409
059393,25,1210,1235,1.28865,103.847383
059394,4,8,12,1.288623,103.847389
059395,119,3574,3693,1.288376,103.847177
059398,23,437,460,1.288276,103.84711
059400,12,284,296,1.288217,103.84705
059401,7,112,119,1.288193,103.847025
059402,23,382,405,1.28814,103.846978
059404,3,192,195,1.288095,103.846948
059405,50,792,842,1.288054,103.846906
059406,39,1347,1386,1.288006,103.846874
059407,42,3366,3408,1.28797,103.846838
059413,7309,41124,48433,1.285202,103.84494
059418,497,5155,5652,1.284583,103.844095
059419,28,1810,1838,1.281272,103.840786
059422,47,5723,5770,1.284398,103.843941
059423,29,13132,13161,1.284197,103.843782
059424,0,3,3,1.287724,103.846491
059425,58,6,64,1.287721,103.846489
059426,9,0,9,1.287718,103.846486
059428,7,4290,4297,1.284058,103.843678
059429,23,3573,3596,1.284052,103.843598
059430,1,1758,1759,1.284034,103.843597
059431,13,1569,1582,1.283984,103.843542
059432,804,32894,33698,1.283639,103.843311
059433,83,9997,10080,1.28345,103.843036
059434,8,1205,1213,1.283382,103.843036
059435,3,1298,1301,1.28334,103.843004
059436,11,2095,2106,1.283302,103.842955
059437,13,3969,3982,1.283261,103.842925
059438,26,3073,3099,1.283233,103.842884
059439,51,6673,6724,1.283159,103.842876
059441,11,1122,1133,1.283331,103.842965
059442,6,475,481,1.288309,103.847135
059443,115,8258,8373,1.28402,103.842989
059483,17,469,486,1.284104,103.843929
059484,19,189,208,1.284093,103.843963
059485,8,147,155,1.284032,103.844054
059486,10,95,105,1.28412,103.844152
059487,10,99,109,1.284074,103.844215
059488,114,66,180,1.28406,103.844242
059489,23,54,77,1.284019,103.844302
059490,6,50,56,1.284004,103.844332
059491,174,54,228,1.283985,103.84436
059492,17,105,122,1.283964,103.844399
059493,11,93,104,1.283941,103.844437
059494,14,88,102,1.283924,103.844474
059495,5,22,27,1.283904,103.84451
059496,17,46,63,1.283886,103.844536
059497,44,46,90,1.283873,103.844564
059498,685,30,715,1.28384,103.844612
059499,5,128,133,1.283821,103.844647
059500,59,83,142,1.283801,103.844697
059501,16,121,137,1.283692,103.84466
059502,86,101,187,1.283665,103.844732
059503,66,128,194,1.283622,103.844737
059504,17,204,221,1.283599,103.84478
059505,121,537,658,1.283501,103.845586
059506,18,61,79,1.283527,103.845535
059507,38,273,311,1.283561,103.845475
059508,83,207,290,1.283569,103.845415
059509,36,270,306,1.283601,103.845362
059510,148,149,297,1.283633,103.845313
059511,89,377,466,1.283644,103.845295
059512,27,63,90,1.283677,103.845228
059513,51,40,91,1.283721,103.845161
059514,14,90,104,1.283737,103.845126
059515,1,74,75,1.283769,103.845067
059516,70,87,157,1.283782,103.845036
059517,10,49,59,1.283818,103.844976
059518,9,52,61,1.283839,103.844932
059519,25,188,213,1.283865,103.844878
059520,31,250,281,1.283998,103.844685
059521,64,42,106,1.284009,103.844662
059522,29,113,142,1.284024,103.844648
059523,82,84,166,1.284039,103.844626
059524,17,96,113,1.284143,103.844446
059525,21,359,380,1.284182,103.844376
059526,987,180,1167,1.28422,103.844294
059527,29,274,303,1.284272,103.844212
059528,391,1590,1981,1.284332,103.844104
059567,1573,16500,18073,1.288526,103.842085
059568,17,1417,1434,1.289392,103.842677
059570,247,16967,17214,1.288819,103.842322
059571,504,1612,2116,1.289178,103.842709
059572,766,5614,6380,1.288857,103.842346
059573,3402,7156,10558,1.289123,103.842014
059607,68,808,876,1.287873,103.844195
059608,631,2498,3129,1.288187,103.844007
059647,16,346,362,1.287366,103.847868
059648,899,65,964,1.287381,103.847841
059649,1,61,62,1.287433,103.847766
059650,205,191,396,1.287458,103.847722
059651,10,45,55,1.287473,103.847686
059652,16,130,146,1.287488,103.847661
059653,23,160,183,1.287519,103.847601
059654,42,115,157,1.28754,103.847567
059655,16,331,347,1.287567,103.847514
059656,4,104,108,1.287596,103.847468
059658,436,216,652,1.287625,103.847418
059660,112,255,367,1.28769,103.847304
059661,62,104,166,1.28772,103.847253
059662,15,196,211,1.287743,103.847224
059663,1997,251,2248,1.287768,103.847172
059664,2,168,170,1.352083,103.819836
059665,35,1086,1121,1.287813,103.847068
059666,180,1197,1377,1.287689,103.846932
059667,458,28,486,1.287655,103.846983
059668,367,8,375,1.287632,103.84704
059669,59,1005,1064,1.28761,103.847071
059670,42,12,54,1.287591,103.84711
059671,8,2,10,1.287567,103.847157
059672,117,164,281,1.287524,103.847243
059673,0,62,62,1.287546,103.847215
059674,6,3,9,1.287505,103.847299
059675,46,341,387,1.28748,103.847359
059676,59,132,191,1.287448,103.847405
059677,49,5,54,1.287392,103.84751
059678,496,126,622,1.287406,103.847482
059679,514,137,651,1.287379,103.847527
059680,1,8,9,1.287334,103.847609
059681,243,572,815,1.287324,103.847628
059682,11,7,18,1.287287,103.847665
059683,211,54,265,1.287267,103.847709
059684,723,116,839,1.352083,103.819836
059685,201,255,456,1.287224,103.847792
059724,883,10264,11147,1.286997,103.842782
059725,335,4640,4975,1.287177,103.843914
059726,58,4871,4929,1.286106,103.84341
059763,248,8831,9079,1.287135,103.84517
059764,1212,5122,6334,1.287552,103.843951
059765,3134,5064,8198,1.288304,103.842986
059803,54,4359,4413,1.287248,103.845737
059804,1224,71159,72383,1.286551,103.844618
059805,64,5248,5312,1.284775,103.843619
059810,39,5121,5160,1.284591,103.843259
059811,124,10160,10284,1.283099,103.841629
059813,130,2980,3110,1.281969,103.840885
059814,59,2610,2669,1.278424,103.83749
059815,836,10752,11588,1.288751,103.846837
059816,205,1551,1756,1.279742,103.839381
059817,2991,38781,41772,1.288424,103.846694
059818,5016,22202,27218,1.288529,103.846784
059819,113,5663,5776,1.288477,103.846732
059820,33,3,36,1.281272,103.840786
059892,11,248,259,1.287945,103.848218
059893,6,115,121,1.287968,103.848187
059894,2,41,43,1.288066,103.848053
059895,0,3,3,1.288067,103.848059
059896,0,11,11,1.288116,103.847991
059897,0,171,171,1.288055,103.848067
059898,1,0,1,1.288108,103.848002
059899,12,0,12,1.288086,103.848033
059902,7,53,60,1.288152,103.847948
059904,113,78,191,1.288199,103.847892
059905,241,29,270,1.288242,103.847829
059906,218,22,240,1.288304,103.847757
059907,29,82,111,1.288314,103.84774
059908,276,48,324,1.288373,103.847663
059909,10,53,63,1.288202,103.847502
059910,20,41,61,1.288186,103.847534
059911,317,58,375,1.288172,103.847557
059912,12,93,105,1.288127,103.84762
059915,62,87,149,1.288071,103.847723
059916,0,78,78,1.288032,103.847782
059917,18,1,19,1.288008,103.847815
059918,16,34,50,1.287966,103.847868
059919,23,36,59,1.287946,103.847915
059920,15,42,57,1.2879,103.848012
059921,660,4,664,1.287917,103.847996
059922,86,83,169,1.287848,103.848089
059923,204,170,374,1.288266,103.847411
059962,25,430,455,1.281672,103.843887
068574,339,742,1081,1.299509,103.837
068575,24,158,182,1.299509,103.837
068576,11,204,215,1.299509,103.837
068577,7,161,168,1.299509,103.837
068578,7,158,165,1.281693,103.848318
068579,127,787,914,1.299509,103.837
068580,157,198,355,1.299509,103.837
068581,38,335,373,1.299509,103.837
068582,14,187,201,1.299509,103.837
068583,7,199,206,1.299509,103.837
068584,36,346,382,1.299509,103.837
068585,37,271,308,1.299509,103.837
068586,32,319,351,1.299509,103.837
068587,123,211,334,1.299509,103.837
068588,5,133,138,1.299509,103.837
068589,33,216,249,1.299509,103.837
068590,81,66,147,1.299509,103.837
068591,54,242,296,1.299509,103.837
068592,65,195,260,1.299509,103.837
068593,14,195,209,1.299509,103.837
068594,17,138,155,1.299509,103.837
068595,17,212,229,1.299509,103.837
068596,226,422,648,1.299509,103.837
068597,24,212,236,1.299509,103.837
068598,4,224,228,1.299509,103.837
068599,71,297,368,1.299509,103.837
068600,88,262,350,1.281624,103.848128
068601,201,244,445,1.281577,103.848086
068602,2056,1049,3105,1.299509,103.837
068603,56,805,861,1.299509,103.837
068604,39,631,670,1.299509,103.837
068605,204,781,985,1.299509,103.837
068606,35,393,428,1.299509,103.837
068607,37,160,197,1.299509,103.837
068608,45,513,558,1.299509,103.837
068609,16,169,185,1.352083,103.819836
068610,33,195,228,1.299509,103.837
068611,388,350,738,1.299509,103.837
068612,95,131,226,1.299509,103.837
068613,96,858,954,1.299509,103.837
068614,57,193,250,1.299509,103.837
068615,74,198,272,1.299509,103.837
068616,215,168,383,1.299509,103.837
068617,34,252,286,1.299509,103.837
068618,211,242,453,1.299509,103.837
068619,43,288,331,1.299509,103.837
068620,166,218,384,1.299509,103.837
068621,32,296,328,1.299509,103.837
068622,40,491,531,1.299509,103.837
068623,101,441,542,1.299509,103.837
068624,4,293,297,1.299509,103.837
068625,72,305,377,1.299509,103.837
068626,20,175,195,1.299509,103.837
068627,271,675,946,1.279872,103.847277
068628,5,135,140,1.299509,103.837
068629,129,1657,1786,1.299509,103.837
068630,77,245,322,1.299509,103.837
068631,9,140,149,1.299509,103.837
068632,13,134,147,1.299509,103.837
068633,5,182,187,1.299509,103.837
068634,4,155,159,1.299509,103.837
068635,27,530,557,1.299509,103.837
068637,89,328,417,1.299509,103.837
068638,49,300,349,1.299509,103.837
068639,264,243,507,1.299509,103.837
068640,85,303,388,1.280035,103.847234
068641,342,197,539,1.299509,103.837
068642,91,179,270,1.299509,103.837
068643,114,331,445,1.299509,103.837
068645,47,2310,2357,1.299509,103.837
068656,129,1499,1628,1.299509,103.837
068720,100,182,282,1.299509,103.837
068721,48,77,125,1.299509,103.837
068722,77,93,170,1.299509,103.837
068723,101,92,193,1.299509,103.837
068724,232,99,331,1.299509,103.837
068725,311,106,417,1.299509,103.837
068726,27,88,115,1.299509,103.837
068727,106,111,217,1.299509,103.837
068728,110,88,198,1.299509,103.837
068729,15,152,167,1.299509,103.837
068730,456,49,505,1.299509,103.837
068731,13,216,229,1.299509,103.837
068732,69,45,114,1.299509,103.837
068733,74,189,263,1.299509,103.837
068734,39,146,185,1.299509,103.837
068735,42,245,287,1.299509,103.837
068736,56,770,826,1.299509,103.837
068737,63,261,324,1.299509,103.837
068738,32,66,98,1.299509,103.837
068739,20,145,165,1.299509,103.837
068740,224,702,926,1.299509,103.837
068803,5962,10034,15996,1.299509,103.837
068804,9811,24982,34793,1.299509,103.837
068805,236,5318,5554,1.299509,103.837
068806,49,2216,2265,1.278268,103.849645
068807,2403,5804,8207,1.299509,103.837
068808,93,6823,6916,1.299509,103.837
068809,14114,19703,33817,1.299509,103.837
068810,279,625,904,1.278369,103.84982
068811,17718,19607,37325,1.299509,103.837
068812,11,476,487,1.299509,103.837
068813,60,967,1027,1.299509,103.837
068814,120,7725,7845,1.299509,103.837
068876,9335,7094,16429,1.299509,103.837
068877,302,5456,5758,1.299509,103.837
068882,330,1087,1417,1.299509,103.837
068886,30,1770,1800,1.299509,103.837
068887,26,2576,2602,1.299509,103.837
068890,103,1693,1796,1.299509,103.837
068891,31,2820,2851,1.299509,103.837
068892,248,6730,6978,1.299509,103.837
068893,2551,1586,4137,1.299509,103.837
068894,237,2982,3219,1.299509,103.837
068895,10129,15709,25838,1.299509,103.837
068896,3480,2129,5609,1.299509,103.837
068897,353,6463,6816,1.299509,103.837
068898,831,2581,3412,1.299509,103.837
068899,153,3232,3385,1.299509,103.837
068900,108,2500,2608,1.299509,103.837
068901,20,1941,1961,1.299509,103.837
068902,101,1746,1847,1.299509,103.837
068906,57,5471,5528,1.299509,103.837
068907,99,9087,9186,1.299509,103.837
068908,56,3766,3822,1.299509,103.837
068909,79,1436,1515,1.299509,103.837
068911,6267,5127,11394,1.299509,103.837
068912,23601,24270,47871,1.299509,103.837
068913,193,1887,2080,1.299509,103.837
068914,331,1441,1772,1.299509,103.837
068974,9,3,12,1.299509,103.837
068975,9,35,44,1.299509,103.837
068976,1,69,70,1.299509,103.837
068978,0,5,5,1.282643,103.846025
068979,5,11,16,1.299509,103.837
068980,0,10,10,1.299509,103.837
068981,1,24,25,1.299509,103.837
069043,89,369,458,1.299509,103.837
069044,47,488,535,1.299509,103.837
069045,375,2316,2691,1.279538,103.847411
069046,1602,1755,3357,1.299509,103.837
069047,3704,637,4341,1.299509,103.837
069110,6468,878,7346,1.299509,103.837
069111,1130,6096,7226,1.299509,103.837
069112,577,827,1404,1.299509,103.837
069113,1093,4142,5235,1.299509,103.837
069114,88,675,763,1.352083,103.819836
069115,2580,4180,6760,1.299509,103.837
069116,353,4291,4644,1.299509,103.837
069118,2262,3440,5702,1.299509,103.837
069119,70,763,833,1.299509,103.837
069120,1513,2428,3941,1.299509,103.837
069183,124,978,1102,1.299509,103.837
069184,1232,12052,13284,1.299509,103.837
069247,505,3795,4300,1.299509,103.837
069248,8,93,101,1.299509,103.837
069249,95,8,103,1.299509,103.837
069250,40,11,51,1.299509,103.837
069251,100,6,106,1.299509,103.837
069252,52,35,87,1.299509,103.837
069253,65,25,90,1.282361,103.847162
069254,29,69,98,1.282357,103.847134
069255,341,64,405,1.299509,103.837
069256,161,52,213,1.299509,103.837
069257,812,258,1070,1.299509,103.837
069261,331,610,941,1.299509,103.837
069320,39,473,512,1.299509,103.837
069321,54,0,54,1.299509,103.837
069322,11,0,11,1.280522,103.845472
069323,2,0,2,1.280535,103.845466
069326,0,182,182,1.280569,103.845453
069327,0,49,49,1.299509,103.837
069328,2,73,75,1.299509,103.837
069331,0,26,26,1.299509,103.837
069332,1,39,40,1.299509,103.837
069333,3821,725,4546,1.299509,103.837
069335,72,2361,2433,1.299509,103.837
069400,906,9266,10172,1.282735,103.847223
069401,96,818,914,1.299509,103.837
069402,31,136,167,1.282708,103.84716
069403,21,335,356,1.299509,103.837
069404,29,490,519,1.282546,103.847132
069405,19,160,179,1.299509,103.837
069406,17,537,554,1.299509,103.837
069407,11,429,440,1.299509,103.837
069408,13,229,242,1.299509,103.837
069409,18,778,796,1.299509,103.837
069410,987,480,1467,1.299509,103.837
069411,6,411,417,1.299509,103.837
069412,52,1748,1800,1.299509,103.837
069413,76,78,154,1.299509,103.837
069414,109,571,680,1.299509,103.837
069415,3432,1074,4506,1.299509,103.837
069418,15,18,33,1.299509,103.837
069419,17,12,29,1.299509,103.837
069420,52,6,58,1.299509,103.837
069421,80,13,93,1.299509,103.837
069422,92,700,792,1.299509,103.837
069423,10,22,32,1.299509,103.837
069424,107,108,215,1.299509,103.837
069425,26,19,45,1.299509,103.837
069426,74,58,132,1.299509,103.837
069427,15,11,26,1.299509,103.837
069428,356,917,1273,1.282059,103.845921
069429,18,3,21,1.282126,103.845847
069430,39,578,617,1.299509,103.837
069431,42,9,51,1.299509,103.837
069432,25,17,42,1.299509,103.837
069433,51,64,115,1.299509,103.837
069434,15,16,31,1.299509,103.837
069435,109,87,196,1.299509,103.837
069436,39,12,51,1.299509,103.837
069437,129,8,137,1.299509,103.837
069438,7,4,11,1.299509,103.837
069439,6,3,9,1.281659,103.846243
069440,264,0,264,1.299509,103.837
069442,5,4,9,1.299509,103.837
069443,33,33,66,1.299509,103.837
069444,0,19,19,1.281492,103.846198
069445,7,6,13,1.299509,103.837
069446,158,12,170,1.281298,103.846395
069447,0,15,15,1.299509,103.837
069448,124,117,241,1.299509,103.837
069449,88,203,291,1.299509,103.837
069450,13,103,116,1.299509,103.837
069451,58,116,174,1.299509,103.837
069452,6,109,115,1.281829,103.845692
069453,244,20,264,1.299509,103.837
069454,55,91,146,1.299509,103.837
069455,116,4,120,1.281688,103.8457
069456,19,71,90,1.299509,103.837
069457,98,437,535,1.299509,103.837
069458,10,25,35,1.299509,103.837
069459,13,122,135,1.299509,103.837
069460,36,50,86,1.299509,103.837
069461,35,75,110,1.299509,103.837
069462,12,55,67,1.299509,103.837
069463,151,666,817,1.299509,103.837
069464,23,32,55,1.299509,103.837
069465,0,49,49,1.299509,103.837
069467,79,172,251,1.299509,103.837
069468,332,1923,2255,1.299509,103.837
069469,83,715,798,1.299509,103.837
069470,261,3514,3775,1.299509,103.837
069471,36,19,55,1.299509,103.837
069531,220,2731,2951,1.299509,103.837
069532,120,792,912,1.299509,103.837
069533,1887,1037,2924,1.299509,103.837
069534,527,1836,2363,1.299509,103.837
069535,8823,16879,25702,1.299509,103.837
069536,1306,4460,5766,1.299509,103.837
069537,218,1439,1657,1.299509,103.837
069538,172,1065,1237,1.299509,103.837
069539,17,585,602,1.299509,103.837
069540,205,5167,5372,1.299509,103.837
069541,41,1359,1400,1.299509,103.837
069542,5109,9796,14905,1.299509,103.837
069543,124,11626,11750,1.299509,103.837
069544,1241,1872,3113,1.299509,103.837
069545,124,772,896,1.299509,103.837
069546,520,3640,4160,1.299509,103.837
069547,41,4830,4871,1.299509,103.837
069611,62,860,922,1.28169,103.847712
069612,114,346,460,1.299509,103.837
069613,64,321,385,1.299509,103.837
069614,110,626,736,1.299509,103.837
069615,21,86,107,1.299509,103.837
069616,17,97,114,1.281405,103.848229
069617,15,156,171,1.299509,103.837
069618,122,305,427,1.299509,103.837
069619,344,494,838,1.299509,103.837
069620,357,504,861,1.299509,103.837
069621,721,416,1137,1.299509,103.837
069622,357,375,732,1.299509,103.837
069623,110,436,546,1.299509,103.837
069624,183,555,738,1.299509,103.837
069625,842,1399,2241,1.281159,103.848733
069688,351,1695,2046,1.299509,103.837
069689,194,225,419,1.299509,103.837
069690,111,191,302,1.299509,103.837
069691,72,93,165,1.299509,103.837
069692,332,313,645,1.299509,103.837
069693,22,95,117,1.299509,103.837
069694,149,208,357,1.299509,103.837
069695,19,103,122,1.299509,103.837
069696,72,98,170,1.299509,103.837
069697,79,152,231,1.299509,103.837
069698,27,127,154,1.281134,103.845656
069699,21,141,162,1.299509,103.837
069700,24,98,122,1.299509,103.837
069701,2,141,143,1.299509,103.837
069702,99,78,177,1.299509,103.837
069703,157,147,304,1.280959,103.845854
069704,130,82,212,1.299509,103.837
069705,13,110,123,1.299509,103.837
069706,143,150,293,1.299509,103.837
069707,2,110,112,1.299509,103.837
069708,1570,285,1855,1.299509,103.837
069709,89,143,232,1.280856,103.845938
069710,131,653,784,1.299509,103.837
069711,10,115,125,1.299509,103.837
069712,30,203,233,1.299509,103.837
069713,14,207,221,1.280799,103.845977
069714,33,220,253,1.280759,103.846
069715,248,312,560,1.299509,103.837
069716,41,298,339,1.299509,103.837
069717,29,130,159,1.299509,103.837
069718,16,108,124,1.299509,103.837
069719,442,125,567,1.299509,103.837
069720,723,2757,3480,1.299509,103.837
069784,147,80,227,1.281573,103.845342
069785,32,60,92,1.299509,103.837
069786,130,204,334,1.299509,103.837
069787,58,89,147,1.299509,103.837
069788,58,116,174,1.299509,103.837
069789,200,1086,1286,1.299509,103.837
069791,55,13,68,1.299509,103.837
069854,218,2758,2976,1.299509,103.837
069855,72,371,443,1.299509,103.837
069856,98,478,576,1.299509,103.837
069857,95,594,689,1.299509,103.837
069858,170,1728,1898,1.299509,103.837
069864,19,330,349,1.299509,103.837
069865,18,111,129,1.280675,103.847017
069866,59,187,246,1.299509,103.837
069867,133,202,335,1.299509,103.837
069868,51,251,302,1.28053,103.846935
069869,18,175,193,1.28048,103.846917
069870,29,174,203,1.299509,103.837
069871,20,121,141,1.299509,103.837
069872,15,122,137,1.299509,103.837
069873,7,166,173,1.299509,103.837
069874,70,221,291,1.280314,103.846864
069875,30,221,251,1.280293,103.846857
069876,92,247,339,1.280221,103.846837
069877,43,267,310,1.299509,103.837
069878,80,243,323,1.299509,103.837
069879,17,200,217,1.299509,103.837
069880,9,201,210,1.299509,103.837
069881,9,172,181,1.299509,103.837
069882,6,138,144,1.299509,103.837
069883,48,143,191,1.299509,103.837
069884,41,626,667,1.299509,103.837
069886,26,297,323,1.299509,103.837
069887,16,59,75,1.299509,103.837
069888,15,28,43,1.299509,103.837
069889,44,90,134,1.299509,103.837
069890,115,67,182,1.299509,103.837
069891,72,62,134,1.280229,103.846779
069892,265,131,396,1.299509,103.837
069893,48,72,120,1.299509,103.837
069894,100,59,159,1.280338,103.846807
069895,109,49,158,1.299509,103.837
069896,308,74,382,1.299509,103.837
069897,250,90,340,1.299509,103.837
069898,7,58,65,1.280487,103.846864
069899,221,50,271,1.299509,103.837
069900,40,59,99,1.299509,103.837
069901,89,67,156,1.299509,103.837
069902,119,58,177,1.299509,103.837
069903,331,61,392,1.299509,103.837
069904,34,48,82,1.299509,103.837
069905,140,335,475,1.280894,103.847046
069906,256,280,536,1.299509,103.837
069907,499,302,801,1.299509,103.837
069908,65,289,354,1.299509,103.837
069909,229,322,551,1.299509,103.837
069911,160,461,621,1.299509,103.837
069913,101,427,528,1.299509,103.837
069914,27,116,143,1.281246,103.847265
069915,27,330,357,1.299509,103.837
069916,90,65,155,1.28132,103.847305
069917,157,57,214,1.299509,103.837
069918,174,50,224,1.299509,103.837
069919,341,148,489,1.299509,103.837
069920,135,677,812,1.299509,103.837
069921,272,697,969,1.299509,103.837
069922,177,406,583,1.299509,103.837
069923,82,471,553,1.281541,103.847442
069924,34,321,355,1.299509,103.837
069925,312,431,743,1.299509,103.837
069926,1,18,19,1.299509,103.837
069927,36,130,166,1.299509,103.837
069928,86,165,251,1.299509,103.837
069929,19,109,128,1.299509,103.837
069930,64,449,513,1.28185,103.847628
069931,67,546,613,1.299509,103.837
069932,425,162,587,1.299509,103.837
069933,52,292,344,1.299509,103.837
069934,32,210,242,1.299509,103.837
069935,1011,167,1178,1.299509,103.837
069936,434,3029,3463,1.299509,103.837
078862,2503,21278,23781,1.299509,103.837
078867,1905,6424,8329,1.299509,103.837
078872,22,171,193,1.274547,103.849652
078873,0,51,51,1.274547,103.849652
078877,102,4297,4399,1.299509,103.837
078878,7511,3592,11103,1.299509,103.837
078880,147,659,806,1.299509,103.837
078881,10276,3969,14245,1.299509,103.837
078882,33,1354,1387,1.299509,103.837
078883,194,872,1066,1.299509,103.837
078884,227,784,1011,1.299509,103.837
078885,57,1857,1914,1.299509,103.837
078972,65,877,942,1.299509,103.837
078973,396,910,1306,1.299509,103.837
078974,25,153,178,1.299509,103.837
078975,56,55,111,1.299509,103.837
078976,18,138,156,1.278357,103.844564
078977,266,33,299,1.299509,103.837
078978,25,103,128,1.299509,103.837
078979,24,63,87,1.299509,103.837
078980,27,104,131,1.299509,103.837
078981,80,81,161,1.278299,103.84433
078982,89,107,196,1.299509,103.837
078983,23,69,92,1.27826,103.844323
078984,17,133,150,1.299509,103.837
078985,45,98,143,1.299509,103.837
078986,42,116,158,1.299509,103.837
078987,87,101,188,1.299509,103.837
078988,113,222,335,1.299509,103.837
078989,195,120,315,1.299509,103.837
078990,56,162,218,1.299509,103.837
078991,15,88,103,1.299509,103.837
078992,35,124,159,1.299509,103.837
078993,228,106,334,1.299509,103.837
078994,134,212,346,1.299509,103.837
078995,729,127,856,1.27797,103.844273
078996,103,199,302,1.299509,103.837
078997,53,125,178,1.299509,103.837
078998,69,229,298,1.299509,103.837
078999,239,125,364,1.299509,103.837
079000,178,258,436,1.277818,103.844474
079001,246,139,385,1.299509,103.837
079002,62,248,310,1.277752,103.844471
079003,337,118,455,1.277798,103.844227
079004,41,206,247,1.299509,103.837
079005,513,53,566,1.299509,103.837
079006,51,154,205,1.277674,103.84444
079007,69,69,138,1.27762,103.844198
079008,231,159,390,1.299509,103.837
079009,45,58,103,1.277598,103.844198
079010,85,147,232,1.299509,103.837
079011,56,56,112,1.277561,103.844185
079012,171,101,272,1.299509,103.837
079013,79,78,157,1.277505,103.844184
079014,40,133,173,1.299509,103.837
079015,144,68,212,1.277458,103.844177
079016,21,99,120,1.299509,103.837
079017,33,51,84,1.299509,103.837
079018,21,109,130,1.277377,103.844383
079019,22,66,88,1.299509,103.837
079020,4,86,90,1.299509,103.837
079021,1,97,98,1.299509,103.837
079022,114,974,1088,1.277295,103.844362
079023,12,2637,2649,1.299509,103.837
079024,194,604,798,1.299509,103.837
079025,1071,1828,2899,1.299509,103.837
079026,271,210,481,1.299509,103.837
079027,1375,2097,3472,1.299509,103.837
079117,2534,5342,7876,1.299509,103.837
079118,18,550,568,1.299509,103.837
079119,1267,2555,3822,1.299509,103.837
079120,3729,2487,6216,1.299509,103.837
079212,8,64,72,1.299509,103.837
079213,5,268,273,1.299509,103.837
079305,701,1411,2112,1.299509,103.837
079312,183,695,878,1.299509,103.837
079313,11,471,482,1.299509,103.837
079314,442,164,606,1.299509,103.837
079315,48,593,641,1.299509,103.837
079316,24,248,272,1.299509,103.837
079317,930,141,1071,1.299509,103.837
079318,1,113,114,1.277911,103.844876
079319,10,78,88,1.299509,103.837
079320,3,48,51,1.299509,103.837
079321,54,35,89,1.299509,103.837
079322,1,27,28,1.299509,103.837
079323,68,39,107,1.299509,103.837
079324,3,41,44,1.277611,103.844819
079325,4,26,30,1.277555,103.844814
079326,10,80,90,1.299509,103.837
079327,349,92,441,1.299509,103.837
079328,18,97,115,1.299509,103.837
079329,184,86,270,1.299509,103.837
079330,1,146,147,1.299509,103.837
079331,80,560,640,1.277253,103.844759
079332,45,2616,2661,1.299509,103.837
079333,9452,4284,13736,1.299509,103.837
079423,1,112,113,1.272833,103.847588
079424,118,115,233,1.299509,103.837
079426,9,409,418,1.299509,103.837
079427,138,316,454,1.299509,103.837
079428,10,173,183,1.299509,103.837
079519,46,1050,1096,1.299509,103.837
079520,16,3,19,1.299509,103.837
079521,1,4,5,1.279704,103.844381
079522,2,2,4,1.299509,103.837
079523,0,1,1,1.279478,103.844451
079524,0,1,1,1.299509,103.837
079525,1,3,4,1.279712,103.844397
079526,1,6,7,1.279712,103.844397
079527,1,6,7,1.299509,103.837
079528,0,5,5,1.279647,103.844385
079529,0,6,6,1.299509,103.837
079530,2,23,25,1.299509,103.837
079531,2,53,55,1.299509,103.837
079532,6,201,207,1.299509,103.837
079624,1625,610,2235,1.299509,103.837
079716,928,3673,4601,1.299509,103.837
079717,3183,1939,5122,1.299509,103.837
079718,2276,1835,4111,1.299509,103.837
079809,80,4236,4316,1.299509,103.837
079902,35,1390,1425,1.274931,103.845837
079903,16033,3589,19622,1.276109,103.845924
079904,404,1194,1598,1.274627,103.845714
079905,526,9544,10070,1.274056,103.844805
079906,313,2688,3001,1.274231,103.845569
079907,5734,13071,18805,1.273208,103.843634
079908,9341,11589,20930,1.273803,103.845034
079909,5181,79043,84224,1.27518,103.84624
079911,412,13909,14321,1.27372,103.844486
079912,7603,5427,13030,1.275207,103.845748
079914,8990,5414,14404,1.274743,103.845494
080001,651,19,670,1.299509,103.837
080003,157,230,387,1.299509,103.837
080004,169,138,307,1.276955,103.84009
080005,283,238,521,1.299509,103.837
080006,335,207,542,1.299509,103.837
080007,133,664,797,1.299509,103.837
080008,170,473,643,1.299509,103.837
080009,262,833,1095,1.299509,103.837
080010,47,259,306,1.274218,103.839021
080011,673,157,830,1.299509,103.837
080012,710,448,1158,1.274454,103.840043
080013,480,580,1060,1.274679,103.840444
080014,1,19,20,1.274521,103.840339
080015,1,11,12,1.274099,103.84032
080016,258,184,442,1.299509,103.837
080017,320,1740,2060,1.299509,103.837
080018,375,1737,2112,1.299509,103.837
080019,515,2329,2844,1.273841,103.839037
080020,6,6,12,1.274169,103.83952
080101,309,143,452,1.299509,103.837
080102,642,3798,4440,1.299509,103.837
080103,149,40,189,1.299509,103.837
080104,66,4,70,1.27443,103.83486
080105,643,37,680,1.299509,103.837
080106,409,1697,2106,1.299509,103.837
080107,575,1466,2041,1.299509,103.837
080108,826,379,1205,1.299509,103.837
080109,322,122,444,1.299509,103.837
080333,235,483,718,1.299509,103.837
080334,160,3121,3281,1.281699,103.842327
081001,357,5194,5551,1.299509,103.837
081002,273,691,964,1.277416,103.83927
081003,109,226,335,1.299509,103.837
081004,55,457,512,1.299509,103.837
081005,482,1446,1928,1.299509,103.837
081006,100,3232,3332,1.276671,103.84295
081007,174,2016,2190,1.299509,103.837
081008,1005,1368,2373,1.299509,103.837
081110,292,3322,3614,1.299509,103.837
082001,814,7283,8097,1.299509,103.837
082002,108,4193,4301,1.299509,103.837
082003,15,635,650,1.299509,103.837
082006,10,470,480,1.276241,103.838805
083001,16,5451,5467,1.299509,103.837
085101,1125,1407,2532,1.277898,103.840963
085201,1140,106,1246,1.27799,103.84122
085301,1032,134,1166,1.277437,103.841695
085401,868,100,968,1.299509,103.837
085501,1248,6389,7637,1.276639,103.841152
085601,1078,2845,3923,1.299509,103.837
085701,723,1238,1961,1.299509,103.837
088109,1,0,1,1.299509,103.837
088256,297,269,566,1.299509,103.837
088262,40,263,303,1.299509,103.837
088263,30,111,141,1.299509,103.837
088264,43,15,58,1.288097,103.842754
088265,3,37,40,1.276367,103.842146
088266,10,7,17,1.299509,103.837
088267,10,48,58,1.299509,103.837
088268,24,127,151,1.299509,103.837
088271,517,218,735,1.275296,103.841653
088321,126,3395,3521,1.299509,103.837
088322,72,545,617,1.299509,103.837
088323,81,3423,3504,1.299509,103.837
088324,17,106,123,1.28028,103.840802
088325,44,14,58,1.299509,103.837
088326,16,330,346,1.299509,103.837
088327,9,65,74,1.280145,103.840774
088328,20,190,210,1.299509,103.837
088329,17,201,218,1.299509,103.837
088330,11,158,169,1.279996,103.840746
088331,40,144,184,1.299509,103.837
088332,37,80,117,1.299509,103.837
088333,8,16,24,1.299509,103.837
088334,63,45,108,1.299509,103.837
088335,81,62,143,1.299509,103.837
088336,34,994,1028,1.299509,103.837
088337,15,7,22,1.299509,103.837
088379,25,173,198,1.299509,103.837
088380,143,76,219,1.299509,103.837
088381,18,33,51,1.299509,103.837
088382,14,18,32,1.299509,103.837
088383,27,67,94,1.299509,103.837
088384,7,37,44,1.299509,103.837
088385,403,83,486,1.299509,103.837
088386,297,35,332,1.299509,103.837
088387,290,49,339,1.299509,103.837
088388,34,86,120,1.299509,103.837
088389,2,82,84,1.280468,103.841968
088390,283,56,339,1.299509,103.837
088391,323,59,382,1.299509,103.837
088392,680,573,1253,1.299509,103.837
088394,48,267,315,1.299509,103.837
088437,331,2072,2403,1.299509,103.837
088438,63,1622,1685,1.299509,103.837
088439,53,1166,1219,1.279881,103.844
088440,29,586,615,1.279579,103.844032
088441,23,296,319,1.299509,103.837
088442,51,839,890,1.299509,103.837
088443,42,193,235,1.299509,103.837
088444,573,490,1063,1.299509,103.837
088445,32,1039,1071,1.299509,103.837
088446,65,975,1040,1.299509,103.837
088447,11,86,97,1.299509,103.837
088448,103,1031,1134,1.299509,103.837
088449,51,359,410,1.299509,103.837
088450,379,628,1007,1.27932,103.84401
088451,29,1527,1556,1.299509,103.837
088452,43,738,781,1.299509,103.837
088453,82,676,758,1.299509,103.837
088454,247,1216,1463,1.299509,103.837
088455,86,1820,1906,1.299509,103.837
088456,140,436,576,1.299509,103.837
088457,5,213,218,1.299509,103.837
088458,33,1217,1250,1.279133,103.844001
088459,32,1094,1126,1.299509,103.837
088460,299,789,1088,1.279081,103.843997
088461,1545,5065,6610,1.299509,103.837
088462,21,407,428,1.299509,103.837
088463,53,1000,1053,1.299509,103.837
088464,166,1970,2136,1.299509,103.837
088465,173,3485,3658,1.299509,103.837
088467,48,469,517,1.27932,103.843818
088468,60,2526,2586,1.299509,103.837
088469,88,1249,1337,1.299509,103.837
088470,25,375,400,1.299509,103.837
088471,25,332,357,1.299509,103.837
088472,29,708,737,1.299509,103.837
088473,61,480,541,1.299509,103.837
088474,26,1049,1075,1.299509,103.837
088475,34,829,863,1.299509,103.837
088476,12,336,348,1.278468,103.843987
088477,51,677,728,1.299509,103.837
088478,6,338,344,1.299509,103.837
088479,24,494,518,1.279038,103.843854
088480,89,478,567,1.278383,103.843969
088481,111,1653,1764,1.299509,103.837
088482,34,577,611,1.278322,103.843953
088483,57,891,948,1.278973,103.843865
088484,88,648,736,1.299509,103.837
088485,27,828,855,1.299509,103.837
088486,31,755,786,1.278238,103.843927
088487,37,1579,1616,1.299509,103.837
088488,27,580,607,1.299509,103.837
088489,518,1039,1557,1.299509,103.837
088490,40,337,377,1.299509,103.837
088491,4,557,561,1.299509,103.837
088492,18,552,570,1.299509,103.837
088493,37,537,574,1.299509,103.837
088494,72,595,667,1.299509,103.837
088495,2,520,522,1.299509,103.837
088496,50,594,644,1.299509,103.837
088497,51,392,443,1.299509,103.837
088498,71,498,569,1.299509,103.837
088499,23,582,605,1.299509,103.837
088500,20,198,218,1.299509,103.837
088501,90,210,300,1.299509,103.837
088502,20,52,72,1.299509,103.837
088503,3,246,249,1.278499,103.843843
088504,181,646,827,1.299509,103.837
088505,3,374,377,1.299509,103.837
088506,46,938,984,1.299509,103.837
088507,59,202,261,1.299509,103.837
088508,57,1631,1688,1.277662,103.84377
088509,40,420,460,1.299509,103.837
088510,170,821,991,1.277613,103.843767
088511,3,246,249,1.278406,103.843812
088512,28,655,683,1.299509,103.837
088513,3,423,426,1.278323,103.843781
088514,25,555,580,1.277544,103.843767
088515,14,248,262,1.278283,103.843762
088516,68,818,886,1.277489,103.843759
088517,48,370,418,1.278229,103.843747
088518,102,822,924,1.277435,103.843758
088519,24,308,332,1.278193,103.843741
088520,52,738,790,1.277382,103.84375
088521,29,307,336,1.278165,103.843727
088522,248,8197,8445,1.277318,103.843754
088523,6,225,231,1.299509,103.837
088524,17,282,299,1.299509,103.837
088525,4,451,455,1.278068,103.843674
088526,20,252,272,1.278024,103.843659
088527,14,379,393,1.277973,103.843618
088528,26,215,241,1.277939,103.843604
088529,29,325,354,1.277898,103.84359
088530,33,200,233,1.277876,103.84358
088531,13,601,614,1.277819,103.843575
088532,30,358,388,1.27778,103.843573
088533,13,232,245,1.277716,103.843565
088534,59,267,326,1.277667,103.843565
088535,13,526,539,1.277589,103.843557
088536,16,332,348,1.27754,103.843549
088537,25,464,489,1.299509,103.837
088538,192,4657,4849,1.299509,103.837
088539,8086,55568,63654,1.299509,103.837
088540,193,5921,6114,1.274361,103.842777
088541,638,2516,3154,1.299509,103.837
088542,102,2433,2535,1.299509,103.837
088543,109,34346,34455,1.273318,103.84312
088628,13,43,56,1.299509,103.837
088629,1,4,5,1.299509,103.837
088630,2,0,2,1.299509,103.837
088631,3,59,62,1.299509,103.837
088632,6,21,27,1.299509,103.837
088633,7,34,41,1.299509,103.837
088634,11,84,95,1.299509,103.837
088635,24,247,271,1.299509,103.837
088636,11,208,219,1.299509,103.837
088637,1,138,139,1.299509,103.837
088638,13,83,96,1.299509,103.837
088639,18,60,78,1.299509,103.837
088640,17,428,445,1.299509,103.837
088641,8,302,310,1.299509,103.837
088642,2745,2183,4928,1.299509,103.837
088643,12,182,194,1.299509,103.837
088644,6,21,27,1.299509,103.837
088646,22,27,49,1.299509,103.837
088647,9,29,38,1.299509,103.837
088648,21,17,38,1.299509,103.837
088649,13,100,113,1.299509,103.837
088650,4,0,4,1.299509,103.837
088651,9,1,10,1.299509,103.837
088652,74,41,115,1.299509,103.837
088653,7,44,51,1.299509,103.837
088654,173,0,173,1.299509,103.837
088655,24,0,24,1.352083,103.819836
088656,4,1,5,1.299509,103.837
088658,115,11,126,1.299509,103.837
088659,49,1558,1607,1.299509,103.837
088660,5459,450,5909,1.299509,103.837
088661,15,11,26,1.299509,103.837
088702,6923,693,7616,1.299509,103.837
088745,99,10828,10927,1.299509,103.837
088746,19,770,789,1.282489,103.842357
088747,5,621,626,1.352083,103.819836
088748,1,267,268,1.28242,103.842278
088749,7,913,920,1.299509,103.837
088750,33,232,265,1.282343,103.842189
088751,7,476,483,1.299509,103.837
088752,6,900,906,1.299509,103.837
088753,0,233,233,1.299509,103.837
088754,2,206,208,1.282129,103.842153
088755,9,4264,4273,1.299509,103.837
088756,212,4220,4432,1.299509,103.837
088757,44,1848,1892,1.352083,103.819836
088758,7,537,544,1.299509,103.837
088759,14,463,477,1.280926,103.840991
088760,131,1139,1270,1.299509,103.837
088761,33,1897,1930,1.299509,103.837
088762,1273,1249,2522,1.299509,103.837
088763,71,505,576,1.299509,103.837
088764,291,3579,3870,1.299509,103.837
088765,3808,5467,9275,1.299509,103.837
088794,59,2451,2510,1.299509,103.837
088804,49,1605,1654,1.299509,103.837
088805,10,34,44,1.299509,103.837
088806,22,48,70,1.280251,103.843649
088807,6,7,13,1.299509,103.837
088808,4,24,28,1.299509,103.837
088809,1,38,39,1.280193,103.843525
088810,7,6,13,1.352083,103.819836
088811,2,25,27,1.299509,103.837
088812,4,22,26,1.280127,103.843445
088813,20,30,50,1.299509,103.837
088814,79,68,147,1.299509,103.837
088815,2,25,27,1.280055,103.843335
088816,23,221,244,1.280026,103.843289
088817,39,1249,1288,1.279992,103.843228
088818,50,2076,2126,1.299509,103.837
088819,46,197,243,1.299509,103.837
088820,46,162,208,1.299509,103.837
088821,41,171,212,1.299509,103.837
088822,11,246,257,1.299509,103.837
088823,100,484,584,1.299509,103.837
088824,102,1651,1753,1.299509,103.837
088825,73,1705,1778,1.299509,103.837
088826,87,1480,1567,1.299509,103.837
088827,81,1242,1323,1.299509,103.837
088828,122,1328,1450,1.299509,103.837
088829,236,725,961,1.299509,103.837
088830,278,355,633,1.299509,103.837
088831,4,0,4,1.279777,103.842657
088832,1,2,3,1.279764,103.842606
088833,14,21,35,1.299509,103.837
088834,4,5,9,1.280003,103.842214
088835,31,4,35,1.299509,103.837
088836,3,6,9,1.299509,103.837
088837,4,4,8,1.299509,103.837
088838,29,0,29,1.299509,103.837
088839,85,698,783,1.299509,103.837
088840,31,1175,1206,1.27968,103.842498
088841,157,903,1060,1.299509,103.837
088842,33,1630,1663,1.299509,103.837
088843,28,840,868,1.299509,103.837
088844,98,363,461,1.299509,103.837
088846,8,313,321,1.299509,103.837
088848,32,194,226,1.299509,103.837
088849,861,5119,5980,1.299509,103.837
088850,3,343,346,1.299509,103.837
088851,15,621,636,1.299509,103.837
088852,158,1752,1910,1.299509,103.837
088853,95,661,756,1.299509,103.837
088854,106,387,493,1.299509,103.837
088855,17,362,379,1.299509,103.837
088856,157,4776,4933,1.278985,103.841645
088857,29,2576,2605,1.299509,103.837
088858,21,1709,1730,1.299509,103.837
088859,20,737,757,1.299509,103.837
088860,16,2297,2313,1.277424,103.838005
088861,7,492,499,1.299509,103.837
088862,1,22,23,1.299509,103.837
088863,155,1523,1678,1.299509,103.837
088864,26,627,653,1.299509,103.837
088865,609,725,1334,1.299509,103.837
088866,5,31,36,1.299509,103.837
088867,13,138,151,1.278254,103.840996
088868,7,232,239,1.299509,103.837
088869,81,336,417,1.299509,103.837
088871,28,179,207,1.299509,103.837
088872,30,86,116,1.299509,103.837
088873,5,137,142,1.299509,103.837
088874,14,0,14,1.299509,103.837
088875,52,53,105,1.299509,103.837
088876,2,0,2,1.277351,103.837603
088877,39,667,706,1.299509,103.837
088878,2,0,2,1.299509,103.837
088879,43,1122,1165,1.278088,103.840627
088880,3,457,460,1.277338,103.837498
088881,7,1,8,1.299509,103.837
088882,23,495,518,1.277326,103.837413
088883,80,1,81,1.299509,103.837
088884,9,635,644,1.299509,103.837
088885,19,923,942,1.299509,103.837
088886,11,1,12,1.299509,103.837
088887,35,46,81,1.27728,103.83709
088888,7,947,954,1.277279,103.837061
088889,60,4779,4839,1.299509,103.837
088890,50,5560,5610,1.299509,103.837
088891,128,588,716,1.279661,103.842588
088892,45,1763,1808,1.299509,103.837
088893,59,778,837,1.299509,103.837
088894,30,996,1026,1.27958,103.84247
088895,4,651,655,1.299509,103.837
088896,35,571,606,1.299509,103.837
088897,40,662,702,1.299509,103.837
088898,36,541,577,1.279448,103.842338
088899,18,253,271,1.299509,103.837
088900,516,133,649,1.279389,103.842289
088901,21,160,181,1.299509,103.837
088902,260,267,527,1.299509,103.837
088903,94,507,601,1.299509,103.837
088904,46,432,478,1.299509,103.837
088905,31,656,687,1.299509,103.837
088933,62,948,1010,1.299509,103.837
088934,882,2215,3097,1.299509,103.837
088935,22,66,88,1.299509,103.837
088936,14,351,365,1.273516,103.842631
088937,38,599,637,1.273532,103.842573
088938,33,461,494,1.299509,103.837
088981,5,157,162,1.299509,103.837
088982,3,65,68,1.299509,103.837
088983,132,59,191,1.299509,103.837
088984,10,677,687,1.299509,103.837
088985,790,8,798,1.299509,103.837
088986,1,28,29,1.299509,103.837
088988,7,341,348,1.299509,103.837
088989,0,1,1,1.280401,103.842505
088991,14,146,160,1.299509,103.837
088992,7,108,115,1.299509,103.837
088993,86,191,277,1.299509,103.837
088994,22,153,175,1.280585,103.842366
088995,14,162,176,1.299509,103.837
088996,17,266,283,1.299509,103.837
088997,40,153,193,1.299509,103.837
088998,96,537,633,1.299509,103.837
088999,23,479,502,1.299509,103.837
089000,27,448,475,1.280739,103.842289
089001,22,216,238,1.299509,103.837
089002,29,256,285,1.280833,103.842247
089003,34,394,428,1.299509,103.837
089004,695,652,1347,1.299509,103.837
089005,36,450,486,1.280941,103.842198
089006,59,323,382,1.280993,103.842173
089007,54,848,902,1.281098,103.842125
089008,116,6813,6929,1.281187,103.842077
089053,1835,2795,4630,1.299509,103.837
089054,64,50,114,1.299509,103.837
089055,962,0,962,1.299509,103.837
089057,108,986,1094,1.299509,103.837
089058,377,1430,1807,1.299509,103.837
089059,144,1704,1848,1.299509,103.837
089064,822,530,1352,1.299509,103.837
089065,1141,484,1625,1.299509,103.837
089066,373,7559,7932,1.299509,103.837
089067,57,1603,1660,1.299509,103.837
089069,39,350,389,1.299509,103.837
089109,1377,321,1698,1.297778,103.854333
089110,28,753,781,1.279311,103.84161
089111,12,36,48,1.279234,103.841465
089112,22,67,89,1.279342,103.841597
089113,36,417,453,1.297778,103.854333
089114,31,168,199,1.279451,103.841602
089115,202,33,235,1.297778,103.854333
089116,78,360,438,1.279512,103.84158
089117,95,3,98,1.297778,103.854333
089118,2,1,3,1.299509,103.837
089119,85,1494,1579,1.297778,103.854333
089120,4,247,251,1.297778,103.854333
089121,171,152,323,1.297778,103.854333
089122,54,792,846,1.297778,103.854333
089123,4,73,77,1.297778,103.854333
089124,10,17,27,1.279733,103.841484
089125,60,358,418,1.279948,103.841632
089126,71,936,1007,1.279779,103.84149
089127,89,544,633,1.279996,103.841635
089128,223,0,223,1.297778,103.854333
089129,27,8,35,1.297778,103.854333
089130,20,2,22,1.297778,103.854333
089131,46,377,423,1.297778,103.854333
089132,49,18,67,1.279902,103.841498
089133,63,239,302,1.280145,103.841684
089134,1,32,33,1.297778,103.854333
089135,194,430,624,1.297778,103.854333
089136,285,9,294,1.27998,103.841516
089137,84,287,371,1.280252,103.84171
089138,118,467,585,1.297778,103.854333
089139,24,263,287,1.297778,103.854333
089140,3,1,4,1.280072,103.84152
089141,56,691,747,1.297778,103.854333
089142,142,78,220,1.297778,103.854333
089143,546,2301,2847,1.297778,103.854333
089144,628,0,628,1.297778,103.854333
089145,128,218,346,1.297778,103.854333
089146,11,6,17,1.297778,103.854333
089147,81,60,141,1.297778,103.854333
089149,27,0,27,1.297778,103.854333
089151,105,302,407,1.280467,103.841634
089152,2,1312,1314,1.280845,103.841768
089153,50,90,140,1.28052,103.841647
089154,600,331,931,1.280932,103.841789
089158,1812,389,2201,1.280638,103.841614
089165,471,227,698,1.281008,103.841752
089167,90,1147,1237,1.281252,103.841856
089168,36,2126,2162,1.282094,103.842345
089169,16,733,749,1.297778,103.854333
089170,53,2492,2545,1.282264,103.842447
089172,134,5752,5886,1.282454,103.842519
089218,98,999,1097,1.299509,103.837
089260,341,651,992,1.299509,103.837
089261,77,117,194,1.299509,103.837
089262,126,140,266,1.299509,103.837
089263,336,111,447,1.299509,103.837
089264,43,51,94,1.279815,103.841911
089265,2,36,38,1.299509,103.837
089266,46,4,50,1.299509,103.837
089267,184,158,342,1.299509,103.837
089310,16,918,934,1.299509,103.837
089311,24,257,281,1.299509,103.837
089312,28,74,102,1.299509,103.837
089313,19,385,404,1.299509,103.837
089314,6,711,717,1.274037,103.842401
089315,12427,6564,18991,1.299509,103.837
089316,2611,5727,8338,1.299509,103.837
089359,8,61,69,1.299509,103.837
089360,59,13,72,1.299509,103.837
089361,9,28,37,1.299509,103.837
089362,160,1,161,1.299509,103.837
089363,90,43,133,1.299509,103.837
089364,4,87,91,1.276873,103.838122
089365,2,120,122,1.299509,103.837
089366,94,433,527,1.299509,103.837
089367,21,12,33,1.299509,103.837
089368,0,3,3,1.297778,103.854333
089369,5,4,9,1.299509,103.837
089370,23,4,27,1.276675,103.837781
089371,0,3,3,1.299509,103.837
089372,5,11,16,1.299509,103.837
089373,31,5,36,1.299509,103.837
089374,29,14,43,1.299509,103.837
089375,10,6,16,1.276629,103.837429
089376,59,8,67,1.299509,103.837
089377,14,6,20,1.276635,103.837294
089378,0,1,1,1.299509,103.837
089379,3,11,14,1.299509,103.837
089380,4,2,6,1.299509,103.837
089381,257,22,279,1.299509,103.837
089382,58,44,102,1.299509,103.837
089383,1,8,9,1.299509,103.837
089384,10,7,17,1.299509,103.837
089385,12,12,24,1.299509,103.837
089386,1,5,6,1.299509,103.837
089387,1,11,12,1.299509,103.837
089388,1,26,27,1.299509,103.837
089389,13,39,52,1.299509,103.837
089390,8,46,54,1.299509,103.837
089391,3,55,58,1.299509,103.837
089392,29,35,64,1.299509,103.837
089393,20,1455,1475,1.299509,103.837
089394,700,62,762,1.299509,103.837
089481,72,55,127,1.299509,103.837
089482,58,12,70,1.299509,103.837
089483,61,23,84,1.299509,103.837
089484,118,17,135,1.299509,103.837
089485,109,13,122,1.299509,103.837
089486,39,27,66,1.299509,103.837
089487,46,496,542,1.299509,103.837
089488,173,1223,1396,1.299509,103.837
089489,26,167,193,1.279303,103.843408
089490,212,119,331,1.352083,103.819836
089492,2,0,2,1.299509,103.837
089493,41,16,57,1.299509,103.837
089494,40,102,142,1.299509,103.837
089495,23,119,142,1.299509,103.837
089496,70,96,166,1.299509,103.837
089497,14,62,76,1.299509,103.837
089498,84,88,172,1.299509,103.837
089499,28,74,102,1.299509,103.837
089500,56,88,144,1.278905,103.843447
089501,12,126,138,1.299509,103.837
089502,38,263,301,1.278817,103.843445
089503,128,275,403,1.278767,103.843442
089504,55,107,162,1.299509,103.837
089505,30,100,130,1.278664,103.843433
089506,49,91,140,1.278606,103.843434
089507,21,112,133,1.299509,103.837
089508,21,180,201,1.299509,103.837
089509,15,351,366,1.278514,103.843439
089510,53,236,289,1.299509,103.837
089511,28,198,226,1.278439,103.843409
089512,124,206,330,1.299509,103.837
089513,259,219,478,1.299509,103.837
089514,288,196,484,1.299509,103.837
089515,56,94,150,1.299509,103.837
089516,148,132,280,1.278253,103.84333
089517,36,141,177,1.299509,103.837
089518,15,134,149,1.299509,103.837
089519,8,142,150,1.299509,103.837
089520,89,262,351,1.299509,103.837
089521,23,142,165,1.278042,103.843222
089522,62,230,292,1.299509,103.837
089523,63,223,286,1.277945,103.843154
089524,213,547,760,1.299509,103.837
089525,30,11,41,1.299509,103.837
089526,2,226,228,1.299509,103.837
089527,204,33,237,1.299509,103.837
089528,0,2,2,1.299509,103.837
089529,200,123,323,1.299509,103.837
089530,21,50,71,1.278022,103.843091
089531,21,58,79,1.2781,103.843138
089532,148,52,200,1.299509,103.837
089533,90,24,114,1.299509,103.837
089534,24,30,54,1.299509,103.837
089535,10,26,36,1.278305,103.843212
089536,172,35,207,1.299509,103.837
089537,115,27,142,1.299509,103.837
089538,38,34,72,1.299509,103.837
089539,6,74,80,1.299509,103.837
089540,68,154,222,1.299509,103.837
089541,29,974,1003,1.299509,103.837
089542,9,42,51,1.299509,103.837
089543,197,18,215,1.279596,103.843248
089544,8,42,50,1.299509,103.837
089587,104,10,114,1.299509,103.837
089588,66,188,254,1.299509,103.837
089589,265,116,381,1.299509,103.837
089590,285,196,481,1.352083,103.819836
089591,333,192,525,1.299509,103.837
089592,205,225,430,1.299509,103.837
089593,18,70,88,1.299509,103.837
089594,245,537,782,1.299509,103.837
089595,1276,332,1608,1.299509,103.837
089596,18,190,208,1.299509,103.837
089597,973,1277,2250,1.299509,103.837
089598,474,71,545,1.299509,103.837
089599,87,0,87,1.299509,103.837
089600,1,1,2,1.299509,103.837
089601,47,0,47,1.299509,103.837
089602,52,0,52,1.352083,103.819836
089603,16,0,16,1.352083,103.819836
089604,72,0,72,1.299509,103.837
089605,37,0,37,1.278384,103.842659
089606,79,0,79,1.278324,103.842646
089607,57,0,57,1.299509,103.837
089608,21,4,25,1.299509,103.837
089609,9,1,10,1.299509,103.837
089610,23,4,27,1.299509,103.837
089611,0,9,9,1.299509,103.837
089612,22,4,26,1.299509,103.837
089613,28,0,28,1.299509,103.837
089614,71,1,72,1.299509,103.837
089615,77,0,77,1.299509,103.837
089616,97,0,97,1.299509,103.837
089617,9,0,9,1.299509,103.837
089618,322,1,323,1.299509,103.837
089619,198,10,208,1.299509,103.837
089662,121,2168,2289,1.299509,103.837
089663,35,541,576,1.299509,103.837
089664,24,527,551,1.299509,103.837
089665,79,777,856,1.299509,103.837
089666,35,847,882,1.299509,103.837
089667,152,2860,3012,1.299509,103.837
089668,150,1296,1446,1.299509,103.837
089669,29,307,336,1.299509,103.837
089670,35,269,304,1.299509,103.837
089671,274,270,544,1.299509,103.837
089672,42,612,654,1.299509,103.837
089673,368,634,1002,1.299509,103.837
089674,98,140,238,1.299509,103.837
089675,22,69,91,1.299509,103.837
089676,318,268,586,1.299509,103.837
089677,16,291,307,1.299509,103.837
089678,18,117,135,1.299509,103.837
089679,23,75,98,1.299509,103.837
089680,9,96,105,1.299509,103.837
089681,13,79,92,1.278123,103.8421
089682,6,104,110,1.299509,103.837
089683,5,109,114,1.299509,103.837
089684,3,160,163,1.299509,103.837
089685,28,102,130,1.299509,103.837
089686,6,62,68,1.299509,103.837
089687,15,83,98,1.299509,103.837
089688,36,160,196,1.299509,103.837
089689,20,333,353,1.299509,103.837
089690,52,226,278,1.299509,103.837
089691,161,1144,1305,1.299509,103.837
089692,1284,427,1711,1.299509,103.837
089734,8,377,385,1.299509,103.837
089735,8,62,70,1.299509,103.837
089736,6,56,62,1.299509,103.837
089737,4,65,69,1.299509,103.837
089739,40,201,241,1.299509,103.837
089740,28,440,468,1.279172,103.84017
089741,71,213,284,1.279131,103.840188
089742,0,48,48,1.299509,103.837
089743,1,36,37,1.299509,103.837
089744,1,67,68,1.299509,103.837
089745,54,236,290,1.299509,103.837
089746,86,89,175,1.299509,103.837
089747,25,58,83,1.299509,103.837
089748,24,138,162,1.299509,103.837
089749,2,177,179,1.299509,103.837
089750,77,121,198,1.299509,103.837
089752,7,61,68,1.278742,103.840424
089753,2,38,40,1.299509,103.837
089754,10,51,61,1.299509,103.837
089755,2,53,55,1.352083,103.819836
089756,44,45,89,1.299509,103.837
089757,73,136,209,1.278539,103.840542
089758,3,25,28,1.278494,103.840567
089759,10,126,136,1.27832,103.840374
089760,987,5896,6883,1.276612,103.840361
089761,7,5729,5736,1.299509,103.837
089762,1172,4238,5410,1.299509,103.837
089763,6276,2058,8334,1.299509,103.837
089764,37,2885,2922,1.299509,103.837
089765,3,330,333,1.299509,103.837
089766,1,1,2,1.275094,103.841145
089767,44,242,286,1.299509,103.837
089768,3,51,54,1.299509,103.837
089769,4,466,470,1.299509,103.837
089770,21,120,141,1.299509,103.837
089771,6,444,450,1.299509,103.837
089772,39,1390,1429,1.274354,103.841368
089774,158,2409,2567,1.299509,103.837
089775,1339,3913,5252,1.299509,103.837
089816,336,161,497,1.299509,103.837
089817,118,141,259,1.299509,103.837
089818,17,19,36,1.299509,103.837
089819,4,61,65,1.299509,103.837
089820,194,33,227,1.278769,103.841019
089821,40,76,116,1.278685,103.840676
089822,53,119,172,1.299509,103.837
089823,57,90,147,1.299509,103.837
089824,26,17,43,1.299509,103.837
089825,49,77,126,1.278792,103.840624
089826,5,72,77,1.278891,103.840907
089827,12,46,58,1.299509,103.837
089828,6,42,48,1.299509,103.837
089829,7,35,42,1.299509,103.837
089830,5,4,9,1.299509,103.837
089831,271,42,313,1.299509,103.837
089832,84,140,224,1.299509,103.837
089833,122,53,175,1.299509,103.837
089834,172,141,313,1.299509,103.837
089835,27,38,65,1.279023,103.840529
089836,6,74,80,1.299509,103.837
089837,6,43,49,1.299509,103.837
089838,4,37,41,1.278926,103.84087
089839,11,0,11,1.299509,103.837
089840,6,25,31,1.299509,103.837
089841,9,57,66,1.299509,103.837
089842,60,75,135,1.299509,103.837
089843,37,156,193,1.299509,103.837
089844,32,87,119,1.299509,103.837
089845,977,60,1037,1.299509,103.837
089846,43,64,107,1.299509,103.837
089848,10,37,47,1.299509,103.837
089849,12,166,178,1.299509,103.837
089850,46,10,56,1.279519,103.840835
089851,174,0,174,1.299509,103.837
089852,2,0,2,1.299509,103.837
089854,109,2,111,1.299509,103.837
089855,1138,89,1227,1.299509,103.837
089856,30,549,579,1.299509,103.837
089857,90,738,828,1.279778,103.840491
089858,855,206,1061,1.299509,103.837
089859,37,1635,1672,1.279812,103.840457
089902,2,0,2,1.276556,103.836603
089903,57,73,130,1.299509,103.837
089904,5,0,5,1.299509,103.837
089905,118,10,128,1.299509,103.837
089906,12,3,15,1.299509,103.837
089907,27,0,27,1.299509,103.837
089908,17,4,21,1.299509,103.837
089909,8,0,8,1.299509,103.837
089910,22,3,25,1.276539,103.836502
089911,14,12,26,1.276333,103.836336
089912,11,9,20,1.299509,103.837
089914,1,1,2,1.299509,103.837
089915,0,3,3,1.299509,103.837
089916,1,15,16,1.299509,103.837
089917,3,13,16,1.299509,103.837
089918,1,12,13,1.299509,103.837
089919,138,11,149,1.299509,103.837
089920,8,11,19,1.276408,103.836291
089921,10,4,14,1.299509,103.837
089922,72,7,79,1.299509,103.837
089923,11,12,23,1.299509,103.837
089924,302,23,325,1.299509,103.837
089925,5,12,17,1.299509,103.837
089926,10,12,22,1.299509,103.837
089927,54,9,63,1.299509,103.837
089928,22,7,29,1.276319,103.836191
089929,6,8,14,1.276118,103.836126
089930,45,21,66,1.276289,103.836153
089931,13,4,17,1.299509,103.837
089932,0,18,18,1.299509,103.837
089933,9,6,15,1.299509,103.837
089934,28,8,36,1.299509,103.837
089935,0,6,6,1.276021,103.836018
089936,0,11,11,1.299509,103.837
089937,363,15,378,1.299509,103.837
089938,12,13,25,1.299509,103.837
089939,19,9,28,1.299509,103.837
089940,214,11,225,1.276125,103.835941
089941,65,12,77,1.299509,103.837
089942,2,13,15,1.299509,103.837
089943,42,19,61,1.275906,103.835894
089944,28,10,38,1.299509,103.837
089945,32,16,48,1.275885,103.835859
089946,4,24,28,1.299509,103.837
089947,12,10,22,1.299509,103.837
089948,2,13,15,1.299509,103.837
089949,14,17,31,1.299509,103.837
089950,5,31,36,1.299509,103.837
089951,2,10,12,1.275788,103.835731
089952,27,21,48,1.299509,103.837
089953,12,34,46,1.299509,103.837
089954,55,233,288,1.275918,103.835719
089955,117,2,119,1.299509,103.837
089956,15,59,74,1.299509,103.837
089957,75,3,78,1.275616,103.835529
090001,312,108,420,1.279398,103.817786
090003,370,1247,1617,1.299509,103.837
090004,127,69,196,1.281699,103.842327
090005,241,59,300,1.281699,103.842327
090006,260,10163,10423,1.281699,103.842327
090007,163,2299,2462,1.281699,103.842327
090008,126,5983,6109,1.281699,103.842327
090009,53,103,156,1.299509,103.837
090010,203,13598,13801,1.299509,103.837
090011,60,10635,10695,1.281699,103.842327
090012,115,333,448,1.27719,103.819525
090013,41,63,104,1.281699,103.842327
090014,281,8110,8391,1.281699,103.842327
090015,320,2678,2998,1.281699,103.842327
090016,403,107,510,1.281699,103.842327
090017,389,150,539,1.277876,103.821711
090018,756,418,1174,1.281699,103.842327
090019,355,589,944,1.281699,103.842327
090020,240,20,260,1.281699,103.842327
090021,120,2499,2619,1.281699,103.842327
090022,206,5088,5294,1.281699,103.842327
090023,149,2514,2663,1.281699,103.842327
090024,176,2126,2302,1.281699,103.842327
090025,205,4071,4276,1.281699,103.842327
090026,401,4316,4717,1.281699,103.842327
090027,803,5474,6277,1.281699,103.842327
090028,125,365,490,1.281699,103.842327
090029,633,1934,2567,1.281699,103.842327
090030,365,1858,2223,1.299509,103.837
090031,384,2220,2604,1.281699,103.842327
090032,520,2219,2739,1.281699,103.842327
090033,457,3844,4301,1.281699,103.842327
090034,461,520,981,1.281699,103.842327
090035,411,172,583,1.281699,103.842327
090036,34,539,573,1.272617,103.821985
090037,434,942,1376,1.281699,103.842327
090038,188,2401,2589,1.281699,103.842327
090039,335,927,1262,1.281699,103.842327
090040,1056,5249,6305,1.299509,103.837
090041,170,3343,3513,1.281699,103.842327
090042,357,2142,2499,1.281699,103.842327
090043,229,352,581,1.281699,103.842327
090101,224,387,611,1.299509,103.837
090102,300,1880,2180,1.299509,103.837
090103,413,254,667,1.299509,103.837
090104,474,192,666,1.299509,103.837
090105,678,3443,4121,1.272581,103.824831
090106,476,390,866,1.299509,103.837
090107,275,140,415,1.299509,103.837
090108,233,282,515,1.273475,103.825312
090109,484,22231,22715,1.299509,103.837
090110,412,354,766,1.273925,103.826904
090111,329,450,779,1.299509,103.837
090112,199,5095,5294,1.299509,103.837
090113,308,718,1026,1.274813,103.826506
090114,446,558,1004,1.299509,103.837
090115,695,188,883,1.275331,103.826839
091001,26,2560,2586,1.299509,103.837
091003,35,5011,5046,1.299509,103.837
091004,2,136,138,1.299509,103.837
091005,13,143,156,1.299509,103.837
091014,70,96,166,1.299509,103.837
091016,7,290,297,1.277442,103.820921
091017,795,491,1286,1.299509,103.837
091021,200,249,449,1.299509,103.837
091023,12,202,214,1.299509,103.837
092017,14,614,628,1.299509,103.837
098002,2,2,4,1.299509,103.837
098007,6,4,10,1.299509,103.837
098008,185,0,185,1.251248,103.820123
098012,311,26,337,1.299509,103.837
098013,60,13,73,1.299509,103.837
098014,70,28,98,1.299509,103.837
098015,12,17,29,1.299509,103.837
098016,394,56,450,1.299509,103.837
098017,385,73,458,1.299509,103.837
098018,287,176,463,1.299509,103.837
098019,348,35,383,1.362269,103.963386
098020,130,113,243,1.299509,103.837
098021,359,45,404,1.299509,103.837
098022,173,713,886,1.299509,103.837
098023,104,13,117,1.299509,103.837
098027,34,2,36,1.239552,103.831536
098028,5,1,6,1.299509,103.837
098032,46,426,472,1.299509,103.837
098033,320,576,896,1.299509,103.837
098037,56,13,69,1.299509,103.837
098043,0,1,1,1.299509,103.837
098045,4,0,4,1.299509,103.837
098046,2,6,8,1.299509,103.837
098047,46,0,46,1.299509,103.837
098048,8,1,9,1.299509,103.837
098049,0,2,2,1.299509,103.837
098050,17,5,22,1.299509,103.837
098051,7,6,13,1.299509,103.837
098052,1,17,18,1.299509,103.837
098053,19,9,28,1.299509,103.837
098054,2,0,2,1.299509,103.837
098055,56,16,72,1.299509,103.837
098056,4,1,5,1.299509,103.837
098057,6,2,8,1.299509,103.837
098058,25,4,29,1.299509,103.837
098060,1,1,2,1.299509,103.837
098061,40,1,41,1.299509,103.837
098067,1,1,2,1.299509,103.837
098068,78,2,80,1.299509,103.837
098069,5,43,48,1.299509,103.837
098070,11,11,22,1.299509,103.837
098071,68,31,99,1.299509,103.837
098072,77,798,875,1.260275,103.823417
098077,32,14,46,1.299509,103.837
098078,60,21,81,1.299509,103.837
098079,14,49,63,1.299509,103.837
098080,31,9,40,1.352083,103.819836
098082,7,0,7,1.299509,103.837
098083,126,4,130,1.24059,103.833907
098084,0,5,5,1.299509,103.837
098085,8,1,9,1.352083,103.819836
098086,0,10,10,1.352083,103.819836
098087,1,0,1,1.299509,103.837
098088,29,14,43,1.299509,103.837
098089,9,6,15,1.299509,103.837
098090,7,8,15,1.299509,103.837
098091,62,11,73,1.299509,103.837
098092,18,1,19,1.299509,103.837
098093,36,1,37,1.299509,103.837
098095,42,0,42,1.299509,103.837
098096,132,11,143,1.299509,103.837
098097,1,5,6,1.352083,103.819836
098098,89,0,89,1.299509,103.837
098099,136,2,138,1.352083,103.819836
098101,44,5,49,1.299509,103.837
098103,0,1,1,1.241414,103.836072
098105,0,1,1,1.299509,103.837
098106,0,1,1,1.241103,103.835746
098107,7,3,10,1.241033,103.835617
098108,3,4,7,1.299509,103.837
098109,0,3,3,1.299509,103.837
098111,24,42,66,1.241205,103.836628
098112,2,10,12,1.241009,103.836612
098113,0,1,1,1.240733,103.836586
098114,6,0,6,1.299509,103.837
098115,2,0,2,1.299509,103.837
098116,47,1,48,1.240726,103.836161
098117,2,1,3,1.240693,103.835979
098118,1,1,2,1.240651,103.835814
098122,0,1,1,1.299509,103.837
098123,1,3,4,1.299509,103.837
098124,1,1,2,1.241142,103.834617
098125,4,0,4,1.238409,103.833446
098126,186,1,187,1.299509,103.837
098127,2,9,11,1.299509,103.837
098129,24,0,24,1.299509,103.837
098130,53,0,53,1.299509,103.837
098131,1,2,3,1.239409,103.836164
098132,41,33,74,1.299509,103.837
098133,7039,3402,10441,1.257332,103.817011
098134,77,9,86,1.258513,103.815969
098135,7,22,29,1.299509,103.837
098136,31,0,31,1.258791,103.819299
098137,12,4,16,1.299509,103.837
098138,496,22,518,1.257681,103.822223
098139,5413,192,5605,1.299509,103.837
098140,337,185,522,1.299509,103.837
098141,6,139,145,1.299509,103.837
098142,14,6,20,1.299509,103.837
098143,4,18,22,1.299509,103.837
098145,11,1,12,1.239119,103.833857
098147,0,2,2,1.250871,103.844065
098148,11,53,64,1.247926,103.845786
098149,1,0,1,1.239592,103.831585
098150,23,15,38,1.299509,103.837
098152,16,220,236,1.299509,103.837
098153,12,3,15,1.299509,103.837
098154,12,0,12,1.299509,103.837
098155,61,12,73,1.301871,103.906051
098156,4,53,57,1.299509,103.837
098157,4,15,19,1.299509,103.837
098158,38,7,45,1.240335,103.838244
098159,16,96,112,1.299509,103.837
098160,26,17,43,1.299509,103.837
098161,123,48,171,1.299509,103.837
098162,1,8,9,1.299509,103.837
098163,2,16,18,1.299509,103.837
098164,33,12,45,1.243114,103.836479
098165,1,5,6,1.299509,103.837
098166,31,1,32,1.301871,103.906051
098167,1,1,2,1.299509,103.837
098168,15,0,15,1.242932,103.836118
098169,5,3,8,1.299509,103.837
098170,3,3,6,1.299509,103.837
098171,87,3,90,1.299509,103.837
098172,76,0,76,1.242798,103.835881
098173,44,1,45,1.299509,103.837
098174,52,0,52,1.242751,103.835826
098175,49,5,54,1.242712,103.835798
098176,14,11,25,1.299509,103.837
098177,146,6,152,1.242654,103.835598
098178,50,24,74,1.242625,103.835541
098179,157,10,167,1.299509,103.837
098180,449,8,457,1.299509,103.837
098181,0,5,5,1.299509,103.837
098182,32,2,34,1.240057,103.830929
098183,223,8,231,1.299509,103.837
098184,136,32,168,1.243296,103.837148
098185,9,4,13,1.243274,103.836978
098186,146,2,148,1.299509,103.837
098187,1,11,12,1.299509,103.837
098188,9,11,20,1.250171,103.841836
098189,113,26,139,1.299509,103.837
098190,46,15,61,1.299509,103.837
098191,10,11,21,1.299509,103.837
098192,17,0,17,1.250778,103.842204
098193,64,12,76,1.299509,103.837
098194,0,1,1,1.299509,103.837
098195,1,9,10,1.299509,103.837
098196,0,3,3,1.299509,103.837
098197,98,3,101,1.251596,103.842472
098198,11,7,18,1.252001,103.84435
098199,2,88,90,1.2517,103.847351
098200,57,8,65,1.299509,103.837
098201,35,0,35,1.299509,103.837
098202,1784,170,1954,1.241329,103.840035
098203,2114,488,2602,1.241489,103.839279
098204,1778,301,2079,1.240721,103.839449
098205,2939,141,3080,1.240623,103.83912
098206,1328,9,1337,1.241126,103.839168
098207,539,11,550,1.299509,103.837
098208,759,8,767,1.241806,103.839329
098209,1306,12,1318,1.299509,103.837
098210,7,288,295,1.299509,103.837
098211,52,3,55,1.299509,103.837
098212,1,0,1,1.299509,103.837
098213,4,0,4,1.299509,103.837
098214,10,2,12,1.299509,103.837
098215,9,1,10,1.299509,103.837
098216,47,10,57,1.299509,103.837
098217,0,18,18,1.299509,103.837
098218,1,4,5,1.299509,103.837
098219,4,1,5,1.238417,103.832495
098220,44,0,44,1.239291,103.833899
098221,134,6,140,1.239861,103.831348
098222,202,0,202,1.299509,103.837
098223,28,0,28,1.241219,103.8342
098224,59,0,59,1.23945,103.831718
098225,1,0,1,1.299509,103.837
098226,11,6,17,1.238574,103.832627
098227,136,27,163,1.251398,103.842587
098228,1,0,1,1.249912,103.841791
098229,27,123,150,1.251786,103.844117
098230,8,9,17,1.299509,103.837
098231,0,1,1,1.249917,103.841531
098233,71,0,71,1.250525,103.819894
098234,13,1,14,1.299509,103.837
098235,42,2,44,1.299509,103.837
098236,24,6,30,1.249346,103.821855
098237,2,3,5,1.241988,103.838109
098241,5,0,5,1.299509,103.837
098242,0,1,1,1.242299,103.837641
098243,0,1,1,1.299509,103.837
098244,0,3,3,1.299509,103.837
098245,0,3,3,1.241436,103.837942
098246,139,12,151,1.299509,103.837
098247,1,2,3,1.241284,103.837944
098248,0,1,1,1.299509,103.837
098249,0,1,1,1.299509,103.837
098250,19,1,20,1.241668,103.837437
098251,3,1,4,1.299509,103.837
098252,0,4,4,1.299509,103.837
098253,5,1,6,1.241228,103.837488
098254,6,1,7,1.299509,103.837
098262,17,1,18,1.239303,103.831896
098263,72,34,106,1.299509,103.837
098264,4,7,11,1.238467,103.833028
098265,9,2,11,1.299509,103.837
098266,1,1,2,1.299509,103.837
098267,3,1787,1790,1.253243,103.826165
098268,10,165081,165091,1.253369,103.826533
098269,992,313,1305,1.299509,103.837
098270,46,60,106,1.255534,103.819466
098271,1236,1808,3044,1.256021,103.819026
098272,35,26,61,1.299509,103.837
098273,13,2,15,1.241733,103.838996
098274,4,15,19,1.242849,103.838706
098275,18,14,32,1.240284,103.838003
098276,9,23,32,1.299509,103.837
098277,0,1,1,1.299509,103.837
098278,3,33,36,1.299509,103.837
098279,5,0,5,1.299509,103.837
098280,23,11,34,1.247519,103.845191
098281,7,1,8,1.299509,103.837
098283,28,0,28,1.299509,103.837
098284,1,0,1,1.249044,103.839762
098285,5,0,5,1.299509,103.837
098286,53,253,306,1.24874,103.839389
098289,61,0,61,1.299509,103.837
098290,15,22,37,1.241174,103.838887
098291,11,33,44,1.299509,103.837
098292,1,1,2,1.299509,103.837
098293,137,8,145,1.299509,103.837
098294,141,12,153,1.238968,103.834123
098295,10,1,11,1.299509,103.837
098296,72,1,73,1.242225,103.835607
098297,13213,5126,18339,1.299509,103.837
098302,15,2,17,1.299509,103.837
098303,2,0,2,1.248927,103.845818
098304,40,11,51,1.299509,103.837
098305,5,2,7,1.247977,103.845433
098306,11,22,33,1.252052,103.844469
098307,175,575,750,1.299509,103.837
098308,1948,85,2033,1.299509,103.837
098309,4157,32,4189,1.299509,103.837
098311,15,1,16,1.241049,103.838824
098312,7,0,7,1.299509,103.837
098313,31,2,33,1.299509,103.837
098314,119,6,125,1.299509,103.837
098315,1,8,9,1.299509,103.837
098316,37,7,44,1.299509,103.837
098317,23,121,144,1.299509,103.837
098318,19,1,20,1.299509,103.837
098319,1,0,1,1.249477,103.837923
098320,7,12,19,1.299509,103.837
098321,6,1,7,1.299509,103.837
098323,0,5,5,1.299509,103.837
098324,10,12,22,1.257053,103.840551
098326,0,1,1,1.299509,103.837
098327,2781,15,2796,1.299509,103.837
098328,655,13,668,1.242782,103.839292
098329,1989,672,2661,1.299509,103.837
098330,174,154,328,1.299509,103.837
098331,9,2,11,1.299509,103.837
098332,47,0,47,1.249295,103.842453
098333,0,7,7,1.24915,103.842735
098334,50,8,58,1.249221,103.842954
098335,68,15,83,1.24897,103.843135
098336,1,32,33,1.299509,103.837
098337,20,1,21,1.248692,103.843547
098338,12,32,44,1.248611,103.8437
098339,53,4,57,1.299509,103.837
098340,1,2,3,1.299509,103.837
098341,85,0,85,1.299509,103.837
098342,17,5,22,1.248937,103.842362
098343,5,2,7,1.299509,103.837
098344,53,1,54,1.299509,103.837
098345,18,0,18,1.248674,103.84304
098346,6,24,30,1.248494,103.843222
098347,61,1,62,1.299509,103.837
098348,338,31,369,1.299509,103.837
098349,9,1,10,1.247782,103.8436
098350,2,2,4,1.299509,103.837
098358,2,1,3,1.299509,103.837
098359,16,28,44,1.249996,103.841879
098360,35,5,40,1.250332,103.842163
098361,10,10,20,1.252463,103.844936
098367,1494,884,2378,1.299509,103.837
098368,687,843,1530,1.248786,103.841309
098369,2698,1794,4492,1.299509,103.837
098370,508,0,508,1.247984,103.842091
098371,517,28,545,1.248124,103.842218
098372,4499,11529,16028,1.299509,103.837
098373,853,86,939,1.299509,103.837
098374,20062,23,20085,1.299509,103.837
098375,1481,385,1866,1.299509,103.837
098377,52,27,79,1.299509,103.837
098378,21,5,26,1.251846,103.842504
098379,21,0,21,1.299509,103.837
098380,20,2,22,1.252814,103.845862
098381,6,14,20,1.248711,103.845961
098382,6317,1935,8252,1.299509,103.837
098387,7,7,14,1.251796,103.843731
098388,10,4,14,1.299509,103.837
098389,2,0,2,1.247536,103.84484
098390,16,6,22,1.299509,103.837
098391,29,30,59,1.299509,103.837
098392,15,4,19,1.299509,103.837
098393,1792,9,1801,1.299509,103.837
098394,154,268,422,1.299509,103.837
098395,2454,110,2564,1.242948,103.836539
098396,2,1,3,1.299509,103.837
098397,137,0,137,1.248859,103.839354
098398,33,1,34,1.249567,103.837753
098399,4,6,10,1.299509,103.837
098400,7,0,7,1.299509,103.837
098401,15,4,19,1.250291,103.836824
098402,1121,1309,2430,1.299509,103.837
098403,1295,407,1702,1.267699,103.814099
098404,2174,1473,3647,1.299509,103.837
098405,1085,126,1211,1.26685,103.813301
098406,1973,133,2106,1.266988,103.812771
098407,590,64,654,1.266659,103.81242
098408,1686,410,2096,1.267153,103.811973
098409,258,26,284,1.26844,103.814197
098410,1605,61,1666,1.299509,103.837
098411,407,27,434,1.266244,103.81082
098412,1017,166,1183,1.299509,103.837
098413,225,12,237,1.299509,103.837
098414,2569,568,3137,1.299509,103.837
098415,2489,1035,3524,1.299509,103.837
098416,2035,85,2120,1.299509,103.837
098417,2493,596,3089,1.299509,103.837
098418,1466,306,1772,1.299509,103.837
098419,3297,1384,4681,1.299509,103.837
098422,4,18,22,1.299509,103.837
098423,13,3,16,1.299509,103.837
098424,28,0,28,1.247775,103.84534
098425,18,2,20,1.299509,103.837
098426,37,0,37,1.248259,103.845396
098427,135,0,135,1.249195,103.844509
098428,19,1,20,1.249286,103.844553
098429,28,1,29,1.299509,103.837
098430,146,1,147,1.299509,103.837
098432,1,0,1,1.299509,103.837
098433,7,48,55,1.299509,103.837
098434,19,170,189,1.247125,103.844988
098435,4,28,32,1.299509,103.837
098436,199,0,199,1.251091,103.844157
098437,17,1,18,1.299509,103.837
098438,68,0,68,1.299509,103.837
098439,1,38,39,1.249114,103.83859
098440,18,0,18,1.299509,103.837
098441,0,2,2,1.299509,103.837
098442,76,19,95,1.299509,103.837
098443,30,0,30,1.299509,103.837
098444,6,4,10,1.250202,103.842079
098445,12,0,12,1.252214,103.844614
098446,198,31,229,1.299509,103.837
098447,8,75,83,1.250119,103.847005
098448,54,22,76,1.299509,103.837
098449,2916,466,3382,1.299509,103.837
098450,5208,797,6005,1.299509,103.837
098451,2959,2,2961,1.299509,103.837
098452,8,2,10,1.299509,103.837
098453,16,10,26,1.252694,103.846521
098454,2,6,8,1.252576,103.846792
098455,11,18,29,1.299509,103.837
098456,73,65,138,1.299509,103.837
098457,2,21,23,1.299509,103.837
098458,4,2,6,1.299509,103.837
098459,19,13,32,1.299509,103.837
098460,269,9,278,1.250877,103.847229
098461,3,26,29,1.299509,103.837
098465,42,15,57,1.288619,103.805121
098466,56,78,134,1.299509,103.837
098467,19,2,21,1.299509,103.837
098468,258,9,267,1.299509,103.837
098469,105,47,152,1.250216,103.843425
098470,34,0,34,1.299509,103.837
098471,2,0,2,1.299509,103.837
098472,161,23,184,1.299509,103.837
098473,0,12,12,1.299509,103.837
098475,144,22,166,1.249938,103.843423
098476,98,11,109,1.299509,103.837
098477,40,5,45,1.249914,103.843575
098478,133,0,133,1.299509,103.837
098479,2,4,6,1.299509,103.837
098480,20,14,34,1.299509,103.837
098481,24,11,35,1.299509,103.837
098482,16,0,16,1.299509,103.837
098483,41,19,60,1.299509,103.837
098484,12,2,14,1.299509,103.837
098485,27,0,27,1.299509,103.837
098486,19,2,21,1.299509,103.837
098487,14,0,14,1.299509,103.837
098488,0,1,1,1.24958,103.844644
098489,27,6,33,1.299509,103.837
098491,9,8,17,1.299509,103.837
098493,2,0,2,1.249047,103.844491
098496,1,10,11,1.252715,103.846155
098497,2987,2934,5921,1.299509,103.837
098498,8,0,8,1.250386,103.820656
098499,5544,7470,13014,1.265459,103.818675
098500,41,0,41,1.25071,103.836408
098501,33,5,38,1.299509,103.837
098502,42,23,65,1.250681,103.842354
098503,19,17,36,1.247652,103.845256
098504,102,0,102,1.251953,103.84423
098505,25,0,25,1.299509,103.837
098506,0,11,11,1.252556,103.845358
098507,0,10,10,1.252617,103.845464
098508,24,0,24,1.252667,103.845549
098509,18,14,32,1.299509,103.837
098510,52,11,63,1.299509,103.837
098511,25,0,25,1.252748,103.845807
098512,12,27,39,1.252754,103.845865
098513,45,7,52,1.299509,103.837
098514,4,8,12,1.299509,103.837
098515,292,30,322,1.352083,103.819836
098516,141,1,142,1.251297,103.847222
098517,5,5,10,1.299509,103.837
098518,127,37,164,1.299509,103.837
098519,0,3,3,1.249218,103.838468
098522,13,2,15,1.249691,103.821678
098523,2,1,3,1.299509,103.837
098525,56,3,59,1.299509,103.837
098526,13,5,18,1.252671,103.845409
098527,2136,24,2160,1.299509,103.837
098528,1000,315,1315,1.244094,103.842734
098529,1462,9,1471,1.299509,103.837
098530,1622,62,1684,1.299509,103.837
098531,752,34,786,1.243254,103.841952
098532,1201,32,1233,1.243229,103.841979
098533,879,14,893,1.299509,103.837
098534,1625,56,1681,1.299509,103.837
098535,1171,1068,2239,1.299509,103.837
098536,47,5,52,1.250978,103.847399
098537,7779,1831,9610,1.299509,103.837
098538,19,5,24,1.248289,103.845662
098539,3,5,8,1.248448,103.845524
098540,3,4,7,1.250283,103.847102
098541,26,0,26,1.299509,103.837
098542,62,0,62,1.252784,103.845707
098543,0,1,1,1.299509,103.837
098544,2470,22630,25100,1.299509,103.837
098545,9,1,10,1.299509,103.837
098546,0,1,1,1.299509,103.837
098547,0,21,21,1.299509,103.837
098548,1,31,32,1.250645,103.847266
098549,10,0,10,1.299509,103.837
098550,14,13,27,1.299509,103.837
098551,2,10,12,1.299509,103.837
098552,19,3,22,1.299509,103.837
098553,2,4,6,1.299509,103.837
098554,42,0,42,1.299509,103.837
098555,25,1,26,1.299509,103.837
098556,120,21,141,1.251282,103.845472
098557,65,16,81,1.299509,103.837
098558,14,7,21,1.251414,103.845694
098559,9,12,21,1.251481,103.845806
098560,16,1,17,1.251587,103.845968
098561,3,1,4,1.251088,103.845902
098562,3,10,13,1.299509,103.837
098563,2,4,6,1.251152,103.846111
098564,1,1,2,1.299509,103.837
098565,8,0,8,1.251269,103.846231
098566,6,0,6,1.299509,103.837
098567,8,11,19,1.299509,103.837
098568,4,0,4,1.299509,103.837
098569,20,9,29,1.299509,103.837
098575,5,50,55,1.252356,103.845132
098576,37,0,37,1.252295,103.845078
098579,3,28,31,1.252166,103.844914
098580,29,0,29,1.252127,103.844868
098581,4,0,4,1.252097,103.844837
098582,3,16,19,1.299509,103.837
098583,439,349,788,1.251673,103.847514
098584,3646,28,3674,1.299509,103.837
098585,57925,60698,118623,1.299509,103.837
098587,0,17,17,1.299509,103.837
098588,59,551,610,1.299509,103.837
098589,0,1,1,1.299509,103.837
098591,0,3,3,1.299509,103.837
098593,0,20,20,1.299509,103.837
098595,1,4,5,1.299509,103.837
098596,3,1,4,1.299509,103.837
098597,18,0,18,1.299509,103.837
098598,0,1,1,1.299509,103.837
098601,1,0,1,1.299509,103.837
098602,0,5,5,1.299509,103.837
098603,1,0,1,1.218898,103.849461
098604,1576,267,1843,1.251746,103.81854
098605,5,0,5,1.24842,103.845747
098606,1,3,4,1.299509,103.837
098607,6,1,7,1.250696,103.847647
098608,20,35,55,1.352083,103.819836
098609,3,4,7,1.299509,103.837
098610,10,11,21,1.250318,103.846969
098611,16,13,29,1.250405,103.847027
098612,17,15,32,1.250478,103.847068
098613,325,7,332,1.250524,103.847094
098614,8,11,19,1.299509,103.837
098615,45,6,51,1.299509,103.837
098616,623,0,623,1.299509,103.837
098617,600,0,600,1.250066,103.84631
098618,237,0,237,1.299509,103.837
098619,536,6,542,1.250048,103.846314
098620,163,0,163,1.250047,103.846317
098621,486,0,486,1.250073,103.846317
098622,329,0,329,1.250041,103.846343
098623,1043,0,1043,1.250074,103.846307
098624,1024,45,1069,1.299509,103.837
098625,412,0,412,1.248918,103.846137
098626,237,0,237,1.299509,103.837
098627,236,0,236,1.299509,103.837
098628,386,0,386,1.299509,103.837
098629,292,9,301,1.249095,103.846454
098630,757,427,1184,1.249075,103.846435
098631,2,38,40,1.257157,103.829953
098632,13618,5524,19142,1.299509,103.837
098633,13502,23041,36543,1.299509,103.837
098634,1,0,1,1.217018,103.850309
098635,1587,275,1862,1.299509,103.837
098636,521,2060,2581,1.299509,103.837
098637,1005,557,1562,1.299509,103.837
098638,348,3229,3577,1.267236,103.816167
098639,762,1572,2334,1.299509,103.837
098640,890,1602,2492,1.266916,103.816628
098641,410,95,505,1.299509,103.837
098642,374,201,575,1.266388,103.816372
098643,955,270,1225,1.299509,103.837
098644,663,146,809,1.265864,103.815982
098645,575,327,902,1.299509,103.837
098646,597,78,675,1.299509,103.837
098647,700,158,858,1.299509,103.837
098648,345,101,446,1.265146,103.815105
098649,279,90,369,1.264841,103.814925
098650,2474,525,2999,1.266429,103.815462
098651,1789,367,2156,1.299509,103.837
098652,1499,397,1896,1.299509,103.837
098653,1040,77,1117,1.299509,103.837
098654,851,30,881,1.299509,103.837
098655,2226,169,2395,1.299509,103.837
098656,2185,225,2410,1.299509,103.837
098657,2275,274,2549,1.299509,103.837
098658,0,1,1,1.299509,103.837
098659,0,534,534,1.299509,103.837
098672,13,3,16,1.253429,103.82017
098675,9,1,10,1.258401,103.829804
098679,8378,300,8678,1.299509,103.837
098682,1,0,1,1.256284,103.835769
098684,0,1,1,1.260042,103.830788
098685,4,0,4,1.260937,103.831683
098686,0,209,209,1.269311,103.81603
098687,22,268,290,1.247967,103.836785
098716,42,98,140,1.299509,103.837
098717,15,35,50,1.299509,103.837
098719,1,0,1,1.269751,103.814473
098720,0,9,9,1.299509,103.837
098721,273,17,290,1.299509,103.837
098722,8,199,207,1.299509,103.837
098725,1,7,8,1.269947,103.813948
098726,1,0,1,1.270072,103.813968
098727,3,29,32,1.299509,103.837
098728,8,535,543,1.270891,103.812646
098729,4,0,4,1.299509,103.837
098730,9,5,14,1.299509,103.837
098731,1,4,5,1.299509,103.837
098732,13,1,14,1.299509,103.837
098733,15,5,20,1.299509,103.837
098734,0,1,1,1.271042,103.813237
098735,1,2,3,1.299509,103.837
098736,2,0,2,1.299509,103.837
098737,4,1,5,1.299509,103.837
098740,1,2,3,1.299509,103.837
098741,3,2,5,1.271404,103.812633
098742,8,5,13,1.299509,103.837
098743,16,30,46,1.299509,103.837
098744,38,36,74,1.299509,103.837
098745,5,8,13,1.299509,103.837
098746,8,9,17,1.299509,103.837
098747,1,4,5,1.270858,103.812844
098748,255,15,270,1.299509,103.837
098749,485,54,539,1.299509,103.837
098750,46,489,535,1.299509,103.837
098751,327,3,330,1.270366,103.813789
098752,307,17,324,1.299509,103.837
098753,15,6,21,1.299509,103.837
098754,32,8,40,1.299509,103.837
098771,7,8,15,1.267601,103.822784
098772,1,0,1,1.299509,103.837
098773,0,1,1,1.299509,103.837
098774,8,1,9,1.299509,103.837
098775,10,4,14,1.299509,103.837
098800,27,408,435,1.278384,103.817754
098801,39,884,923,1.275521,103.819221
098803,2078,8281,10359,1.299509,103.837
098827,141,10971,11112,1.266301,103.824541
098828,7656,5850,13506,1.299509,103.837
098829,357,88414,88771,1.299509,103.837
098830,1004,8608,9612,1.299509,103.837
098833,10,1163,1173,1.299509,103.837
098834,6,807,813,1.269004,103.81471
098835,24,221,245,1.299509,103.837
098836,2,33,35,1.299509,103.837
098837,19,975,994,1.269352,103.814339
098838,485,601,1086,1.299509,103.837
098839,4,612,616,1.299509,103.837
098840,88,1002,1090,1.269631,103.813744
098842,7,95,102,1.299509,103.837
098843,8,497,505,1.269852,103.813429
098844,7,37,44,1.299509,103.837
098845,3,84,87,1.269892,103.813357
098846,1,128,129,1.269921,103.813322
098847,0,174,174,1.269944,103.813271
098848,0,93,93,1.299509,103.837
098849,8,482,490,1.299509,103.837
098850,1,59,60,1.270066,103.813081
098851,10,145,155,1.299509,103.837
098852,6,125,131,1.270137,103.812976
098853,2,197,199,1.299509,103.837
098854,8,1102,1110,1.270193,103.812879
098857,17,129,146,1.270457,103.812772
098865,394,124,518,1.266149,103.822874
098866,29,35,64,1.299509,103.837
098867,755,22488,23243,1.299509,103.837
098886,414,15142,15556,1.299509,103.837
098888,75,346,421,1.299509,103.837
098889,6,2251,2257,1.299509,103.837
098915,260,2371,2631,1.299509,103.837
098941,359,633,992,1.247111,103.824776
098942,8722,1948,10670,1.299509,103.837
098943,2972,508,3480,1.299509,103.837
098944,25,1,26,1.299509,103.837
098945,56,71,127,1.299509,103.837
098967,19,1945,1964,1.299509,103.837
098968,1,128,129,1.299509,103.837
098969,116,110,226,1.299509,103.837
098970,21966,7318,29284,1.299509,103.837
098972,4,5,9,1.299509,103.837
098974,1,4,5,1.257724,103.811415
098975,337,1052,1389,1.299509,103.837
098977,16,8,24,1.299509,103.837
098978,13,3,16,1.299509,103.837
098979,809,3,812,1.299509,103.837
098980,51,494,545,1.299509,103.837
098995,89,21,110,1.299509,103.837
098996,186,0,186,1.299509,103.837
098997,138,8,146,1.299509,103.837
098999,104,5,109,1.299509,103.837
099000,194,1,195,1.252495,103.816038
099001,37,0,37,1.252867,103.81555
099002,306,1020,1326,1.257213,103.811174
099003,51,4,55,1.299509,103.837
099004,185,4,189,1.299509,103.837
099005,110,0,110,1.299509,103.837
099007,79,0,79,1.299509,103.837
099008,10,33,43,1.255989,103.812385
099010,168,0,168,1.299509,103.837
099011,46,10,56,1.299509,103.837
099012,73,1,74,1.299509,103.837
099013,35,5,40,1.299509,103.837
099023,100,255,355,1.248552,103.830443
099024,158,226,384,1.299509,103.837
099050,8,23,31,1.299509,103.837
099053,2,59,61,1.299729,103.857084
099057,18,41,59,1.299509,103.837
099106,39,3,42,1.299509,103.837
099107,46,17,63,1.299509,103.837
099108,39,8,47,1.299509,103.837
099109,0,28,28,1.299509,103.837
099110,70,27,97,1.299509,103.837
099111,4,5,9,1.299509,103.837
099112,105,27,132,1.299509,103.837
099113,0,1,1,1.299509,103.837
099114,472,7009,7481,1.266668,103.818942
099115,141,1088,1229,1.299509,103.837
099138,553,4760,5313,1.299509,103.837
099163,24,0,24,1.270911,103.814166
099165,0,2,2,1.299509,103.837
099166,8,0,8,1.271981,103.814648
099167,12,9,21,1.299509,103.837
099168,1,6,7,1.299509,103.837
099169,136,24,160,1.271541,103.813279
099170,26,128,154,1.299509,103.837
099171,256,24,280,1.299509,103.837
099172,1,13,14,1.270785,103.814399
099196,450,127,577,1.299509,103.837
099197,369,925,1294,1.299509,103.837
099198,0,11,11,1.270272,103.824125
099199,312,11,323,1.299509,103.837
099200,2624,1144,3768,1.268426,103.824677
099201,140,174,314,1.299509,103.837
099203,5944,3123,9067,1.299509,103.837
099204,13,4,17,1.267349,103.822116
099206,897,2142,3039,1.299509,103.837
099207,51,27,78,1.299509,103.837
099208,1308,22,1330,1.299509,103.837
099209,343,1186,1529,1.299509,103.837
099228,24,16,40,1.299509,103.837
099253,30251,151906,182157,1.299509,103.837
099254,506,35,541,1.299509,103.837
099255,92,1423,1515,1.299509,103.837
099279,99,8,107,1.26753,103.821394
099280,304,9,313,1.299509,103.837
099281,79,51,130,1.299509,103.837
099282,52,9,61,1.299509,103.837
099283,9,29,38,1.299509,103.837
099307,119,3806,3925,1.299509,103.837
099308,1560,625,2185,1.299509,103.837
099309,3248,306,3554,1.299509,103.837
099310,785,347,1132,1.299509,103.837
099337,4,0,4,1.250533,103.820828
099338,38,0,38,1.249985,103.820912
099341,10,0,10,1.249762,103.82155
099342,201,0,201,1.299509,103.837
099343,14,1,15,1.299509,103.837
099344,8,0,8,1.249972,103.821304
099347,1,97,98,1.250348,103.821564
099394,5010,1850,6860,1.299509,103.837
099395,9,369,378,1.299509,103.837
099397,1,1,2,1.299509,103.837
099398,10,151,161,1.299509,103.837
099418,1011,448,1459,1.299509,103.837
099419,983,870,1853,1.299509,103.837
099446,504,9,513,1.299509,103.837
099447,4860,1210,6070,1.299509,103.837
099448,2846,2206,5052,1.299509,103.837
099449,60,5,65,1.299509,103.837
099450,4,2,6,1.272416,103.82766
099451,26,289,315,1.299509,103.837
099452,18,296,314,1.299509,103.837
099453,71,5,76,1.299509,103.837
099454,424,3654,4078,1.299509,103.837
099455,373,2417,2790,1.299509,103.837
099456,2,0,2,1.272586,103.82682
099457,19,177,196,1.299509,103.837
099458,27,1179,1206,1.299509,103.837
099481,4,635,639,1.299509,103.837
099482,2,2,4,1.299509,103.837
099483,3,406,409,1.254101,103.822044
099537,1013,305,1318,1.255008,103.814133
099538,4587,462,5049,1.299509,103.837
099562,30,704,734,1.252336,103.821705
099566,27,491,518,1.252069,103.82308
099591,0,18,18,1.299509,103.837
099592,0,42,42,1.334319,103.740417
099593,0,60,60,1.299509,103.837
099594,8937,1363,10300,1.299509,103.837
099595,2,940,942,1.299509,103.837
099597,34,959,993,1.299509,103.837
099598,5,673,678,1.299509,103.837
099599,20,32830,32850,1.299509,103.837
099600,4,591,595,1.299509,103.837
099621,153,54,207,1.299509,103.837
099622,32,6295,6327,1.299509,103.837
099623,8,12944,12952,1.255944,103.818462
099624,4,260,264,1.255659,103.819106
099625,12,64,76,1.256627,103.821479
099626,25,13,38,1.299509,103.837
099627,15,2656,2671,1.299509,103.837
099628,56,3616,3672,1.25609,103.81914
099629,0,9,9,1.256214,103.819147
099630,0,1,1,1.256315,103.819184
099631,2,1,3,1.299509,103.837
099633,5,1,6,1.256584,103.819276
099636,1,338,339,1.299509,103.837
099696,1,2,3,1.299509,103.837
099699,58,533,591,1.299509,103.837
099700,65,0,65,1.299509,103.837
099701,36,16,52,1.254844,103.817643
099702,518,438,956,1.299509,103.837
099703,13,24,37,1.255347,103.816926
099704,28,112,140,1.299509,103.837
099705,9,202,211,1.299509,103.837
099706,14,29,43,1.299509,103.837
099707,49,24,73,1.299509,103.837
099708,35,212,247,1.255356,103.816633
099738,0,15,15,1.299509,103.837
099739,7,0,7,1.299509,103.837
099740,1,0,1,1.299509,103.837
099741,3,0,3,1.275427,103.825281
099742,3,2,5,1.299509,103.837
099743,2,0,2,1.275567,103.824998
099744,2,0,2,1.275918,103.825025
099745,112,30,142,1.299509,103.837
099746,1,26,27,1.299509,103.837
099747,1,2,3,1.275912,103.825546
099749,1,2,3,1.299509,103.837
099750,87,13,100,1.276213,103.826117
099751,6,3,9,1.299509,103.837
099752,0,22,22,1.275641,103.825407
099753,2,55,57,1.299509,103.837
099754,8,0,8,1.299509,103.837
099755,0,1,1,1.299509,103.837
099757,16,325,341,1.299509,103.837
099758,20,3,23,1.276265,103.825182
099759,7,0,7,1.276155,103.825058
099760,3,0,3,1.299509,103.837
099761,2,1,3,1.299509,103.837
099762,5,1,6,1.276189,103.824983
099763,3,0,3,1.299509,103.837
099764,4,0,4,1.299509,103.837
099765,22,0,22,1.299509,103.837
099774,6,1,7,1.299509,103.837
099777,0,1,1,1.276251,103.825419
099779,2,0,2,1.299509,103.837
099780,6,1,7,1.276506,103.825755
099781,4,5,9,1.299509,103.837
099782,7,2,9,1.299509,103.837
099783,0,4,4,1.299509,103.837
099784,1,26,27,1.299509,103.837
099785,1,5,6,1.299509,103.837
099786,5,54,59,1.299509,103.837
099787,6,13,19,1.299509,103.837
099788,3,0,3,1.276875,103.825561
099789,1,0,1,1.299509,103.837
099790,20,52,72,1.299509,103.837
099792,5,0,5,1.299509,103.837
099794,1,0,1,1.299509,103.837
099797,13,0,13,1.299509,103.837
099799,6,18,24,1.276661,103.825754
099800,4,20,24,1.276626,103.825735
099801,29,4,33,1.276544,103.825683
099802,3,8,11,1.276484,103.825632
099840,203,1115,1318,1.299509,103.837
099865,229,1913,2142,1.299509,103.837
099866,11,1920,1931,1.299509,103.837
099891,14997,2221,17218,1.299509,103.837
099892,7936,1307,9243,1.299509,103.837
099893,139,72,211,1.299509,103.837
099949,17,1009,1026,1.299509,103.837
099951,15,360,375,1.299509,103.837
099953,8,10,18,1.252019,103.820981
099954,119,1546,1665,1.249819,103.826798
099955,14,124,138,1.299509,103.837
099956,113,78,191,1.299509,103.837
099957,85,139,224,1.299509,103.837
099958,1188,16,1204,1.299509,103.837
099976,9,0,9,1.299509,103.837
099977,10,0,10,1.299509,103.837
099978,2,0,2,1.299509,103.837
099980,262,481,743,1.248697,103.82801
099981,1089,163,1252,1.299509,103.837
099982,146,348,494,1.299509,103.837
099983,606,466,1072,1.248176,103.827455
100044,546,1204,1750,1.271305,103.810491
100045,351,480,831,1.271744,103.809458
100046,122,518,640,1.271666,103.809881
100047,117,34,151,1.272001,103.810046
100048,339,1782,2121,1.272398,103.810584
100049,371,481,852,1.272247,103.810928
100050,515,12448,12963,1.273104,103.809951
100051,305,181,486,1.273491,103.809729
100052,249,689,938,1.273793,103.811127
100053,647,575,1222,1.274275,103.811433
100054,425,3320,3745,1.27366,103.811698
100055,231,1359,1590,1.273995,103.811968
100056,341,514,855,1.274342,103.812209
100057,1117,771,1888,1.274659,103.812445
100058,151,632,783,1.275053,103.813085
100059,340,4873,5213,1.275452,103.813221
100060,353,8961,9314,1.276241,103.811659
100061,415,1364,1779,1.275817,103.811679
100062,762,223,985,1.275275,103.810968
100063,14,43,57,1.274835,103.810786
100064,15,3,18,1.274494,103.810403
100065,380,124,504,1.274066,103.810227
100066,336,12732,13068,1.274098,103.809515
100067,118,5652,5770,1.274614,103.809515
100068,145,12,157,1.275213,103.809897
100069,320,236,556,1.275618,103.810162
100070,45,11,56,1.276242,103.810802
100071,11,627,638,1.299509,103.837
100072,193,5596,5789,1.276188,103.809473
100073,337,135,472,1.275805,103.809091
100074,494,136,630,1.275426,103.808718
100075,176,223,399,1.27487,103.80855
100076,270,379,649,1.274416,103.808627
100077,166,239,405,1.273906,103.808521
100079,33,990,1023,1.273301,103.807598
100080,6,123,129,1.274097,103.807098
100082,21,144,165,1.273787,103.807777
100084,235,2798,3033,1.276766,103.809843
100085,477,2629,3106,1.27726,103.808742
100086,371,169,540,1.27674,103.808437
100087,365,44,409,1.276897,103.807942
100088,588,2387,2975,1.277427,103.808033
100090,0,8,8,1.299509,103.837
100091,0,21,21,1.299509,103.837
100092,1,2,3,1.299509,103.837
100093,2,25,27,1.299509,103.837
100102,3,2,5,1.299509,103.837
100105,51,1730,1781,1.279878,103.816385
100108,229,1690,1919,1.281235,103.810341
100110,24,1475,1499,1.299509,103.837
100113,366,160,526,1.281475,103.807253
100114,378,3623,4001,1.281795,103.806834
101048,2,106,108,1.27178,103.810535
101051,2,96,98,1.273399,103.810781
101052,19,3463,3482,1.273268,103.811106
101057,24,610,634,1.274977,103.811818
101070,601,4984,5585,1.276218,103.81085
101073,36,3296,3332,1.275302,103.809361
101078,110,10897,11007,1.273512,103.809024
101080,599,385,984,1.274086,103.807535
101086,19,1,20,1.277088,103.808275
101088,10,178,188,1.277088,103.807729
101090,0,79,79,1.299509,103.837
101091,0,2,2,1.299509,103.837
101092,0,4,4,1.299509,103.837
101093,1,12,13,1.299509,103.837
101102,23,51,74,1.31549,103.899788
101103,363,781,1144,1.281035,103.813084
101104,298,149,447,1.280483,103.812375
101105,70,582,652,1.281326,103.810405
101106,379,54,433,1.280665,103.81098
101108,35,353,388,1.280877,103.810126
101109,223,763,986,1.280919,103.809441
101110,107,306,413,1.281326,103.810405
101111,250,107,357,1.28115,103.808663
101112,168,3164,3332,1.281639,103.80804
102070,491,2716,3207,1.276597,103.810847
102078,58,49,107,1.273562,103.808121
102080,50,580,630,1.274086,103.807535
102090,0,23,23,1.299509,103.837
102091,1,12,13,1.299509,103.837
102092,0,2,2,1.299509,103.837
102103,276,1444,1720,1.280851,103.812971
102104,314,184,498,1.280606,103.812099
102105,9,2709,2718,1.299509,103.837
102106,331,87,418,1.280688,103.810707
102109,448,93,541,1.281042,103.80914
102110,13,1378,1391,1.299509,103.837
102111,309,82,391,1.281211,103.808339
102112,224,2723,2947,1.281697,103.807681
103070,276,112,388,1.276022,103.810943
103078,4,96,100,1.274108,103.808386
103080,228,192,420,1.274086,103.807535
103104,31,87,118,1.280543,103.811563
103105,3,237,240,1.358007,103.837865
103112,12,35,47,1.281331,103.807856
104078,5,92,97,1.274108,103.808386
104080,38,331,369,1.299509,103.837
108925,73,438,511,1.299509,103.837
108926,290,93,383,1.278398,103.804586
108927,127,76,203,1.278391,103.804377
108931,36,2309,2345,1.271828,103.811765
108932,122,103,225,1.277372,103.803426
108933,197,119,316,1.27725,103.803731
108934,327,58,385,1.27711,103.804045
108935,282,125,407,1.277666,103.804429
108936,303,66,369,1.277607,103.804045
108937,258,166,424,1.278398,103.804586
108938,727,90,817,1.278601,103.804775
108939,99,100,199,1.279311,103.804888
108940,21,55,76,1.278227,103.804579
108941,5,0,5,1.278324,103.804623
108942,173,827,1000,1.272184,103.806251
108943,8,76,84,1.274703,103.807994
108944,0,1,1,1.274366,103.807918
108945,1,415,416,1.27262,103.805258
108946,3,17,20,1.299509,103.837
109022,18,1373,1391,1.270725,103.809696
109023,61,22,83,1.273658,103.805277
109024,11,658,669,1.271458,103.808992
109025,924,1779,2703,1.271639,103.807736
109026,1242,147,1389,1.272414,103.807725
109027,21,494,515,1.271809,103.807064
109028,161,616,777,1.270692,103.809854
109029,222,686,908,1.272255,103.803149
109030,1565,1368,2933,1.271482,103.807708
109031,8,61,69,1.299509,103.837
109100,378,2135,2513,1.276261,103.808522
109134,4,39,43,1.299509,103.837
109178,201,210,411,1.278877,103.813289
109256,6,1224,1230,1.273353,103.811875
109257,7,3358,3365,1.272821,103.811549
109258,2196,481,2677,1.271975,103.80848
109260,10,1194,1204,1.274411,103.807277
109339,125,1018,1143,1.281153,103.80439
109340,191,783,974,1.281073,103.80439
109341,3,9,12,1.2803,103.804919
109342,70,4,74,1.280892,103.804446
109343,13,3,16,1.280526,103.804661
109344,24,6,30,1.280459,103.804692
109345,381,2,383,1.280281,103.804827
109346,4,7,11,1.280844,103.804636
109347,2,3,5,1.279966,103.805106
109348,1,6,7,1.279886,103.805221
109349,162,10,172,1.279824,103.80544
109350,26,3,29,1.279819,103.805555
109351,100,7,107,1.279806,103.805754
109352,15,1,16,1.279797,103.805844
109353,8,2,10,1.279969,103.80601
109355,911,57,968,1.280666,103.805745
109433,1783,27,1810,1.276006,103.80341
109434,84,2482,2566,1.277181,103.803154
109441,19,24,43,1.27646,103.80447
109442,174,38,212,1.2763,103.8044
109443,104,117,221,1.274996,103.804502
109444,368,7,375,1.274468,103.80417
109452,22,7,29,1.276714,103.804638
109454,77,75,152,1.275272,103.804233
109455,125,6,131,1.274824,103.803844
109590,54,73,127,1.281733,103.814194
109668,7,831,838,1.281427,103.81439
109669,11,83,94,1.281494,103.814293
109670,258,2356,2614,1.281506,103.814108
109672,16,3560,3576,1.282031,103.809211
109673,512,597,1109,1.282747,103.807381
109674,68,845,913,1.282318,103.805962
109675,12,48,60,1.283133,103.805999
109678,16,105,121,1.28291,103.805534
109679,1140,11071,12211,1.279487,103.816284
109680,684,214,898,1.280195,103.815126
109681,897,8660,9557,1.280269,103.814053
109682,302,5,307,1.28031,103.814102
109683,5984,1535,7519,1.283037,103.808216
109684,510,1222,1732,1.28199,103.803049
109685,454,0,454,1.282145,103.802793
109686,637,54,691,1.282295,103.802491
109687,991,0,991,1.282568,103.802585
109688,726,0,726,1.282777,103.802506
109689,1105,974,2079,1.282946,103.802108
109690,1370,0,1370,1.28318,103.801963
109691,388,0,388,1.283478,103.802217
109692,534,0,534,1.283484,103.802658
109693,1164,8,1172,1.283302,103.802867
109694,2285,5518,7803,1.282206,103.803656
109695,694,0,694,1.28338,103.803654
109696,489,0,489,1.283426,103.804028
109697,1026,0,1026,1.283217,103.804201
109698,861,365,1226,1.282934,103.8041
109699,401,0,401,1.282727,103.804245
109700,547,18,565,1.282461,103.804214
109701,685,767,1452,1.282446,103.803884
109702,1257,0,1257,1.282605,103.803584
109703,632,0,632,1.282892,103.80369
109704,1148,0,1148,1.283119,103.803464
109705,1568,689,2257,1.283043,103.80316
109706,177,0,177,1.28254,103.803211
109707,602,0,602,1.282715,103.802932
109753,4,2648,2652,1.281924,103.810616
109754,117,3363,3480,1.281561,103.812725
109755,33,2162,2195,1.281531,103.813315
109756,52,31,83,1.281859,103.813087
109757,12,36,48,1.2821,103.813097
109758,10,17,27,1.282022,103.812008
109759,7,21,28,1.282272,103.812027
109760,30,138,168,1.282634,103.812045
109761,39,53,92,1.2829,103.811198
109762,23,38,61,1.282972,103.810417
109763,4,470,474,1.281689,103.812287
109764,10,10,20,1.282565,103.810519
109765,3,3,6,1.282845,103.809614
109766,3,52,55,1.281853,103.81159
109767,41,5,46,1.282164,103.810867
109840,575,169,744,1.283129,103.806845
109841,1070,934,2004,1.283183,103.805835
109918,3317,393,3710,1.267374,103.808598
109919,509,323,832,1.266583,103.80877
109920,159,589,748,1.266336,103.808605
109921,95,17,112,1.265524,103.808784
109922,95,8,103,1.26524,103.808611
109923,274,324,598,1.2688,103.811534
110001,370,393,763,1.285391,103.778934
110002,28,958,986,1.285708,103.778178
110003,3,73,76,1.286407,103.777807
110004,4,61,65,1.28667,103.7769
110005,44,192,236,1.287242,103.776525
110006,38,95,133,1.287146,103.776097
110007,14,0,14,1.286678,103.776166
110008,118,8,126,1.286798,103.776558
110009,156,2,158,1.286228,103.776795
110010,63,1,64,1.286184,103.777394
110011,20,3,23,1.285609,103.777629
110012,5,0,5,1.28536,103.77787
110013,153,137,290,1.285248,103.778149
110014,142,100,242,1.285175,103.778464
110015,48,3,51,1.284751,103.778467
110016,190,41,231,1.284454,103.777915
110017,84,70,154,1.284274,103.777873
110018,103,74,177,1.284228,103.777262
110019,62,34,96,1.284553,103.777211
110020,55,33,88,1.284487,103.77682
110021,15,40,55,1.285127,103.776418
110022,21,88,109,1.284842,103.776183
110023,252,313,565,1.285421,103.775994
110024,124,896,1020,1.28525,103.775464
110025,36,29,65,1.285784,103.775402
110026,151,66,217,1.285659,103.774745
111013,7,11,18,1.285579,103.776468
111016,8,2,10,1.299509,103.837
112016,1,0,1,1.274366,103.807918
117361,12,0,12,1.299509,103.837
117366,0,1,1,1.299509,103.837
117367,1,1,2,1.299509,103.837
117371,1856,643,2499,1.276394,103.799498
117372,1561,252,1813,1.276479,103.799213
117373,1,33,34,1.27528,103.798999
117374,0,1,1,1.299509,103.837
117375,0,1,1,1.276478,103.798886
117376,338,71,409,1.30221,103.772909
117377,639,1335,1974,1.301405,103.773645
117381,25,18,43,1.299509,103.837
117382,76,18,94,1.299509,103.837
117383,35,26,61,1.275568,103.798667
117384,621,126,747,1.276478,103.798886
117385,719,128,847,1.276299,103.800017
117393,14,12,26,1.299509,103.837
117394,1,95,96,1.299509,103.837
117395,87,3,90,1.289476,103.777564
117396,179,1521,1700,1.28256,103.781774
117399,1,3,4,1.299509,103.837
117400,1,0,1,1.299509,103.837
117401,2,24,26,1.282367,103.779973
117402,24,13,37,1.299509,103.837
117403,119,64,183,1.299509,103.837
117404,140,8,148,1.274841,103.791455
117406,1902,857,2759,1.286215,103.783457
117407,341,633,974,1.288026,103.782939
117411,882,393,1275,1.299787,103.772094
117417,725,248,973,1.295053,103.773846
117418,282,160,442,1.293734,103.774184
117422,61,3,64,1.281571,103.783481
117423,158,20,178,1.281571,103.783481
117424,704,828,1532,1.276156,103.791588
117425,207,121,328,1.281571,103.783481
117426,15,0,15,1.291216,103.772503
117427,22,7,29,1.29123,103.772605
117428,6,11,17,1.291215,103.772641
117429,7,0,7,1.291349,103.772631
117430,5,0,5,1.291395,103.772656
117431,3,0,3,1.299509,103.837
117432,13,0,13,1.291485,103.772642
117433,2,0,2,1.299509,103.837
117434,33,0,33,1.291549,103.772648
117435,7,0,7,1.291628,103.772681
117436,2,0,2,1.291508,103.772665
117437,5,342,347,1.291684,103.772684
117438,9579,768,10347,1.274945,103.798934
117439,31232,26381,57613,1.274938,103.798929
117440,19212,2941,22153,1.274967,103.798904
117443,4,0,4,1.291614,103.772545
117444,17,0,17,1.29142,103.772534
117445,4,0,4,1.291318,103.77253
117446,1,6,7,1.288272,103.776934
117447,3,25,28,1.288264,103.77709
117449,2,0,2,1.291643,103.772651
117451,2,0,2,1.288413,103.777169
117452,199,426,625,1.282251,103.783483
117453,4,13,17,1.292077,103.770018
117455,0,2,2,1.289017,103.777515
117456,727,1,728,1.294449,103.780525
117468,15,214,229,1.289018,103.777516
117470,1,0,1,1.299509,103.837
117472,5,0,5,1.289017,103.777515
117473,0,2,2,1.292052,103.769995
117474,0,1,1,1.289017,103.777515
117475,3,0,3,1.291411,103.772668
117482,293,726,1019,1.287671,103.778326
117483,2,2,4,1.276732,103.787782
117484,73,41,114,1.289123,103.775581
117485,209,90,299,1.302321,103.772489
117486,1,93,94,1.285382,103.780741
117487,2,31,33,1.285143,103.78088
117488,62,22,84,1.279322,103.788636
117489,173,152,325,1.280685,103.785307
117490,122,3,125,1.280822,103.785458
117491,106,2,108,1.28103,103.785621
117492,266,9,275,1.28083,103.785893
117493,165,13,178,1.280665,103.785714
117494,98,689,787,1.280509,103.78546
117502,21,6,27,1.282065,103.779341
117503,122,77,199,1.291414,103.76888
117504,205,747,952,1.291812,103.769387
117505,219,868,1087,1.29183,103.768486
117506,73,47,120,1.291475,103.768575
117507,0,1,1,1.289017,103.777515
117508,105,242,347,1.300598,103.775001
117509,18,0,18,1.292312,103.769284
117510,100,8,108,1.296296,103.781299
117511,32,232,264,1.297021,103.771376
117512,2078,156,2234,1.285942,103.782424
117522,12,103,115,1.286135,103.780077
117523,5,71,76,1.286361,103.779843
117524,4,130,134,1.286587,103.77961
117525,2214,527,2741,1.286416,103.783516
117526,268,132,400,1.278326,103.787467
117527,0,6,6,1.299509,103.837
117528,4071,838,4909,1.289617,103.778966
117529,3,1,4,1.272904,103.800473
117530,3,4,7,1.272904,103.800473
117534,2,0,2,1.289017,103.777515
117535,12,35,47,1.271768,103.798785
117536,46,14,60,1.26946,103.799168
117537,35,1,36,1.270575,103.798593
117538,5,50,55,1.271686,103.796931
117539,23,1,24,1.282099,103.776312
117540,737,94,831,1.266777,103.803717
117541,508,745,1253,1.297158,103.779915
117542,75,202,277,1.297158,103.779895
117543,664,138,802,1.296119,103.778134
117544,6,57,63,1.296056,103.779842
117545,18,63,81,1.295744,103.780809
117546,44,0,44,1.296385,103.779572
117547,27,1,28,1.295509,103.779525
117549,1095,91,1186,1.295577,103.780071
117550,26,253,279,1.297,103.779082
117551,161,1235,1396,1.297051,103.778424
117552,27,4,31,1.296525,103.778932
117553,2,32,34,1.296768,103.778992
117554,0,6,6,1.296535,103.778922
117555,73,28,101,1.297139,103.778375
117556,17,0,17,1.29585,103.777716
117557,18,0,18,1.29561,103.777795
117558,14,2,16,1.29563,103.778434
117559,96,0,96,1.295691,103.778965
117560,17,9,26,1.295883,103.779021
117561,307,478,785,1.298961,103.775982
117563,183,247,430,1.300699,103.775916
117565,31,0,31,1.297413,103.771114
117566,786,1315,2101,1.29751,103.770684
117567,27,117,144,1.297267,103.770447
117568,94,159,253,1.295203,103.771322
117569,122,239,361,1.294521,103.770795
117570,910,121,1031,1.294235,103.770879
117571,149,57,206,1.294256,103.77179
117572,44,1,45,1.294585,103.771664
117573,7,1,8,1.295212,103.772112
117574,763,159,922,1.300197,103.771453
117575,337,557,894,1.300259,103.770791
117576,160,22,182,1.299144,103.770845
117577,84,27,111,1.298588,103.770752
117578,12,2,14,1.298678,103.771253
117579,3,0,3,1.288584,103.777081
117580,204,21,225,1.299463,103.772087
117581,23,8,31,1.299431,103.771945
117582,102,11,113,1.299255,103.772206
117583,16,6,22,1.298575,103.772203
117584,1110,391,1501,1.297916,103.772187
117585,374,45,419,1.298148,103.772452
117586,1996,1196,3192,1.287031,103.783162
117587,17,119,136,1.301756,103.773631
117588,31,111,142,1.292874,103.774212
117589,54,0,54,1.299509,103.837
117590,145,0,145,1.294962,103.773905
117591,6,0,6,1.299509,103.837
117592,72,270,342,1.293211,103.775105
117593,18,324,342,1.296722,103.78118
117594,62,1543,1605,1.296715,103.782151
117595,1,862,863,1.300705,103.772342
117596,3,4,7,1.296106,103.780938
117597,684,1310,1994,1.295892,103.781638
117598,8,1,9,1.295665,103.781284
117599,1355,21532,22887,1.29534,103.781526
117600,3,1,4,1.295348,103.781004
117601,26,50,76,1.29489,103.781605
117602,156,4,160,1.294263,103.775274
117603,97,5,102,1.295667,103.775183
117604,718,89,807,1.294439,103.776992
117605,996,506,1502,1.287365,103.787433
117606,824,2,826,1.283146,103.773894
117608,78,7,85,1.299226,103.772803
117609,354,5,359,1.294777,103.780408
117610,4286,322,4608,1.288695,103.782857
117611,3115,1787,4902,1.288196,103.782123
117612,4101,711,4812,1.283076,103.779343
117614,4,13,17,1.292712,103.769648
117615,0,3,3,1.299465,103.771147
117616,1,0,1,1.273683,103.793393
117617,1,0,1,1.292801,103.769711
117618,4,0,4,1.292896,103.769812
117619,28,821,849,1.28233,103.782559
117620,2,143,145,1.280885,103.785186
117621,152,18,170,1.291544,103.76965
117622,10,76,86,1.281375,103.784612
117623,2,3,5,1.281419,103.784564
117624,24,8,32,1.281477,103.784492
117625,7,0,7,1.281483,103.784454
117626,3,96,99,1.28149,103.784379
117627,13,15,28,1.281569,103.784363
117628,106,256,362,1.288665,103.781059
117629,252,19,271,1.279296,103.784817
117630,53,10,63,1.264402,103.804641
117631,6,145,151,1.265288,103.804867
117632,6,69,75,1.290745,103.770703
117633,12,1,13,1.291435,103.770832
117634,4,16,20,1.291439,103.770814
117635,51,165,216,1.291449,103.770779
117636,2,2,4,1.280936,103.785155
117637,17,0,17,1.27931,103.789243
117638,23,2,25,1.279319,103.789255
117639,11,0,11,1.27933,103.78926
117640,0,1,1,1.292811,103.769774
117641,11,2,13,1.279359,103.789278
117642,22,3,25,1.279385,103.789293
117643,1,0,1,1.279345,103.789269
117645,30,0,30,1.279537,103.789452
117646,1,0,1,1.279413,103.789308
117647,1,0,1,1.279553,103.789436
117650,63,8,71,1.279772,103.789175
117651,2,13,15,1.280276,103.789582
117652,14,5,19,1.280262,103.789616
117653,6,0,6,1.280251,103.789654
117654,9,3,12,1.280236,103.789693
117655,5,2,7,1.280224,103.789725
117657,7,0,7,1.280197,103.789803
117658,12,7,19,1.280246,103.789824
117659,4,3,7,1.280253,103.789802
117660,3,10,13,1.280262,103.789773
117661,0,2,2,1.270047,103.800511
117662,0,7,7,1.280288,103.789705
117663,15,14,29,1.280306,103.789645
117664,62,113,175,1.280321,103.789601
117665,6,23,29,1.290045,103.776652
117666,1,9,10,1.289998,103.776596
117667,0,10,10,1.289937,103.776603
117668,0,10,10,1.289844,103.776559
117669,1,24,25,1.2898,103.776526
117670,0,18,18,1.289711,103.776509
117671,2,636,638,1.289671,103.776481
117672,5,0,5,1.289727,103.774371
117673,16,0,16,1.289729,103.774349
117674,3005,364,3369,1.28646,103.781881
117675,4,110,114,1.285797,103.780428
117676,5,42,47,1.285909,103.78031
117677,1,53,54,1.28591,103.780311
117678,0,1,1,1.279619,103.78937
117679,2,2,4,1.29065,103.776549
117683,2,0,2,1.280272,103.789746
117684,4421,2091,6512,1.288119,103.779601
117685,2107,0,2107,1.289659,103.779104
117686,252,324,576,1.282,103.786949
117687,304,206,510,1.283287,103.786406
117688,382,47,429,1.282406,103.786942
117689,6,5,11,1.282301,103.78658
117690,2,0,2,1.290442,103.776491
117691,10,3,13,1.282535,103.786454
117692,3,1,4,1.282675,103.78639
117693,22,19,41,1.282914,103.786238
117694,1,1,2,1.282426,103.7865
117695,38,3,41,1.282943,103.786217
117696,7,35,42,1.283161,103.786087
117697,1,2,3,1.292768,103.76969
117698,3,0,3,1.283305,103.786014
117699,36,0,36,1.283424,103.785893
117700,2,1,3,1.283454,103.78584
117701,6,3,9,1.283594,103.785345
117702,24,56,80,1.282239,103.786638
117703,45,8,53,1.281238,103.784301
117704,14,200,214,1.281168,103.784409
117705,0,23,23,1.284992,103.780954
117706,3,17,20,1.284992,103.780954
117707,0,85,85,1.284992,103.780954
117708,1,18,19,1.284992,103.780954
117709,0,50,50,1.284992,103.780954
117710,3,106,109,1.284992,103.780954
117711,5,79,84,1.284992,103.780954
117712,112,1,113,1.283028,103.78617
117713,4,0,4,1.283671,103.785186
117714,7,3,10,1.283696,103.78513
117715,25,1,26,1.283608,103.784994
117716,15,7,22,1.283678,103.784941
117719,99,16,115,1.28309,103.798785
117720,74,4,78,1.282964,103.79829
117721,309,13,322,1.283441,103.798345
117722,65,25,90,1.283628,103.797073
117723,24,10,34,1.283806,103.796789
117724,110,7,117,1.283549,103.795773
117725,125,14,139,1.282689,103.797259
117726,42,27,69,1.282632,103.797148
117727,0,1,1,1.290003,103.776211
117746,1,3,4,1.276737,103.79225
117747,1,1,2,1.282868,103.786261
117748,1,4,5,1.276984,103.792374
117749,2,2,4,1.277015,103.792396
117750,0,7,7,1.277055,103.792631
117751,1,16,17,1.277181,103.792654
117752,288,98,386,1.277279,103.793142
117753,4,1,5,1.27729,103.792554
117754,1,0,1,1.282588,103.798705
117755,499,51,550,1.278095,103.793398
117756,318,30,348,1.278798,103.793508
117757,880,29,909,1.278905,103.79273
117758,62,43,105,1.278355,103.792508
117776,146,2,148,1.285006,103.79496
117777,82,3,85,1.285003,103.79548
117778,67,7,74,1.284321,103.794873
117779,11,0,11,1.28415,103.794168
117780,62,1,63,1.284361,103.793759
117781,195,1,196,1.28489,103.793488
117782,3,23,26,1.285179,103.794195
117783,247,73,320,1.286135,103.79468
117784,90,37,127,1.285953,103.7954
117785,3,0,3,1.283562,103.78544
117786,330,160,490,1.286281,103.795435
117821,5,308,313,1.277468,103.789931
117822,1,2,3,1.284895,103.794311
117823,21,250,271,1.277423,103.789914
117824,7,0,7,1.277508,103.790212
117825,9,131,140,1.277496,103.790242
117826,3,23,26,1.277458,103.790316
117827,7,30,37,1.277443,103.790392
117828,3,1,4,1.277422,103.790466
117829,2,652,654,1.277371,103.79057
117830,0,8,8,1.277358,103.790612
117831,0,2,2,1.276836,103.792293
117832,3,0,3,1.277529,103.790094
117833,37,0,37,1.27759,103.790085
117835,1,0,1,1.277427,103.792595
117836,12,0,12,1.277557,103.790185
117837,0,1,1,1.277571,103.790151
117838,19,1,20,1.277502,103.790319
117839,5,1,6,1.277475,103.790386
117840,2,0,2,1.277594,103.789999
117841,2,2,4,1.27742,103.790521
117842,3,1,4,1.277392,103.790588
117843,3,0,3,1.277599,103.790031
117844,31,4,35,1.277596,103.789968
117845,1,0,1,1.27753,103.790252
117846,31,0,31,1.277542,103.789911
117847,20,3,23,1.277567,103.789928
117861,4,12,16,1.279854,103.782676
117862,18,51,69,1.282834,103.779987
117863,3,8,11,1.281774,103.781657
117864,110,178,288,1.284457,103.780115
117865,0,29,29,1.281989,103.781897
117866,2,18,20,1.279345,103.783258
117867,726,896,1622,1.283221,103.780681
117868,6,18,24,1.299509,103.837
117880,1,68,69,1.279241,103.786342
117881,5,36,41,1.279098,103.786447
117882,13,3,16,1.279177,103.786417
117883,5,0,5,1.279072,103.786473
117884,1,0,1,1.277591,103.789952
117885,2,2,4,1.279052,103.786507
117886,1,1,2,1.277447,103.790453
117887,41,11,52,1.279012,103.786573
117889,2,20,22,1.279008,103.786611
117929,2,2,4,1.278761,103.790585
117930,34,4,38,1.27877,103.790632
117931,11,0,11,1.278779,103.790552
117932,28,0,28,1.278794,103.790592
117934,1,0,1,1.279131,103.786463
117936,0,2,2,1.279111,103.786486
117937,1,0,1,1.278822,103.790533
117940,2,1,3,1.277365,103.790655
117959,6,7,13,1.279929,103.791388
117960,7,32,39,1.279929,103.791456
117961,4,0,4,1.279901,103.791447
117962,65,0,65,1.279911,103.791494
117963,0,2,2,1.278842,103.790473
117967,2,28,30,1.279851,103.791591
117971,0,1,1,1.278879,103.79038
117989,1,4,5,1.280404,103.791738
117990,22,0,22,1.280445,103.791706
117991,6,0,6,1.28042,103.791689
117992,10,3,13,1.280459,103.791673
117993,159,4,163,1.280444,103.791631
117994,2,1,3,1.278916,103.790327
117995,7,6,13,1.280459,103.791579
117997,2,0,2,1.27988,103.791501
117998,4,0,4,1.280498,103.791498
117999,0,8,8,1.280442,103.791335
118000,6,0,6,1.280426,103.791432
118001,0,2,2,1.280428,103.791374
118002,8,2,10,1.280431,103.791396
118003,12,0,12,1.280481,103.791203
118004,6,0,6,1.280445,103.791351
118005,5,1,6,1.280498,103.791131
118006,9,2,11,1.280474,103.791259
118007,59,0,59,1.280521,103.791085
118008,4,0,4,1.280504,103.791168
118010,3,0,3,1.280488,103.791608
118028,87,1,88,1.279048,103.790879
118029,0,1,1,1.279856,103.791621
118030,34,1,35,1.279,103.790922
118031,5,1,6,1.279036,103.790905
118034,27,0,27,1.278915,103.791111
118035,7,1,8,1.278988,103.791009
118036,2,0,2,1.280455,103.791271
118037,9,0,9,1.278964,103.791062
118038,1,2,3,1.280533,103.791076
118039,3,0,3,1.278851,103.791251
118040,1,0,1,1.278956,103.791015
118041,1,21,22,1.278916,103.791166
118042,0,1,1,1.278819,103.791321
118043,7,5,12,1.278892,103.791218
118044,1,1,2,1.278881,103.791185
118045,1,8,9,1.278868,103.79127
118046,174,16,190,1.278404,103.791286
118047,31,1,32,1.278844,103.791323
118049,1,16,17,1.27882,103.791375
118050,3,3,6,1.27838,103.791268
118051,11,12,23,1.278796,103.791427
118053,0,6,6,1.278747,103.79147
118054,11,1,12,1.278354,103.791247
118055,0,1,1,1.278815,103.791365
118056,16,0,16,1.279177,103.786417
118057,8,0,8,1.278301,103.791205
118076,11,1,12,1.278358,103.790151
118079,3,2,5,1.278268,103.790233
118080,0,1,1,1.278722,103.791491
118081,65,0,65,1.278239,103.79029
118082,1,3,4,1.278249,103.790338
118083,22,3,25,1.278199,103.790366
118084,5,5,10,1.278175,103.790416
118085,4,3,7,1.278132,103.790522
118086,28,0,28,1.278104,103.790585
118087,25,1,26,1.278082,103.790647
118088,3,0,3,1.27894,103.791114
118089,47,0,47,1.278033,103.790792
118108,23,1,24,1.27952,103.790979
118110,1,0,1,1.27829,103.790273
118111,5,0,5,1.279338,103.790863
118112,3,0,3,1.278051,103.790718
118115,13,0,13,1.278387,103.790533
118116,0,3,3,1.279294,103.790837
118135,6,1084,1090,1.279096,103.786124
118136,1038,0,1038,1.27958,103.786245
118137,2,12,14,1.279149,103.786159
118138,20,99,119,1.299509,103.837
118139,14,190,204,1.27962,103.786261
118140,5,109,114,1.27989,103.786353
118141,70,107,177,1.280061,103.786409
118143,4,8,12,1.280433,103.786545
118144,3,53,56,1.279692,103.786335
118145,2,131,133,1.279739,103.786351
118146,92,13,105,1.280569,103.786649
118147,2,0,2,1.278759,103.791439
118148,1,10,11,1.279905,103.786404
118149,6,27,33,1.280704,103.786719
118150,0,18,18,1.280119,103.786482
118151,2,1,3,1.27833,103.790502
118152,2,28,30,1.280873,103.786813
118153,3,0,3,1.280061,103.786465
118154,51,56,107,1.280272,103.78658
118155,6,128,134,1.281108,103.786933
118156,58,92,150,1.280459,103.786651
118157,36,90,126,1.280505,103.786666
118158,14,61,75,1.280561,103.786701
118159,134,117,251,1.280613,103.786719
118160,153,156,309,1.280674,103.786753
118161,136,26,162,1.280744,103.78678
118162,305,104,409,1.280816,103.786822
118163,10,0,10,1.280905,103.786856
118164,183,0,183,1.280951,103.786891
118165,62,191,253,1.280988,103.786905
118166,777,146,923,1.281177,103.787758
118167,272,207,479,1.281106,103.789943
118168,276,48,324,1.280935,103.79041
118169,109,10,119,1.280703,103.790088
118170,164,1,165,1.280349,103.790715
118171,107,35,142,1.280736,103.790898
118172,980,55,1035,1.281239,103.790967
118173,355,36,391,1.281419,103.790244
118174,896,97,993,1.281754,103.789617
118175,737,72,809,1.281353,103.789014
118176,197,84,281,1.283478,103.788617
118177,163,708,871,1.293067,103.78459
118178,13,11,24,1.299509,103.837
118194,27,10,37,1.278082,103.789111
118195,1,1,2,1.279853,103.786389
118196,8,5,13,1.278033,103.789206
118197,95,1,96,1.278032,103.789121
118200,3,3,6,1.277956,103.7894
118201,2,0,2,1.278044,103.789043
118202,3,0,3,1.280988,103.786875
118203,7,4,11,1.277858,103.789518
118204,3,1,4,1.277898,103.78953
118205,14,1,15,1.277885,103.78955
118206,0,2,2,1.27793,103.789345
118221,2926,877,3803,1.291401,103.785218
118222,3902,2978,6880,1.291094,103.785103
118223,877,695,1572,1.29125,103.787023
118224,36,623,659,1.290705,103.785786
118225,991,2834,3825,1.290323,103.786674
118226,1194,83,1277,1.289223,103.787209
118227,3087,595,3682,1.290277,103.787492
118228,13,3,16,1.278328,103.791242
118229,3130,0,3130,1.290224,103.788292
118230,258,26,284,1.289097,103.788601
118231,0,7,7,1.291898,103.787016
118232,2,0,2,1.299509,103.837
118239,3,13,16,1.289626,103.787766
118240,2,0,2,1.291929,103.787018
118241,6,0,6,1.292391,103.786614
118247,0,23,23,1.292388,103.786622
118252,0,110,110,1.292416,103.786649
118253,725,3178,3903,1.291074,103.788244
118254,2285,2688,4973,1.290467,103.789073
118255,1026,469,1495,1.289885,103.790225
118256,2140,246,2386,1.289339,103.791521
118257,1647,776,2423,1.289052,103.790547
118258,334,304,638,1.288508,103.791233
118259,1476,1860,3336,1.28828,103.790535
118260,1456,1352,2808,1.287916,103.790416
118261,6360,503,6863,1.288147,103.791239
118262,7,93,100,1.288298,103.791409
118263,43,1781,1824,1.288445,103.791479
118264,4265,1487,5752,1.289707,103.790278
118281,112,201,313,1.284111,103.79877
118282,41,89,130,1.285209,103.796793
118283,13,35,48,1.285157,103.796517
118284,112,136,248,1.285709,103.79601
118285,160,52,212,1.285455,103.796085
118303,28,207,235,1.283276,103.800255
118304,74,0,74,1.283108,103.800107
118305,24,57,81,1.283248,103.799593
118306,75,4,79,1.283,103.798727
118307,16,2,18,1.282262,103.797696
118308,0,1,1,1.279419,103.790913
118401,14,31,45,1.292577,103.779993
118402,6,11,17,1.292735,103.779678
118403,6,2,8,1.292958,103.778752
118404,2,4,6,1.29308,103.778379
118405,7,0,7,1.293235,103.778344
118406,6,5,11,1.293256,103.77779
118407,1,0,1,1.281885,103.797353
118408,4,4,8,1.293661,103.777166
118409,9,60,69,1.293674,103.776299
118410,6,0,6,1.293723,103.776687
118411,24,39,63,1.293644,103.776974
118412,7,2,9,1.293289,103.7775
118413,0,5,5,1.29342,103.77729
118414,34,5,39,1.293108,103.777825
118415,0,4,4,1.292966,103.778169
118416,0,6,6,1.292558,103.779214
118417,22,1,23,1.292406,103.779556
118420,115,99,214,1.291766,103.782848
118422,37,22,59,1.290799,103.782153
118424,63,5,68,1.290144,103.781799
118425,1954,1100,3054,1.291178,103.781569
118426,328,194,522,1.291341,103.78047
118427,53,0,53,1.290616,103.78139
118428,38,1,39,1.290669,103.780736
118429,117,8,125,1.290858,103.780416
118430,68,7,75,1.291175,103.780086
118431,121,262,383,1.291848,103.779962
118442,424,53,477,1.276412,103.793525
118443,703,111,814,1.276756,103.793621
118450,673,70,743,1.277451,103.793853
118451,1,0,1,1.293468,103.777442
118452,0,31,31,1.278323,103.794312
118453,0,2,2,1.292421,103.786619
118454,283,9,292,1.279982,103.793694
118455,108,1,109,1.280228,103.792935
118456,236,4,240,1.280496,103.793223
118457,408,132,540,1.280122,103.793689
118458,39,39,78,1.279539,103.794332
118476,0,20,20,1.270412,103.801381
118477,0,18,18,1.270895,103.801391
118478,119,3772,3891,1.27239,103.801433
118479,41,259,300,1.271745,103.802537
118480,575,28,603,1.272845,103.795576
118481,243,30223,30466,1.27239,103.801433
118482,1,6,7,1.273654,103.793368
118483,153,4393,4546,1.27239,103.801433
118484,14,8,22,1.272495,103.792721
118485,48,30,78,1.272353,103.799764
118487,0,4,4,1.271227,103.801048
118488,0,41,41,1.27156,103.801095
118490,5,524,529,1.27256,103.8013
118492,15,59,74,1.275183,103.791721
118493,4,0,4,1.273637,103.790715
118495,0,4,4,1.270732,103.797512
118496,8,0,8,1.270735,103.797517
118497,0,1,1,1.277073,103.795409
118498,3,0,3,1.277905,103.789421
118499,1,3,4,1.276496,103.786255
118500,15,5,20,1.27831,103.783293
118501,41,795,836,1.274126,103.798707
118502,49,6,55,1.276645,103.797976
118503,101,1970,2071,1.273538,103.798088
118505,56,9,65,1.272963,103.79667
118506,19,223,242,1.273761,103.796365
118507,86,351,437,1.274615,103.795904
118508,21,545,566,1.274857,103.795516
118509,6,269,275,1.274869,103.79544
118510,22,20,42,1.274833,103.795376
118511,30,45,75,1.274869,103.7953
118512,0,28,28,1.274864,103.795241
118513,12,114,126,1.274942,103.795217
118514,22,1632,1654,1.274913,103.795128
118515,19,101,120,1.2749,103.795042
118516,14,2279,2293,1.275146,103.795835
118517,295,436,731,1.275011,103.794955
118518,1111,131,1242,1.275525,103.795551
118519,479,20,499,1.275828,103.79585
118520,482,332,814,1.27631,103.795721
118521,165,19,184,1.276569,103.795869
118522,16,69,85,1.276855,103.795955
118523,561,30,591,1.277575,103.796356
118524,22,76,98,1.278141,103.796717
118525,563,69,632,1.278491,103.79669
118526,73,39,112,1.278948,103.796776
118527,4,38,42,1.275007,103.7948
118528,20,6,26,1.278332,103.795831
118529,1121,467,1588,1.276015,103.795452
118530,620,1,621,1.276217,103.794921
118531,102,558,660,1.275021,103.794769
118534,12,1556,1568,1.275712,103.794314
118535,3164,474,3638,1.276601,103.794394
118536,22,13,35,1.274922,103.793385
118538,4,1527,1531,1.27582,103.793751
118539,15,699,714,1.275922,103.793411
118540,3,34,37,1.275963,103.793309
118541,51,535,586,1.275954,103.79333
118542,3,25,28,1.27599,103.793227
118543,38,225,263,1.2759,103.791393
118544,31,297,328,1.275999,103.793198
118545,3,15,18,1.276014,103.793158
118546,7,285,292,1.276032,103.793097
118547,3,28,31,1.276054,103.793045
118548,48,1384,1432,1.276069,103.792993
118549,56,1,57,1.27617,103.793371
118551,8,865,873,1.276448,103.792827
118552,1,4,5,1.276487,103.792344
118553,155,5236,5391,1.276606,103.792051
118554,71,1714,1785,1.277054,103.790924
118555,31,197,228,1.277156,103.790603
118556,78,249,327,1.277539,103.78968
118557,3,200,203,1.27747,103.789464
118558,0,18,18,1.277476,103.789415
118559,4,36,40,1.277536,103.789351
118560,17,0,17,1.27751,103.789331
118561,0,31,31,1.277561,103.789255
118562,0,13,13,1.277576,103.789205
118563,4,22,26,1.27756,103.789183
118564,0,32,32,1.277583,103.789118
118565,0,50,50,1.277659,103.788987
118566,4,85,89,1.277701,103.788905
118567,2,65,67,1.277696,103.788823
118568,9,903,912,1.277754,103.788757
118570,2,10,12,1.299509,103.837
118571,630,2187,2817,1.278687,103.787414
118572,1577,14,1591,1.279096,103.787166
118573,12,73,85,1.278707,103.786874
118574,3,38,41,1.278863,103.785349
118575,6,192,198,1.278897,103.78528
118576,33,1,34,1.278928,103.785209
118577,7,529,536,1.279193,103.785907
118578,0,1,1,1.276491,103.789404
118579,93,116,209,1.279261,103.785914
118580,21,2,23,1.279006,103.785089
118581,3,178,181,1.279272,103.785901
118582,0,2,2,1.277792,103.79441
118583,1,276,277,1.279336,103.785891
118584,2,17,19,1.279095,103.78495
118585,1,166,167,1.279355,103.78585
118586,5,147,152,1.279399,103.785859
118587,0,104,104,1.279434,103.785807
118588,3,110,113,1.27947,103.785804
118589,2,128,130,1.279523,103.785791
118590,11,1,12,1.279967,103.785312
118591,0,9,9,1.279881,103.784639
118592,3,117,120,1.27958,103.785795
118593,4,161,165,1.279627,103.785758
118594,3,258,261,1.279635,103.785762
118595,15,1074,1089,1.279675,103.785753
118597,37,1069,1106,1.279794,103.785732
118598,102,1227,1329,1.280164,103.785587
118599,103,0,103,1.280574,103.785101
118600,5,1,6,1.280672,103.785026
118601,1,7,8,1.280718,103.784983
118602,0,39,39,1.276069,103.79307
118603,5,0,5,1.280134,103.784427
118604,10,2,12,1.280167,103.784432
118605,37,58,95,1.281075,103.785067
118606,1,1,2,1.279073,103.785045
118607,227,66,293,1.280338,103.783957
118608,25,41,66,1.281245,103.78467
118609,188,44,232,1.281148,103.784449
118610,19,43,62,1.28128,103.784163
118613,4,0,4,1.281279,103.784162
118616,0,13,13,1.280957,103.783627
118617,503,121,624,1.282408,103.783205
118618,416,488,904,1.281457,103.783894
118619,1,11,12,1.282457,103.7831
118620,3,21,24,1.281633,103.783625
118621,0,9,9,1.281778,103.783011
118622,0,50,50,1.282485,103.78301
118623,4,58,62,1.28181,103.783356
118624,9,5,14,1.281809,103.783355
118625,7,169,176,1.28251,103.782928
118626,8,195,203,1.281987,103.783087
118627,0,76,76,1.282163,103.782818
118628,72,1,73,1.285506,103.783144
118630,3,158,161,1.284993,103.780955
118631,3,36,39,1.285144,103.780881
118632,14,53,67,1.285383,103.780742
118633,169,58,227,1.286975,103.780374
118634,99,68,167,1.286136,103.780078
118635,268,11,279,1.287145,103.780171
118636,2,4,6,1.286362,103.779844
118637,2,35,37,1.286588,103.779611
118638,1,137,138,1.286725,103.779474
118639,0,35,35,1.286724,103.779473
118640,396,51,447,1.287346,103.779911
118641,20,113,133,1.287477,103.780319
118642,4,562,566,1.287048,103.779233
118643,13,0,13,1.287526,103.779813
118644,10,28,38,1.287743,103.780159
118645,5,156,161,1.28722,103.779114
118646,2,126,128,1.287456,103.778952
118647,11,30,41,1.287749,103.778741
118648,8,25,33,1.287748,103.77874
118649,2,167,169,1.287748,103.77874
118650,20,486,506,1.287748,103.77874
118651,1,66,67,1.287924,103.778626
118652,209,491,700,1.288598,103.778154
118653,78,303,381,1.288446,103.777339
118654,41,983,1024,1.289248,103.777887
118655,106,14,120,1.289593,103.777985
118656,12,1,13,1.299509,103.837
118658,9,17,26,1.288472,103.776825
118659,29,706,735,1.289375,103.777525
118660,36,11,47,1.289108,103.777269
118661,1,235,236,1.289107,103.777268
118662,1,116,117,1.289107,103.777268
118663,0,23,23,1.289107,103.777268
118664,3,58,61,1.289107,103.777268
118665,0,72,72,1.289107,103.777268
118666,0,19,19,1.289107,103.777268
118667,5,55,60,1.289107,103.777268
118668,236,438,674,1.289574,103.777114
118669,341,7,348,1.290033,103.777297
118670,7,15,22,1.288507,103.776647
118671,3,203,206,1.288581,103.776339
118672,16,0,16,1.288656,103.776339
118673,63,0,63,1.288694,103.776389
118674,5,0,5,1.28877,103.776385
118675,6,1,7,1.288829,103.776409
118676,766,21,787,1.289748,103.776895
118677,3,1,4,1.289289,103.776776
118678,1,0,1,1.278961,103.785142
118679,1,0,1,1.289288,103.776775
118680,6,1,7,1.289288,103.776775
118681,3,3,6,1.289288,103.776775
118682,7,604,611,1.289288,103.776775
118683,7,13,20,1.276177,103.792782
118684,133,1,134,1.288797,103.776218
118685,4,5,9,1.290522,103.776795
118687,46,1,47,1.290379,103.776709
118688,18,128,146,1.289291,103.776009
118689,11,466,477,1.28975,103.776227
118690,0,1,1,1.289288,103.776775
118691,131,651,782,1.289278,103.77584
118692,19,11,30,1.290397,103.775933
118693,186,8,194,1.289265,103.775546
118694,19,626,645,1.290482,103.775407
118695,43,273,316,1.289461,103.775388
118696,2,22,24,1.289444,103.775235
118697,59,24,83,1.289451,103.774922
118699,720,180,900,1.290403,103.774851
118700,6,53,59,1.289689,103.774598
118701,20,361,381,1.289802,103.774553
118702,15,317,332,1.290374,103.774823
118703,5,38,43,1.289731,103.774383
118705,10,28,38,1.291025,103.774595
118706,12,76,88,1.289889,103.774105
118707,708,31,739,1.290944,103.774356
118708,4,666,670,1.290024,103.773892
118709,613,240,853,1.290959,103.774063
118710,2,208,210,1.29015,103.773682
118711,1,58,59,1.290122,103.773686
118712,17,14,31,1.291689,103.772558
118713,28,219,247,1.290306,103.772767
118717,4,0,4,1.291298,103.772647
118718,34,905,939,1.290541,103.772516
118719,559,134,693,1.290764,103.772069
118720,2,104,106,1.291083,103.771183
118721,5,30,35,1.290735,103.771208
118722,24,0,24,1.291343,103.772405
118723,6,192,198,1.291352,103.772236
118724,4,7,11,1.291504,103.772248
118725,2,19,21,1.291036,103.771171
118728,0,20,20,1.291055,103.771134
118729,47,0,47,1.290764,103.771085
118730,6,224,230,1.291378,103.771728
118731,9,2,11,1.291072,103.771068
118732,7,1,8,1.290803,103.771015
118733,55,448,503,1.291583,103.771139
118734,0,1,1,1.289773,103.776242
118735,2,2,4,1.290786,103.770926
118736,22,295,317,1.291061,103.770935
118737,3,3,6,1.290833,103.770863
118738,2,190,192,1.291747,103.770634
118739,22,0,22,1.291833,103.770437
118740,7,89,96,1.291854,103.770393
118741,877,571,1448,1.292088,103.770198
118742,34,3,37,1.292358,103.770172
118743,9,409,418,1.292025,103.769772
118744,97,208,305,1.292116,103.769633
118746,0,1,1,1.291084,103.770973
118749,1,0,1,1.292356,103.769896
118750,1,0,1,1.292157,103.769754
118751,1,127,128,1.292158,103.769367
118753,1,0,1,1.292246,103.76977
118754,0,2,2,1.281143,103.784969
118756,163,6,169,1.292592,103.769543
118757,1,334,335,1.2922,103.769191
118758,5,250,255,1.291495,103.770601
118759,961,6,967,1.292234,103.768912
118760,0,6,6,1.291504,103.770566
118761,3,590,593,1.276259,103.792563
118762,0,18,18,1.291513,103.77053
118763,4,410,414,1.276261,103.792558
118764,0,12,12,1.291523,103.770495
118765,18,1412,1430,1.276264,103.792552
118766,0,5,5,1.291532,103.770459
118768,0,7,7,1.291541,103.770424
118769,1098,1153,2251,1.292363,103.768604
118770,1,18,19,1.29155,103.770388
118772,0,2,2,1.292421,103.769354
118773,393,0,393,1.292407,103.7685
118774,0,8,8,1.291569,103.770317
118775,2,0,2,1.29156,103.770353
118776,1,20,21,1.291578,103.770282
118777,16,1417,1433,1.276277,103.792517
118778,1,279,280,1.291588,103.770246
118779,13,841,854,1.292429,103.768382
118782,7,25,32,1.29241,103.768346
118784,1,37,38,1.290882,103.770482
118785,9,680,689,1.292556,103.768399
118786,5,299,304,1.29245,103.768334
118788,0,5,5,1.290887,103.770368
118789,1,0,1,1.292516,103.769433
118790,0,3,3,1.275211,103.788223
118791,1,0,1,1.290904,103.770329
118792,0,1,1,1.290907,103.770221
118794,0,2,2,1.276274,103.792523
118795,0,4,4,1.290936,103.77002
118796,1,2,3,1.29092,103.7703
118797,463,0,463,1.290982,103.769904
118799,0,3,3,1.290956,103.769945
118801,1,1,2,1.290922,103.770054
118807,0,556,556,1.291975,103.768195
118809,2,39,41,1.289626,103.774421
118810,10115,1508,11623,1.269957,103.796127
118811,7,0,7,1.292464,103.770269
118812,116,0,116,1.292539,103.770313
118813,2,6,8,1.292569,103.770001
118814,3,3,6,1.292628,103.770057
118815,3,325,328,1.275378,103.793332
118816,3,1,4,1.289823,103.776234
118817,4,0,4,1.289874,103.776283
118818,0,2,2,1.291067,103.769725
118819,0,3,3,1.291053,103.769795
118821,7,2,9,1.29007,103.77632
118822,0,2,2,1.289919,103.776306
118823,1,1,2,1.290111,103.776341
118824,32,0,32,1.290381,103.77646
118825,10,0,10,1.290416,103.776474
118826,23,64,87,1.280048,103.785816
118827,84,32,116,1.280349,103.785775
118828,26,44,70,1.280107,103.785856
118829,12,45,57,1.280652,103.786186
118830,14,23,37,1.280255,103.785989
118831,14,5,19,1.281162,103.786113
118833,1,12,13,1.281397,103.786228
118834,2,21,23,1.281743,103.786247
118836,3,9,12,1.281805,103.786232
118838,45,30,75,1.28185,103.786208
118840,8,36,44,1.281912,103.786194
118842,10,9,19,1.282182,103.786104
118843,0,18,18,1.282159,103.786111
118844,19,0,19,1.282133,103.786125
118846,2,3,5,1.282327,103.785976
118847,22,6,28,1.282348,103.785946
118848,1,5,6,1.282394,103.785855
118850,2,13,15,1.282497,103.785684
118851,7,42,49,1.282607,103.785612
118852,82,2,84,1.28272,103.78557
118853,349,110,459,1.281386,103.785493
118854,1,0,1,1.290931,103.770163
118856,12,0,12,1.282915,103.7855
118858,1,0,1,1.282944,103.785489
118859,7,0,7,1.282925,103.785494
118860,613,11,624,1.281665,103.784894
118861,58,1,59,1.282955,103.785481
118862,477,20,497,1.282026,103.784466
118863,189,127,316,1.281864,103.784275
118864,284,500,784,1.281968,103.784001
118865,2,16,18,1.282245,103.7841
118866,124,4,128,1.28267,103.784311
118868,123,1,124,1.282569,103.784424
118869,4,0,4,1.282495,103.784436
118870,1,2,3,1.28999,103.776311
118871,11,1,12,1.282423,103.784522
118872,21,1,22,1.282369,103.78461
118873,0,5,5,1.281821,103.78496
118874,1,2,3,1.282446,103.784504
118875,2,3,5,1.281879,103.784881
118876,1,2,3,1.28188,103.784882
118877,5,7,12,1.281937,103.784802
118878,29,19,48,1.281996,103.784723
118879,6,62,68,1.281995,103.784722
118880,45,6,51,1.282054,103.784644
118881,56,3,59,1.282053,103.784643
118882,22,99,121,1.281906,103.785191
118883,45,38,83,1.281856,103.785266
118884,72,27,99,1.28176,103.78539
118885,154,4,158,1.281564,103.785709
118886,1,22,23,1.281076,103.786003
118887,1,0,1,1.282897,103.785504
118888,0,9,9,1.281075,103.786002
118890,9,0,9,1.281637,103.78621
118891,31,2,33,1.281749,103.785986
118892,899,63,962,1.281858,103.785839
118893,977,2,979,1.282393,103.78529
118894,789,349,1138,1.282779,103.785505
118895,374,3,377,1.282982,103.785443
118896,408,6,414,1.283161,103.784662
118897,62,7,69,1.280419,103.786104
118898,2,3,5,1.280466,103.786147
118899,5,72,77,1.282423,103.784291
118902,16,7,23,1.282753,103.784808
118903,17,1,18,1.281873,103.785264
118904,1,0,1,1.281075,103.786002
118905,5,0,5,1.281767,103.785421
118906,15,8,23,1.281686,103.785477
118907,173,1,174,1.28168,103.785538
118908,2,8,10,1.281638,103.785576
118911,3,1,4,1.291865,103.770715
118913,14,2,16,1.29239,103.786749
118914,0,1,1,1.281842,103.785322
118915,5,15,20,1.291645,103.771422
118916,5,5,10,1.291658,103.77138
118917,4,1,5,1.291685,103.771295
118918,123,4,127,1.291711,103.771211
118919,0,3,3,1.281938,103.784803
118920,4,2,6,1.291764,103.771042
118921,9,7,16,1.29182,103.77086
118922,6,0,6,1.292368,103.770999
118923,0,1,1,1.2918,103.770947
118924,17,1,18,1.292114,103.771047
118925,0,1,1,1.292125,103.771
118926,3,1,4,1.292113,103.771158
118927,4,0,4,1.292111,103.771232
118928,117,7,124,1.29211,103.771306
118929,16,12,28,1.292109,103.77138
118930,6,21,27,1.292118,103.771444
118931,2,2,4,1.292108,103.771474
118932,158,0,158,1.292107,103.771494
118933,2,2,4,1.292106,103.771534
118934,0,2,2,1.290325,103.776416
118935,1,0,1,1.292114,103.771084
118936,0,1,1,1.292104,103.771615
118937,8,0,8,1.292102,103.771696
118938,3,2,5,1.292101,103.771736
118939,3,9,12,1.29211,103.771766
118940,0,2,2,1.292105,103.771575
118941,1,6,7,1.291642,103.771454
118959,2,65,67,1.291317,103.772068
118961,81,0,81,1.291424,103.772077
118962,3,0,3,1.291737,103.771126
118963,2,0,2,1.292108,103.771454
118964,7,0,7,1.291564,103.772085
118966,1,5,6,1.291744,103.772098
118967,0,1,1,1.292103,103.771655
118968,8,0,8,1.291924,103.772111
118969,2,14,16,1.29179,103.770957
118971,1,0,1,1.291964,103.772115
118972,25,0,25,1.291978,103.772108
118973,14,0,14,1.291974,103.772125
118974,17,0,17,1.291968,103.772149
118975,8,2,10,1.291962,103.772174
118976,14,21,35,1.291951,103.772222
118977,11,0,11,1.29194,103.77227
118980,9,0,9,1.291905,103.772416
118998,2172,73,2245,1.28671,103.790986
118999,1923,173,2096,1.286349,103.791465
119000,1351,2,1353,1.287435,103.792498
119001,1170,935,2105,1.288092,103.793036
119002,2246,319,2565,1.287788,103.793509
119003,100,536,636,1.286991,103.791402
119004,234,86,320,1.286974,103.791771
119005,287,19,306,1.286451,103.792375
119006,98,10,108,1.286066,103.792375
119007,64,38,102,1.286609,103.79284
119008,74,1,75,1.286301,103.792917
119009,212,1316,1528,1.287493,103.792636
119010,54,23,77,1.28716,103.793014
119011,17,44,61,1.286771,103.792128
119029,0,4,4,1.292166,103.768632
119030,9,3,12,1.292165,103.768631
119031,1,3,4,1.292134,103.768623
119032,0,6,6,1.292133,103.768622
119033,0,5,5,1.292245,103.768703
119034,29,0,29,1.292182,103.768666
119035,6,0,6,1.292181,103.768665
119037,5,1,6,1.292323,103.768774
119038,0,1,1,1.292064,103.772033
119039,2,2,4,1.292456,103.768886
119041,10,1,11,1.292372,103.768835
119042,1,0,1,1.292277,103.768752
119043,2,5,7,1.292571,103.769002
119044,0,4,4,1.29285,103.769217
119045,6,2,8,1.292849,103.769216
119047,3,2,5,1.292849,103.769216
119048,0,1,1,1.292472,103.768919
119049,0,2,2,1.291604,103.772089
119050,12,1,13,1.292982,103.769327
119051,0,3,3,1.291384,103.772073
119055,0,3,3,1.293113,103.769438
119056,2,5,7,1.292587,103.768996
119057,63,0,63,1.292718,103.769106
119074,19827,126832,146659,1.294736,103.782853
119075,193,377,570,1.299123,103.775692
119076,132,917,1049,1.296248,103.783381
119077,1681,1072,2753,1.295696,103.778921
119078,1015,954,1969,1.298219,103.774488
119080,295,616,911,1.298873,103.775969
119081,212,478,690,1.297963,103.776655
119082,5668,12445,18113,1.293631,103.784385
119083,166,661,827,1.29698,103.78161
119093,0,1,1,1.292849,103.769216
119094,290,5,295,1.279527,103.786713
119095,2,6,8,1.279573,103.786768
119096,3,18,21,1.279632,103.786807
119097,3,9,12,1.279703,103.786846
119098,3,3,6,1.279877,103.786931
119099,14,2,16,1.280122,103.786931
119100,1,1,2,1.292669,103.769085
119101,97,3,100,1.280137,103.787136
119102,0,5,5,1.280244,103.787054
119104,14,2,16,1.280122,103.786931
119105,4,0,4,1.280291,103.78729
119106,0,5,5,1.280363,103.787353
119107,1,3,4,1.280411,103.787399
119108,1,3,4,1.280391,103.787304
119111,17,0,17,1.280493,103.787471
119112,42,1,43,1.28043,103.787332
119113,22,0,22,1.280495,103.787393
119114,21,1,22,1.280527,103.787429
119116,10,10,20,1.280362,103.787116
119117,4,16,20,1.280331,103.787251
119118,1,4,5,1.280632,103.787531
119119,5,7,12,1.280652,103.787553
119129,8,308,316,1.281083,103.787136
119131,125,6,131,1.281039,103.787207
119132,1,26,27,1.280874,103.787381
119133,70,0,70,1.280985,103.787276
119135,3,4,7,1.280953,103.787325
119137,3,0,3,1.293103,103.769448
119138,17,14,31,1.280626,103.78759
119139,2,0,2,1.280207,103.786965
119140,3,0,3,1.280917,103.78736
119141,0,1,1,1.279517,103.786672
119142,1,3,4,1.280819,103.787501
119143,10,1,11,1.280769,103.78756
119144,25,3,28,1.280692,103.78769
119145,13,49,62,1.280341,103.788392
119146,2,2,4,1.280657,103.787727
119148,4,2,6,1.28061,103.787779
119149,0,1,1,1.28085,103.787449
119150,1,12,13,1.280651,103.788091
119151,39,18,57,1.280293,103.788541
119152,13,2,15,1.280803,103.788215
119153,0,2,2,1.280871,103.787427
119154,3,2,5,1.28084,103.788251
119155,37,10,47,1.280244,103.788685
119157,1,6,7,1.280216,103.788759
119158,1,2,3,1.280597,103.787752
119159,40,1,41,1.280991,103.788393
119160,1,38,39,1.281015,103.788424
119161,64,27,91,1.280794,103.788263
119162,32,0,32,1.28034,103.788499
119163,156,2,158,1.28035,103.788467
119164,78,3,81,1.280336,103.788512
119165,5,21,26,1.280366,103.78842
119166,9,0,9,1.280324,103.788538
119167,49,2,51,1.280345,103.788488
119168,21,0,21,1.280562,103.788528
119169,11,2,13,1.280444,103.788081
119170,17,4,21,1.280401,103.788203
119171,23,0,23,1.280396,103.788249
119172,315,0,315,1.280322,103.78844
119173,8,2,10,1.28095,103.787274
119174,1283,242,1525,1.280169,103.789055
119189,1672,105,1777,1.267897,103.800351
119191,3,2,5,1.268807,103.801324
119192,10,184,194,1.299509,103.837
119193,219,90,309,1.299509,103.837
119210,42,12,54,1.293661,103.780553
119211,23,0,23,1.293888,103.780525
119212,4,1,5,1.294048,103.780435
119213,23,0,23,1.294156,103.780214
119214,5,0,5,1.294573,103.779667
119216,3,1,4,1.294558,103.778629
119217,30,109,139,1.294076,103.780607
119218,7,0,7,1.294201,103.778379
119219,4,0,4,1.29422,103.778637
119220,6,2,8,1.297027,103.775441
119221,0,1,1,1.280563,103.787858
119222,7,0,7,1.297248,103.774788
119223,11,2,13,1.297407,103.774481
119224,90,22,112,1.291356,103.78083
119225,65,0,65,1.297104,103.773958
119227,16,6,22,1.297441,103.774184
119228,5482,2018,7500,1.292471,103.78333
119241,2146,843,2989,1.29386,103.77326
119242,249,125,374,1.292874,103.770113
119243,266,160,426,1.292611,103.771027
119244,1533,10,1543,1.29389,103.773257
119245,2345,996,3341,1.292423,103.774017
119246,647,799,1446,1.295423,103.770322
119260,202,143,345,1.294229,103.771172
119275,1732,1964,3696,1.296705,103.77315
119276,14,48,62,1.298049,103.773308
119277,106,134,240,1.299312,103.773671
119278,267,1,268,1.299563,103.773284
119279,2411,1448,3859,1.301214,103.772994
119280,54,526,580,1.300871,103.773271
119292,68,20,88,1.277367,103.791407
119293,4,1,5,1.277386,103.791351
119294,1,0,1,1.297248,103.774788
119295,5,2,7,1.277435,103.791237
119296,10,0,10,1.277455,103.791215
119297,82,0,82,1.27753,103.791197
119298,1,1,2,1.280263,103.788628
119299,40,8,48,1.277628,103.791221
119300,1,0,1,1.27741,103.791282
119301,3,0,3,1.280921,103.788334
119303,5,2,7,1.277802,103.791287
119304,6,0,6,1.278382,103.79138
119305,20,2,22,1.277835,103.791306
119306,1,0,1,1.277688,103.791249
119307,1,1,2,1.277578,103.791197
119308,2,0,2,1.278039,103.791365
119309,91,1,92,1.278117,103.791299
119310,8,5,13,1.278172,103.79125
119328,3,3,6,1.279645,103.790185
119329,24,8,32,1.280262,103.790282
119330,4,0,4,1.279627,103.790222
119331,42,1,43,1.280193,103.790235
119333,0,1,1,1.278014,103.791384
119334,1,0,1,1.280161,103.790236
119335,7,0,7,1.280093,103.790206
119336,21,0,21,1.279561,103.790357
119337,1,1,2,1.27808,103.791341
119338,3,3,6,1.279542,103.790401
119339,1,4,5,1.279958,103.790145
119340,7,0,7,1.279523,103.790431
119341,8,0,8,1.279891,103.790115
119342,18,8,26,1.279513,103.790447
119344,1,0,1,1.279568,103.790336
119346,0,5,5,1.27951,103.790383
119347,2,7,9,1.279698,103.790034
119348,14,0,14,1.279516,103.790363
119349,65,0,65,1.279381,103.789831
119350,8,2,10,1.279534,103.790338
119351,5,5,10,1.279338,103.789806
119352,2,0,2,1.280026,103.790176
119353,45,0,45,1.279271,103.78979
119354,2,0,2,1.279551,103.790318
119355,3,5,8,1.279225,103.789767
119356,9,0,9,1.27957,103.790263
119357,6,0,6,1.279191,103.789746
119358,14,8,22,1.279601,103.790196
119360,5,0,5,1.278989,103.789889
119362,1,0,1,1.279496,103.790416
119363,4,4,8,1.279054,103.78968
119364,4,15,19,1.278908,103.789724
119365,1,0,1,1.278921,103.789896
119366,8,5,13,1.278805,103.78971
119368,7,0,7,1.278755,103.789715
119369,1,0,1,1.279026,103.789671
119370,2,0,2,1.27956,103.79029
119371,3,2,5,1.278873,103.789654
119372,7,0,7,1.278581,103.789784
119373,1,1,2,1.278708,103.789726
119374,6,2,8,1.278521,103.789808
119375,2,1,3,1.277759,103.79127
119376,7,0,7,1.278444,103.789836
119378,3,0,3,1.278783,103.789663
119379,0,4,4,1.278718,103.789682
119380,119,5,124,1.278648,103.789704
119381,31,8,39,1.278614,103.789715
119382,3,2,5,1.278562,103.78975
119383,1,1,2,1.278826,103.789661
119384,2,2,4,1.278416,103.789822
119385,33,0,33,1.27839,103.789835
119386,6,0,6,1.278305,103.789868
119388,3,0,3,1.278347,103.789884
119389,1,2,3,1.278254,103.789899
119407,5,10,15,1.274526,103.79483
119408,8,1,9,1.274828,103.794795
119409,9,2,11,1.274459,103.794915
119410,1,12,13,1.274777,103.794768
119411,10,0,10,1.274378,103.795038
119413,15,18,33,1.274342,103.795088
119415,1,15,16,1.274292,103.79506
119416,19,0,19,1.274536,103.794639
119418,2,0,2,1.278489,103.789784
119419,1,1,2,1.274492,103.794615
119420,1,1,2,1.274441,103.794591
119422,2,16,18,1.274428,103.794846
119424,0,3,3,1.278231,103.78991
119425,5,0,5,1.274284,103.794512
119426,7,1,8,1.273968,103.794589
119427,3,0,3,1.274026,103.794527
119428,3,14,17,1.273832,103.794773
119429,2,16,18,1.273792,103.794707
119430,0,2,2,1.274373,103.794929
119431,5,0,5,1.273961,103.794515
119432,18,0,18,1.274003,103.794451
119434,64,0,64,1.274243,103.794273
119452,2,2,4,1.276533,103.792525
119453,2,0,2,1.273859,103.79464
119454,6,1,7,1.276557,103.792615
119455,0,5,5,1.276583,103.792572
119456,0,5,5,1.276966,103.792684
119457,16,12,28,1.277034,103.793056
119458,1,0,1,1.278908,103.789655
119459,2,0,2,1.276562,103.79256
119460,1,1,2,1.276537,103.792606
119461,6,2,8,1.276973,103.793005
119462,70,735,805,1.299509,103.837
119497,6,108,114,1.276969,103.791341
119498,40,2,42,1.277403,103.791314
119499,2,20,22,1.277458,103.791538
119500,56,5,61,1.277489,103.791549
119501,6,4,10,1.277566,103.791572
119502,16,14,30,1.277623,103.791596
119503,65,6,71,1.2789,103.791972
119504,6,0,6,1.277675,103.791617
119505,239,10,249,1.278938,103.792025
119506,0,4,4,1.277725,103.791637
119507,36,2,38,1.27898,103.792056
119508,2,2,4,1.2778,103.791663
119509,0,3,3,1.27389,103.794689
119510,5,17,22,1.27785,103.791672
119511,2,5,7,1.27908,103.79212
119512,1,3,4,1.277897,103.791688
119513,8,6,14,1.279101,103.792132
119514,3,1,4,1.277968,103.791715
119515,2,0,2,1.276576,103.79262
119516,1,9,10,1.278065,103.791756
119517,2,6,8,1.279149,103.792149
119518,20,1,21,1.278134,103.791781
119519,969,58,1027,1.279249,103.791787
119520,995,49,1044,1.28024,103.792255
119521,1073,52,1125,1.279594,103.792962
119522,850,55,905,1.279459,103.793038
119523,3,0,3,1.279025,103.792086
119524,10,4,14,1.27821,103.791803
119525,1,12,13,1.278274,103.79183
119527,0,10,10,1.278425,103.791875
119528,1,1,2,1.279127,103.79214
119529,0,10,10,1.27852,103.791908
119530,8,10,18,1.278568,103.791907
119531,7,19,26,1.278668,103.791918
119532,13,10,23,1.278729,103.791892
119533,0,1,1,1.276518,103.792597
119534,0,8,8,1.279405,103.791286
119535,30,1,31,1.279907,103.790994
119536,9,1,10,1.279483,103.791237
119537,2,0,2,1.278496,103.791902
119538,6,5,11,1.279453,103.791002
119539,1,2,3,1.278163,103.791787
119540,0,4,4,1.279769,103.79106
119541,0,4,4,1.280026,103.790823
119542,16,5,21,1.279816,103.791025
119543,49,0,49,1.280176,103.790944
119544,2,0,2,1.279922,103.790961
119545,37,0,37,1.2799,103.790918
119546,5,3,8,1.28,103.790795
119547,1,0,1,1.279859,103.791046
119548,1,14,15,1.280055,103.790699
119549,1,0,1,1.280037,103.790732
119550,10,0,10,1.280114,103.790576
119551,10,1,11,1.28016,103.790504
119552,1,1,2,1.279857,103.790974
119553,3,7,10,1.280242,103.790395
119554,8,259,267,1.299509,103.837
119572,155,14,169,1.279542,103.800609
119573,17,101,118,1.279533,103.800313
119574,24,7,31,1.279502,103.799862
119575,4,3,7,1.279835,103.799217
119576,26,3,29,1.279909,103.799082
119577,16,3,19,1.280899,103.798662
119578,1285,520,1805,1.278749,103.801292
119579,772,3814,4586,1.279784,103.801842
119595,381,104,485,1.291173,103.778327
119597,267,315,582,1.290903,103.777676
119598,32,549,581,1.290875,103.773374
119599,12,0,12,1.290874,103.773373
119600,11,10,21,1.290875,103.773394
119601,8,0,8,1.290874,103.773393
119603,2,1,3,1.279979,103.790882
119604,1,1509,1510,1.290874,103.773393
119605,1,30,31,1.291047,103.773452
119606,8,36,44,1.291047,103.773472
119607,0,9,9,1.291046,103.773471
119608,0,18,18,1.291046,103.773471
119609,4,20,24,1.291392,103.773608
119610,1,40,41,1.291392,103.773628
119611,20,160,180,1.291736,103.773764
119612,46,148,194,1.291726,103.773774
119613,1071,26,1097,1.292285,103.775857
119614,756,24,780,1.290788,103.776698
119615,709,236,945,1.291608,103.776333
119616,330,85,415,1.290232,103.778126
119617,178,271,449,1.291903,103.774623
119618,118,298,416,1.291489,103.775891
119619,16,109,125,1.291758,103.777074
119620,1065,88,1153,1.290427,103.777317
119622,0,2,2,1.280192,103.790443
119630,16,93,109,1.291009,103.772865
119631,3,6,9,1.291008,103.772864
119632,3,500,503,1.290959,103.772876
119633,6,4,10,1.291141,103.772892
119634,1,2,3,1.290874,103.773393
119635,1,2,3,1.291042,103.772892
119636,10,1,11,1.291208,103.772925
119637,0,1,1,1.280103,103.790618
119638,1,0,1,1.291672,103.772997
119639,2,0,2,1.291046,103.773451
119640,12,0,12,1.291539,103.772991
119641,120,89,209,1.292202,103.773103
119643,5,0,5,1.29187,103.773057
119644,104,2,106,1.292036,103.77309
119645,11,90,101,1.292192,103.773113
119646,0,2,2,1.291937,103.77305
119647,0,4,4,1.291671,103.772996
119663,51,3,54,1.282283,103.799852
119664,42,10,52,1.28188,103.800399
119665,263,2,265,1.281478,103.800652
119666,92,12,104,1.280865,103.800592
119667,20,5,25,1.280457,103.799933
119668,43,2,45,1.281089,103.799912
119669,0,12,12,1.28144,103.800005
119670,69,8,77,1.2816,103.800344
119687,3,5,8,1.279736,103.788392
119688,292,3,295,1.279718,103.788606
119689,14,0,14,1.279713,103.788373
119691,1,0,1,1.291373,103.772958
119692,1,0,1,1.279744,103.788508
119693,2,1,3,1.291406,103.772945
119694,26,0,26,1.279574,103.788255
119695,12,5,17,1.279788,103.788345
119696,12,0,12,1.279528,103.788215
119697,0,1,1,1.27962,103.788294
119699,0,1,1,1.2798,103.788301
119700,27,2,29,1.279389,103.788097
119701,23,3,26,1.279784,103.788287
119702,1,0,1,1.279435,103.788136
119703,0,1,1,1.279801,103.788238
119704,12,1,13,1.27984,103.788117
119705,6,0,6,1.27986,103.788065
119706,1,0,1,1.279828,103.788184
119707,6,1,7,1.280181,103.787862
119708,0,4,4,1.279988,103.78799
119711,2,0,2,1.291671,103.772996
119712,2,2,4,1.280131,103.787909
119713,3,2,5,1.280129,103.787739
119714,0,2,2,1.280166,103.787762
119716,2,0,2,1.279996,103.787664
119718,1,0,1,1.279926,103.788018
119719,3,1,4,1.280011,103.787639
119720,13,2,15,1.279807,103.787476
119721,3,0,3,1.279755,103.788446
119722,0,13,13,1.279775,103.787449
119723,6,1,7,1.279911,103.78755
119724,2,0,2,1.279911,103.78758
119725,2,0,2,1.27986,103.787506
119726,0,6,6,1.279785,103.787439
119727,2,19,21,1.279833,103.788216
119728,12,0,12,1.279847,103.78817
119744,425,280,705,1.277851,103.788481
119745,614,177,791,1.278107,103.787785
119746,38,25,63,1.277988,103.788728
119747,35,42,77,1.278091,103.788655
119748,6,6,12,1.278078,103.788967
119749,1527,76,1603,1.278147,103.788746
119750,1,1,2,1.279836,103.78747
119751,6,4,10,1.278419,103.789113
119752,6,7,13,1.278522,103.78913
119753,8,4,12,1.278864,103.78877
119754,69,5,74,1.279714,103.788923
119755,0,2,2,1.278347,103.789094
119756,1,2,3,1.279961,103.787595
119757,7,3,10,1.279872,103.789064
119759,21,20,41,1.28014,103.788994
119779,14,0,14,1.27865,103.789096
119780,17,2,19,1.278714,103.789048
119781,3,0,3,1.279808,103.789009
119782,0,3,3,1.278773,103.78902
119783,2,0,2,1.279772,103.78897
119784,1,4,5,1.279023,103.788805
119786,0,5,5,1.279105,103.788775
119787,84,3,87,1.279147,103.788765
119788,6,4,10,1.279584,103.789334
119789,5,2,7,1.27957,103.789332
119791,2,0,2,1.278966,103.788856
119792,5,0,5,1.279406,103.78927
119793,7,1,8,1.279383,103.789253
119794,4,7,11,1.279361,103.789234
119795,5,0,5,1.279338,103.789221
119796,15,0,15,1.284204,103.796259
119797,13,7,20,1.284603,103.796891
119798,129,14,143,1.284161,103.796877
119799,47,24,71,1.284166,103.797489
119800,57,9,66,1.280978,103.796913
119801,24,6,30,1.280902,103.797437
119802,61,3,64,1.2808,103.797884
119820,159,362,521,1.282924,103.800712
119821,36,339,375,1.282723,103.800801
119822,5,191,196,1.282025,103.801215
119823,2,96,98,1.281824,103.801318
119824,23,213,236,1.281527,103.801445
119825,0,136,136,1.281274,103.801519
119843,265,1483,1748,1.275251,103.796219
119844,806,2061,2867,1.275154,103.796527
119863,15,33,48,1.275713,103.796652
119866,430,36,466,1.276012,103.797317
119884,35,5,40,1.281983,103.79911
119885,32,2,34,1.281979,103.798711
119886,21,2,23,1.281832,103.798391
119887,55,3,58,1.281266,103.799279
119888,15,2,17,1.28127,103.798094
119906,0,39,39,1.28271,103.782839
119907,4,39,43,1.282709,103.782838
119908,9,27,36,1.282709,103.782838
119909,4,6,10,1.282709,103.782838
119910,3,0,3,1.278905,103.788885
119912,20,38,58,1.282142,103.783741
119913,203,22,225,1.282745,103.782845
119914,223,45,268,1.28278,103.78287
119915,908,24,932,1.283483,103.783604
119916,873,8,881,1.283083,103.784297
119917,51,53,104,1.283019,103.78365
119918,1474,192,1666,1.282799,103.784035
119919,665,12,677,1.282451,103.783851
119931,14,114,128,1.275358,103.797231
119932,337,62,399,1.275564,103.797425
119933,2,45,47,1.275689,103.797499
119934,1,56,57,1.275856,103.797595
119936,1378,567,1945,1.276909,103.797914
119937,282,122,404,1.276871,103.797881
119938,244,3,247,1.275861,103.79758
119953,131,7249,7380,1.278912,103.802439
119954,7115,9390,16505,1.277906,103.802296
119955,204,2469,2673,1.277034,103.80032
119956,29,55,84,1.27844,103.800617
119957,9,0,9,1.278367,103.80072
119958,4080,1782,5862,1.27732,103.801915
119959,9,5,14,1.278313,103.800861
119960,3157,6007,9164,1.276302,103.801659
119961,260,99,359,1.276777,103.800942
119962,1784,3071,4855,1.275262,103.801734
119963,16718,32232,48950,1.273673,103.801381
119964,1049,997,2046,1.274432,103.802902
119966,20,210,230,1.275983,103.801168
119967,4942,1466,6408,1.277325,103.800274
119968,15980,4826,20806,1.27696,103.799746
119969,643,152,795,1.274292,103.803718
119970,580,279,859,1.273889,103.803415
119971,2027,557,2584,1.27371,103.804347
119972,321,604,925,1.273049,103.803815
119973,1520,457,1977,1.273245,103.80294
119974,66,191,257,1.273525,103.803548
119975,1047,10493,11540,1.273709,103.802639
119982,310,1328,1638,1.275288,103.797804
120101,920,49,969,1.322234,103.768905
120102,34,27,61,1.32231,103.769209
120103,717,250,967,1.322679,103.76883
120104,231,332,563,1.323031,103.769077
120105,712,3142,3854,1.322642,103.770005
120106,89,44,133,1.321952,103.769975
120107,86,155,241,1.322259,103.769978
120108,46,355,401,1.322167,103.770304
120109,885,1591,2476,1.322296,103.770591
120110,305,2416,2721,1.322855,103.770649
120111,468,259,727,1.323217,103.770966
120112,393,301,694,1.323304,103.769807
120113,611,322,933,1.323631,103.770108
120114,972,271,1243,1.323777,103.770913
120115,849,569,1418,1.32384,103.771261
120116,1259,528,1787,1.324409,103.77183
120117,1087,224,1311,1.324401,103.771208
120118,1019,214,1233,1.324846,103.77184
120201,312,553,865,1.320334,103.762888
120202,284,261,545,1.320663,103.762731
120203,45,2719,2764,1.320819,103.762245
120204,527,721,1248,1.320968,103.763098
120205,220,89,309,1.32107,103.762413
120206,242,1289,1531,1.321499,103.762328
120207,0,24,24,1.299509,103.837
120208,12,7,19,1.299509,103.837
120301,484,159,643,1.322114,103.764729
120302,969,386,1355,1.321809,103.76485
120303,433,15,448,1.3213,103.764742
120304,1309,51,1360,1.320993,103.764748
120305,932,332,1264,1.32201,103.765861
120306,293,346,639,1.321529,103.765866
120307,246,1223,1469,1.321453,103.767054
120308,531,7584,8115,1.321165,103.76687
120309,495,133,628,1.320828,103.766484
120310,519,280,799,1.320255,103.766095
120311,65,115,180,1.319945,103.765758
120312,83,737,820,1.299509,103.837
120313,7,19,26,1.299509,103.837
120314,5,223,228,1.299509,103.837
120315,192,1612,1804,1.318458,103.765048
120316,345,167,512,1.318454,103.764691
120317,381,412,793,1.318057,103.764684
120318,469,2694,3163,1.318055,103.76507
120319,315,472,787,1.317748,103.764718
120320,546,2431,2977,1.31748,103.765547
120321,260,2655,2915,1.316552,103.766332
120322,521,1119,1640,1.316183,103.766447
120323,441,675,1116,1.315761,103.767038
120324,816,3131,3947,1.315142,103.766151
120325,317,292,609,1.315245,103.766757
120326,1444,809,2253,1.314436,103.766345
120327,43,746,789,1.313944,103.766538
120328,733,2054,2787,1.313511,103.766986
120329,564,2527,3091,1.313107,103.767279
120330,461,1469,1930,1.313722,103.767749
120331,541,1117,1658,1.3142,103.767822
120332,648,750,1398,1.314745,103.767411
120333,83,2,85,1.31518,103.767326
120334,673,719,1392,1.315188,103.768229
120335,488,3837,4325,1.31695,103.7685
120336,197,885,1082,1.316638,103.769127
120337,540,2568,3108,1.315949,103.76904
120338,36,743,779,1.316236,103.769439
120339,98,3,101,1.31954,103.769202
120340,309,1,310,1.318806,103.769883
120341,856,0,856,1.319119,103.769054
120342,297,202,499,1.318441,103.769721
120343,948,1448,2396,1.318006,103.770845
120344,133,1028,1161,1.318093,103.768877
120345,625,11203,11828,1.317706,103.768766
120346,446,5683,6129,1.317236,103.769868
120347,666,518,1184,1.31716,103.770614
120348,33,1349,1382,1.316775,103.770787
120349,352,927,1279,1.315917,103.770959
120350,325,9006,9331,1.315581,103.770154
120351,743,436,1179,1.315422,103.770809
120352,836,1823,2659,1.314595,103.77153
120353,118,685,803,1.314399,103.770821
120354,579,336,915,1.313528,103.770778
120355,1004,1883,2887,1.314536,103.769414
120356,27,2,29,1.313901,103.769723
120357,17,558,575,1.314041,103.769063
120358,261,2924,3185,1.313534,103.768992
120359,387,220,607,1.313415,103.769808
120362,1209,471,1680,1.312734,103.76985
120363,854,2203,3057,1.312867,103.768824
120364,93,1312,1405,1.312407,103.768583
120365,93,2830,2923,1.31225,103.769904
120366,484,635,1119,1.31255,103.771592
120367,816,371,1187,1.312937,103.771549
120371,727,6497,7224,1.320156,103.768283
120372,244,1375,1619,1.319819,103.767641
120373,139,3374,3513,1.319443,103.767289
120374,254,3278,3532,1.318984,103.767059
120375,619,2826,3445,1.318489,103.766582
120376,149,3043,3192,1.318105,103.766597
120377,588,4544,5132,1.317622,103.768012
120378,126,1999,2125,1.317635,103.767364
120379,741,317,1058,1.317928,103.767909
120380,419,361,780,1.318371,103.767442
120381,259,435,694,1.318466,103.767965
120401,30,65,95,1.30693,103.768112
120402,3,49,52,1.307723,103.767424
120403,0,59,59,1.308456,103.767074
120404,2,73,75,1.308823,103.767172
120405,8,73,81,1.309384,103.767312
120406,12,455,467,1.309915,103.767679
120407,9,233,242,1.310358,103.767828
120408,10,2813,2823,1.31113,103.768343
120409,13,2296,2309,1.311447,103.76839
120410,515,2469,2984,1.311412,103.769727
120411,838,227,1065,1.310907,103.769744
120412,650,102,752,1.310933,103.770957
120413,534,1058,1592,1.31131,103.771153
120414,460,378,838,1.311585,103.771559
120415,498,527,1025,1.311057,103.771539
120416,638,5967,6605,1.310362,103.771381
120417,445,37,482,1.310191,103.770787
120418,1110,56,1166,1.310137,103.770134
120419,394,248,642,1.310243,103.769615
120420,1622,2555,4177,1.310116,103.768984
120421,1741,3039,4780,1.309091,103.768518
120422,425,287,712,1.309169,103.769183
120423,359,203,562,1.309401,103.769815
120424,441,90,531,1.309495,103.770616
120425,1170,2025,3195,1.309614,103.771237
120426,748,598,1346,1.311573,103.764181
120427,837,321,1158,1.312017,103.763682
120428,1311,851,2162,1.312507,103.763313
120429,54,40,94,1.312934,103.762813
120430,1037,158,1195,1.313364,103.762418
120431,691,356,1047,1.313755,103.762359
120432,500,334,834,1.314085,103.762496
120433,1778,589,2367,1.314079,103.761687
120434,746,295,1041,1.314559,103.76158
120435,910,473,1383,1.31457,103.762499
120436,6,3,9,1.316366,103.762516
120437,1,10,11,1.316144,103.763414
120438,3,74,77,1.316658,103.762713
120439,0,8,8,1.299509,103.837
120440,0,61,61,1.314992,103.763537
120441,18,250,268,1.315027,103.763991
120442,152,108,260,1.313808,103.764264
120443,212,159,371,1.314195,103.764019
120444,8,2259,2267,1.313589,103.763904
120445,35,545,580,1.312526,103.764317
120446,31,71,102,1.312444,103.764777
120447,3,0,3,1.282709,103.782838
120448,11,2,13,1.313218,103.764506
120449,167,161,328,1.313385,103.764914
120450,323,58291,58614,1.313578,103.765368
120451,453,5127,5580,1.312638,103.765669
120453,69,5869,5938,1.311906,103.76596
120454,568,1187,1755,1.312338,103.766399
120455,392,777,1169,1.312173,103.7667
120456,382,916,1298,1.311998,103.767033
120457,549,747,1296,1.311861,103.767299
120458,645,29,674,1.311637,103.76689
120459,662,1272,1934,1.311305,103.767122
120460,340,112,452,1.311104,103.766953
120461,1018,207,1225,1.311013,103.766379
120462,816,288,1104,1.311037,103.765978
120501,81,3294,3375,1.311289,103.758457
120502,32,88,120,1.311718,103.759029
120503,68,134,202,1.31172,103.75967
120504,65,144,209,1.312236,103.759461
120505,255,5050,5305,1.312239,103.759907
120506,97,923,1020,1.312516,103.760821
120507,744,431,1175,1.312085,103.760707
120508,347,187,534,1.311667,103.761647
120509,613,207,820,1.311206,103.760958
120510,405,240,645,1.310836,103.760683
120511,457,340,797,1.310355,103.760338
120512,125,7796,7921,1.309965,103.760122
120513,238,2112,2350,1.30865,103.760159
120514,164,206,370,1.308971,103.759171
120515,658,391,1049,1.308416,103.759703
120516,42,1879,1921,1.30812,103.760351
120517,82,688,770,1.307477,103.76011
120518,1268,324,1592,1.308331,103.758844
120519,739,360,1099,1.307711,103.759405
120520,415,134,549,1.30715,103.759678
120601,320,965,1285,1.304771,103.765112
120602,1333,374,1707,1.305058,103.766304
120603,539,453,992,1.304877,103.767222
120604,44,0,44,1.30537,103.767461
120605,760,203,963,1.305324,103.768002
120606,871,376,1247,1.304811,103.767967
120607,519,768,1287,1.304253,103.767733
120608,699,842,1541,1.30443,103.766328
120609,178,3945,4123,1.304122,103.765384
120610,1305,842,2147,1.304541,103.768513
120611,1470,391,1861,1.303965,103.769038
120612,904,134,1038,1.303445,103.768402
120613,462,106,568,1.303687,103.767778
120701,148,14,162,1.307689,103.761088
120702,585,579,1164,1.307294,103.760967
120703,968,521,1489,1.306729,103.760716
120704,1402,355,1757,1.306344,103.760487
120705,488,736,1224,1.305756,103.760549
120706,379,142,521,1.306818,103.762111
120707,308,3252,3560,1.306306,103.762281
120708,268,1556,1824,1.305736,103.762088
120709,355,240,595,1.305445,103.761649
120710,666,958,1624,1.306298,103.761484
120711,899,553,1452,1.305275,103.76105
120712,468,1688,2156,1.304974,103.761774
120713,418,4781,5199,1.304202,103.762082
120714,678,330,1008,1.304458,103.761546
120715,615,676,1291,1.302825,103.762174
120716,781,355,1136,1.302349,103.762822
120717,353,3805,4158,1.303246,103.762371
120720,189,3340,3529,1.302532,103.763759
120721,128,193,321,1.302451,103.764237
120722,56,177,233,1.302909,103.763786
120723,322,4460,4782,1.303169,103.763361
120724,265,1000,1265,1.303606,103.763281
120725,34,165,199,1.303542,103.763715
120726,180,15536,15716,1.303831,103.764132
120727,77,256,333,1.304455,103.763716
120728,581,969,1550,1.30535,103.763688
120729,279,2452,2731,1.305248,103.763304
120730,550,8084,8634,1.304673,103.763138
120731,212,3128,3340,1.304212,103.762771
121107,10,15,25,1.322112,103.770073
121108,16,130,146,1.322291,103.770153
121109,45,1011,1056,1.32171,103.770365
121208,161,48,209,1.299509,103.837
121306,31,725,756,1.321272,103.765908
121309,9,1057,1066,1.320555,103.766271
121311,1471,1135,2606,1.319804,103.765616
121312,608,297,905,1.318889,103.764534
121317,16,1396,1412,1.317779,103.76447
121318,16,536,552,1.317408,103.765197
121331,26,1130,1156,1.299509,103.837
121336,6,146,152,1.315622,103.769519
121344,3,295,298,1.299509,103.837
121353,13,1893,1906,1.31475,103.770559
121366,7,231,238,1.312774,103.771865
121413,135,2763,2898,1.311495,103.77037
121416,27,43,70,1.309842,103.770112
121420,686,3312,3998,1.309752,103.768627
121423,6,8,14,1.309527,103.770232
121427,41,294,335,1.299509,103.837
121431,10,185,195,1.313843,103.76293
121432,30,2000,2030,1.299509,103.837
121440,5,867,872,1.299509,103.837
121441,45,4484,4529,1.314593,103.764704
121442,2,407,409,1.312347,103.764153
121445,1,1373,1374,1.299509,103.837
121448,5,24,29,1.313307,103.76449
121455,4,32,36,1.311702,103.766532
121459,36,403,439,1.311603,103.767218
121462,54,2269,2323,1.311756,103.765562
121502,8,0,8,1.312161,103.759233
121503,28,4016,4044,1.31161,103.759884
122208,252,5,257,1.299509,103.837
122311,778,182,960,1.319709,103.765698
122312,424,123,547,1.319534,103.764582
122403,1,26,27,1.299509,103.837
122423,2,13,15,1.310164,103.768491
122440,0,2,2,1.279426,103.789285
122441,25,36,61,1.314864,103.764058
122445,3,0,3,1.312826,103.764788
122462,11,5,16,1.274292,103.79506
123208,4,19,23,1.299509,103.837
123311,1284,937,2221,1.319576,103.765853
123312,777,279,1056,1.319669,103.764005
123440,0,1,1,1.279891,103.78755
124208,0,2,2,1.299509,103.837
124311,43,4701,4744,1.299509,103.837
124312,118,114,232,1.299509,103.837
126753,28,54,82,1.319161,103.751726
126758,14,17,31,1.31477,103.755721
126759,71,746,817,1.299509,103.837
126764,8,9,17,1.299509,103.837
126765,2,23,25,1.299509,103.837
126766,11,16,27,1.299509,103.837
126767,53,215,268,1.299509,103.837
126768,30,443,473,1.299509,103.837
126769,0,5,5,1.299509,103.837
126770,1,10,11,1.299509,103.837
126771,1,8,9,1.299509,103.837
126772,55,3,58,1.299509,103.837
126773,4,3,7,1.299509,103.837
126774,2,5,7,1.299509,103.837
126775,4,11,15,1.299509,103.837
126776,7,368,375,1.299509,103.837
126777,927,478,1405,1.298753,103.764461
126778,458,716,1174,1.298753,103.764461
126779,2171,750,2921,1.298958,103.764955
126784,19,161,180,1.299509,103.837
126785,135,126,261,1.320509,103.769984
126786,18,107,125,1.320203,103.769878
126787,25,7,32,1.361459,103.838769
126790,196,0,196,1.298282,103.765048
126791,22,75,97,1.298303,103.765126
126792,10,133,143,1.298304,103.76515
126793,2101,237,2338,1.298243,103.764602
126794,2704,682,3386,1.298076,103.764304
126795,3,9,12,1.299509,103.837
126796,7,6,13,1.299509,103.837
126797,17,1,18,1.299509,103.837
126798,3,6,9,1.299509,103.837
126799,6,12,18,1.299509,103.837
126800,912,196,1108,1.290948,103.761568
126805,13,1,14,1.293184,103.767139
126806,2,1,3,1.299509,103.837
126807,2,0,2,1.299509,103.837
126808,0,4,4,1.293184,103.767139
126809,6,154,160,1.295205,103.765813
126810,678,1528,2206,1.296804,103.767529
126811,9,9,18,1.296239,103.767726
126812,6,11,17,1.293056,103.767275
126813,1,8,9,1.293056,103.767275
126814,15,156,171,1.293056,103.767275
126815,363,19,382,1.295617,103.767428
126816,349,175,524,1.296006,103.76755
126817,606,631,1237,1.296489,103.767521
126818,251,4,255,1.296449,103.768144
126819,662,4,666,1.296755,103.768219
126820,164,7,171,1.293499,103.76803
126821,326,120,446,1.293704,103.767494
126822,194,30,224,1.293549,103.767393
126823,243,12,255,1.293633,103.768107
126824,97,6,103,1.293317,103.767241
126826,152,2402,2554,1.294635,103.767167
126827,46,77,123,1.294928,103.767148
126828,185,111,296,1.295348,103.767184
126829,282,32,314,1.295298,103.767446
126830,112,45,157,1.29525,103.767679
126831,242,32,274,1.295333,103.768407
126832,415,19,434,1.295333,103.768412
126833,234,40,274,1.295332,103.768414
126834,307,38,345,1.295342,103.768406
126835,680,47,727,1.29555,103.768434
126836,318,43,361,1.295767,103.768471
126837,377,25,402,1.295984,103.768508
126838,687,38,725,1.296093,103.768527
126839,606,38,644,1.295767,103.768491
126840,199,157,356,1.295649,103.769098
126841,71,68,139,1.294633,103.768702
126842,235,249,484,1.295216,103.769174
126843,267,362,629,1.294827,103.769117
126844,1182,426,1608,1.297829,103.763581
126846,25,0,25,1.308308,103.764602
126847,5,0,5,1.30825,103.764659
126848,3,0,3,1.293184,103.767139
126849,7,0,7,1.308135,103.764733
126850,3,4,7,1.308135,103.764713
126851,6,2,8,1.308021,103.764807
126853,16,0,16,1.307906,103.764881
126854,1,3,4,1.307906,103.764861
126855,1,44,45,1.307801,103.764945
126856,3,65,68,1.307791,103.764935
126857,20,10,30,1.307835,103.764982
126858,4,0,4,1.307801,103.764945
126859,7,9,16,1.307906,103.764881
126860,11,16,27,1.30777,103.764898
126861,6,0,6,1.307936,103.765092
126862,15,0,15,1.307707,103.764804
126863,10,0,10,1.308003,103.765166
126864,10,12,22,1.307644,103.76471
126865,0,13,13,1.308071,103.765239
126866,9,0,9,1.307582,103.764616
126867,5,0,5,1.308131,103.765298
126868,3,22,25,1.307519,103.764523
126869,2,76,78,1.308233,103.765368
126870,7,0,7,1.307457,103.764429
126871,2,60,62,1.308284,103.765403
126872,1,0,1,1.299509,103.837
126873,0,8,8,1.307331,103.764241
126874,1,37,38,1.307253,103.764108
126875,4,0,4,1.307228,103.764053
126876,16,21,37,1.307179,103.763944
126877,10,2,12,1.30713,103.763834
126878,5,67,72,1.30712,103.763814
126879,3,0,3,1.30825,103.764639
126880,2,58,60,1.307089,103.763754
126881,1,4,5,1.307069,103.763714
126883,8,0,8,1.307028,103.763634
126884,4,0,4,1.307008,103.763594
126885,2,215,217,1.306987,103.763554
126886,6,824,830,1.306967,103.763514
126887,3945,2487,6432,1.292738,103.76257
126888,21,0,21,1.311477,103.754545
126889,0,8,8,1.311702,103.754807
126890,2,0,2,1.293184,103.767139
126891,5,434,439,1.311714,103.753255
126892,5,1,6,1.312063,103.753793
126893,1,0,1,1.307394,103.764335
126894,3,2,5,1.308482,103.757131
126895,9,15,24,1.312462,103.755934
126896,7,0,7,1.312519,103.755894
126897,66,11,77,1.312561,103.755848
126898,36,0,36,1.312618,103.755813
126899,83,9,92,1.312702,103.755733
126900,15,3,18,1.312767,103.755675
126901,4,13,17,1.312823,103.755614
126902,4,131,135,1.312855,103.755579
126903,45,16,61,1.312855,103.755901
126904,11,5,16,1.311179,103.754163
126905,1,6,7,1.312243,103.754067
126978,57,318,375,1.291991,103.761685
126979,8795,5292,14087,1.292517,103.762114
126980,854,63,917,1.293932,103.763047
126981,29,469,498,1.314223,103.754874
126982,2,0,2,1.312385,103.753118
126983,1,24,25,1.314222,103.754873
126984,5,0,5,1.314222,103.754873
126985,13,1,14,1.314222,103.754873
126986,4,114,118,1.31427,103.754933
126987,20,4,24,1.314326,103.754983
126988,2,2,4,1.314976,103.755512
126989,1,20,21,1.31444,103.755082
126991,2,0,2,1.314222,103.754873
126992,0,6,6,1.315162,103.75563
126994,0,3,3,1.30711,103.763794
126995,5,39,44,1.31478,103.755378
126997,27,58,85,1.315453,103.755745
126998,21,1,22,1.315552,103.755749
126999,2,19,21,1.315814,103.755736
127000,11,86,97,1.31613,103.755732
127001,21,148,169,1.316206,103.755725
127002,2,4,6,1.316271,103.755729
127003,3,37,40,1.316438,103.755779
127004,10,3,13,1.316527,103.755845
127005,0,84,84,1.316586,103.755899
127006,29,23,52,1.316645,103.755953
127007,44,69,113,1.316653,103.755955
127008,5,19,24,1.316661,103.755958
127009,2,6,8,1.316677,103.755962
127010,2,2,4,1.316693,103.755967
127011,2,2,4,1.316709,103.755972
127012,8,4,12,1.316725,103.755977
127013,0,6,6,1.316748,103.755996
127014,28,15,43,1.316758,103.756009
127015,715,8,723,1.318024,103.756284
127016,504,8,512,1.318136,103.756054
127017,625,3,628,1.318277,103.755752
127018,358,0,358,1.318022,103.755403
127019,409,6,415,1.317877,103.755594
127020,942,8,950,1.317546,103.755798
127021,474,2,476,1.316826,103.756105
127022,445,36,481,1.316836,103.756118
127023,150,397,547,1.317557,103.756492
127024,2,1,3,1.315282,103.755687
127025,0,2,2,1.314554,103.75518
127026,0,1,1,1.311024,103.755185
127027,5,1,6,1.316884,103.756186
127028,1,5,6,1.316894,103.7562
127029,6,2,8,1.316904,103.756214
127030,1,4,5,1.316914,103.756227
127032,0,2,2,1.316865,103.756159
127033,1,6,7,1.316943,103.756268
127034,0,5,5,1.316953,103.756282
127035,3,4,7,1.316963,103.756295
127036,2,0,2,1.316933,103.756254
127037,5,2,7,1.316982,103.756322
127038,8,3,11,1.316992,103.756336
127039,2,14,16,1.317002,103.75635
127040,21,26,47,1.31691,103.757237
127041,0,9,9,1.317011,103.756363
127043,0,12,12,1.317021,103.756377
127045,1,25,26,1.317031,103.75639
127047,3,187,190,1.317041,103.756404
127049,9,407,416,1.31705,103.756418
127050,0,1,1,1.316875,103.756173
127051,3,118,121,1.31706,103.756431
127052,0,6,6,1.316863,103.756597
127053,1,87,88,1.317055,103.756428
127056,0,7,7,1.316801,103.756645
127057,0,11,11,1.31678,103.756661
127065,0,188,188,1.316112,103.75754
127075,3,0,3,1.316855,103.756145
127079,4,8,12,1.316565,103.757474
127085,1,0,1,1.316916,103.757231
127100,0,1,1,1.316197,103.757108
127109,0,106,106,1.315698,103.757492
127110,0,3,3,1.315762,103.75761
127112,0,7,7,1.315636,103.75754
127135,1,0,1,1.316497,103.757208
127136,2,0,2,1.316972,103.756309
127137,2,0,2,1.309014,103.76101
127138,4,32,36,1.309014,103.76101
127139,0,11,11,1.309014,103.76101
127140,899,130,1029,1.310015,103.76113
127141,0,8,8,1.309206,103.761166
127142,1,22,23,1.309205,103.761165
127143,9,0,9,1.309205,103.761165
127145,2,1,3,1.315677,103.757508
127146,1183,293,1476,1.310354,103.761336
127147,1,4,5,1.309588,103.761475
127149,11,66,77,1.309587,103.761474
127150,18,0,18,1.309587,103.761474
127152,21,26,47,1.310034,103.761919
127153,9,83,92,1.310033,103.761918
127154,0,4,4,1.310033,103.761918
127155,43,493,536,1.310033,103.761918
127156,123,5,128,1.310066,103.762529
127157,706,316,1022,1.309546,103.763868
127158,931,9,940,1.309659,103.760966
127159,1035,543,1578,1.310572,103.761567
127160,1581,200,1781,1.310822,103.761912
127161,1199,76,1275,1.310905,103.76225
127162,1013,209,1222,1.310799,103.762653
127163,576,294,870,1.310617,103.762108
127179,1,64,65,1.294822,103.766769
127180,0,1,1,1.309015,103.761011
127181,0,3,3,1.309205,103.761165
127182,13,7,20,1.294776,103.766641
127183,3,0,3,1.294788,103.766673
127184,4,5,9,1.294713,103.766514
127185,0,1,1,1.294811,103.766737
127186,0,3,3,1.294745,103.766577
127189,2,30,32,1.294557,103.766195
127191,0,123,123,1.294814,103.766801
127192,3,16,19,1.294807,103.766781
127193,50,16,66,1.294792,103.766741
127194,6,0,6,1.294778,103.766701
127195,5,1,6,1.294763,103.766661
127196,5,10,15,1.294747,103.766623
127212,0,7,7,1.314655,103.757156
127213,8,0,8,1.314417,103.756693
127214,11,5,16,1.31464,103.757167
127216,3,0,3,1.294651,103.766386
127218,3,3,6,1.314577,103.757208
127219,0,1,1,1.294682,103.76645
127220,0,1,1,1.31453,103.756892
127221,3,0,3,1.314608,103.757187
127222,0,10,10,1.314515,103.757249
127223,0,2,2,1.309014,103.76101
127224,8,0,8,1.314643,103.75709
127225,13,33,46,1.314452,103.75729
127226,7,0,7,1.314671,103.757146
127227,54,1,55,1.314421,103.75731
127228,2,0,2,1.314483,103.757269
127229,2,2,4,1.314389,103.757331
127230,0,3,3,1.314568,103.756958
127231,28,1,29,1.314358,103.757351
127232,7,0,7,1.314774,103.757273
127233,28,4,32,1.314327,103.757372
127234,5,1,6,1.31482,103.757331
127235,33,3,36,1.314295,103.757392
127236,4,0,4,1.314867,103.757389
127237,7,2,9,1.314264,103.757413
127238,4,2,6,1.314914,103.757448
127239,1,0,1,1.314546,103.757228
127240,3,0,3,1.314728,103.757214
127241,2,3,5,1.314202,103.757454
127242,0,4,4,1.315006,103.757565
127243,20,1,21,1.31417,103.757474
127244,1,0,1,1.314233,103.757433
127245,40,0,40,1.314139,103.757495
127246,7,0,7,1.315053,103.757623
127247,2,0,2,1.314704,103.757185
127249,35,11,46,1.313471,103.757757
127250,2,120,122,1.315193,103.757866
127251,2,4,6,1.313539,103.75812
127253,3,0,3,1.31496,103.757506
127254,27,53,80,1.313951,103.757618
127255,6,0,6,1.31392,103.757638
127256,1,0,1,1.315043,103.757613
127257,1,0,1,1.313889,103.757659
127258,1,1,2,1.314108,103.757515
127259,26,0,26,1.313795,103.75772
127262,1,34,35,1.313701,103.757782
127263,10,1,11,1.31367,103.757802
127264,0,4,4,1.31428,103.757643
127265,12,2,14,1.314386,103.757615
127266,0,2,2,1.313826,103.7577
127267,0,17,17,1.314488,103.757519
127268,0,67,67,1.314537,103.75749
127269,3,59,62,1.314558,103.75748
127270,27,20,47,1.314628,103.757421
127271,1,0,1,1.313857,103.757679
127272,14,5,19,1.314717,103.757368
127294,8,153,161,1.292447,103.767924
127295,11,589,600,1.292631,103.767725
127296,47,64,111,1.29271,103.767642
127297,48,21,69,1.29278,103.767569
127298,96,1320,1416,1.293858,103.767594
127299,1,5,6,1.293857,103.767593
127300,10,73,83,1.293056,103.767276
127301,0,33,33,1.293056,103.767275
127302,111,234,345,1.294013,103.767695
127303,617,9,626,1.294012,103.767694
127304,1,3,4,1.293185,103.76714
127305,1,1,2,1.314401,103.757586
127306,68,3,71,1.294167,103.767796
127307,165,5,170,1.294166,103.767795
127308,298,14,312,1.294312,103.767887
127309,213,28,241,1.293541,103.76687
127310,2,134,136,1.294083,103.766791
127311,0,1,1,1.314666,103.757428
127313,12,48,60,1.293737,103.766707
127314,3,443,446,1.293979,103.766583
127316,3,379,382,1.293891,103.766666
127318,12,1,13,1.293912,103.766439
127319,0,5,5,1.293981,103.766447
127320,0,3,3,1.313983,103.757597
127321,3,16,19,1.29409,103.766412
127323,3,159,162,1.29395,103.766446
127324,2,579,581,1.2942,103.766697
127325,26,4,30,1.293989,103.766526
127326,1,0,1,1.293561,103.766746
127328,1,0,1,1.294314,103.766481
127330,5,0,5,1.294314,103.766481
127334,6,0,6,1.294313,103.76648
127335,425,22,447,1.294191,103.76841
127343,481,55,536,1.294086,103.768648
127356,4,106,110,1.295508,103.766652
127357,35,11,46,1.295426,103.766411
127358,0,9,9,1.295349,103.766228
127359,8,21,29,1.295281,103.766059
127360,33,10,43,1.295263,103.765919
127363,963,37,1000,1.296192,103.768556
127364,7,319,326,1.295582,103.765871
127365,813,13,826,1.295529,103.766818
127366,272,25,297,1.296121,103.766207
127367,6672,3793,10465,1.299866,103.764828
127368,230,1321,1551,1.301511,103.765385
127369,25,4339,4364,1.303379,103.764946
127370,72,10386,10458,1.30275,103.765838
127371,3329,3140,6469,1.303843,103.766292
127372,14,41,55,1.303308,103.766541
127373,242,1886,2128,1.308093,103.761232
127376,9,169,178,1.308752,103.761406
127377,3,2192,2195,1.308784,103.76134
127379,3,0,3,1.29403,103.766424
127380,1,1998,1999,1.308881,103.761188
127381,9,3772,3781,1.308927,103.761172
127382,7,27,34,1.30897,103.761098
127383,676,64,740,1.311378,103.756783
127384,3,1300,1303,1.295368,103.768109
127385,1,0,1,1.294314,103.766481
127386,2,1188,1190,1.295369,103.768101
127387,3,1,4,1.29537,103.768096
127388,4,2680,2684,1.29537,103.768092
127389,0,1156,1156,1.295371,103.768088
127390,957,142,1099,1.314249,103.754451
127391,347,80,427,1.309698,103.758184
127392,16,1720,1736,1.311398,103.758058
127393,10,5,15,1.311464,103.75808
127394,5,23,28,1.311589,103.758148
127395,4,0,4,1.311668,103.758158
127396,1,25,26,1.311821,103.758195
127397,0,14,14,1.311861,103.758189
127398,2,21,23,1.312011,103.758256
127399,3,50,53,1.312394,103.758385
127400,5,0,5,1.312401,103.758269
127401,1,0,1,1.295369,103.768105
127402,3,2,5,1.312346,103.758093
127403,2,2,4,1.312313,103.757957
127404,0,6,6,1.312281,103.757863
127406,1,4,5,1.312237,103.757636
127407,2,0,2,1.293184,103.767139
127408,1,1,2,1.312215,103.757556
127410,33,0,33,1.311814,103.757648
127411,2,0,2,1.312222,103.757475
127412,8,1,9,1.311833,103.75784
127414,17,62,79,1.311534,103.757301
127415,0,34,34,1.311644,103.757121
127416,10,129,139,1.311716,103.756968
127419,0,1,1,1.312395,103.758166
127420,29,0,29,1.311855,103.757072
127421,1,4,5,1.311903,103.757098
127422,6,0,6,1.311978,103.757141
127423,1,7,8,1.312025,103.757193
127425,76,0,76,1.312076,103.757239
127426,21,356,377,1.311945,103.756717
127427,3,58,61,1.312055,103.756648
127428,6,96,102,1.315181,103.753207
127429,4,1,5,1.315273,103.753096
127430,2,457,459,1.315271,103.752881
127431,16,618,634,1.315414,103.752822
127432,20,1,21,1.311607,103.75772
127433,4,167,171,1.311487,103.757461
127434,4,0,4,1.3117,103.757504
127436,2,1,3,1.308834,103.761256
127437,11,769,780,1.311436,103.757684
127438,9,385,394,1.295886,103.76675
127439,4,0,4,1.295955,103.766763
127440,2,62,64,1.296004,103.766772
127441,9,2900,2909,1.296074,103.76678
127442,4,0,4,1.312206,103.75731
127443,4,2,6,1.306538,103.765132
127444,191,2993,3184,1.311277,103.759828
127445,781,403,1184,1.317956,103.750839
127446,256,126,382,1.294113,103.767405
127447,144,31,175,1.294319,103.76756
127448,283,11,294,1.294756,103.767354
127449,407,21,428,1.294744,103.767517
127450,503,33,536,1.295023,103.767742
127451,331,41,372,1.29492,103.768119
127452,435,266,701,1.294459,103.768911
127453,23,3,26,1.315428,103.752471
127454,15,0,15,1.315841,103.753206
127455,16,10,26,1.315824,103.753216
127456,33,6,39,1.315796,103.753235
127457,3,0,3,1.311535,103.757734
127458,96,0,96,1.315687,103.753314
127459,4,6,10,1.315633,103.753353
127461,3,59,62,1.315578,103.753392
127464,30,31,61,1.316843,103.754093
127465,2,2,4,1.315414,103.75351
127466,439,76,515,1.316283,103.753502
127467,273,6,279,1.315359,103.753549
127468,331,46,377,1.316348,103.753054
127469,55,6,61,1.315305,103.753588
127470,219,86,305,1.316562,103.752749
127471,1,0,1,1.311827,103.75706
127472,732,50,782,1.31703,103.753036
127473,107,0,107,1.315196,103.753667
127474,889,203,1092,1.317246,103.753448
127475,5,8,13,1.315828,103.753543
127476,784,285,1069,1.316888,103.75376
127477,1,9,10,1.315996,103.753593
127479,25,1,26,1.31607,103.753817
127481,1,0,1,1.31525,103.753628
127483,1,0,1,1.316046,103.753835
127485,20,1,21,1.31595,103.753904
127487,1,1,2,1.311867,103.75777
127492,6,0,6,1.315759,103.754044
127494,1,0,1,1.315998,103.75387
127496,2,1,3,1.315742,103.753274
127498,2,0,2,1.315902,103.753939
127500,0,1,1,1.315711,103.754079
127504,124,41,165,1.316238,103.753902
127506,31,19,50,1.316383,103.753984
127508,40,72,112,1.316658,103.754068
127510,2,30,32,1.316833,103.754103
127511,17,0,17,1.316818,103.75411
127512,1,0,1,1.315567,103.754183
127513,15,0,15,1.316097,103.754488
127514,1,4,5,1.316048,103.754522
127517,9,0,9,1.31537,103.755191
127518,2,0,2,1.315615,103.754148
127519,1,0,1,1.316794,103.754127
127520,2,3,5,1.315727,103.75529
127521,32,0,32,1.316058,103.754634
127523,28,3,31,1.31596,103.754702
127524,6,1,7,1.315911,103.754735
127525,150,7,157,1.315862,103.754769
127526,18,10,28,1.315813,103.754803
127527,2,1,3,1.315663,103.754113
127529,12,0,12,1.316618,103.754533
127530,0,3,3,1.316386,103.754696
127531,1,1,2,1.315442,103.755273
127532,9,21,30,1.316864,103.754362
127554,0,10,10,1.313498,103.758625
127555,7,59,66,1.313181,103.757358
127556,9,4,13,1.313533,103.758602
127557,2,2,4,1.313199,103.757416
127558,9,1,10,1.313601,103.758557
127559,17,4,21,1.313235,103.757532
127560,0,3,3,1.316669,103.754497
127561,3,0,3,1.31367,103.758512
127562,12,2,14,1.313739,103.758467
127563,13,1,14,1.313306,103.757765
127565,8,2,10,1.313342,103.757881
127566,91,2,93,1.313378,103.757997
127567,95,2,97,1.313945,103.758332
127568,7,1,8,1.313382,103.758034
127569,2,2,4,1.314013,103.758287
127570,2,2,4,1.313386,103.75807
127575,9,9,18,1.314219,103.758152
127576,11,1,12,1.313412,103.75829
127577,19,0,19,1.314288,103.758108
127578,1,0,1,1.315649,103.755306
127579,2,0,2,1.316806,103.754399
127580,0,4,4,1.313429,103.758437
127581,2,2,4,1.314425,103.758018
127582,14,0,14,1.313437,103.75851
127583,0,1,1,1.31342,103.758364
127584,2,2,4,1.313446,103.758584
127585,2,1,3,1.31327,103.757648
127587,3,3,6,1.314631,103.757883
127588,0,8,8,1.313465,103.758695
127589,11,0,11,1.3147,103.757838
127591,3,17,20,1.314768,103.757793
127592,1,0,1,1.314494,103.757973
127593,0,3,3,1.314562,103.757928
127594,1,0,1,1.3135,103.75881
127595,9,0,9,1.314906,103.757703
127596,11,3,14,1.313534,103.758925
127597,1,3,4,1.314974,103.757658
127598,0,1,1,1.313523,103.758887
127599,8,8,16,1.315033,103.757623
127600,3,5,8,1.31358,103.759066
127601,1,0,1,1.313556,103.759022
127602,0,1,1,1.313603,103.75911
127603,3,0,3,1.314837,103.757748
127604,8,104,112,1.313734,103.759295
127605,10,0,10,1.313542,103.758347
127626,15,0,15,1.31616,103.755723
127627,2,6,8,1.316494,103.754985
127629,67,17,84,1.317122,103.754559
127630,0,1,1,1.313655,103.759195
127631,4,21,25,1.317177,103.754526
127632,19,1,20,1.316191,103.75506
127633,101,46,147,1.317231,103.754492
127634,3,0,3,1.313708,103.759262
127635,0,6,6,1.316372,103.754921
127636,1,1,2,1.314356,103.758063
127638,40,3,43,1.316578,103.754808
127640,19,0,19,1.316682,103.754717
127642,18,19,37,1.316799,103.754673
127644,1,25,26,1.316929,103.754531
127645,1,43,44,1.317906,103.754785
127646,2,7,9,1.317786,103.754863
127647,747,53,800,1.318057,103.753547
127648,5,1,6,1.317545,103.75502
127649,529,12,541,1.318911,103.753387
127650,4,1,5,1.317304,103.755178
127651,1108,66,1174,1.31892,103.754357
127656,5,81,86,1.318798,103.755301
127657,1,19,20,1.318797,103.7553
127658,7,52,59,1.318796,103.755299
127659,30,25,55,1.318795,103.755297
127660,141,245,386,1.318183,103.754962
127661,24,20,44,1.318108,103.754974
127662,2,1,3,1.316291,103.754958
127663,64,6,70,1.31792,103.755117
127664,66,2,68,1.317831,103.755164
127665,13,6,19,1.317737,103.755198
127666,1,0,1,1.316219,103.755726
127667,1,0,1,1.317608,103.755275
127668,9,1,10,1.317407,103.755389
127669,3,3,6,1.317332,103.755484
127684,6,271,277,1.318754,103.755261
127685,4,44,48,1.318753,103.75526
127703,38,0,38,1.317077,103.755705
127705,19,4,23,1.317007,103.755494
127706,10,1,11,1.316909,103.755457
127707,5,2,7,1.316794,103.755404
127708,42,2,44,1.316711,103.755355
127709,13,2,15,1.316607,103.755312
127710,20,30,50,1.316459,103.75527
127711,9,27,36,1.317063,103.755335
127712,797,213,1010,1.3188,103.755302
127713,209,4,213,1.3188,103.755302
127714,512,0,512,1.3188,103.755302
127715,424,0,424,1.3188,103.755302
127716,530,0,530,1.3188,103.755302
127717,518,0,518,1.3188,103.755302
127718,733,0,733,1.3188,103.755302
127719,174,22,196,1.3188,103.755302
127720,957,49,1006,1.318423,103.753569
127721,668,84,752,1.31786,103.754108
127722,477,108,585,1.317899,103.753824
127723,569,54,623,1.317958,103.753271
127724,642,58,700,1.317779,103.753045
127725,399,26,425,1.318978,103.75365
127726,704,34,738,1.319016,103.753941
127727,1013,291,1304,1.31872,103.754642
127728,463,732,1195,1.318558,103.754055
127732,0,9,9,1.312691,103.757666
127733,8,6,14,1.312671,103.757666
127734,1,0,1,1.31755,103.755362
127735,1,4,5,1.312678,103.757704
127737,1,0,1,1.312698,103.757704
127739,0,1,1,1.312692,103.757781
127740,2,0,2,1.316515,103.754833
127742,10,11,21,1.312754,103.75801
127743,1,2,3,1.318001,103.75508
127744,7,0,7,1.312749,103.758086
127745,8,0,8,1.312783,103.758162
127746,9,8,17,1.312763,103.758162
127747,1,2,3,1.312734,103.75801
127748,7,12,19,1.312777,103.758239
127749,19,2,21,1.312811,103.758315
127750,1,6,7,1.312791,103.758315
127751,0,1,1,1.312706,103.757857
127752,105,1,106,1.312805,103.758391
127753,33,13,46,1.312839,103.758468
127754,1,20,21,1.312819,103.758468
127755,2,0,2,1.31274,103.757933
127756,6,13,19,1.312833,103.758544
127757,3,8,11,1.312867,103.75862
127758,3,29,32,1.312847,103.75862
127759,1,0,1,1.312825,103.758391
127760,0,12,12,1.312861,103.758696
127761,0,5,5,1.312895,103.758773
127762,1,0,1,1.312881,103.758696
127763,0,2,2,1.312853,103.758544
127764,5,0,5,1.312889,103.758849
127765,4,0,4,1.312924,103.758925
127766,2,80,82,1.312904,103.758925
127767,1,0,1,1.312875,103.758773
127768,0,9,9,1.312918,103.759002
127769,1,5,6,1.312952,103.759078
127771,35,0,35,1.312966,103.759154
127772,1,24,25,1.312946,103.759154
127773,8,0,8,1.31298,103.759231
127774,37,9,46,1.31296,103.759231
127776,37,12,49,1.312974,103.759307
127778,0,19,19,1.312997,103.759351
127779,0,1,1,1.312938,103.759002
127780,0,62,62,1.313053,103.759432
127781,0,1,1,1.313073,103.759432
127782,0,117,117,1.313095,103.75948
127783,3,2,5,1.313171,103.759524
127785,0,1,1,1.313095,103.75946
127786,0,3,3,1.312797,103.758239
127787,4,2,6,1.3133,103.759643
127788,0,256,256,1.3133,103.759663
127789,6,168,174,1.313332,103.759673
127790,58,233,291,1.313322,103.759683
127812,0,22,22,1.31489,103.75548
127813,0,3,3,1.313235,103.759604
127814,1,0,1,1.313235,103.759584
127815,1,0,1,1.314887,103.755483
127816,3,3,6,1.314879,103.755489
127817,3,0,3,1.314392,103.755833
127818,1,0,1,1.31436,103.755811
127820,0,1,1,1.314872,103.755496
127821,6,1,7,1.314171,103.755678
127822,2,1,3,1.314297,103.755766
127823,0,1,1,1.314865,103.755502
127825,7,3,10,1.314045,103.75559
127826,2,1,3,1.314857,103.755508
127827,1,1,2,1.312909,103.758849
127829,1,26,27,1.313929,103.755511
127830,2,0,2,1.313982,103.755545
127831,7,19,26,1.313846,103.755545
127832,10,0,10,1.314476,103.75613
127833,5,0,5,1.313773,103.755589
127834,3,6,9,1.314395,103.756178
127837,3,0,3,1.314842,103.755521
127839,20,0,20,1.313337,103.755853
127840,3,0,3,1.313482,103.755765
127841,1,70,71,1.313191,103.755941
127843,0,6,6,1.313208,103.755951
127844,2,1,3,1.314269,103.756229
127845,1,1,2,1.314503,103.756109
127848,14,1,15,1.314013,103.756421
127850,5,2,7,1.31393,103.756415
127851,1,7,8,1.313323,103.755881
127852,23,3,26,1.31388,103.75648
127854,0,2,2,1.313224,103.755941
127856,1,0,1,1.314108,103.755634
127857,4,1,5,1.313423,103.755821
127858,1,6,7,1.313755,103.756583
127859,5,0,5,1.313456,103.755801
127860,0,5,5,1.313489,103.755781
127861,131,32,163,1.313522,103.755761
127862,1,2,3,1.314142,103.75629
127863,19,0,19,1.313588,103.755721
127864,37,3,40,1.313621,103.755701
127866,3,0,3,1.314187,103.755932
127867,0,1,1,1.3138,103.756515
127868,0,2,2,1.313832,103.756491
127869,3,1,4,1.313787,103.755601
127870,0,2,2,1.313754,103.755621
127871,1,5,6,1.313666,103.756243
127872,1,0,1,1.31372,103.755641
127873,1,4,5,1.313585,103.756331
127874,89,21,110,1.313143,103.755998
127875,15,1,16,1.313056,103.756036
127876,5,6,11,1.313012,103.756107
127877,8,0,8,1.299509,103.837
127878,3,0,3,1.313687,103.755661
127879,100,1,101,1.312829,103.756228
127880,27,0,27,1.312737,103.756272
127881,18,2,20,1.312677,103.756285
127882,0,1,1,1.313631,103.75629
127883,81,2,83,1.312549,103.756369
127884,2,4,6,1.312515,103.756444
127885,18,1,19,1.312452,103.756469
127886,27,2,29,1.312356,103.756526
127887,5,0,5,1.312322,103.75655
127888,9,0,9,1.312232,103.756601
127889,5,0,5,1.312171,103.756649
127890,28,94,122,1.312129,103.756364
127891,4,5,9,1.312206,103.756236
127892,18,6,24,1.312323,103.75614
127893,2,4,6,1.31239,103.756058
127894,8,1,9,1.312416,103.756055
127895,0,3,3,1.312886,103.756171
127896,0,1,1,1.312635,103.756362
127897,1,0,1,1.314892,103.756306
127898,0,12,12,1.314987,103.756457
127899,4,8,12,1.315034,103.756533
127900,15,2,17,1.315082,103.756608
127901,2,0,2,1.313746,103.756227
127902,10,3,13,1.315176,103.75676
127903,3,0,3,1.314869,103.756268
127904,58,2,60,1.315271,103.756911
127905,0,1,1,1.31494,103.756381
127906,13,0,13,1.315308,103.756982
127907,8,2,10,1.315345,103.757052
127909,1,0,1,1.31529,103.756946
127910,3,1,4,1.315457,103.757264
127911,0,1,1,1.315419,103.757193
127912,2,4,6,1.315531,103.757405
127913,14,23,37,1.315568,103.757475
127914,23,190,213,1.315605,103.757546
127915,2,92,94,1.316613,103.755996
127916,0,1,1,1.315494,103.757334
127917,1,1,2,1.315129,103.756684
127918,3,1,4,1.31645,103.756108
127919,1,0,1,1.31658,103.756018
127920,2,24,26,1.31632,103.756199
127921,48,46,94,1.316255,103.756244
127922,1,5,6,1.31619,103.756289
127923,0,2,2,1.316515,103.756063
127924,1,2,3,1.315224,103.756835
127926,3,0,3,1.31606,103.756379
127927,1,2,3,1.315931,103.75647
127928,5,0,5,1.315801,103.75656
127929,3,9,12,1.315736,103.756605
127930,0,3,3,1.315866,103.756515
127931,12,2,14,1.315606,103.756695
127932,4,0,4,1.315541,103.75674
127933,1,3,4,1.315476,103.756786
127934,8,1,9,1.315411,103.756831
127935,48,2,50,1.315346,103.756876
127936,2,6,8,1.315291,103.756911
127958,13,371,384,1.316971,103.756494
127959,4,27,31,1.316955,103.756507
127961,75,36,111,1.316888,103.756558
127962,0,41,41,1.316854,103.756584
127963,0,15,15,1.316821,103.75661
127964,0,17,17,1.316787,103.756635
127965,1,19,20,1.316754,103.756661
127966,4,11,15,1.31672,103.756687
127967,2,42,44,1.316687,103.756713
127968,1,0,1,1.316385,103.756154
127970,3,49,52,1.316586,103.75679
127972,26,0,26,1.316519,103.756841
127973,2,11,13,1.316486,103.756867
127974,53,4,57,1.316452,103.756893
127975,1,0,1,1.316653,103.756738
127976,9,61,70,1.316385,103.756944
127977,14,0,14,1.316352,103.75697
127978,0,1,1,1.316419,103.756918
127979,5,20,25,1.315724,103.757323
127981,2,0,2,1.316125,103.756334
127984,0,43,43,1.31493,103.758144
127986,3,0,3,1.315671,103.75665
127987,19,0,19,1.314732,103.758338
127988,0,1088,1088,1.314666,103.758402
127989,0,54,54,1.3146,103.758466
127991,0,2,2,1.315127,103.75795
127992,1,12,13,1.314403,103.75866
127994,2,0,2,1.314468,103.758596
127996,0,8,8,1.315682,103.757485
127997,843,7,850,1.315549,103.758139
127998,0,1,1,1.315739,103.757247
127999,797,19,816,1.315344,103.758343
128001,586,13,599,1.315138,103.758629
128002,364,24,388,1.313754,103.759295
128003,0,1,1,1.315648,103.75751
128004,3,25,28,1.313662,103.759383
128007,1,46,47,1.313414,103.759615
128008,0,27,27,1.313342,103.759683
128014,41,3408,3449,1.311581,103.76053
128015,630,96,726,1.314929,103.758803
128016,918,515,1433,1.314708,103.759047
128017,1013,131,1144,1.31389,103.759203
128018,537,80,617,1.313833,103.75926
128019,157,64,221,1.31496,103.759171
128020,234,36,270,1.316685,103.757493
128021,362,0,362,1.299509,103.837
128035,959,551,1510,1.298893,103.76545
128036,818,166,984,1.298726,103.766358
128037,394,2406,2800,1.299316,103.76654
128038,728,396,1124,1.299561,103.766085
128039,62,156,218,1.298893,103.76545
128040,690,1187,1877,1.298893,103.76545
128041,413,614,1027,1.297807,103.766169
128042,1352,2158,3510,1.29758,103.766795
128043,135,1211,1346,1.297726,103.766007
128044,627,30,657,1.297726,103.766007
128045,980,90,1070,1.296835,103.765428
128046,1664,215,1879,1.296907,103.765117
128047,1742,209,1951,1.297009,103.765291
128048,2348,302,2650,1.297224,103.764869
128049,1196,268,1464,1.297656,103.764926
128050,495,548,1043,1.297503,103.765616
128051,17,415,432,1.298581,103.765037
128052,26,1,27,1.298527,103.764983
128053,11,7,18,1.298528,103.764924
128054,8,15,23,1.298471,103.76487
128055,1,3,4,1.298474,103.764846
128056,1,5,6,1.298449,103.764759
128057,24,159,183,1.298403,103.764706
128058,20,116,136,1.298156,103.764824
128059,75,8,83,1.298206,103.764893
128060,5,7,12,1.298229,103.76496
128061,2,0,2,1.314337,103.758724
128062,6,30,36,1.315252,103.755725
128063,2,3,5,1.315221,103.755763
128064,2,0,2,1.298226,103.765008
128065,3,0,3,1.314798,103.758273
128066,0,1,1,1.313703,103.759344
128067,16,3,19,1.314977,103.756068
128068,8,5,13,1.314916,103.756144
128069,30,0,30,1.314329,103.756655
128070,0,2,2,1.31516,103.755839
128071,19,0,19,1.314289,103.756672
128072,2,0,2,1.314855,103.75622
128073,2,0,2,1.314814,103.756253
128074,0,1,1,1.315038,103.755992
128075,11,0,11,1.314128,103.756743
128076,0,6,6,1.314693,103.756352
128077,2,5,7,1.314048,103.756778
128079,9,0,9,1.313968,103.756813
128080,1,0,1,1.314774,103.756286
128081,3,2,5,1.313887,103.756849
128082,1,1,2,1.314208,103.756708
128083,17,0,17,1.313817,103.756874
128084,1,0,1,1.314531,103.756485
128085,1,2,3,1.315099,103.755915
128086,8,0,8,1.314338,103.756631
128087,3,1,4,1.313744,103.756927
128089,6,4,10,1.31368,103.756969
128091,2,0,2,1.31445,103.756551
128092,45,8,53,1.314182,103.756699
128093,11,42,53,1.313553,103.757054
128094,2,0,2,1.313617,103.757012
128096,0,2,2,1.314119,103.756727
128097,38,1,39,1.313427,103.75714
128098,99,8,107,1.313994,103.756782
128100,64,9,73,1.313932,103.756809
128101,20,4,24,1.3133,103.757225
128102,1,12,13,1.313869,103.756837
128103,13,3,16,1.313236,103.757267
128104,526,1,527,1.312805,103.757141
128105,4,11,15,1.313183,103.7573
128127,4,7,11,1.308317,103.762505
128129,1,2,3,1.313775,103.756905
128130,1,0,1,1.314369,103.756617
128131,10,2,12,1.307995,103.761775
128132,18,4119,4137,1.307995,103.761775
128133,6,0,6,1.308327,103.76254
128134,15,0,15,1.308288,103.762471
128135,30,0,30,1.308345,103.762609
128136,0,6,6,1.308298,103.762507
128139,4,0,4,1.308383,103.762746
128140,2,0,2,1.314057,103.756754
128141,21,2,23,1.308401,103.762815
128142,0,3,3,1.307995,103.761775
128144,2,0,2,1.308327,103.762614
128146,0,1,1,1.307995,103.761775
128147,0,3,3,1.308346,103.762686
128148,12,0,12,1.308476,103.763091
128149,0,1,1,1.308457,103.763022
128150,5,0,5,1.308495,103.76316
128152,6,0,6,1.308513,103.763228
128153,2,0,2,1.308439,103.762953
128154,10,2,12,1.308532,103.763297
128155,11,1,12,1.308482,103.763186
128156,3,2,5,1.308551,103.763366
128157,2,0,2,1.308462,103.763114
128159,0,3,3,1.308404,103.7629
128160,3,0,3,1.308521,103.763329
128162,16,2,18,1.308607,103.763573
128163,7,0,7,1.308559,103.763472
128165,2,0,2,1.308501,103.763258
128167,0,4,4,1.308598,103.763615
128168,1,0,1,1.308424,103.762972
128171,5,0,5,1.308637,103.763758
128172,1,2,3,1.308588,103.763504
128173,2,0,2,1.308579,103.763544
128174,28,0,28,1.308719,103.763986
128175,2,0,2,1.308656,103.76383
128177,0,1,1,1.308663,103.763779
128178,4,1,5,1.308756,103.764123
128180,2,1,3,1.3087,103.763917
128182,1,2,3,1.308775,103.764192
128183,5,1,6,1.308753,103.764187
128184,11,0,11,1.308802,103.76432
128185,29,0,29,1.308773,103.764258
128187,2,0,2,1.308676,103.763901
128188,1,0,1,1.308695,103.763973
128190,0,1,1,1.308817,103.764362
128191,15,5,20,1.308905,103.764616
128192,5,0,5,1.308934,103.764701
128193,0,19,19,1.308935,103.764811
128194,1,13,14,1.308908,103.764907
128195,2,14,16,1.313236,103.757267
128196,8,15,23,1.308835,103.765034
128197,1,34,35,1.308796,103.765111
128219,15,67,82,1.310506,103.755637
128220,3,2,5,1.307519,103.756207
128221,4,3,7,1.310488,103.755612
128222,6,3,9,1.307537,103.756228
128223,2,6,8,1.310451,103.755561
128224,1,0,1,1.308876,103.764532
128225,14,13,27,1.310414,103.755511
128226,6,2,8,1.307611,103.756311
128227,5,5,10,1.310377,103.75546
128228,3,0,3,1.308793,103.764261
128229,4,7,11,1.31034,103.75541
128230,1,1,2,1.308792,103.76433
128232,8,0,8,1.307722,103.756437
128233,6,4,10,1.310266,103.755309
128234,2,2,4,1.307759,103.756478
128235,1,3,4,1.310229,103.755259
128236,2,3,5,1.307796,103.75652
128237,3,3,6,1.310192,103.755208
128238,2,5,7,1.307833,103.756562
128239,3,5,8,1.310155,103.755158
128240,9,0,9,1.307871,103.756604
128241,0,4,4,1.310118,103.755108
128242,2,1,3,1.307648,103.756353
128243,7,47,54,1.310081,103.755057
128244,248,23,271,1.307945,103.756687
128245,2,8,10,1.307982,103.756729
128246,5,2,7,1.308019,103.756771
128247,6,153,159,1.30997,103.754906
128248,1,2,3,1.307908,103.756646
128249,2,2,4,1.309933,103.754856
128250,0,2,2,1.307685,103.756395
128251,0,1,1,1.307574,103.75627
128253,3,0,3,1.308056,103.756813
128254,1,2,3,1.309859,103.754755
128256,4,2,6,1.308165,103.755827
128257,1,1,2,1.308093,103.756854
128258,2,0,2,1.31036,103.755069
128259,3,0,3,1.307838,103.756115
128260,2,0,2,1.308235,103.755923
128261,1,1,2,1.308374,103.756115
128263,3,1,4,1.310579,103.755329
128264,8,0,8,1.308513,103.756307
128266,1,0,1,1.309896,103.754805
128268,2,0,2,1.310493,103.75527
128269,20,3,23,1.308912,103.756821
128270,4,0,4,1.310776,103.754847
128271,1,4,5,1.308892,103.756836
128272,1,1,2,1.310876,103.754983
128273,204,7,211,1.308851,103.756865
128274,8,0,8,1.310588,103.754587
128275,3,10,13,1.30881,103.756895
128277,1,3,4,1.308769,103.756924
128278,9,0,9,1.31043,103.754358
128279,0,1,1,1.310975,103.755118
128280,3,350,353,1.310292,103.754149
128281,2,1,3,1.310425,103.75516
128282,13,87,100,1.310588,103.754567
128283,4,1,5,1.308646,103.757013
128284,3,0,3,1.308687,103.756983
128285,0,110,110,1.311169,103.754153
128286,1,2,3,1.308605,103.757042
128287,2,24,26,1.308523,103.757101
128288,1,29,30,1.311254,103.754089
128289,0,23,23,1.31133,103.754035
128290,1,2,3,1.308564,103.757072
128291,0,3,3,1.308441,103.75716
128292,56,3,59,1.310806,103.754526
128293,0,4,4,1.308359,103.757219
128294,2,0,2,1.310677,103.754712
128297,0,1,1,1.308728,103.756954
128299,0,7,7,1.308236,103.757308
128300,1,0,1,1.308277,103.757278
128301,0,2,2,1.31091,103.754645
128303,1,2,3,1.3084,103.75719
128304,2,0,2,1.308888,103.757124
128305,2,10,12,1.308979,103.756787
128306,1,3,4,1.309004,103.756768
128307,0,2,2,1.311579,103.754676
128308,0,2,2,1.309055,103.756729
128309,0,1,1,1.311057,103.754859
128310,0,2,2,1.311272,103.754284
128311,1,89,90,1.311888,103.754687
128312,0,2,2,1.309158,103.756653
128313,1,1,2,1.309209,103.756614
128314,1,50,51,1.30926,103.756576
128315,0,5,5,1.31177,103.754765
128316,16,14,30,1.309311,103.756538
128317,71,0,71,1.309362,103.756499
128318,1,1,2,1.311849,103.754713
128320,0,7,7,1.311528,103.754934
128321,1,0,1,1.309106,103.756691
128322,1,2,3,1.308943,103.757088
128323,5,1,6,1.308929,103.756597
128324,1,3,4,1.311355,103.755062
128325,0,3,3,1.311441,103.754998
128326,1,0,1,1.309516,103.756384
128327,4,6,10,1.311181,103.755189
128329,2,0,2,1.309414,103.756461
128330,0,1,1,1.308578,103.756259
128332,18,3,21,1.3088,103.756105
128333,1,3,4,1.310934,103.755367
128334,1,1,2,1.308689,103.756182
128335,0,1,1,1.311054,103.755282
128338,0,4,4,1.310695,103.755538
128340,1,1,2,1.308856,103.756067
128341,2,1,3,1.308551,103.756278
128342,5,63,68,1.310535,103.755652
128343,6,0,6,1.309133,103.755875
128345,1,1,2,1.310615,103.755595
128346,2,0,2,1.308061,103.755595
128347,13,1,14,1.311907,103.753674
128349,0,1,1,1.310854,103.755424
128351,0,1,1,1.311974,103.753755
128352,0,3,3,1.309077,103.755914
128353,0,2,2,1.311859,103.753604
128354,3,3,6,1.308475,103.755285
128355,8,1,9,1.312087,103.753926
128356,1,4,5,1.308567,103.755216
128357,18,12,30,1.312121,103.753978
128358,2,78,80,1.308659,103.755147
128359,6,95,101,1.308734,103.755224
128360,2,0,2,1.312055,103.753881
128361,1,0,1,1.312016,103.753829
128362,2,6,8,1.312653,103.753919
128363,5,1,6,1.309058,103.755662
128364,55,3,58,1.312767,103.753836
128365,2,1,3,1.308383,103.755354
128366,0,1,1,1.308928,103.755487
128367,1,1,2,1.308799,103.755312
128369,0,1,1,1.309251,103.755922
128370,21,49,70,1.309557,103.756336
128371,4,1,5,1.306668,103.75524
128372,4,4,8,1.312183,103.753975
128373,422,16,438,1.307255,103.755009
128374,97,9,106,1.307869,103.754926
128375,3,1,4,1.311944,103.75361
128376,2926,19,2945,1.308331,103.754518
128377,1,1,2,1.313095,103.753584
128378,1358,22,1380,1.309032,103.753808
128379,580,38,618,1.310213,103.753477
128380,14,400,414,1.312267,103.752959
128381,2938,31,2969,1.311175,103.752811
128382,2,1,3,1.309178,103.755827
128383,885,476,1361,1.310338,103.752013
128384,1216,33,1249,1.310563,103.751069
128385,2,0,2,1.311824,103.753428
128386,76,271,347,1.311396,103.752457
128387,1,0,1,1.309441,103.756176
128388,870,701,1571,1.311205,103.751897
128389,12,0,12,1.312623,103.753435
128390,72,28,100,1.312851,103.752576
128391,3,2,5,1.312702,103.753541
128392,0,1,1,1.312543,103.75333
128393,1,2,3,1.312306,103.753012
128394,84,10,94,1.312176,103.75204
128395,0,1,1,1.312701,103.75354
128397,155,29,184,1.312536,103.751889
128398,2,1,3,1.312701,103.75354
128399,5,9,14,1.312622,103.753112
128400,32,493,525,1.312587,103.753049
128401,164,13,177,1.311392,103.751286
128402,33,3,36,1.312115,103.750973
128403,218,0,218,1.311177,103.750574
128404,153,15,168,1.313413,103.753422
128405,1327,0,1327,1.310743,103.749572
128406,7,126,133,1.313966,103.752789
128408,13,6,19,1.311294,103.748576
128409,26,3,29,1.311737,103.748398
128410,1,21,22,1.312434,103.749062
128411,393,2,395,1.312639,103.748981
128412,2500,0,2500,1.31337,103.748724
128413,137,345,482,1.313835,103.748786
128414,63,46,109,1.314175,103.749113
128415,97,14,111,1.314494,103.749259
128416,308,1,309,1.315074,103.749607
128417,583,70,653,1.316082,103.75024
128418,429,21,450,1.313471,103.750292
128419,1039,220,1259,1.314552,103.750675
128420,1278,295,1573,1.316476,103.750504
128421,52,86,138,1.313974,103.750856
128422,925,533,1458,1.314868,103.751983
128423,35,357,392,1.313943,103.751928
128424,2255,385,2640,1.313235,103.751605
128425,10,718,728,1.312861,103.752566
128426,44,84,128,1.312832,103.751659
128428,68,14,82,1.312736,103.751142
128429,4,20,24,1.312709,103.75098
128430,5,0,5,1.312611,103.750869
128431,22,14,36,1.312597,103.750657
128432,120,32,152,1.31209,103.750875
128433,23,60,83,1.31196,103.750591
128434,181,45,226,1.311829,103.750308
128435,73,63,136,1.311699,103.750024
128436,4,0,4,1.311569,103.749741
128437,11,182,193,1.311526,103.749503
128438,31,143,174,1.312918,103.749587
128439,72,2,74,1.313361,103.749882
128440,875,20,895,1.309466,103.752665
128441,3,68,71,1.311217,103.754116
128442,2,1,3,1.312695,103.75318
128443,1,1,2,1.312464,103.753224
128444,2,11,13,1.312426,103.754085
128445,12,127,139,1.310884,103.754355
128446,0,194,194,1.311395,103.753991
128447,3,0,3,1.31278,103.753646
128448,2,8,10,1.311659,103.754839
128449,1,6,7,1.311615,103.754871
128450,1,7,8,1.311268,103.755126
128451,0,4,4,1.311094,103.755253
128452,0,5,5,1.311014,103.75531
128453,0,1,1,1.312781,103.753647
128454,65,503,568,1.311754,103.753446
128455,30,1,31,1.311816,103.753541
128456,21,106,127,1.31237,103.754127
128457,3,6,9,1.31254,103.754002
128458,13,5,18,1.31287,103.753763
128459,0,1,1,1.310775,103.755481
128460,1,8,9,1.31288,103.753753
128461,4514,584,5098,1.302174,103.761273
128462,1439,174,1613,1.302531,103.760484
128463,26,629,655,1.301945,103.760728
128464,1386,284,1670,1.304548,103.75826
128465,112,0,112,1.300645,103.75917
128466,2242,288,2530,1.305599,103.759259
128467,959,0,959,1.301525,103.758492
128468,86,52,138,1.302255,103.75887
128469,8,1,9,1.302924,103.758605
128470,401,75,476,1.304299,103.757404
128471,311,0,311,1.305017,103.755706
128472,457,91,548,1.306174,103.756528
128473,217,188,405,1.306991,103.758452
128475,310,239,549,1.303763,103.760111
128476,402,106,508,1.306197,103.757756
128477,1560,133,1693,1.307191,103.757497
128478,98,0,98,1.303211,103.758026
128496,0,1,1,1.312992,103.753664
128518,3,1,4,1.305244,103.764317
128519,29,1539,1568,1.305243,103.764316
128520,2,1,3,1.311374,103.754415
128521,89,0,89,1.305243,103.764316
128522,1,0,1,1.321976,103.760154
128523,2,0,2,1.308107,103.75556
128524,22,8887,8909,1.305201,103.764349
128525,0,1,1,1.305243,103.764316
128526,1,19,20,1.305069,103.764425
128527,1,3,4,1.305275,103.764412
128528,10,0,10,1.305267,103.764446
128529,1,3,4,1.305338,103.764602
128530,1,1,2,1.30523,103.764334
128531,6,5,11,1.30534,103.764671
128532,16,0,16,1.3054,103.764792
128533,11,0,11,1.305416,103.764782
128534,2,2,4,1.305414,103.764895
128535,6,2,8,1.305462,103.764981
128536,3,0,3,1.305243,103.764316
128537,2,9,11,1.305487,103.765118
128538,0,2,2,1.305356,103.764596
128539,5,0,5,1.305487,103.765118
128540,199,0,199,1.305525,103.765171
128541,4,0,4,1.305561,103.765344
128542,4,7,11,1.30556,103.765343
128543,1,11,12,1.30556,103.765343
128544,1,3,4,1.305649,103.765551
128546,2,0,2,1.305487,103.765118
128547,0,2,2,1.305708,103.765793
128548,0,6,6,1.305707,103.765792
128549,0,2,2,1.305707,103.765792
128550,3,3,6,1.30571,103.76574
128551,30,5,35,1.30571,103.76574
128552,1,14,15,1.30571,103.76574
128553,1,10,11,1.305782,103.766017
128554,19,1,20,1.305781,103.766016
128555,2,0,2,1.305711,103.765741
128556,18,37,55,1.305773,103.76593
128557,2,11,13,1.305856,103.766241
128558,11,9,20,1.305855,103.76624
128559,7,0,7,1.305836,103.76612
128561,2,4,6,1.305929,103.766466
128562,3,0,3,1.305488,103.765119
128564,16,0,16,1.3054,103.764792
128566,0,5,5,1.305961,103.7665
128567,10,0,10,1.30596,103.766499
128568,3,0,3,1.305898,103.76631
128569,1,5,6,1.30596,103.766499
128570,6,0,6,1.306031,103.766784
128571,1,2,3,1.30596,103.766499
128572,38,0,38,1.30603,103.766783
128573,42,6,48,1.30603,103.766783
128574,5,20,25,1.306013,103.76668
128575,1299,301,1600,1.307045,103.766313
128576,2,4,6,1.30606,103.766878
128577,4,18,22,1.306059,103.766877
128578,2,15,17,1.306023,103.76669
128579,1,0,1,1.305209,103.764342
128580,8,3,11,1.306022,103.766689
128581,21,0,21,1.306022,103.766689
128582,120,0,120,1.306116,103.767066
128583,69,69,138,1.306136,103.767066
128584,1,82,83,1.306173,103.767254
128585,15,71,86,1.30623,103.767442
128588,1,1,2,1.305774,103.765931
128590,2,24,26,1.306172,103.767253
128591,13,24,37,1.306012,103.766679
128592,5,3,8,1.306012,103.766679
128593,22,20,42,1.306012,103.766679
128607,16,1995,2011,1.308508,103.761394
128609,1,426,427,1.30847,103.761438
128610,5,0,5,1.308513,103.762432
128611,13,464,477,1.308435,103.76149
128613,3,316,319,1.308395,103.761538
128616,2,4,6,1.308751,103.76236
128617,1,400,401,1.308316,103.761637
128618,3,0,3,1.30603,103.766783
128619,3,1,4,1.308887,103.762273
128620,5,3,8,1.308199,103.761809
128621,0,1,1,1.306022,103.766689
128622,18,3661,3679,1.308203,103.761894
128624,1,2,3,1.308834,103.762324
128625,1,0,1,1.308921,103.762245
128626,11,24,35,1.308247,103.762034
128627,0,5,5,1.30914,103.762056
128628,110,15,125,1.308265,103.762091
128629,4,1,5,1.309227,103.761981
128630,2,0,2,1.306002,103.766689
128631,49,0,49,1.308325,103.762187
128632,1,21,22,1.308347,103.762229
128633,2,0,2,1.308299,103.762133
128634,2,15,17,1.308392,103.762326
128635,20,0,20,1.308416,103.762366
128636,3,17,20,1.308436,103.762414
128637,18,18,36,1.308596,103.762363
128638,1,7,8,1.308841,103.762254
128639,10,0,10,1.308823,103.762201
128641,6,0,6,1.308783,103.762115
128642,1,0,1,1.309052,103.762132
128643,3,1,4,1.308731,103.762009
128644,10,0,10,1.308729,103.761946
128645,1,0,1,1.308757,103.762067
128646,0,2,2,1.308369,103.762269
128647,22,1,23,1.308816,103.76181
128648,0,1,1,1.308751,103.761894
128649,1,0,1,1.308844,103.761764
128652,1,0,1,1.30888,103.76174
128654,0,1,1,1.309072,103.761595
128655,0,3,3,1.308227,103.761978
128658,0,1,1,1.309017,103.761737
128659,4,1,5,1.309227,103.761961
128661,1,0,1,1.309188,103.761919
128662,0,1,1,1.30928,103.762026
128663,2,8,10,1.309357,103.762127
128685,5,5,10,1.30749,103.762393
128686,1,8,9,1.307489,103.762392
128687,6,3090,3096,1.307489,103.762392
128688,1,4,5,1.307812,103.763007
128689,4,679,683,1.307708,103.762752
128690,0,109,109,1.307708,103.762752
128691,0,57,57,1.307708,103.762752
128692,3,31,34,1.307708,103.762752
128693,3,113,116,1.307708,103.762752
128694,47,319,366,1.307708,103.762752
128695,1,0,1,1.309324,103.762082
128696,5,0,5,1.307526,103.762426
128697,0,3,3,1.309042,103.761763
128698,1,0,1,1.307708,103.762752
128699,44,2,46,1.307717,103.76308
128701,1,4,5,1.307653,103.763129
128703,1,0,1,1.307599,103.762493
128705,16,30,46,1.307558,103.763202
128706,1,0,1,1.30759,103.763178
128707,0,4,4,1.307837,103.762944
128710,19,17,36,1.307461,103.763362
128711,0,11,11,1.307864,103.763029
128714,1,0,1,1.307499,103.763278
128716,1,4,5,1.307499,103.763298
128717,13,1,14,1.307915,103.763207
128718,3,0,3,1.30778,103.763032
128720,39,2,41,1.307546,103.763237
128721,20,0,20,1.307955,103.763349
128723,0,2,2,1.308783,103.761852
128724,1,0,1,1.307489,103.763314
128727,5,0,5,1.308016,103.763563
128728,9,0,9,1.307587,103.763889
128729,1,0,1,1.307584,103.763202
128730,1,2,3,1.307523,103.763268
128731,0,3,3,1.307673,103.764003
128732,1,0,1,1.308036,103.763634
128733,3,0,3,1.308056,103.763706
128734,2,2,4,1.307741,103.764067
128735,4,13,17,1.308096,103.763848
128736,2,0,2,1.307975,103.763421
128737,6,0,6,1.308117,103.763919
128738,1,0,1,1.307711,103.764007
128739,2,0,2,1.307772,103.764101
128741,0,6,6,1.308147,103.764052
128742,2,1,3,1.308076,103.763777
128743,24,0,24,1.308186,103.76414
128744,2,2,4,1.308031,103.764245
128745,5,72,77,1.308215,103.764218
128747,2,82,84,1.308272,103.764373
128748,59,0,59,1.308173,103.764159
128749,6,0,6,1.308301,103.764451
128750,7,0,7,1.308209,103.764256
128752,3,0,3,1.307912,103.764205
128753,13,4,17,1.308413,103.764522
128755,0,1,1,1.307841,103.764143
128756,2,0,2,1.308137,103.763991
128757,1,0,1,1.308462,103.764478
128758,32,2,34,1.308355,103.764575
128759,1,0,1,1.30851,103.764435
128760,0,5,5,1.308378,103.764605
128761,4,4,8,1.308701,103.764356
128762,0,1,1,1.3086,103.764391
128763,0,3,3,1.308245,103.764354
128764,0,10,10,1.308449,103.764694
128767,16,1,17,1.308589,103.764873
128768,0,2,2,1.308306,103.764492
128769,3,1,4,1.308682,103.764992
128770,8,27,35,1.308729,103.765051
128771,44,21,65,1.308776,103.765111
128793,963,147,1110,1.31727,103.759851
128794,652,82,734,1.316961,103.759497
128795,816,111,927,1.316628,103.759124
128796,219,50,269,1.316001,103.75973
128797,1076,131,1207,1.315971,103.760243
128798,954,209,1163,1.316511,103.76077
128799,780,256,1036,1.317033,103.760275
128800,150,55,205,1.3185,103.760055
128801,221,49,270,1.318043,103.760181
128802,304,0,304,1.318064,103.760204
128803,1321,357,1678,1.317249,103.761539
128804,43,17,60,1.31718,103.761178
128805,2436,189,2625,1.317265,103.761013
128806,807,307,1114,1.319799,103.761213
128807,108,361,469,1.317936,103.761794
128808,37,70,107,1.443255,103.780324
128809,61,278,339,1.317936,103.761794
128810,17,55,72,1.299509,103.837
128828,57,311,368,1.30971,103.754927
128944,85,23,108,1.322536,103.757112
128945,4,10,14,1.322235,103.755727
128946,2,3,5,1.32252,103.757066
128947,2,3,5,1.322211,103.756168
128948,34,0,34,1.322486,103.756972
128949,5,0,5,1.322144,103.755979
128950,65,2,67,1.322453,103.756878
128951,18,0,18,1.322072,103.755688
128952,0,1,1,1.308402,103.764635
128953,17,4,21,1.321999,103.755397
128954,9,4,13,1.322387,103.756692
128955,2,1,3,1.308792,103.76433
128957,30,0,30,1.32232,103.756504
128958,66,7,73,1.322048,103.754637
128959,10,0,10,1.322297,103.756421
128960,5,0,5,1.322263,103.75635
128961,3,2,5,1.322239,103.75629
128962,13,31,44,1.322191,103.756168
128963,6,13,19,1.322146,103.756042
128964,4,1,5,1.322124,103.755979
128965,7,2,9,1.322092,103.75585
128966,4,3,7,1.32206,103.75572
128967,4,0,4,1.322027,103.755591
128968,1,9,10,1.321995,103.755462
128969,22,2,24,1.321979,103.755397
128970,2,3,5,1.321964,103.755265
128971,10,0,10,1.321948,103.755132
128972,1,4,5,1.321933,103.755
128973,5,0,5,1.321954,103.754835
128974,1,27,28,1.321977,103.754704
128975,41,69,110,1.322038,103.754627
128978,1,0,1,1.32242,103.756785
128981,0,1,1,1.299509,103.837
128983,1,0,1,1.299509,103.837
128991,0,20,20,1.299509,103.837
128992,1,0,1,1.299509,103.837
128998,21,0,21,1.320113,103.756224
129000,4,1,5,1.320191,103.756164
129001,2,0,2,1.308636,103.764932
129003,7,2,9,1.320326,103.75604
129004,0,1,1,1.299509,103.837
129005,11,19,30,1.320423,103.755966
129006,2,1,3,1.321968,103.755132
129007,0,3,3,1.320655,103.755807
129008,0,1,1,1.3205,103.755926
129009,6,0,6,1.320861,103.755756
129010,1,7,8,1.320713,103.755742
129011,12,0,12,1.320921,103.755835
129012,3,2,5,1.3208,103.755678
129013,4,7,11,1.320982,103.755913
129014,28,14,42,1.320848,103.755637
129015,11,0,11,1.321086,103.756083
129016,27,3,30,1.320887,103.755605
129017,16,0,16,1.321164,103.756256
129018,1,8,9,1.320964,103.755543
129020,3,4,7,1.32104,103.75548
129021,9,1,10,1.32127,103.756614
129022,3,33,36,1.321117,103.755418
129024,2,75,77,1.321184,103.755365
129025,19,0,19,1.32135,103.756882
129026,2,3,5,1.321338,103.756882
129027,8,0,8,1.321316,103.756892
129028,1,1,2,1.32023,103.756114
129029,1,0,1,1.32081,103.755688
129030,1,0,1,1.321228,103.756931
129031,72,53,125,1.321141,103.75697
129033,15,8,23,1.321053,103.757009
129034,69,7,76,1.321009,103.757029
129035,120,0,120,1.320965,103.757049
129037,1,0,1,1.321185,103.75695
129038,3,1,4,1.320834,103.757107
129039,4,8,12,1.32079,103.757127
129040,36,6,42,1.321496,103.757312
129041,11,0,11,1.321487,103.757279
129042,57,2,59,1.321467,103.757213
129043,1,0,1,1.320878,103.757088
129044,1,1,2,1.321272,103.756911
129045,26,1,27,1.321409,103.757014
129046,3,0,3,1.32052,103.755891
129048,58,0,58,1.32137,103.756882
129049,23,1,24,1.321357,103.75684
129051,3,0,3,1.321389,103.756948
129053,16,0,16,1.321164,103.756256
129054,2,0,2,1.321428,103.75708
129055,1,2,3,1.321307,103.756671
129056,6,1,7,1.321182,103.75625
129058,10,13,23,1.321106,103.756083
129059,17,0,17,1.321082,103.75604
129061,3,1,4,1.320976,103.755879
129062,2,0,2,1.321232,103.756419
129063,4,0,4,1.320872,103.755745
129064,7,0,7,1.32082,103.755678
129065,8,6,14,1.320848,103.755657
129066,16,0,16,1.320887,103.755625
129067,8,0,8,1.320964,103.755563
129068,19,4,23,1.32104,103.7555
129069,1,2,3,1.321207,103.756334
129070,6,0,6,1.321194,103.755375
129092,14,0,14,1.321425,103.758975
129093,7,7,14,1.320923,103.758512
129094,82,2,84,1.321451,103.758933
129095,2,2,4,1.321388,103.759027
129096,0,1,1,1.321448,103.757147
129097,3,2,5,1.321004,103.759646
129098,170,0,170,1.321661,103.758091
129099,83,3,86,1.320265,103.76041
129101,247,17,264,1.320195,103.760327
129102,31,3,34,1.321664,103.758599
129103,34,36,70,1.320088,103.760193
129104,25,2,27,1.320233,103.759998
129106,18,4,22,1.320334,103.759859
129107,31,3,34,1.321823,103.758348
129108,14,11,25,1.320583,103.759708
129110,24,15,39,1.320711,103.759834
129111,195,3,198,1.321398,103.759037
129112,6,3,9,1.321206,103.759346
129113,28,3,31,1.321024,103.759646
129114,5,10,15,1.320975,103.759742
129115,31,0,31,1.320936,103.759828
129116,255,6,261,1.32088,103.75991
129117,22,7,29,1.320726,103.76004
129118,11,2,13,1.320572,103.76017
129119,8,3,11,1.320419,103.7603
129120,22,1,23,1.320275,103.76042
129121,133,190,323,1.320064,103.760513
129122,3,130,133,1.319946,103.760467
129123,32,22,54,1.31984,103.760354
129124,3,37,40,1.319823,103.760221
129125,10,44,54,1.319809,103.760133
129126,2,19,21,1.319875,103.760014
129127,56,2,58,1.319976,103.759885
129128,5,1,6,1.320105,103.759734
129129,3,4,7,1.320257,103.759615
129130,14,3,17,1.3204,103.759492
129131,2,7,9,1.320546,103.759447
129132,3,1,4,1.320697,103.759464
129133,0,34,34,1.321014,103.759636
129134,19,7,26,1.299509,103.837
129135,1,14,15,1.299509,103.837
129136,4,1,5,1.321004,103.758808
129155,1,2,3,1.321117,103.755438
129156,22,32,54,1.321294,103.75761
129157,0,12,12,1.321295,103.757449
129158,14,5,19,1.321435,103.757561
129159,8,0,8,1.321717,103.757463
129160,2,1,3,1.321153,103.757639
129161,0,3,3,1.321999,103.757365
129162,1,3,4,1.322618,103.757108
129163,3,1,4,1.321841,103.757713
129164,8,1,9,1.322725,103.756931
129165,10,5,15,1.322796,103.756812
129166,21,12,33,1.322867,103.756694
129167,20,3,23,1.322938,103.756576
129170,9,0,9,1.323152,103.756221
129171,1,1,2,1.320924,103.755812
129172,1,1,2,1.323223,103.756102
129173,1,1,2,1.323284,103.755994
129174,0,1,1,1.321504,103.75885
129175,5,2,7,1.323529,103.755632
129176,1,0,1,1.323412,103.755808
129177,11,24,35,1.322618,103.757128
129178,13,13,26,1.322652,103.757072
129179,0,10,10,1.322719,103.756959
129180,3,1,4,1.322787,103.756847
129181,4,9,13,1.322855,103.756735
129182,22,72,94,1.322922,103.756622
129183,3,68,71,1.32299,103.75651
129184,1,39,40,1.323057,103.756397
129185,8,34,42,1.323125,103.756285
129186,13,2,15,1.323193,103.756173
129187,71,20,91,1.32326,103.75606
129188,62,25,87,1.323294,103.756004
129189,9,4,13,1.323329,103.755951
129190,12,45,57,1.323365,103.755898
129191,6,2,8,1.323435,103.755793
129192,3,3,6,1.323506,103.755687
129193,12,0,12,1.323576,103.755582
129194,2,4,6,1.323647,103.755476
129195,512,39,551,1.32357,103.756686
129196,579,7,586,1.323851,103.75623
129197,100,20,120,1.324143,103.755732
129198,443,203,646,1.324192,103.756019
129199,237,190,427,1.32414,103.756596
129200,518,50,568,1.323627,103.757201
129201,296,156,452,1.323279,103.75785
129202,356,121,477,1.322991,103.758342
129203,562,139,701,1.322824,103.758815
129204,333,105,438,1.322627,103.758318
129205,265,56,321,1.322722,103.757865
129206,245,5,250,1.323238,103.7574
129207,134,39,173,1.323413,103.757102
129216,2,23,25,1.322431,103.756259
129217,5,7,12,1.322364,103.75635
129218,10,6,16,1.320887,103.755625
129220,14,0,14,1.322674,103.755822
129222,3,14,17,1.322665,103.755588
129223,6,0,6,1.322535,103.756092
129224,2,0,2,1.323353,103.755896
129225,4,8,12,1.322605,103.755967
129226,2,1,3,1.321738,103.757742
129227,6,3,9,1.322674,103.755842
129228,0,1,1,1.323637,103.755466
129229,10,36,46,1.322642,103.755418
129230,12,9,21,1.322685,103.755588
129231,7,1,8,1.322635,103.755361
129232,6,1,7,1.323191,103.755916
129233,0,1,1,1.322676,103.755723
129234,4,0,4,1.322881,103.755713
129235,8,21,29,1.322685,103.755588
129236,186,0,186,1.322627,103.755304
129257,1,2,3,1.322657,103.755531
129258,2,4,6,1.318553,103.758451
129259,1,4,5,1.319052,103.757979
129260,2,0,2,1.322661,103.75556
129262,24,6,30,1.318673,103.758341
129263,15,2,17,1.319169,103.75788
129264,1,0,1,1.323088,103.755849
129265,51,0,51,1.319227,103.75783
129266,0,22,22,1.318834,103.758195
129267,6,2,8,1.319286,103.757781
129268,0,1,1,1.318754,103.758268
129269,0,1,1,1.318914,103.758121
129270,49,0,49,1.319402,103.757682
129271,0,21,21,1.319461,103.757632
129272,21,0,21,1.319519,103.757583
129273,3,0,3,1.319023,103.758003
129274,3,6,9,1.319636,103.757484
129276,13,0,13,1.319753,103.757385
129278,11,8,19,1.319869,103.757286
129279,8,0,8,1.319928,103.757236
129280,1,2,3,1.319578,103.757533
129281,1,2,3,1.319976,103.757197
129282,4,3,7,1.320059,103.757289
129283,96,0,96,1.320132,103.75739
129284,130,12,142,1.320204,103.757492
129285,34,0,34,1.320277,103.757593
129286,26,0,26,1.32035,103.757695
129287,6,7,13,1.320406,103.757777
129288,0,1,1,1.318994,103.758048
129289,5,2,7,1.320421,103.757993
129290,1,2,3,1.320022,103.757238
129291,3,2,5,1.320244,103.758199
129292,4,0,4,1.320151,103.758276
129293,1,0,1,1.320428,103.757893
129294,4,1,5,1.319965,103.75843
129295,9,0,9,1.319872,103.758507
129296,25,8,33,1.31978,103.758583
129297,62,0,62,1.319687,103.75866
129298,167,8,175,1.319604,103.758727
129299,24,1,25,1.319519,103.758802
129300,25,4,29,1.319444,103.758867
129301,1,0,1,1.320058,103.758353
129302,202,12,214,1.319154,103.759117
129303,77,14,91,1.319541,103.758678
129304,7,0,7,1.319498,103.758629
129305,3,5,8,1.319413,103.75853
129306,1,0,1,1.319294,103.758997
129307,24,1,25,1.319241,103.758333
129308,1,2,3,1.320337,103.758122
129309,5,0,5,1.31907,103.758136
129310,1,1,2,1.318593,103.758415
129332,8,44,52,1.317828,103.757689
129333,7,3,10,1.318092,103.757979
129334,0,2,2,1.318994,103.758048
129335,0,2,2,1.317861,103.757721
129336,6,0,6,1.317926,103.757785
129339,6,1,7,1.31832,103.758256
129341,3,1,4,1.318412,103.758367
129342,0,3,3,1.319155,103.758235
129343,73,2,75,1.318503,103.758478
129344,23,0,23,1.318566,103.758542
129345,8,1,9,1.31818,103.758062
129346,8,1,9,1.318629,103.758606
129347,4,0,4,1.318237,103.758131
129348,12,0,12,1.318755,103.758734
129349,5,0,5,1.318294,103.7582
129350,145,2,147,1.318882,103.758861
129352,5,1,6,1.319008,103.758989
129353,5,1,6,1.318409,103.758339
129354,7,2,9,1.319134,103.759117
129355,2,7,9,1.318466,103.758409
129356,15,2,17,1.319577,103.759617
129357,1,12,13,1.318513,103.758468
129358,2,0,2,1.318137,103.758034
129359,137,3,140,1.318568,103.758524
129360,8,16,24,1.319403,103.759768
129361,13,0,13,1.318613,103.758569
129362,0,10,10,1.319347,103.759833
129363,5,1,6,1.318703,103.758661
129364,46,1,47,1.319237,103.759939
129365,1,0,1,1.319327,103.758432
129366,43,26,69,1.319161,103.760004
129367,23,2,25,1.318884,103.758843
129368,1,80,81,1.319007,103.760264
129370,4,10,14,1.319661,103.759603
129371,9,1,10,1.319064,103.759026
129372,81,6,87,1.320683,103.759034
129373,1,7,8,1.319144,103.759107
129375,0,2,2,1.319506,103.759688
129376,0,4,4,1.320933,103.758502
129377,1,0,1,1.318793,103.758752
129378,53,11,64,1.321098,103.75818
129379,8,0,8,1.31989,103.759385
129380,49,14,63,1.321163,103.757649
129381,12,0,12,1.320005,103.759285
129382,1,2,3,1.318095,103.757958
129383,15,1,16,1.320235,103.759087
129384,2,5,7,1.320349,103.758988
129385,2,0,2,1.319718,103.759533
129386,1,2,3,1.32012,103.759186
129387,1,10,11,1.320694,103.75869
129388,0,1,1,1.319776,103.759484
129389,12,2,14,1.320913,103.758502
129390,4,3,7,1.320984,103.758433
129391,24,4,28,1.321036,103.758349
129392,25,3,28,1.321098,103.75816
129393,2,1,3,1.320579,103.75879
129394,3,2,5,1.321145,103.757747
129395,1,1,2,1.320464,103.758889
129396,37,2,39,1.321082,103.757564
129397,124,5,129,1.321022,103.757478
129398,3,8,11,1.320901,103.757308
129399,4,0,4,1.32079,103.757147
129400,3,16,19,1.320722,103.757075
129401,4,0,4,1.320664,103.757013
129402,2,0,2,1.321143,103.757649
129403,0,6,6,1.320441,103.756775
129404,5,4,9,1.320364,103.756683
129405,13,3,16,1.320235,103.759087
129406,26,2,28,1.320451,103.756765
129407,17,1,18,1.32045,103.756764
129408,5,1,6,1.320161,103.756437
129409,5,22,27,1.320417,103.756724
129410,37,0,37,1.320416,103.756723
129411,80,5,85,1.320036,103.756283
129412,12,4,16,1.320384,103.756683
129413,7,2,9,1.320383,103.756682
129414,1,6,7,1.319988,103.756222
129415,17,10,27,1.320316,103.756601
129416,19,0,19,1.320315,103.7566
129417,1,1,2,1.320547,103.756889
129418,7,4,11,1.320248,103.756519
129419,19,2,21,1.320248,103.756518
129420,13,0,13,1.319875,103.756069
129421,2,25,27,1.320181,103.756437
129422,8,0,8,1.32018,103.756436
129423,1,23,24,1.31981,103.755977
129424,0,1,1,1.320808,103.758591
129425,1,7,8,1.320113,103.756354
129426,165,1,166,1.320046,103.756273
129427,15,59,74,1.320045,103.756272
129428,1,7,8,1.320008,103.756222
129429,4,0,4,1.319971,103.756171
129430,30,0,30,1.319895,103.756069
129431,2,24,26,1.31982,103.755967
129449,11,3,14,1.318954,103.758002
129450,84,5,89,1.318607,103.757515
129452,3,0,3,1.32113,103.757963
129453,2,1,3,1.318638,103.75749
129454,0,2,2,1.319951,103.756171
129455,3,0,3,1.318865,103.757893
129458,113,3,116,1.318821,103.757341
129459,8,0,8,1.318686,103.757675
129460,6,0,6,1.318882,103.757291
129461,2,3,5,1.318943,103.757242
129462,44,0,44,1.318577,103.75754
129463,3,0,3,1.318805,103.75782
129464,17,0,17,1.318556,103.757521
129465,5,1,6,1.319064,103.757142
129466,0,1,1,1.320114,103.756355
129467,0,2,2,1.318699,103.75744
129468,4,0,4,1.318493,103.757464
129469,16,0,16,1.320384,103.756683
129470,3,3,6,1.318451,103.757426
129471,0,5,5,1.319247,103.756993
129472,0,8,8,1.318409,103.757388
129473,18,0,18,1.319308,103.756943
129474,0,25,25,1.318367,103.75735
129475,0,12,12,1.319369,103.756893
129476,11,9,20,1.318631,103.757476
129477,21,0,21,1.31943,103.756844
129478,35,0,35,1.318685,103.757432
129479,18,5,23,1.319491,103.756794
129480,0,20,20,1.318794,103.757343
129481,0,4,4,1.319552,103.756744
129482,0,21,21,1.318902,103.757255
129483,1,7,8,1.31901,103.757166
129484,1,2,3,1.319004,103.757192
129485,0,8,8,1.319227,103.756989
129486,17,2,19,1.319335,103.756901
129487,2,19,21,1.319444,103.756812
129488,19,177,196,1.319542,103.756734
129489,7,0,7,1.319506,103.756545
129490,6,0,6,1.319679,103.756633
129491,3,0,3,1.319119,103.757078
129493,2,0,2,1.319125,103.757092
129494,6,1,7,1.320003,103.757007
129495,11,0,11,1.31957,103.756721
129516,25,38,63,1.317986,103.757976
129517,0,1,1,1.318535,103.757502
129518,7,19,26,1.317917,103.75804
129519,0,2,2,1.319944,103.756962
129520,21,0,21,1.317778,103.758166
129521,1,1,2,1.317594,103.758512
129522,3,2,5,1.317639,103.758293
129523,36,0,36,1.317783,103.758698
129524,1,13,14,1.3175,103.758419
129525,3,1,4,1.317877,103.758791
129526,5,0,5,1.31749,103.758429
129527,3,9,12,1.317356,103.758536
129528,4,1,5,1.318066,103.758976
129529,60,38,98,1.317211,103.758654
129530,12,0,12,1.31816,103.759069
129531,2,6,8,1.317544,103.758482
129532,5,0,5,1.318255,103.759162
129533,166,5,171,1.317587,103.758525
129534,3,0,3,1.319806,103.756798
129536,56,3,59,1.318443,103.759348
129537,5,0,5,1.317761,103.758696
129538,17,1,18,1.318538,103.759441
129539,4,5,9,1.317848,103.758782
129540,4,13,17,1.318632,103.759534
129541,1,8,9,1.317935,103.758868
129542,51,6,57,1.318022,103.758954
129543,14,6,20,1.31811,103.759039
129544,2,16,18,1.318197,103.759125
129545,0,9,9,1.318284,103.759211
129546,3,11,14,1.318371,103.759297
129547,4,14,18,1.318458,103.759382
129548,1,2,3,1.318349,103.759255
129549,12,12,24,1.318622,103.759544
129550,13,1,14,1.318683,103.759511
129551,23,3,26,1.318734,103.759469
129552,247,14,261,1.318837,103.759383
129553,5,0,5,1.318939,103.759298
129554,57,0,57,1.319042,103.759212
129555,146,8,154,1.319144,103.759127
129577,42,988,1030,1.321939,103.761613
129579,106,2473,2579,1.312476,103.771067
129580,4490,73189,77679,1.315483,103.765041
129581,715,2500,3215,1.314319,103.765158
129582,3,304,307,1.322631,103.761594
129583,20,17,37,1.323025,103.761886
129586,9,464,473,1.319389,103.76237
129587,9,777,786,1.316823,103.764091
129588,3394,67,3461,1.315011,103.764356
129605,157,8512,8669,1.302569,103.764943
129610,47,1407,1454,1.302258,103.76506
129741,51,405,456,1.292688,103.768493
129742,47,264,311,1.292701,103.768295
129743,38,452,490,1.292724,103.768312
129744,6,140,146,1.293387,103.768615
129745,18,0,18,1.292771,103.768346
129746,4,47,51,1.293397,103.768623
129747,47,453,500,1.292817,103.768381
129748,6,39,45,1.293417,103.768638
129749,56,158,214,1.292863,103.768415
129750,3,57,60,1.293437,103.768654
129751,38,242,280,1.29291,103.768449
129752,58,186,244,1.293457,103.76867
129753,19,120,139,1.292956,103.768483
129754,26,212,238,1.293048,103.768552
129755,4,0,4,1.293095,103.768586
129756,8,138,146,1.293141,103.76862
129757,4,33,37,1.293187,103.768655
129759,0,20,20,1.293234,103.768689
129764,70,280,350,1.29328,103.768723
129781,113,161,274,1.299779,103.768672
129782,2420,596,3016,1.300428,103.769551
129783,192,805,997,1.311895,103.773553
129784,298,42,340,1.31153,103.773142
129785,126,291,417,1.311237,103.772877
129786,18,3,21,1.321278,103.769189
129787,505,1797,2302,1.301799,103.769378
129788,2462,342,2804,1.300802,103.768074
129789,1635,255,1890,1.301337,103.768263
129790,2941,212,3153,1.302433,103.767337
129791,2720,1411,4131,1.302243,103.767895
129792,997,30,1027,1.301993,103.768572
129793,703,234,937,1.302526,103.768775
129794,1,371,372,1.292658,103.768276
129795,32,6,38,1.320613,103.770164
129796,32,261,293,1.301769,103.769401
129797,23,634,657,1.298738,103.769126
129798,134,56,190,1.301434,103.768999
129799,8392,447,8839,1.302377,103.767352
129800,1999,1172,3171,1.302377,103.767352
129801,581,947,1528,1.302569,103.77032
129802,671,21,692,1.302377,103.767352
129803,0,221,221,1.299509,103.837
129808,2218,550,2768,1.325175,103.76352
129809,835,324,1159,1.326603,103.76337
129810,49,64,113,1.327995,103.763281
129811,253,65,318,1.326646,103.761513
129812,147,0,147,1.327361,103.761653
129813,2338,146,2484,1.328397,103.761542
129814,831,390,1221,1.328001,103.763257
129815,117,311,428,1.325719,103.762809
129816,2643,192,2835,1.325414,103.761429
129817,1666,1186,2852,1.329805,103.761462
129835,9,125,134,1.321724,103.763912
129857,56,2082,2138,1.315889,103.767747
129858,107,4262,4369,1.317164,103.766726
129880,135,220,355,1.319023,103.768076
129881,141,424,565,1.318715,103.768582
129902,278,9144,9422,1.315063,103.764608
129903,94,47,141,1.315403,103.763253
129904,380,1163,1543,1.315501,103.762094
129905,322,2254,2576,1.311933,103.765083
129907,120,146,266,1.311086,103.765029
129908,25,122,147,1.31046,103.765848
129930,29,2330,2359,1.314602,103.76856
129955,620,1146,1766,1.307993,103.770565
129956,831,1115,1946,1.30807,103.769189
129957,1042,325,1367,1.307227,103.769412
129958,112,61,173,1.306313,103.770141
129959,234,129,363,1.306947,103.770705
130001,469,3746,4215,1.302431,103.783377
130002,454,1975,2429,1.302811,103.782692
130003,189,4149,4338,1.303824,103.782046
130004,157,91,248,1.303422,103.783292
130005,883,2502,3385,1.304316,103.782266
130012,595,6,601,1.305041,103.785545
130013,675,128,803,1.305522,103.785834
130014,322,371,693,1.305736,103.785452
130017,1760,3152,4912,1.3073,103.78285
130018,848,701,1549,1.308001,103.783166
130019,223,2934,3157,1.307839,103.783658
130020,351,143,494,1.306685,103.783514
130021,332,514,846,1.307035,103.784662
130022,377,128,505,1.307075,103.783603
130023,493,139,632,1.30744,103.783649
130025,6,131,137,1.306048,103.782044
130026,387,463,850,1.305921,103.781564
130027,225,6003,6228,1.305328,103.781833
130028,142,5558,5700,1.304381,103.781952
130029,2,5,7,1.299494,103.784124
130030,10,190,200,1.299251,103.784475
130031,4,257,261,1.303422,103.783292
130032,6,19,25,1.300053,103.783537
130033,0,18,18,1.299598,103.783627
130034,1,88,89,1.299656,103.783324
130035,9,96,105,1.299143,103.783416
130036,0,38,38,1.299975,103.782729
130037,149,86,235,1.299613,103.782656
130038,366,203,569,1.298934,103.782189
130039,136,155,291,1.298445,103.78254
131002,7,2179,2186,1.302905,103.783706
131003,16,52,68,1.303687,103.782928
131012,21,714,735,1.304244,103.785108
131014,27,79,106,1.305271,103.785398
131018,73,1026,1099,1.3073,103.78285
131019,145,3324,3469,1.307379,103.784569
131028,1058,2244,3302,1.305328,103.781833
132028,796,444,1240,1.305328,103.781833
133028,912,2054,2966,1.305328,103.781833
134028,795,1847,2642,1.306192,103.782499
138502,135,576,711,1.302233,103.787694
138507,11902,15727,27629,1.295308,103.792251
138522,17189,4902,22091,1.299779,103.788329
138523,304,255,559,1.298651,103.787522
138527,1755,440,2195,1.307096,103.772285
138528,355,295,650,1.299509,103.837
138529,43,2,45,1.299509,103.837
138530,6,0,6,1.299509,103.837
138532,3,0,3,1.318545,103.759468
138533,372,518,890,1.307946,103.771935
138537,67,351,418,1.299509,103.837
138542,4112,4428,8540,1.299192,103.78967
138543,2903,1414,4317,1.298504,103.789762
138547,3518,762,4280,1.303172,103.791902
138552,2039,593,2632,1.292116,103.791918
138562,5257,222,5479,1.292427,103.794553
138563,1392,2766,4158,1.292038,103.794895
138564,57,133,190,1.299509,103.837
138567,6739,1915,8654,1.30179,103.792519
138572,198,414,612,1.313201,103.774344
138577,4995,1983,6978,1.299736,103.789426
138582,173,5026,5199,1.292244,103.794564
138587,3946,18162,22108,1.299509,103.837
138588,11153,1427,12580,1.306631,103.79106
138589,10431,2211,12642,1.306231,103.791196
138592,82,200,282,1.299509,103.837
138593,170,0,170,1.306755,103.77339
138594,27,0,27,1.307338,103.772603
138595,868,140,1008,1.306519,103.773669
138596,18,27,45,1.299509,103.837
138597,790,492,1282,1.306317,103.773775
138598,145,59,204,1.299509,103.837
138599,47,0,47,1.305983,103.773482
138600,898,306,1204,1.305495,103.773811
138601,673,4,677,1.305202,103.773905
138602,5694,1174,6868,1.303884,103.774449
138607,911,568,1479,1.304601,103.772313
138608,350,59,409,1.307185,103.773315
138609,185,361,546,1.307096,103.772285
138610,28,24,52,1.299509,103.837
138611,14,141,155,1.299509,103.837
138612,44,546,590,1.308415,103.772995
138613,5,16,21,1.307944,103.773268
138614,402,231,633,1.308244,103.773407
138615,372,171,543,1.307707,103.773246
138616,14,31,45,1.299509,103.837
138617,7770,21418,29188,1.306842,103.78844
138622,857,376,1233,1.301391,103.792669
138623,2502,626,3128,1.301605,103.792766
138627,500,1558,2058,1.299509,103.837
138628,9984,809,10793,1.298109,103.789927
138632,3454,16566,20020,1.299622,103.787656
138633,2156,13929,16085,1.299036,103.78756
138634,5874,4601,10475,1.298775,103.788557
138635,539,1374,1913,1.29894,103.788623
138636,44,4074,4118,1.299129,103.788701
138637,12387,1998,14385,1.305257,103.78842
138638,6986,1782,8768,1.305281,103.788428
138639,801,6466,7267,1.30528,103.788392
138640,45,1737,1782,1.3055,103.787775
138641,43,1535,1578,1.305855,103.78785
138642,4269,1666,5935,1.301746,103.789492
138643,2150,679,2829,1.301881,103.789409
138647,371,137,508,1.299757,103.787469
138648,1554,199,1753,1.301988,103.793372
138649,280,394,674,1.301044,103.790024
138654,1,4,5,1.290172,103.794974
138659,14,286,300,1.301053,103.786934
138662,2025,3061,5086,1.299509,103.837
138664,704,397,1101,1.303709,103.789637
138665,2801,1353,4154,1.302142,103.793012
138666,155,3165,3320,1.298748,103.787034
138667,2550,1057,3607,1.304481,103.791436
138668,1348,4919,6267,1.303943,103.791753
138669,637,1484,2121,1.304609,103.79233
138670,585,116,701,1.303988,103.791404
138671,1306,1621,2927,1.303452,103.792414
138672,803,639,1442,1.302811,103.792489
138673,871,492,1363,1.303087,103.792926
138674,2,238,240,1.30868,103.787007
138675,2409,4498,6907,1.305259,103.790705
138676,5831,1992,7823,1.299737,103.786501
138677,294,3681,3975,1.311318,103.778798
138678,1725,535,2260,1.303614,103.784207
138679,2526,407,2933,1.304441,103.783452
138680,2478,575,3053,1.304441,103.784296
138681,41,19,60,1.30545,103.783844
138682,516,347,863,1.299543,103.780838
138683,3152,922,4074,1.301098,103.779583
138684,1919,4825,6744,1.305793,103.784656
138685,2668,2243,4911,1.305406,103.783153
138686,2627,782,3409,1.306132,103.78337
138687,1607,2901,4508,1.305793,103.784656
138688,53,27,80,1.294283,103.797246
138689,98,4,102,1.295391,103.797115
138690,135,29,164,1.295529,103.796326
138691,102,66,168,1.295925,103.796308
138692,46,7,53,1.296234,103.796498
138693,145,8,153,1.296434,103.796147
138694,2351,454,2805,1.296478,103.794087
138695,37,12,49,1.296228,103.795762
138696,128,288,416,1.297006,103.793808
138697,202,8,210,1.296651,103.794501
138698,103,12,115,1.296596,103.795158
138699,38,6,44,1.297115,103.794363
138700,234,15,249,1.297073,103.79519
138701,55,353,408,1.297589,103.794131
138702,124,41,165,1.297646,103.795179
138703,44,9,53,1.297389,103.794785
138704,85,11,96,1.29792,103.795417
138705,567,68,635,1.297924,103.79456
138706,60,56,116,1.298186,103.794911
138707,66,28,94,1.294807,103.797192
138751,129,1,130,1.299985,103.7941
138752,41,35,76,1.299952,103.793894
138753,126,9,135,1.300223,103.79399
138754,1,0,1,1.317547,103.758465
138755,30,4,34,1.300419,103.794141
138756,10,2,12,1.300512,103.793782
138757,7,15,22,1.300429,103.794151
138758,45,0,45,1.300667,103.794452
138759,11,0,11,1.300314,103.794412
138760,40,0,40,1.300487,103.794674
138761,24,2,26,1.300294,103.794412
138762,39,0,39,1.300236,103.794479
138763,67,10,77,1.299985,103.79412
138764,10,0,10,1.299985,103.794276
138809,189,6,195,1.293911,103.7972
138810,153,0,153,1.29385,103.797259
138811,11,6,17,1.293598,103.798193
138812,134,0,134,1.2936,103.798195
138813,26,0,26,1.29334,103.797998
138814,3,0,3,1.299509,103.837
138815,1,0,1,1.300183,103.793715
138816,39,0,39,1.293558,103.797457
138817,5,5,10,1.293863,103.796862
138818,47,9,56,1.294084,103.796973
138820,2,0,2,1.317689,103.758605
138821,18,1,19,1.293227,103.797457
138822,64,0,64,1.293183,103.797365
138823,10,0,10,1.293087,103.797694
138824,1,38,39,1.293024,103.797978
138825,29,5,34,1.292954,103.798062
138826,8,23,31,1.293307,103.798224
138827,3,12,15,1.293559,103.797472
138828,2,125,127,1.293479,103.798324
138829,0,6,6,1.293474,103.798459
138830,0,13,13,1.293823,103.798406
138831,49,0,49,1.294131,103.798054
138832,30,7,37,1.294092,103.798229
138833,37,6,43,1.294267,103.797576
138834,12,0,12,1.294336,103.797916
138835,64,0,64,1.294293,103.797256
138836,7,13,20,1.294432,103.79754
138837,0,51,51,1.293868,103.798342
138838,1,4,5,1.292948,103.797647
138839,331,15,346,1.293889,103.796456
138882,21,0,21,1.29839,103.793081
138883,2,1,3,1.293116,103.797572
138884,76,3,79,1.298597,103.792977
138885,1,0,1,1.293544,103.79756
138886,1,1,2,1.293979,103.797073
138887,1,149,150,1.299682,103.79322
138888,12,38,50,1.299399,103.793121
138889,2,0,2,1.299001,103.79297
138890,18,19,37,1.299538,103.793386
138891,40,0,40,1.299375,103.793871
138892,139,31,170,1.299142,103.793711
138893,5,0,5,1.298284,103.793695
138894,70,58,128,1.298745,103.793677
138895,25,128,153,1.298237,103.793407
138896,2,37,39,1.298457,103.793608
138941,21,12,33,1.294335,103.796547
138942,2,6,8,1.294418,103.796964
138943,72,26,98,1.294711,103.796395
138944,61,27,88,1.294892,103.796113
138945,14,10,24,1.295234,103.796162
138946,281,44,325,1.295452,103.796064
138947,3,81,84,1.29617,103.795509
138991,20,30,50,1.2874,103.797527
138992,0,12,12,1.287384,103.797498
138993,1,33,34,1.287334,103.797666
138994,27,22,49,1.287399,103.797708
138995,19,0,19,1.287226,103.797996
138996,12,15,27,1.287391,103.797986
138997,0,23,23,1.287105,103.797813
138998,1,2,3,1.298434,103.792902
139000,4,0,4,1.287395,103.797962
139001,7,22,29,1.287514,103.798394
139002,39,38,77,1.287491,103.798218
139003,281,0,281,1.287446,103.798154
139006,3,0,3,1.287393,103.797913
139007,10,22,32,1.287879,103.798306
139008,11,8,19,1.287848,103.798311
139009,103,240,343,1.288049,103.798279
139010,100,13,113,1.288025,103.798288
139100,129,5,134,1.306599,103.775345
139101,56,7,63,1.306719,103.774988
139102,56,4,60,1.306828,103.774801
139103,10,1,11,1.306999,103.774386
139104,55,4,59,1.306963,103.774343
139105,65,37,102,1.306936,103.774313
139150,6,159,165,1.304076,103.776528
139151,102,6,108,1.304095,103.776427
139152,4,3,7,1.304134,103.776286
139153,9,23,32,1.304173,103.776105
139154,6,1,7,1.30425,103.775803
139155,137,15,152,1.30425,103.775783
139156,25,8,33,1.304448,103.775456
139157,2,276,278,1.304505,103.775354
139158,5,70,75,1.304691,103.775187
139159,5,809,814,1.304867,103.77499
139160,2,51,53,1.304877,103.775
139161,32,4,36,1.304965,103.774934
139162,28,4,32,1.304887,103.77499
139163,1,4,5,1.305206,103.774915
139164,9,176,185,1.305279,103.774974
139165,66,3,69,1.305562,103.775192
139166,1,5,6,1.30574,103.77538
139167,7,14,21,1.30575,103.77537
139212,253,395,648,1.305308,103.787689
139213,124,892,1016,1.304794,103.787563
139214,479,370,849,1.30434,103.787038
139215,248,254,502,1.304104,103.786808
139216,747,621,1368,1.304009,103.786277
139217,49,70,119,1.30411,103.786286
139218,2,108,110,1.304609,103.787008
139219,2,26,28,1.304898,103.787407
139220,189,199,388,1.305308,103.787669
139221,2,183,185,1.305308,103.787669
139222,1,88,89,1.305894,103.787457
139223,2,2,4,1.306059,103.786727
139224,2,0,2,1.299385,103.793861
139225,0,1,1,1.298969,103.792803
139226,0,8,8,1.306787,103.787122
139227,0,53,53,1.306816,103.786884
139228,89,3,92,1.306949,103.786947
139229,6,0,6,1.306327,103.786102
139230,7,322,329,1.306593,103.785686
139231,4,2234,2238,1.307001,103.785732
139232,1,44,45,1.306908,103.786095
139233,3,11,14,1.307258,103.786639
139234,339,24,363,1.307249,103.786962
139235,4,46,50,1.306882,103.787259
139236,17,1529,1546,1.307151,103.78756
139237,84,700,784,1.306946,103.788902
139238,50,1332,1382,1.307,103.786272
139239,68,4627,4695,1.306536,103.787336
139240,8,533,541,1.307064,103.786469
139241,71,1017,1088,1.305894,103.787477
139242,1,2,3,1.287524,103.798236
139244,0,4,4,1.305836,103.786675
139245,0,37,37,1.306042,103.786862
139246,2,24,26,1.305168,103.787125
139247,0,4,4,1.304847,103.786896
139248,269,278,547,1.304577,103.786088
139249,720,262,982,1.304599,103.785785
139250,5,1242,1247,1.306253,103.787388
139251,3,349,352,1.305972,103.787721
139295,6,53,59,1.291932,103.796698
139296,73,98,171,1.292793,103.789182
139298,131,44,175,1.293372,103.796062
139299,17025,2475,19500,1.296902,103.7921
139300,3,68,71,1.289565,103.794344
139301,25,0,25,1.300743,103.78803
139302,20,0,20,1.293548,103.79384
139303,11,60,71,1.293516,103.793845
139305,35,191,226,1.290836,103.792813
139306,1,224,225,1.293516,103.793875
139307,7,283,290,1.300323,103.789766
139308,8,58,66,1.293954,103.795713
139310,6,147,153,1.300509,103.789261
139311,1753,614,2367,1.294318,103.795858
139345,2600,3789,6389,1.307238,103.789937
139346,11,442,453,1.300304,103.785599
139347,115,10815,10930,1.306218,103.790852
139349,54,2525,2579,1.305462,103.789786
139350,1006,30765,31771,1.306655,103.790731
139391,28,51,79,1.301499,103.787837
139392,5,12,17,1.301631,103.787795
139393,3,41,44,1.301742,103.787764
139394,22,244,266,1.30189,103.787711
139395,3,0,3,1.306102,103.786097
139396,3,2,5,1.302217,103.787627
139397,8,24,32,1.302203,103.787649
139398,6,288,294,1.301504,103.787858
139399,7,1508,1515,1.300972,103.788452
139400,3,345,348,1.300956,103.788806
139401,0,209,209,1.301229,103.789128
139402,2,0,2,1.306505,103.786583
139404,19,53,72,1.301802,103.788307
139405,3,507,510,1.30175,103.789015
139406,6,78,84,1.301965,103.788817
139407,1031,10,1041,1.301459,103.788383
139408,468,0,468,1.302233,103.787694
139451,10,502,512,1.307261,103.776695
139452,4,0,4,1.307273,103.776863
139453,99,53,152,1.306975,103.776693
139454,53,41,94,1.307125,103.776524
139455,52,10,62,1.307018,103.775898
139456,18,6,24,1.306609,103.775355
139457,21,6,27,1.306747,103.775382
139458,25,0,25,1.306703,103.775566
139459,194,3,197,1.30576,103.77538
139460,6,0,6,1.305956,103.775357
139461,2,4,6,1.306209,103.77518
139462,9,5,14,1.305661,103.775481
139463,67,0,67,1.30543,103.775648
139465,0,1,1,1.306439,103.786001
139466,10,11,21,1.305118,103.776109
139467,6,2,8,1.305084,103.776211
139468,33,0,33,1.304987,103.776363
139469,44,1,45,1.304944,103.776543
139470,69,1,70,1.304936,103.776708
139471,2,1,3,1.302043,103.787666
139472,16,1,17,1.30473,103.776869
139473,17,1,18,1.304664,103.776874
139474,22,3,25,1.304184,103.776793
139475,36,315,351,1.304083,103.77678
139521,1,5,6,1.29054,103.795032
139522,0,16,16,1.29054,103.795032
139524,1,201,202,1.29054,103.795032
139525,45,5,50,1.290779,103.797962
139526,21,0,21,1.290749,103.798405
139527,58,7,65,1.29008,103.798227
139528,26,47,73,1.290287,103.797864
139529,54,9,63,1.290256,103.797315
139530,31,6,37,1.29033,103.796645
139531,93,32,125,1.29013,103.796296
139532,88,32,120,1.290031,103.795936
139533,11,47,58,1.289759,103.798465
139577,39,175,214,1.307413,103.776451
139578,28,108,136,1.30759,103.776151
139579,30,5,35,1.30745,103.776218
139580,1,13,14,1.307573,103.775941
139581,0,30,30,1.307705,103.775851
139582,40,31,71,1.307844,103.775598
139583,49,5,54,1.307729,103.775697
139585,3,16,19,1.307919,103.775443
139586,276,17,293,1.308012,103.775268
139587,8,0,8,1.307968,103.775049
139588,15,1,16,1.29054,103.795032
139589,41,10,51,1.308108,103.775016
139590,21,44,65,1.308207,103.774729
139591,12,42,54,1.308344,103.774404
139592,15,1154,1169,1.308426,103.774198
139593,3,3,6,1.308143,103.774583
139594,3,7,10,1.3082,103.774445
139595,8,1,9,1.307436,103.774241
139596,26,44,70,1.307503,103.773955
139597,14,24,38,1.308328,103.774077
139598,108,16,124,1.308367,103.773989
139599,25,2774,2799,1.308202,103.772079
139644,3452,2100,5552,1.305583,103.779139
139645,8,452,460,1.300158,103.784235
139646,13,0,13,1.300158,103.784235
139647,46,1180,1226,1.300595,103.784407
139648,443,4,447,1.300744,103.785809
139649,242,2006,2248,1.301925,103.78446
139650,1610,1506,3116,1.302189,103.780078
139651,1244,838,2082,1.309126,103.78126
139652,198,42,240,1.307951,103.776885
139653,36,212,248,1.308168,103.776414
139654,18870,2567,21437,1.303254,103.776985
139655,113,199,312,1.306799,103.778964
139656,276,179,455,1.302136,103.781278
139657,380,464,844,1.30915,103.773605
139658,342,421,763,1.309434,103.774739
139659,101,1360,1461,1.303873,103.779372
139660,970,1204,2174,1.307795,103.778036
139745,1274,5364,6638,1.303305,103.785253
139790,247,1934,2181,1.306606,103.782402
139835,40,9,49,1.306749,103.776003
139836,29,1,30,1.306446,103.776047
139837,65,1,66,1.306524,103.776165
139838,20,19,39,1.306467,103.776277
139839,106,5,111,1.30637,103.776409
139840,228,0,228,1.306252,103.77626
139841,124,2,126,1.306058,103.776878
139842,14,1,15,1.306202,103.77692
139843,38,2,40,1.306208,103.77715
139844,22,1,23,1.306069,103.777016
139845,1,0,1,1.305111,103.775935
139935,4960,501,5461,1.294133,103.788893
139936,43,15,58,1.294002,103.790525
139937,545,8,553,1.294302,103.790387
139938,465,368,833,1.293227,103.791689
139939,313,1250,1563,1.29531,103.787434
139940,52,330,382,1.295696,103.787542
139941,1590,736,2326,1.296576,103.78794
139942,490,1122,1612,1.29578,103.789328
139944,1792,4708,6500,1.296341,103.791257
139945,252,1132,1384,1.297031,103.788114
139946,21,198,219,1.29774,103.788661
139947,447,302,749,1.29315,103.787956
139948,391,901,1292,1.293939,103.788164
139949,584,684,1268,1.294237,103.787106
139950,911,361,1272,1.295616,103.786963
139951,1681,2214,3895,1.296721,103.787216
139952,150,1060,1210,1.297376,103.786545
139953,27,8,35,1.297047,103.787336
139954,82,0,82,1.297595,103.787455
139955,1638,4475,6113,1.298131,103.788034
139956,27,288,315,1.293617,103.788614
139957,568,4348,4916,1.296902,103.787413
139958,37,0,37,1.292925,103.790602
139959,6009,331,6340,1.296508,103.790252
139960,218,855,1073,1.294688,103.788174
139961,415,1570,1985,1.296167,103.787009
139962,71,52,123,1.294947,103.787603
139963,1047,1363,2410,1.296446,103.790593
139964,1814,1029,2843,1.295442,103.78985
139965,567,774,1341,1.296172,103.788822
139966,33,84,117,1.299509,103.837
139967,12,8,20,1.298407,103.785899
140000,7,301,308,1.299509,103.837
140001,15,540,555,1.299717,103.79781
140002,1,558,559,1.299437,103.797816
140003,6,0,6,1.299585,103.79804
140007,736,1957,2693,1.30641,103.794644
140019,458,832,1290,1.292315,103.80019
140020,426,330,756,1.292671,103.799948
140021,821,279,1100,1.293302,103.799842
140022,928,59,987,1.293506,103.799614
140023,598,260,858,1.294276,103.799585
140024,79,646,725,1.297628,103.799574
140025,98,824,922,1.297856,103.799579
140027,40,2580,2620,1.295339,103.806026
140028,116,185,301,1.298536,103.799645
140030,160,1346,1506,1.299171,103.799255
140031,0,244,244,1.299509,103.837
140032,0,21,21,1.299509,103.837
140033,3,51,54,1.299509,103.837
140037,169,68,237,1.29758,103.797904
140038,22,1,23,1.297634,103.798576
140039,1,1,2,1.301495,103.788728
140040,0,13,13,1.298784,103.80406
140041,9,947,956,1.298622,103.801851
140042,20,911,931,1.298304,103.802201
140043,1,2,3,1.304836,103.776819
140045,184,1297,1481,1.297416,103.802922
140046,43,920,963,1.298401,103.801532
140047,30,76,106,1.298217,103.80191
140048,1021,2364,3385,1.293723,103.807594
140049,1009,915,1924,1.294098,103.80807
140050,689,817,1506,1.293701,103.808661
140051,1417,268,1685,1.293336,103.80892
140052,47,972,1019,1.2965,103.803417
140053,2,19,21,1.29425,103.807794
140055,2119,238,2357,1.293208,103.809582
140056,764,1156,1920,1.293331,103.809726
140057,48,0,48,1.297921,103.796513
140058,51,0,51,1.297725,103.796962
140059,43,11,54,1.297964,103.796962
140060,27,19,46,1.298217,103.796957
140061,19,63,82,1.298387,103.796516
140062,207,91,298,1.298468,103.796977
140063,121,123,244,1.298767,103.796986
140064,170,1911,2081,1.299273,103.797167
140065,72,15,87,1.299563,103.796661
140066,172,173,345,1.299072,103.796497
140067,8,111,119,1.298696,103.79622
140068,20,1,21,1.298977,103.796039
140069,20,34,54,1.299214,103.796209
140070,63,63,126,1.299392,103.7962
140071,16,577,593,1.299779,103.796868
140072,41,1395,1436,1.29996,103.796874
140073,3,2,5,1.299963,103.796517
140074,0,26,26,1.300941,103.796036
140075,0,29,29,1.301165,103.795907
140076,1,1,2,1.297981,103.80506
140077,0,160,160,1.301406,103.795776
140078,0,132,132,1.301655,103.795644
140079,0,1,1,1.30608,103.77717
140080,0,19,19,1.301888,103.795505
140081,1851,240,2091,1.303799,103.800275
140082,1318,354,1672,1.304284,103.800474
140083,1200,159,1359,1.304731,103.800431
140084,168,73,241,1.303535,103.799329
140085,278,35,313,1.304038,103.799148
140086,424,89,513,1.304357,103.799224
140087,154,41,195,1.304618,103.799157
140088,182,1611,1793,1.304831,103.799095
140089,476,2798,3274,1.305436,103.799309
140090,27,2,29,1.305393,103.799547
140091,210,553,763,1.305869,103.799717
140092,223,2381,2604,1.305718,103.800083
140093,13,0,13,1.305252,103.800017
140094,314,2110,2424,1.305563,103.800654
140095,58,1875,1933,1.305397,103.800939
140096,248,2819,3067,1.306269,103.801142
140097,125,4953,5078,1.306189,103.801396
140098,495,1176,1671,1.306738,103.801367
140099,324,1538,1862,1.307453,103.800999
140100,55,1,56,1.307746,103.801113
140101,25,1,26,1.308148,103.800611
140102,549,2785,3334,1.307829,103.800507
140103,24,1,25,1.308342,103.800064
140104,222,1172,1394,1.30798,103.799965
140106,28,0,28,1.308207,103.799442
140107,112,1,113,1.307831,103.799195
140108,380,258,638,1.307569,103.799033
140109,257,1,258,1.307293,103.798986
140110,381,187,568,1.306831,103.79862
140111,464,93,557,1.30635,103.798369
140112,6,0,6,1.306692,103.798097
140113,100,82,182,1.306853,103.797888
140116,91,81,172,1.307011,103.79996
140117,86,162,248,1.306539,103.800251
140118,20,362,382,1.306771,103.800676
140119,10,316,326,1.299509,103.837
140120,2,1509,1511,1.306523,103.801003
140121,0,222,222,1.299509,103.837
140122,2,0,2,1.300784,103.795499
140123,1,1021,1022,1.306552,103.800949
140124,0,460,460,1.306523,103.800917
140125,0,168,168,1.306523,103.801003
140129,746,331,1077,1.293163,103.814305
140130,607,208,815,1.292795,103.814736
140131,308,957,1265,1.292385,103.815141
140132,223,367,590,1.292262,103.814911
140133,122,2938,3060,1.292363,103.814567
140143,343,165,508,1.293484,103.804527
140145,186,228,414,1.293784,103.804834
140146,535,537,1072,1.293924,103.804405
140147,163,274,437,1.294319,103.80481
140148,444,65,509,1.294491,103.80431
140149,632,181,813,1.29479,103.804278
140150,66,593,659,1.295304,103.803636
140151,113,1714,1827,1.294551,103.803054
140152,435,1867,2302,1.293833,103.802558
140153,273,124,397,1.293822,103.803042
140154,539,1192,1731,1.293603,103.803602
140155,249,167,416,1.293149,103.804692
140156,107,2177,2284,1.293184,103.804373
140157,540,890,1430,1.293115,103.803661
140158,405,1408,1813,1.292684,103.802744
140159,48,542,590,1.293241,103.802434
140160,1252,362,1614,1.292218,103.80398
140161,1359,2730,4089,1.291646,103.803602
140162,220,2652,2872,1.292172,103.802799
140163,270,224,494,1.291856,103.802527
140164,288,1144,1432,1.291498,103.802492
140165,493,7916,8409,1.290733,103.801876
140166,394,407,801,1.290715,103.802278
140167,78,3035,3113,1.289995,103.802582
140168,344,1608,1952,1.288705,103.803632
140169,902,703,1605,1.290402,103.802955
140170,930,1946,2876,1.290878,103.802963
140171,317,1856,2173,1.290675,103.803739
140172,0,115,115,1.299509,103.837
140173,0,39,39,1.291923,103.807383
140174,1,94,95,1.291294,103.804724
140175,8,258,266,1.299509,103.837
140181,361,330,691,1.294549,103.805379
140182,178,5464,5642,1.295108,103.805067
140183,67,230,297,1.295832,103.804744
140184,779,235,1014,1.295563,103.804203
140461,20,402,422,1.299525,103.798424
140462,189,428,617,1.300024,103.798193
140463,27,2257,2284,1.299972,103.797654
141001,4,0,4,1.299438,103.797708
141002,6,293,299,1.299438,103.797708
141003,1,0,1,1.30152,103.79513
141007,208,111,319,1.306805,103.795135
141019,11,263,274,1.293009,103.800721
141023,505,126,631,1.294001,103.799985
141026,86,653,739,1.298084,103.799593
141029,176,1973,2149,1.298853,103.799379
141031,127,1227,1354,1.299433,103.799164
141032,1,0,1,1.299438,103.797708
141035,56,93,149,1.296965,103.798019
141036,13,0,13,1.297203,103.797987
141037,129,6744,6873,1.297694,103.797645
141038,0,123,123,1.299509,103.837
141039,4,46,50,1.299509,103.837
141040,1,0,1,1.299509,103.837
141041,101,546,647,1.298171,103.798419
141042,102,294,396,1.298404,103.798404
141043,35,1146,1181,1.298081,103.802513
141044,13,524,537,1.297805,103.802552
141045,74,107,181,1.299136,103.798399
141047,45,4897,4942,1.300787,103.798071
141048,231,4331,4562,1.297924,103.80158
141049,242,1012,1254,1.297469,103.802163
141050,30,426,456,1.29707,103.803755
141051,98,234,332,1.301545,103.795934
141052,1091,285,1376,1.293261,103.808075
141053,99,57,156,1.296642,103.803565
141054,1,8,9,1.29425,103.807794
141055,236,42,278,1.297072,103.796956
141056,59,29,88,1.297474,103.79697
141057,13,92,105,1.296301,103.804394
141058,5,727,732,1.296148,103.804508
141060,452,298,750,1.292865,103.811903
141061,2,125,127,1.293557,103.811334
141062,12,17,29,1.294607,103.810683
141064,3,18,21,1.299116,103.796819
141078,3,468,471,1.299509,103.837
141079,10,235,245,1.299509,103.837
141080,584,215,799,1.294524,103.809555
141081,558,341,899,1.294569,103.809252
141082,793,480,1273,1.29449,103.808801
141083,367,1254,1621,1.294654,103.80827
141085,404,535,939,1.295379,103.810556
141086,2116,835,2951,1.295379,103.810556
141087,1268,972,2240,1.295379,103.810556
141088,377,3449,3826,1.302208,103.797717
141089,984,661,1645,1.302139,103.797267
141090,831,3849,4680,1.302139,103.797267
141091,15,1356,1371,1.306679,103.799749
141092,986,70,1056,1.295379,103.810556
141093,1,0,1,1.299509,103.837
141094,6,49,55,1.299509,103.837
141095,6,100,106,1.299509,103.837
141096,1,48,49,1.299509,103.837
141103,1,0,1,1.305211,103.800459
141107,2,5,7,1.307931,103.799523
141110,4,542,546,1.307696,103.800145
141129,13,161,174,1.292719,103.814334
141148,16,654,670,1.294461,103.80344
141150,511,228,739,1.294867,103.803471
141151,4,616,620,1.294861,103.80292
141153,26,970,996,1.294215,103.802889
141156,6,193,199,1.292601,103.804149
141157,9,151,160,1.293422,103.803645
141160,6,288,294,1.292299,103.803271
141161,17,727,744,1.292203,103.803449
141162,11,3401,3412,1.292299,103.803271
141163,5,663,668,1.291273,103.802886
141164,10,2230,2240,1.291654,103.802189
141168,745,275,1020,1.290402,103.802955
141169,3,47,50,1.290186,103.80333
141171,4,321,325,1.289884,103.80366
141182,8,40,48,1.295388,103.80455
142006,0,112,112,1.299702,103.803267
142007,4,293,297,1.306271,103.795041
142027,95,405,500,1.298312,103.799612
142031,2,804,806,1.299509,103.837
142032,41,2081,2122,1.299675,103.799093
142033,143,964,1107,1.296509,103.798421
142034,236,0,236,1.296768,103.798138
142035,57,282,339,1.296979,103.798707
142036,3,1,4,1.299509,103.837
142037,75,1740,1815,1.298259,103.797971
142038,1,31,32,1.299509,103.837
142042,8,243,251,1.299509,103.837
142043,103,169,272,1.298656,103.798395
142044,39,43,82,1.298898,103.798395
142046,20,55,75,1.298954,103.797866
142048,26,102,128,1.300766,103.797566
142049,49,1691,1740,1.300361,103.797285
142050,609,1781,2390,1.300842,103.797152
142052,74,512,586,1.300842,103.797152
142053,806,394,1200,1.300842,103.797152
142054,40,908,948,1.300842,103.797152
142055,10,3,13,1.296528,103.804116
142056,6,154,160,1.29668,103.8042
142057,1287,9403,10690,1.292802,103.810934
142058,310,1918,2228,1.293174,103.810629
142059,874,286,1160,1.293104,103.811018
142060,49,2350,2399,1.292762,103.811718
142061,752,386,1138,1.29356,103.811617
142062,798,228,1026,1.294607,103.810683
142078,1,97,98,1.299509,103.837
142083,69,618,687,1.304824,103.801135
142084,4,93,97,1.30365,103.799725
142085,202,289,491,1.303812,103.799249
142086,42,54,96,1.299509,103.837
142088,1947,299,2246,1.295379,103.810556
142089,839,326,1165,1.295379,103.810556
142090,880,267,1147,1.295379,103.810556
142091,1172,249,1421,1.302139,103.797267
142093,792,296,1088,1.295379,103.810556
142094,0,8,8,1.299509,103.837
142095,1,7,8,1.299509,103.837
142096,4,61,65,1.299509,103.837
142160,12,1243,1255,1.292299,103.803271
143030,0,7,7,1.299509,103.837
143037,2,56,58,1.299509,103.837
143039,96,1757,1853,1.297621,103.798852
143040,191,57,248,1.297943,103.798438
143041,0,17,17,1.299509,103.837
143042,3,131,134,1.299509,103.837
143043,1,0,1,1.307696,103.800145
143046,39,3124,3163,1.298419,103.797588
143048,8,125,133,1.293612,103.808326
143050,10,66,76,1.301258,103.797421
143052,12,379,391,1.301903,103.796886
143053,32,3300,3332,1.293339,103.807639
143055,32,459,491,1.293638,103.809731
143056,29,5160,5189,1.292877,103.809916
143057,18,164,182,1.292802,103.810896
143060,1,295,296,1.292911,103.811629
143061,1492,288,1780,1.29356,103.811617
143062,879,132,1011,1.294607,103.810683
143078,5,1409,1414,1.299509,103.837
143083,17,135,152,1.304929,103.801059
143085,21,111,132,1.295379,103.810556
143088,51,40,91,1.295379,103.810556
143089,329,29,358,1.295379,103.810556
143091,43,1365,1408,1.302139,103.797267
143096,0,10,10,1.299509,103.837
144037,2,28,30,1.299509,103.837
144053,6,956,962,1.299509,103.837
144055,91,3567,3658,1.29707,103.797228
144061,659,231,890,1.29356,103.811617
144089,30,1889,1919,1.295379,103.810556
144091,1269,255,1524,1.295379,103.810556
145053,0,1,1,1.299509,103.837
146053,0,2,2,1.295077,103.805948
148795,10,262,272,1.293043,103.813285
148800,652,11,663,1.293467,103.812874
148801,2,72,74,1.30263,103.796481
148802,1,5,6,1.302772,103.79596
148803,0,1,1,1.299509,103.837
148804,0,3,3,1.299509,103.837
148805,0,29,29,1.30296,103.795533
148806,0,1,1,1.302791,103.796195
148807,0,1,1,1.303342,103.794363
148808,1,2,3,1.302811,103.796195
148810,3,164,167,1.306327,103.793133
148811,0,4,4,1.304917,103.793498
148812,384,1728,2112,1.299825,103.799953
148813,23,0,23,1.300961,103.798122
148852,1,5,6,1.303153,103.796188
148853,0,20,20,1.305119,103.794186
148854,1,5,6,1.305516,103.793759
148855,0,12,12,1.305913,103.793332
148860,1,108,109,1.305907,103.793512
148942,25,6,31,1.291961,103.807508
148943,7,787,794,1.292092,103.807391
148944,4,20,24,1.291988,103.807281
148945,3,27,30,1.2921,103.806833
148946,3,21,24,1.292126,103.80669
148947,72,236,308,1.293652,103.805931
148948,383,2,385,1.296963,103.802762
148949,116,0,116,1.296241,103.802265
148951,1569,916,2485,1.296864,103.800775
148952,187,2982,3169,1.298054,103.800938
148953,25,634,659,1.291193,103.804021
148954,2284,662,2946,1.293,103.805671
148955,1834,2883,4717,1.293043,103.80624
148956,478,537,1015,1.293444,103.806318
148957,1717,644,2361,1.292357,103.806475
148958,529,1870,2399,1.298484,103.800959
148959,439,617,1056,1.296577,103.801011
148994,0,99,99,1.291924,103.806977
148995,11,5,16,1.291731,103.806631
148996,0,11,11,1.291711,103.806631
148997,4,1,5,1.291697,103.806537
148998,0,1,1,1.303332,103.794353
148999,5,0,5,1.291616,103.806442
149000,2,0,2,1.299509,103.837
149001,0,1,1,1.291677,103.806537
149002,5,0,5,1.291254,103.806042
149003,2,0,2,1.291466,103.80629
149004,0,1,1,1.291453,103.806252
149005,0,1,1,1.29111,103.805922
149006,1,0,1,1.291128,103.805871
149007,2,3,5,1.291019,103.805717
149008,15,5,20,1.290895,103.805666
149009,31,3,34,1.290937,103.8056
149010,2,0,2,1.29129,103.806061
149051,720,14921,15641,1.295704,103.800798
149053,1017,9783,10800,1.287777,103.803474
149055,16,5,21,1.295113,103.79956
149056,2,3,5,1.295113,103.79956
149058,72,3609,3681,1.29708,103.799758
149059,182,546,728,1.302031,103.800263
149060,31,2478,2509,1.289291,103.803
149061,44,1845,1889,1.291185,103.801035
149062,13,1228,1241,1.291445,103.800869
149063,14,184,198,1.297184,103.799774
149065,7,915,922,1.303109,103.800981
149066,203,1095,1298,1.304187,103.80208
149067,24,331,355,1.306901,103.80242
149072,370,36,406,1.304218,103.802799
149149,1,11,12,1.29152,103.806942
149150,6,0,6,1.291322,103.806681
149152,10,0,10,1.291168,103.806644
149153,19,11,30,1.291522,103.80712
149155,0,8,8,1.291484,103.80705
149156,22,0,22,1.290831,103.806291
149157,1,2,3,1.303352,103.794353
149158,21,0,21,1.290758,103.80616
149159,7,0,7,1.291272,103.806749
149160,104,38,142,1.290675,103.805988
149161,1,0,1,1.290974,103.805772
149162,7,11,18,1.29058,103.80581
149163,6,1,7,1.290828,103.806458
149164,0,2,2,1.290788,103.805433
149165,0,8,8,1.290694,103.80625
149166,9,6,15,1.290622,103.806139
149167,51,6,57,1.290356,103.806082
149169,24,0,24,1.290305,103.806055
149170,42,1,43,1.290439,103.805966
149171,12,11,23,1.29041,103.805725
149214,3,79,82,1.292756,103.799169
149216,0,80,80,1.292756,103.799169
149253,1099,557,1656,1.291781,103.80164
149254,164,338,502,1.294068,103.802318
149295,574,250,824,1.300681,103.801857
149296,12,5,17,1.299029,103.804808
149297,287,128,415,1.298637,103.805356
149298,2,258,260,1.295469,103.811437
149299,0,62,62,1.295631,103.812318
149300,84,925,1009,1.299057,103.802934
149301,81,73,154,1.29918,103.803766
149302,1,0,1,1.291136,103.806732
149303,863,7,870,1.296349,103.807958
149304,9,54,63,1.2961,103.810233
149305,251,443,694,1.296935,103.808393
149306,553,481,1034,1.297529,103.80924
149307,1,40,41,1.295852,103.812057
149309,20,1250,1270,1.293006,103.815464
149310,290,30,320,1.294668,103.81328
149311,197,62,259,1.294647,103.813308
149351,1,0,1,1.297316,103.805814
149353,3,0,3,1.291491,103.806898
149357,2,0,2,1.290729,103.806321
149358,0,3,3,1.297527,103.808432
149360,0,3,3,1.297594,103.808285
149361,4,4,8,1.297777,103.80807
149362,1,0,1,1.297527,103.808432
149364,1,1,2,1.297527,103.808432
149366,0,1,1,1.297839,103.808007
149367,0,1,1,1.298184,103.80845
149368,0,2,2,1.298184,103.808424
149369,0,4,4,1.298182,103.808441
149370,0,1,1,1.298176,103.808421
149371,4,3,7,1.297506,103.808726
149372,0,1,1,1.298184,103.808417
149373,1,0,1,1.298159,103.808977
149375,620,48,668,1.299297,103.807076
149377,261,0,261,1.299509,103.837
149378,1,191,192,1.299509,103.837
149379,2,7,9,1.299509,103.837
149454,43,72,115,1.294919,103.807183
149455,0,3,3,1.297706,103.80814
149456,8,4,12,1.294405,103.806925
149457,1,76,77,1.299509,103.837
149497,1,866,867,1.295007,103.810717
149498,2,294,296,1.294913,103.810692
149499,1,413,414,1.294881,103.810696
149500,0,240,240,1.2948,103.810676
149501,0,363,363,1.294761,103.810686
149502,26,2063,2089,1.295118,103.810733
149544,2021,6189,8210,1.304438,103.796798
149545,34,1121,1155,1.304325,103.797302
149546,37,359,396,1.30501,103.795822
149547,362,851,1213,1.304335,103.797312
149548,12,152,164,1.299509,103.837
149549,5,57,62,1.299509,103.837
149550,4,78,82,1.299509,103.837
149551,6,27,33,1.305727,103.795966
149553,5,22,27,1.305565,103.796593
149554,119,13,132,1.305999,103.797046
149555,1507,41,1548,1.305365,103.798178
149594,114,6496,6610,1.295728,103.798471
149596,504,414,918,1.3049,103.798052
149597,105,1394,1499,1.304212,103.797982
149598,2160,1494,3654,1.303007,103.796334
149599,73,4579,4652,1.303633,103.798221
149600,13,1091,1104,1.304108,103.798178
149601,59,1103,1162,1.306074,103.799359
149602,1,614,615,1.306074,103.799359
149603,339,571,910,1.295636,103.798841
149604,40,5769,5809,1.302806,103.796967
149605,3,416,419,1.306074,103.799359
149644,72,208,280,1.306933,103.800377
149725,0,11,11,1.294472,103.806372
149727,6,176,182,1.297054,103.804723
149728,14,378,392,1.295853,103.805476
149729,709,5271,5980,1.294195,103.806102
149730,18,4134,4152,1.294283,103.806507
149731,14,795,809,1.297524,103.803205
149732,95,1196,1291,1.299122,103.801473
149733,10,774,784,1.299364,103.801277
149735,923,7108,8031,1.302653,103.798047
149736,13,1188,1201,1.305726,103.795075
149737,6,284,290,1.306388,103.792877
149739,3,9,12,1.299509,103.837
149740,0,1,1,1.298539,103.807569
149860,2,2,4,1.290158,103.805668
149861,28,6,34,1.29002,103.805802
149862,10,181,191,1.29,103.805706
149863,4,2,6,1.290027,103.805682
149864,51,0,51,1.290172,103.805601
149865,2,16,18,1.290297,103.805503
149866,0,3,3,1.295288,103.806831
149867,67,13,80,1.290579,103.805296
149868,0,5,5,1.290748,103.80518
149870,90,8,98,1.290576,103.805422
149952,1,239,240,1.292132,103.806361
149953,3,3,6,1.292032,103.806229
149954,44,5,49,1.291893,103.806051
149955,14,4,18,1.291781,103.805935
149956,0,2,2,1.298186,103.808415
149957,8,2,10,1.291574,103.80568
149958,14,5,19,1.291526,103.805617
149959,14,0,14,1.291044,103.805167
150001,133,8141,8274,1.28649,103.8081
150002,306,11788,12094,1.286675,103.806892
150003,346,434,780,1.287075,103.806888
150005,59,264,323,1.284534,103.817786
150006,437,2430,2867,1.286962,103.807937
150007,40,2703,2743,1.287468,103.807959
150008,1418,300,1718,1.288343,103.807967
150009,297,68,365,1.288946,103.808396
150010,91,143,234,1.288231,103.808383
150011,92,1148,1240,1.286601,103.808908
150012,401,317,718,1.287427,103.806935
150013,429,205,634,1.287608,103.807185
150014,414,155,569,1.287781,103.807547
150015,89,38,127,1.285942,103.81707
150016,97,108,205,1.286152,103.817061
150035,899,872,1771,1.287952,103.808767
150036,862,2854,3716,1.288489,103.808685
150037,683,688,1371,1.289214,103.809144
150038,691,603,1294,1.288867,103.80959
150043,36,474,510,1.286981,103.810913
150044,31,2517,2548,1.286884,103.811577
150045,54,623,677,1.286733,103.812633
150046,421,190,611,1.287051,103.812667
150049,607,406,1013,1.287499,103.81174
150050,1023,1817,2840,1.287846,103.811585
150051,204,37,241,1.287809,103.812141
150052,633,12,645,1.288556,103.813296
150053,535,307,842,1.288837,103.813645
150054,38,613,651,1.28912,103.813753
150056,272,5519,5791,1.28788,103.813939
150058,374,380,754,1.28852,103.814188
150059,132,726,858,1.288783,103.814348
150061,372,105,477,1.289803,103.813692
150064,65,657,722,1.289481,103.815111
150068,849,34,883,1.286895,103.816031
150069,313,204,517,1.287037,103.816377
150070,216,547,763,1.28692,103.817038
150071,109,2387,2496,1.287454,103.817352
150072,309,2405,2714,1.287515,103.816162
150073,26,2234,2260,1.287954,103.817335
150074,32,301,333,1.288029,103.815804
150076,12,171,183,1.288663,103.816328
150077,113,240,353,1.299509,103.837
150078,130,4086,4216,1.288458,103.818137
150079,261,12228,12489,1.288045,103.818475
150080,25,127,152,1.288036,103.818751
150081,316,139,455,1.28779,103.819368
150082,468,69,537,1.287311,103.819519
150083,404,69,473,1.28689,103.819286
150084,40,81,121,1.287079,103.818869
150085,153,5395,5548,1.287351,103.818363
150086,250,30,280,1.286943,103.8187
150087,741,206,947,1.286084,103.81905
150088,387,2250,2637,1.28612,103.818519
150089,259,423,682,1.285476,103.818778
150090,251,666,917,1.284976,103.818753
150091,34,4,38,1.287868,103.820396
150092,206,1,207,1.287389,103.820393
150093,974,568,1542,1.286925,103.82033
150094,11,943,954,1.286192,103.820271
150095,3,2,5,1.287236,103.821132
150096,2,2591,2593,1.287343,103.821887
150101,284,1262,1546,1.290758,103.821287
150102,609,170,779,1.290379,103.821349
150103,56,17,73,1.290103,103.821163
150104,360,44,404,1.289414,103.821315
150105,1080,1431,2511,1.29012,103.822487
150106,1741,924,2665,1.289476,103.822253
150110,9,1634,1643,1.287348,103.822693
150111,5,200,205,1.286212,103.823644
150112,8,338,346,1.286091,103.824239
150113,0,85,85,1.28626,103.822747
150114,5,1050,1055,1.286364,103.822283
150115,649,1570,2219,1.283704,103.814647
150116,412,838,1250,1.283704,103.814647
150117,392,1247,1639,1.283779,103.816147
150118,57,1321,1378,1.284051,103.820937
150119,19,3418,3437,1.282904,103.816003
150120,151,341,492,1.286343,103.804526
150121,70,6288,6358,1.286511,103.804901
150122,286,187,473,1.286447,103.804086
150123,473,4739,5212,1.286675,103.803776
150124,386,2503,2889,1.285794,103.803405
150125,270,2676,2946,1.285815,103.802953
150126,20,88,108,1.285121,103.802953
150127,103,324,427,1.285309,103.803287
150128,1445,4301,5746,1.282988,103.823407
150129,413,3879,4292,1.283553,103.824001
150130,892,2757,3649,1.284691,103.823978
150161,361,2012,2373,1.283779,103.816147
150162,396,6368,6764,1.284152,103.816987
150163,44,88,132,1.284152,103.816987
150164,64,111,175,1.28344,103.816199
150165,726,32109,32835,1.28344,103.816199
150166,52,668,720,1.282838,103.817549
150167,502,1470,1972,1.282631,103.818518
150168,740,329,1069,1.282928,103.818795
150169,767,13814,14581,1.283595,103.819112
151001,113,8255,8368,1.284259,103.817827
151002,33,3622,3655,1.2844,103.817284
151003,14,1976,1990,1.284714,103.816279
151006,33,12,45,1.284901,103.81635
151007,120,565,685,1.284886,103.817769
151008,81,128,209,1.285149,103.816795
151009,36,116,152,1.285091,103.816414
151010,29,1177,1206,1.284992,103.816294
151011,163,234,397,1.285474,103.816216
151012,92,358,450,1.285901,103.816632
151013,69,93,162,1.285441,103.816864
151014,229,3,232,1.285686,103.817058
151017,201,1914,2115,1.2852,103.817781
151018,48,781,829,1.285847,103.817794
151019,286,468,754,1.285997,103.818085
151020,20,465,485,1.286791,103.817283
151021,326,57,383,1.286347,103.817605
151022,71,3768,3839,1.28668,103.818089
151028,328,4950,5278,1.286376,103.809667
151035,10,73,83,1.299509,103.837
151037,20,71,91,1.289278,103.810372
151039,646,478,1124,1.288862,103.809965
151040,687,140,827,1.288852,103.81034
151047,835,108,943,1.287129,103.811598
151048,271,2158,2429,1.287239,103.810925
151055,265,298,563,1.28756,103.813452
151057,266,3674,3940,1.288176,103.814051
151063,444,2093,2537,1.289683,103.815141
151068,7,254,261,1.286681,103.81611
151070,3,384,387,1.286684,103.816856
151073,338,1838,2176,1.287867,103.81674
151074,1037,587,1624,1.287863,103.816353
151075,954,4184,5138,1.287978,103.815284
151076,464,21715,22179,1.288792,103.816846
151077,535,12987,13522,1.288475,103.817419
151084,6,264,270,1.287302,103.819
151088,31,501,532,1.286243,103.818517
151095,2,203,205,1.299509,103.837
151096,2,202,204,1.299509,103.837
151104,30,741,771,1.289061,103.821319
151106,95,1535,1630,1.288879,103.822228
151115,128,2660,2788,1.285527,103.822038
151116,384,9231,9615,1.285146,103.82146
151117,131,5066,5197,1.284415,103.82154
151118,19,6716,6735,1.284153,103.820773
151119,154,113,267,1.286106,103.804753
151120,13,2185,2198,1.28668,103.80447
151121,163,819,982,1.28305,103.822783
151123,174,293,467,1.28409,103.82319
151124,330,1318,1648,1.284902,103.822679
151125,230,110,340,1.285131,103.823592
151126,1059,370,1429,1.284473,103.82367
151128,11,273,284,1.283324,103.823638
151129,202,343,545,1.283523,103.823381
152002,5,129,134,1.286901,103.806759
152028,328,2568,2896,1.286355,103.809689
152063,318,7523,7841,1.289137,103.815171
152075,673,227,900,1.288432,103.815886
152095,0,11,11,1.299509,103.837
152096,1,846,847,1.299509,103.837
152116,5,174,179,1.283704,103.814647
152119,688,5341,6029,1.283535,103.820854
152120,153,5363,5516,1.282906,103.822312
152124,390,282,672,1.285337,103.822915
152125,10,251,261,1.28489,103.823582
152126,26,249,275,1.284596,103.82334
153002,17,843,860,1.286947,103.806275
153028,5,2401,2406,1.286651,103.809206
153075,690,955,1645,1.28897,103.816261
153095,2,91,93,1.299509,103.837
154028,4,114,118,1.286707,103.809205
154075,40,609,649,1.288515,103.815713
154095,2,3918,3920,1.299509,103.837
158741,1140,589,1729,1.290586,103.818044
158742,888,963,1851,1.299509,103.837
158744,21,25,46,1.299509,103.837
158746,2313,140,2453,1.290559,103.815628
158747,2341,18,2359,1.290501,103.816036
158748,2882,1739,4621,1.290972,103.816988
158749,1860,259,2119,1.290975,103.816993
158750,429,1790,2219,1.299509,103.837
158751,0,1,1,1.299509,103.837
158752,5,9,14,1.290601,103.818847
158753,0,79,79,1.290601,103.818847
158754,2,5,7,1.290127,103.819115
158787,279,5112,5391,1.288353,103.82018
158788,56,1792,1848,1.288375,103.819565
158789,2,3,5,1.289145,103.818921
158790,557,4753,5310,1.289297,103.820672
158791,17,2808,2825,1.290776,103.820747
158792,2765,12466,15231,1.289719,103.81661
158793,2,281,283,1.290914,103.815987
158900,9,76,85,1.286325,103.81636
158901,455,76,531,1.285631,103.815421
158975,0,1,1,1.289922,103.818885
159011,80,73,153,1.292218,103.82352
159012,1887,2006,3893,1.291951,103.818524
159013,1514,570,2084,1.292022,103.817891
159014,201,505,706,1.291833,103.817358
159015,1623,240,1863,1.292082,103.81728
159016,150,1749,1899,1.29273,103.822089
159017,12,0,12,1.293253,103.819358
159018,3,0,3,1.290469,103.805368
159019,7,38,45,1.299509,103.837
159020,9,16,25,1.299509,103.837
159021,6,9,15,1.299509,103.837
159022,2,11,13,1.299509,103.837
159023,3,0,3,1.299509,103.837
159024,26,1,27,1.299509,103.837
159026,7,4,11,1.299509,103.837
159047,155,5165,5320,1.286523,103.810421
159049,94,312,406,1.289514,103.814388
159050,294,880,1174,1.285583,103.81344
159051,20,2507,2527,1.286429,103.810904
159052,202,7118,7320,1.286627,103.811108
159053,1641,1475,3116,1.287208,103.814834
159085,3,478,481,1.290119,103.815091
159086,2146,874,3020,1.290982,103.814894
159087,3,39,42,1.290239,103.814686
159088,1243,1542,2785,1.291066,103.814315
159089,61,582,643,1.290261,103.814566
159090,25,365,390,1.290345,103.814022
159091,25,317,342,1.290471,103.813579
159092,35,694,729,1.290372,103.813123
159093,13,102,115,1.290419,103.812862
159094,145,58,203,1.290922,103.813095
159095,180,127,307,1.290536,103.812313
159096,43,166,209,1.290902,103.812334
159097,423,2334,2757,1.290694,103.811882
159098,299,194,493,1.290661,103.811541
159099,1201,1314,2515,1.290741,103.811257
159100,244,318,562,1.290879,103.812654
159101,46,2,48,1.299509,103.837
159102,1536,137,1673,1.290866,103.810358
159103,4064,689,4753,1.290418,103.808979
159104,368,150,518,1.291453,103.811779
159105,60,1587,1647,1.291284,103.811074
159139,129,302,431,1.289548,103.81287
159140,9,661,670,1.289701,103.812879
159141,47,5,52,1.289601,103.812637
159142,2,23,25,1.289611,103.81244
159143,165,8,173,1.289998,103.812531
159144,6,29,35,1.289651,103.812164
159145,55,15,70,1.289775,103.812142
159146,11,21,32,1.289897,103.811719
159147,3,29,32,1.289706,103.811802
159148,1,22,23,1.289946,103.811368
159149,0,6,6,1.289713,103.811702
159150,802,238,1040,1.289968,103.811123
159151,1,106,107,1.289726,103.811573
159187,45,34,79,1.294241,103.81888
159188,10,11,21,1.294255,103.818759
159189,297,0,297,1.294256,103.818671
159190,7,50,57,1.294256,103.818576
159191,11,36,47,1.294264,103.818449
159192,906,140,1046,1.294135,103.818293
159193,5,136,141,1.294149,103.818478
159194,0,2,2,1.29163,103.80574
159195,0,46,46,1.294139,103.818729
159303,3997,1977,5974,1.285081,103.810498
159305,438,186,624,1.28458,103.810274
159306,215,57,272,1.284393,103.810381
159308,670,89,759,1.28434,103.811306
159309,15,518,533,1.284322,103.811546
159345,87,49,136,1.285099,103.808282
159346,346,319,665,1.285731,103.808176
159347,1,71,72,1.284957,103.808291
159349,1170,100,1270,1.284648,103.808251
159351,509,23,532,1.285243,103.808199
159353,19,77,96,1.285108,103.808195
159354,107,60,167,1.284837,103.808182
159356,140,5,145,1.284663,103.808186
159357,977,119,1096,1.28447,103.808972
159358,433,465,898,1.284432,103.808182
159360,125,74,199,1.284359,103.808165
159361,630,37,667,1.284861,103.808977
159362,11,58,69,1.284266,103.809236
159363,68,13,81,1.284428,103.80923
159364,4,59,63,1.284554,103.809254
159365,11,152,163,1.284687,103.809266
159366,93,22,115,1.284844,103.809242
159402,313,285,598,1.285324,103.810138
159403,1,57,58,1.285352,103.809931
159404,13,1944,1957,1.285506,103.810255
159405,15,10,25,1.285361,103.809742
159406,144,1348,1492,1.285554,103.81013
159407,164,85,249,1.285401,103.809451
159408,14,206,220,1.285401,103.809547
159409,25,85,110,1.285509,103.809051
159410,913,1160,2073,1.285541,103.809704
159411,1,3,4,1.285477,103.808926
159412,12,675,687,1.285568,103.809489
159413,78,44,122,1.285546,103.808582
159414,17,2383,2400,1.285526,103.80909
159416,533,1276,1809,1.285579,103.809048
159418,25,1055,1080,1.285603,103.808675
159419,254,2174,2428,1.285603,103.80848
159455,579,3796,4375,1.285149,103.812773
159456,2546,188,2734,1.284178,103.812581
159457,631,5401,6032,1.282374,103.821618
159458,42,1591,1633,1.282699,103.821415
159460,95,3977,4072,1.283653,103.818279
159461,70,1289,1359,1.284263,103.816652
159462,81,795,876,1.284341,103.815558
159463,37,871,908,1.284478,103.81504
159464,125,3766,3891,1.284227,103.818404
159465,104,572,676,1.285015,103.81576
159466,70,20757,20827,1.286109,103.807103
159467,14,619,633,1.286204,103.805359
159468,12,3250,3262,1.287131,103.80499
159469,41,129,170,1.284263,103.812938
159470,30,10,40,1.286122,103.806939
159471,3066,2094,5160,1.285298,103.811644
159504,6,55,61,1.290057,103.813407
159505,319,881,1200,1.288269,103.80946
159506,742,728,1470,1.28818,103.811924
159507,0,1333,1333,1.28818,103.812031
159543,46,59,105,1.285502,103.820635
159544,33,16,49,1.285033,103.819595
159545,732,1601,2333,1.282509,103.820457
159546,1047,270,1317,1.28147,103.821202
159547,84,191,275,1.281815,103.820801
159548,129,0,129,1.281671,103.821024
159549,972,258,1230,1.280758,103.820098
159550,143,286,429,1.280891,103.819909
159551,65,240,305,1.281186,103.819608
159552,2034,3068,5102,1.281481,103.819335
159553,693,3047,3740,1.281307,103.819278
159554,539,426,965,1.280752,103.819215
159555,528,495,1023,1.280516,103.819493
159556,1523,2080,3603,1.280219,103.819868
159557,1106,957,2063,1.280589,103.820638
159558,28,35,63,1.279772,103.820009
159561,259,55,314,1.289088,103.823727
159630,550,11,561,1.288785,103.812191
159631,8,771,779,1.28882,103.8126
159632,4,748,752,1.288825,103.812226
159633,43,779,822,1.288847,103.812413
159634,2,25,27,1.288901,103.811766
159635,2,3,5,1.288909,103.812182
159636,1,9,10,1.288838,103.81163
159637,502,107,609,1.288909,103.812182
159638,1,33,34,1.288777,103.811459
159639,93,5,98,1.289149,103.812039
159640,735,220,955,1.288391,103.811383
159641,0,8,8,1.289256,103.811399
159642,0,6,6,1.289314,103.811403
159643,0,27,27,1.28974,103.811497
159681,2,1860,1862,1.283433,103.821891
159682,95,61,156,1.285883,103.822906
159718,113,81,194,1.284519,103.806316
159719,46,77,123,1.284472,103.80539
159720,31,34,65,1.28532,103.805729
159721,22,51,73,1.285525,103.805042
159722,106,87,193,1.28539,103.804639
159723,89,70,159,1.285166,103.804341
159724,146,128,274,1.284913,103.804147
159760,74,2368,2442,1.285786,103.805786
159761,4,120,124,1.28567,103.805817
159762,18,6,24,1.285696,103.805231
159834,34,3240,3274,1.284628,103.814351
159835,4315,3355,7670,1.284344,103.813836
159836,1582,1704,3286,1.283259,103.814735
159837,178,1362,1540,1.282175,103.817879
159838,113,295,408,1.282246,103.817666
159840,34,777,811,1.282148,103.817273
159883,7,263,270,1.293172,103.817007
159919,2782,5411,8193,1.290776,103.825279
159921,176,1202,1378,1.291379,103.819842
159924,183,34,217,1.290427,103.81982
159925,5,953,958,1.290961,103.818581
159927,54,1265,1319,1.291393,103.815958
159928,10,1549,1559,1.291447,103.814636
159929,408,1192,1600,1.29161,103.813896
159930,971,733,1704,1.291743,103.813102
159931,43,1006,1049,1.291743,103.813126
159932,10,365,375,1.291743,103.813102
159933,57,541,598,1.291743,103.813102
159934,366,167,533,1.291956,103.811655
159935,6806,657,7463,1.292062,103.810961
159936,766,2616,3382,1.292095,103.810034
159937,350,358,708,1.292121,103.809912
159938,1284,440,1724,1.292257,103.809131
159939,3,1139,1142,1.292252,103.811662
159940,10,1283,1293,1.290894,103.80834
159941,2577,227,2804,1.289904,103.80764
159942,478,8,486,1.289444,103.807285
159943,601,2966,3567,1.289092,103.806887
159944,1996,2999,4995,1.288539,103.806705
159945,9,233,242,1.292638,103.809225
159946,1,203,204,1.292463,103.808741
159948,258,0,258,1.291081,103.807331
159949,1426,9045,10471,1.291152,103.807382
159950,5,646,651,1.290607,103.806854
159951,8,1125,1133,1.290286,103.80657
159952,228,16675,16903,1.288892,103.805698
159953,3202,11524,14726,1.288541,103.805249
159954,217,1,218,1.289545,103.805576
159955,128,732,860,1.289885,103.805323
159956,141,228,369,1.290234,103.805077
159957,1329,274,1603,1.29036,103.804602
159958,2267,284,2551,1.289831,103.804225
159959,1291,1852,3143,1.288403,103.804259
159960,2430,300,2730,1.28893,103.804496
159961,1626,324,1950,1.289449,103.80502
159962,57,93,150,1.289179,103.804857
159963,2093,2481,4574,1.284818,103.802355
159964,2987,7998,10985,1.287587,103.801364
159965,5998,58644,64642,1.288155,103.805666
159967,1062,3070,4132,1.290588,103.822515
159968,954,53,1007,1.29019,103.808162
159970,98,915,1013,1.299509,103.837
159971,494,10386,10880,1.287564,103.805192
159972,16498,576,17074,1.287249,103.805405
160001,1314,392,1706,1.292048,103.828428
160003,262,389,651,1.291766,103.82723
160005,996,311,1307,1.292253,103.827462
160007,53,2984,3037,1.283585,103.826831
160009,241,250,491,1.287701,103.838623
160010,804,624,1428,1.286168,103.829631
160018,0,1,1,1.293879,103.820508
160019,1,369,370,1.276379,103.830295
160020,117,626,743,1.288165,103.828977
160022,839,3382,4221,1.288768,103.828705
160023,1,132,133,1.276037,103.829356
160024,141,18,159,1.288576,103.828504
160025,45,137,182,1.283669,103.825934
160026,183,30,213,1.288189,103.828484
160027,42,163,205,1.285401,103.830822
160028,100,3,103,1.287968,103.828272
160029,3,1012,1015,1.289081,103.830813
160030,150,2632,2782,1.287684,103.828284
160032,292,2986,3278,1.287502,103.828443
160033,167,261,428,1.285136,103.831569
160034,499,7039,7538,1.288018,103.827144
160035,195,213,408,1.285117,103.831054
160036,100,154,254,1.288303,103.82723
160037,119,228,347,1.285222,103.830413
160038,388,148,536,1.288476,103.827324
160040,100,111,211,1.288999,103.827603
160041,1,0,1,1.276543,103.829969
160042,71,81,152,1.289128,103.826566
160043,2,1,3,1.299509,103.837
160044,27,91,118,1.288782,103.826273
160045,266,13,279,1.284273,103.831777
160046,268,2573,2841,1.288291,103.826105
160047,11,0,11,1.28388,103.830769
160048,269,4272,4541,1.289225,103.825941
160049,75,10,85,1.284313,103.830135
160050,358,2262,2620,1.289466,103.827011
160051,119,2289,2408,1.287465,103.841927
160052,286,356,642,1.287115,103.841413
160053,117,1187,1304,1.287667,103.841307
160054,353,4114,4467,1.287543,103.841041
160055,671,9939,10610,1.284555,103.834056
160056,586,298,884,1.284257,103.833756
160057,508,539,1047,1.284836,103.833304
160058,132,1847,1979,1.284576,103.832846
160059,552,593,1145,1.284274,103.833256
160060,3,12,15,1.284406,103.833062
160061,42,80,122,1.284357,103.83288
160062,446,82,528,1.283773,103.833381
160063,6,0,6,1.283918,103.833477
160064,333,397,730,1.283762,103.833532
160065,212,282,494,1.283404,103.833084
160066,458,300,758,1.28379,103.832663
160067,5,21,26,1.283629,103.833094
160068,164,25,189,1.283689,103.833177
160069,223,41,264,1.284208,103.832772
160070,0,11,11,1.284156,103.832661
160071,292,968,1260,1.284259,103.832429
160072,354,743,1097,1.283845,103.831911
160073,333,75,408,1.283555,103.832304
160074,94,229,323,1.28299,103.832566
160075,268,239,507,1.282604,103.832049
160076,399,351,750,1.283011,103.831677
160077,426,1569,1995,1.291157,103.826739
160078,800,823,1623,1.282842,103.830487
160079,252,773,1025,1.282714,103.83087
160080,409,538,947,1.282821,103.830984
160081,294,337,631,1.282759,103.832829
160082,566,189,755,1.283314,103.833553
160084,3,45,48,1.285286,103.832223
160086,390,47695,48085,1.299509,103.837
160087,620,2618,3238,1.290743,103.832884
160088,44,1491,1535,1.291854,103.832998
160089,2,24,26,1.291505,103.833181
160090,2,2180,2182,1.29114,103.833313
160091,4,10,14,1.290819,103.833501
160092,14,3345,3359,1.29026,103.833611
160093,59,753,812,1.289936,103.83292
160094,633,1636,2269,1.28836,103.833054
160095,375,395,770,1.288612,103.832668
160096,0,30,30,1.288687,103.832316
160104,253,2017,2270,1.281018,103.824265
160105,101,1305,1406,1.280664,103.824941
160106,103,1230,1333,1.280326,103.824357
160107,324,489,813,1.279883,103.824954
160108,291,204,495,1.279172,103.825703
160109,179,356,535,1.279301,103.826163
160110,116,8091,8207,1.279804,103.826585
160111,148,746,894,1.279918,103.82636
160112,31,1434,1465,1.280003,103.826003
160113,202,8912,9114,1.280312,103.825614
160115,248,10587,10835,1.281182,103.826193
160116,108,236,344,1.281434,103.826405
160117,459,50,509,1.281812,103.826546
160118,97,372,469,1.282132,103.826131
160119,41,287,328,1.281793,103.827764
160120,741,343,1084,1.283031,103.827731
160121,147,11434,11581,1.282658,103.82834
160122,668,1716,2384,1.283358,103.828692
160123,340,214,554,1.283676,103.828952
160124,481,216,697,1.28397,103.828049
160125,175,210,385,1.283701,103.828031
160126,409,460,869,1.282525,103.829501
160127,272,259,531,1.281879,103.829313
160128,52,2081,2133,1.281639,103.82885
160129,611,756,1367,1.28118,103.828631
160130,68,453,521,1.280378,103.829053
160131,183,1141,1324,1.280216,103.828204
160132,98,322,420,1.278867,103.828215
160133,83,2843,2926,1.279541,103.827307
160134,337,120,457,1.278857,103.827569
160135,118,94,212,1.278559,103.827031
160136,64,174,238,1.278289,103.827399
160137,78,47,125,1.278286,103.826763
160138,56,83,139,1.27844,103.826228
160139,99,109,208,1.278962,103.826512
160140,247,11217,11464,1.278133,103.829348
160141,468,185,653,1.277154,103.828724
160142,362,252,614,1.27708,103.827938
160143,50,1684,1734,1.277845,103.829819
160144,322,179,501,1.277295,103.829887
160145,80,278,358,1.277531,103.830411
160146,153,8291,8444,1.277819,103.830741
160147,38,1711,1749,1.277353,103.830914
160148,237,576,813,1.276929,103.830673
160149,253,5492,5745,1.277358,103.831752
160150,22,359,381,1.277164,103.831302
160201,82,18471,18553,1.2805,103.827596
160568,155,1072,1227,1.290222,103.831022
161001,125,405,530,1.288274,103.839817
161002,806,536,1342,1.291782,103.82795
161003,276,632,908,1.28825,103.839279
161004,378,8294,8672,1.291934,103.826451
161005,384,225,609,1.28794,103.837884
161006,117,137,254,1.28772,103.831217
161007,8,641,649,1.28603,103.830977
161008,194,276,470,1.2876,103.831851
161009,47,1769,1816,1.286018,103.830388
161010,399,1429,1828,1.287524,103.83253
161011,65,879,944,1.286318,103.829163
161014,216,154,370,1.287928,103.832057
161017,66,384,450,1.285295,103.833229
161019,142,1029,1171,1.285488,103.83259
161021,89,71,160,1.28535,103.832167
161022,47,1449,1496,1.288067,103.829634
161023,85,126,211,1.285355,103.831734
161025,54,293,347,1.285339,103.831301
161026,200,6920,7120,1.282517,103.825796
161027,52,1473,1525,1.282793,103.824695
161028,13,25,38,1.2840975,103.8275425
161029,181,334,515,1.285402,103.83039
161034,15,0,15,1.284946,103.83179
161036,4,0,4,1.284898,103.831064
161038,82,6,88,1.284917,103.830113
161042,9,1,10,1.284465,103.831804
161044,3,6,9,1.28442,103.831056
161045,149,0,149,1.299509,103.837
161046,32,451,483,1.283994,103.831548
161048,148,43,191,1.283987,103.831067
161050,75,451,526,1.283947,103.830584
161051,18,696,714,1.289917,103.827693
161052,464,3537,4001,1.289197,103.828452
161053,426,745,1171,1.289058,103.828844
161054,801,9100,9901,1.288929,103.829102
161055,928,4818,5746,1.289943,103.829277
161056,355,3774,4129,1.290147,103.82894
161057,833,4071,4904,1.290095,103.828563
161058,480,1573,2053,1.290073,103.828114
161061,18,20,38,1.299509,103.837
161077,223,460,683,1.283459,103.831415
161078,453,132,585,1.291365,103.827346
161079,827,2136,2963,1.291126,103.828689
161084,251,629,880,1.285286,103.832223
161105,13,1946,1959,1.280655,103.824273
161107,4,256,260,1.279904,103.825554
161113,9,658,667,1.280295,103.825187
161117,2,114,116,1.281941,103.827009
161118,307,11067,11374,1.281704,103.825418
161119,8,56,64,1.281461,103.827318
161120,534,262,796,1.283377,103.827606
161121,260,1536,1796,1.282624,103.827945
161125,37,3184,3221,1.283159,103.828715
161126,769,3241,4010,1.28288,103.829492
161127,209,106,315,1.281915,103.829701
161129,21,228,249,1.280965,103.829274
161131,67,197,264,1.28074,103.828689
161134,9,85,94,1.279288,103.827038
162001,22,2236,2258,1.286055,103.832884
162002,83,961,1044,1.287318,103.831695
162003,32,1469,1501,1.286055,103.832231
162004,226,743,969,1.287467,103.831043
162005,16,1241,1257,1.286093,103.831567
162006,614,427,1041,1.287637,103.837236
162008,156,3099,3255,1.287444,103.839279
162009,226,991,1217,1.287081,103.828554
162010,144,2519,2663,1.287034,103.838912
162011,518,355,873,1.287319,103.837783
162012,205,32,237,1.287814,103.832645
162013,222,7309,7531,1.286567,103.838049
162017,2,258,260,1.276879,103.830115
162018,99,137,236,1.28813,103.830859
162022,15,149,164,1.287737,103.829281
162025,361,1803,2164,1.283462,103.826169
162026,125,6152,6277,1.283066,103.826076
162027,3,171,174,1.277083,103.829263
162028,0,37,37,1.276946,103.828915
162042,4,1857,1861,1.289127,103.82631
162044,2,194,196,1.288807,103.826898
162048,11,2766,2777,1.290168,103.826573
162051,0,274,274,1.299509,103.837
162052,27,15,42,1.28987,103.828625
162053,25,2077,2102,1.285778,103.830468
162077,85,2272,2357,1.290916,103.827647
162078,652,236,888,1.283741,103.830405
162118,621,1024,1645,1.282053,103.825836
162119,577,755,1332,1.281051,103.827426
162120,51,183,234,1.283416,103.827485
162126,6,24,30,1.282663,103.829741
162127,2,118,120,1.28187,103.829978
162131,524,11935,12459,1.280931,103.828223
163002,247,990,1237,1.288639,103.839582
163004,260,120,380,1.288169,103.838499
163006,343,2364,2707,1.28401,103.827429
163008,118,1707,1825,1.283129,103.827177
163009,175,578,753,1.287139,103.828948
163010,14,1858,1872,1.286828,103.838662
163011,35,944,979,1.299509,103.837
163012,138,364,502,1.286903,103.837815
163016,314,69,383,1.288025,103.831447
163017,41,870,911,1.285674,103.833167
163018,41,1684,1725,1.285842,103.832532
163019,1087,1914,3001,1.285732,103.826112
163020,23,2977,3000,1.28583,103.832106
163021,946,568,1514,1.285077,103.82562
163022,0,154,154,1.276297,103.829797
163023,791,5136,5927,1.284734,103.826671
163025,0,10,10,1.276734,103.829612
163026,0,4,4,1.276923,103.829411
163027,877,955,1832,1.282097,103.824642
163028,31,1135,1166,1.285778,103.830467
163031,1,46,47,1.276874,103.828572
163078,389,470,859,1.282726,103.830368
163118,624,2208,2832,1.282298,103.826106
163119,457,511,968,1.281535,103.827662
163120,3,46,49,1.283175,103.828189
163126,456,2614,3070,1.282261,103.829332
163127,1443,562,2005,1.281516,103.830022
163131,262,216,478,1.280386,103.82883
164002,550,104,654,1.286604,103.833061
164004,430,430,860,1.286619,103.83235
164006,788,175,963,1.286871,103.831396
164008,1275,508,1783,1.28654,103.829999
164009,9,275,284,1.299509,103.837
164010,207,213,420,1.286504,103.828983
164012,38,445,483,1.287755,103.832883
164018,196,2533,2729,1.28568,103.826718
164019,22,33,55,1.285222,103.826331
164020,639,1480,2119,1.285733,103.825558
164022,8,804,812,1.288026,103.828929
164024,20,1027,1047,1.285821,103.831255
164025,1336,798,2134,1.283374,103.825436
164026,21,692,713,1.28577,103.83082
164027,336,1034,1370,1.282956,103.824865
164028,15,955,970,1.288227,103.82778
164078,11,159,170,1.291358,103.828077
164118,615,1082,1697,1.282453,103.826589
164119,528,8932,9460,1.282022,103.827962
164127,1584,370,1954,1.281139,103.829926
165002,27,1321,1348,1.286844,103.833279
165004,431,336,767,1.286601,103.831819
165006,790,465,1255,1.286572,103.830706
165008,644,54,698,1.287083,103.830342
165018,90,3446,3536,1.285289,103.826887
165020,25,717,742,1.285379,103.825757
165022,2,1049,1051,1.285767,103.831692
165026,407,338,745,1.283044,103.825596
166002,564,508,1072,1.286959,103.832756
166006,40,1350,1390,1.286985,103.830728
166008,4,59,63,1.28715,103.829297
166022,781,354,1135,1.284852,103.826318
166026,760,223,983,1.282407,103.825576
167002,12,336,348,1.286606,103.832807
167008,5,67,72,1.287333,103.838848
167026,604,4828,5432,1.282054,103.825077
168591,4,1,5,1.299509,103.837
168592,0,260,260,1.28514,103.829464
168593,0,264,264,1.299509,103.837
168594,1,72,73,1.299509,103.837
168595,1,435,436,1.299509,103.837
168602,1,1,2,1.294145,103.818592
168622,365,216,581,1.286507,103.837091
168641,602,1280,1882,1.282315,103.830552
168642,47,9,56,1.282415,103.830462
168643,359,174,533,1.282449,103.830449
168644,54,144,198,1.282538,103.830381
168645,266,286,552,1.282571,103.830335
168646,200,115,315,1.282706,103.830227
168647,28,306,334,1.282673,103.830261
168649,6,0,6,1.282691,103.830245
168650,546,98,644,1.282766,103.830169
168651,39,171,210,1.282805,103.830148
168652,54,174,228,1.282848,103.830107
168653,41,3,44,1.282985,103.830005
168654,272,1544,1816,1.28287,103.830056
168713,39,1940,1979,1.285723,103.829804
168714,2,635,637,1.285324,103.832108
168716,112,11220,11332,1.285272,103.833111
168719,36,1962,1998,1.284826,103.833856
168720,12,988,1000,1.285424,103.833639
168721,13,0,13,1.284952,103.833928
168722,1,0,1,1.284727,103.831788
168723,10,568,578,1.285058,103.833828
168724,3,223,226,1.285081,103.83381
168725,6,367,373,1.285108,103.833791
168726,15,1985,2000,1.285398,103.833659
168727,747,1121,1868,1.285256,103.833712
168728,2,366,368,1.285389,103.833666
168730,775,1065,1840,1.28613,103.827378
168731,318,14532,14850,1.285782,103.826998
168732,5077,25329,30406,1.286145,103.827342
168733,1168,5556,6724,1.284896,103.834309
168734,127,355,482,1.283923,103.834939
168751,3232,12223,15455,1.280899,103.835501
168752,565,7894,8459,1.281513,103.836834
168753,23,260,283,1.280564,103.836116
168789,504,421,925,1.275501,103.830333
168790,298,1278,1576,1.275554,103.830285
168794,63,679,742,1.275848,103.831279
168851,7,11,18,1.277539,103.828762
168871,73,2306,2379,1.276248,103.830544
168891,1007,844,1851,1.285673,103.83407
168895,218,661,879,1.285859,103.834078
168898,812,4208,5020,1.284707,103.832416
168935,10,383,393,1.28044,103.83851
168936,31,0,31,1.280414,103.838476
168937,2908,11531,14439,1.279555,103.838369
168938,551,4281,4832,1.279768,103.838629
168955,263,208,471,1.282076,103.831207
168975,15,144,159,1.282844,103.840976
168976,489,1326,1815,1.284053,103.841318
168977,1071,234,1305,1.284801,103.841094
168996,104,261,365,1.285507,103.841897
169016,5197,2273,7470,1.282816,103.839767
169017,259,107,366,1.282631,103.839239
169037,1091,2382,3473,1.281367,103.83911
169038,156,1422,1578,1.283373,103.835368
169039,517,871,1388,1.283964,103.835522
169040,1884,2821,4705,1.284303,103.835085
169041,36,2769,2805,1.284557,103.835026
169042,75,17,92,1.284574,103.835006
169043,108,1032,1140,1.284815,103.835159
169044,15,1354,1369,1.284631,103.834991
169045,4,814,818,1.284683,103.834974
169046,16,1276,1292,1.284708,103.834965
169047,12,746,758,1.284754,103.834948
169048,52,393,445,1.284801,103.83493
169049,92,1686,1778,1.284838,103.834918
169050,30,359,389,1.284871,103.834909
169051,55,63,118,1.285734,103.835165
169052,8,461,469,1.284939,103.834892
169053,54,7,61,1.285749,103.835925
169055,18,555,573,1.284976,103.834872
169056,59,4,63,1.285044,103.834854
169057,57,1102,1159,1.285174,103.834803
169058,0,2,2,1.290488,103.833186
169059,68,1110,1178,1.285346,103.834724
169060,33,90,123,1.285406,103.834702
169061,27,977,1004,1.285448,103.834684
169062,4,1,5,1.285475,103.83467
169063,23,464,487,1.285527,103.83464
169064,31,3,34,1.285565,103.834613
169065,7,132,139,1.2856,103.834591
169066,3,15,18,1.285657,103.834554
169067,35,113,148,1.285678,103.834537
169068,139,11,150,1.285706,103.834535
169069,18,24,42,1.285775,103.834505
169070,9,526,535,1.285823,103.834494
169071,2,1393,1395,1.285877,103.834474
169072,21,1581,1602,1.286819,103.834504
169073,870,682,1552,1.287177,103.834662
169074,3636,3002,6638,1.287436,103.833889
169075,4632,53209,57841,1.288842,103.834139
169077,7,3090,3097,1.287373,103.835162
169078,374,1866,2240,1.280434,103.838439
169079,84,19182,19266,1.282231,103.838632
169097,12,58,70,1.284582,103.837785
169115,34,575,609,1.284166,103.836324
169173,0,100,100,1.280687,103.832066
169174,5,164,169,1.279945,103.8315
169175,0,38,38,1.280686,103.832071
169177,0,3,3,1.284691,103.831041
169178,182,79,261,1.280533,103.832571
169179,0,8,8,1.28078,103.832107
169180,5,0,5,1.280713,103.832064
169198,76,3216,3292,1.288836,103.82537
169199,13,2699,2712,1.288385,103.825225
169201,578,97,675,1.279821,103.821259
169202,123,333,456,1.280801,103.823092
169203,458,1069,1527,1.280852,103.8222
169204,808,822,1630,1.28179,103.822626
169205,455,128,583,1.281023,103.821413
169206,924,309,1233,1.280115,103.821974
169207,45,524,569,1.281467,103.82324
169208,4058,1134,5192,1.280226,103.822926
169244,74,670,744,1.28526,103.829337
169245,48,400,448,1.285198,103.829337
169247,45,325,370,1.285104,103.829328
169248,19,353,372,1.285038,103.829342
169249,3,56,59,1.285,103.829346
169250,3,297,300,1.284946,103.829346
169251,40,257,297,1.284893,103.829351
169252,28,636,664,1.284802,103.829353
169253,21,2229,2250,1.28474,103.829353
169262,225,146,371,1.284368,103.829116
169263,18,2617,2635,1.282405,103.827322
169277,1815,402,2217,1.284385,103.828489
169278,1680,247,1927,1.284667,103.828443
169279,994,1604,2598,1.284334,103.829123
169280,3,627,630,1.291893,103.82667
169301,3,224,227,1.285341,103.829909
169302,5,669,674,1.285388,103.8299
169303,3,139,142,1.284585,103.829987
169304,2,500,502,1.28454,103.829995
169311,77,4287,4364,1.28077,103.823358
169339,40,1428,1468,1.277287,103.836908
169340,22,222,244,1.277281,103.836882
169341,40,210,250,1.277273,103.836836
169342,17,327,344,1.27727,103.836806
169343,19,482,501,1.277263,103.836772
169344,25,439,464,1.277257,103.83674
169345,12,181,193,1.277248,103.836701
169346,22,627,649,1.277239,103.836666
169347,35,281,316,1.277208,103.836583
169348,3,2,5,1.277176,103.83656
169349,74,1257,1331,1.277126,103.836485
169350,18,1452,1470,1.276823,103.836128
169351,43,27,70,1.277065,103.836433
169352,11,80,91,1.277044,103.836401
169353,17,1082,1099,1.277013,103.836379
169354,15,95,110,1.27699,103.836345
169355,40,336,376,1.276967,103.836314
169356,15,158,173,1.276944,103.836282
169357,21,759,780,1.276918,103.83626
169358,1,271,272,1.276896,103.836223
169359,15,199,214,1.276874,103.836191
169360,18,202,220,1.276845,103.836167
169361,51,447,498,1.276823,103.836132
169362,35,493,528,1.276795,103.836116
169363,29,642,671,1.276766,103.836076
169364,64,288,352,1.276733,103.836045
169365,16,681,697,1.276701,103.835992
169366,34,367,401,1.276667,103.835948
169367,64,497,561,1.276622,103.835883
169368,23,448,471,1.276595,103.835849
169369,63,647,710,1.276553,103.835812
169370,41,705,746,1.27652,103.835784
169371,6,293,299,1.276498,103.83576
169372,68,439,507,1.276474,103.83573
169373,35,983,1018,1.276451,103.835702
169374,41,621,662,1.276431,103.835674
169375,48,759,807,1.276402,103.835656
169376,69,608,677,1.276372,103.835629
169377,58,669,727,1.276358,103.835602
169378,43,543,586,1.276334,103.835563
169379,36,904,940,1.276308,103.835533
169380,19,867,886,1.276289,103.835503
169381,9,1203,1212,1.276231,103.835442
169382,154,6607,6761,1.276208,103.835418
169420,126,125,251,1.291245,103.835402
169421,7,284,291,1.291178,103.835167
169422,19,93,112,1.291292,103.835306
169479,1419,35,1454,1.285173,103.828522
169480,1067,1642,2709,1.285309,103.828215
169481,824,1844,2668,1.285469,103.828775
169482,10,51,61,1.284919,103.827322
169483,1549,737,2286,1.284713,103.827305
169485,537,465,1002,1.284578,103.826193
169541,119,1230,1349,1.277105,103.832499
169543,119,2241,2360,1.277055,103.832601
169544,6,5591,5597,1.278459,103.830813
169545,58,507,565,1.278631,103.829175
169546,35,279,314,1.279476,103.828086
169547,70,1559,1629,1.27693,103.833553
169565,328,703,1031,1.287502,103.829803
169566,38,439,477,1.287485,103.829339
169567,669,435,1104,1.286938,103.826625
169568,2013,47331,49344,1.287275,103.827865
169586,1413,1337,2750,1.289536,103.829618
169587,106,4,110,1.289773,103.830348
169588,1341,1965,3306,1.29008,103.829879
169608,15253,128286,143539,1.278978,103.834207
169609,3652,15121,18773,1.27834,103.835838
169610,2653,14707,17360,1.280106,103.837125
169611,14,4274,4288,1.277689,103.835633
169612,37,156,193,1.277926,103.835
169628,1659,5035,6694,1.289085,103.837406
169629,2530,25323,27853,1.289427,103.836535
169630,12,1308,1320,1.288528,103.838103
169631,3043,12113,15156,1.288468,103.83738
169632,1479,34201,35680,1.288404,103.836319
169633,1679,999,2678,1.287541,103.836424
169634,87,55,142,1.287747,103.835474
169635,14,1585,1599,1.289425,103.833255
169636,4,446,450,1.290005,103.832674
169637,46,774,820,1.290006,103.832466
169638,656,1704,2360,1.290173,103.831813
169639,3626,774,4400,1.290263,103.831429
169640,69,172,241,1.289567,103.830949
169641,227,1748,1975,1.28942,103.832004
169642,63,4329,4392,1.289215,103.828012
169643,8,270,278,1.289255,103.827977
169644,12,110,122,1.289281,103.827938
169645,13,407,420,1.289303,103.827893
169646,4,117,121,1.289325,103.827825
169647,82,222,304,1.289343,103.827786
169648,53,196,249,1.28937,103.827751
169649,4,116,120,1.289387,103.827726
169650,7,176,183,1.289419,103.827663
169651,53,151,204,1.289427,103.827645
169652,7,97,104,1.289447,103.827601
169653,49,148,197,1.28947,103.827555
169654,19,245,264,1.289491,103.827519
169655,8,124,132,1.289513,103.827471
169656,2,116,118,1.289545,103.827408
169657,3,2699,2702,1.289564,103.827378
169658,5272,3845,9117,1.289387,103.840773
169659,2788,5692,8480,1.289525,103.840528
169660,444,472,916,1.289828,103.840301
169661,916,151,1067,1.29024,103.841385
169662,1796,4333,6129,1.289502,103.835709
169663,5577,15885,21462,1.2903,103.835175
169664,306,1193,1499,1.290107,103.835028
169695,71,414,485,1.291293,103.831732
169715,77,3,80,1.283506,103.831822
169753,1242,97,1339,1.283415,103.835031
169756,35,270,305,1.283393,103.835088
169757,5,74,79,1.283437,103.835019
169758,6,82,88,1.28347,103.835155
169759,13,168,181,1.283502,103.834988
169760,43,19,62,1.283498,103.835101
169761,368,83,451,1.283505,103.834786
169762,16,7,23,1.283509,103.835073
169764,7,4,11,1.283542,103.835
169766,0,9,9,1.28355,103.834973
169767,115,10,125,1.283594,103.834533
169768,5,4,9,1.283563,103.834915
169769,5,49,54,1.283551,103.834654
169770,94,10,104,1.283589,103.834866
169771,4,107,111,1.28357,103.834595
169772,145,18,163,1.283604,103.834799
169773,1,2,3,1.280772,103.832123
169774,5,17,22,1.28362,103.834768
169775,7,82,89,1.283622,103.834441
169776,20,19,39,1.283633,103.834727
169777,12,99,111,1.283659,103.834351
169778,14,12,26,1.283648,103.83467
169779,13,9,22,1.28367,103.834622
169780,27,16,43,1.283679,103.834598
169781,102,28,130,1.283692,103.834559
169782,29,114,143,1.283713,103.8345
169783,49,23,72,1.283731,103.834446
169784,126,119,245,1.283742,103.834406
169785,54,700,754,1.283757,103.834366
169786,107,2064,2171,1.283781,103.834302
169787,17,1,18,1.284183,103.833814
169788,1,0,1,1.285033,103.833857
169789,3,32,35,1.284153,103.83384
169790,1,7,8,1.284168,103.83383
169791,4,0,4,1.284191,103.833809
169794,18,562,580,1.283434,103.835266
169795,6,184,190,1.283448,103.835216
169796,28,135,163,1.283562,103.83463
169797,0,70,70,1.299509,103.837
169813,894,569,1463,1.291898,103.825646
169814,1159,3634,4793,1.2919,103.825832
169831,5,154,159,1.291667,103.828388
169832,1,35,36,1.291655,103.829416
169833,2,82,84,1.291584,103.830367
169850,247,1392,1639,1.282396,103.836024
169851,33,12312,12345,1.281635,103.834839
169852,16,106,122,1.281355,103.833347
169853,2,18,20,1.281382,103.833316
169854,397,6104,6501,1.280353,103.833736
169855,6,87,93,1.280537,103.833306
169856,1899,11108,13007,1.281937,103.835924
169857,1729,19987,21716,1.281185,103.834145
169858,56,47,103,1.26418,103.819897
169874,188,1461,1649,1.287698,103.840408
169875,2351,4010,6361,1.287661,103.839943
169876,656,6864,7520,1.287186,103.84065
169877,955,3398,4353,1.286875,103.840078
169878,1206,2356,3562,1.286366,103.839303
169879,1014,2101,3115,1.285723,103.838384
169902,6,139,145,1.282106,103.830447
169903,9,437,446,1.282106,103.830447
169904,3,9,12,1.282106,103.830447
169905,1802,61,1863,1.281983,103.830367
169906,3,20,23,1.282106,103.830447
169907,1365,9,1374,1.28205,103.830177
169908,1,11,12,1.282106,103.830447
169909,0,5,5,1.282106,103.830447
169910,0,1,1,1.284175,103.833819
169911,0,3,3,1.283589,103.834547
169914,1,47,48,1.281951,103.830253
169915,1,4,5,1.281951,103.830253
169916,1,29,30,1.281951,103.830253
169917,0,23,23,1.281951,103.830253
169919,0,1,1,1.282106,103.830447
169920,0,16,16,1.291731,103.806631
169921,0,3,3,1.282106,103.830447
169922,0,1,1,1.281951,103.830253
169923,0,11,11,1.281951,103.830253
169924,0,4,4,1.281951,103.830253
169981,26,499,525,1.288825,103.828087
169982,50,204,254,1.288766,103.827528
178879,3627,6287,9914,1.290317,103.850899
178880,249,314,563,1.288575,103.850445
178881,7889,843,8732,1.295913,103.845489
178882,6353,69890,76243,1.293196,103.852879
178884,37,14,51,1.293542,103.851567
178885,53,700,753,1.294112,103.850831
178892,1114,1234,2348,1.293942,103.849996
178895,51,1259,1310,1.294765,103.849928
178897,2444,2095,4539,1.296892,103.84883
178898,8,115,123,1.295136,103.849293
178899,324,285,609,1.294866,103.850259
178900,101,979,1080,1.295622,103.850131
178901,1853,1234,3087,1.296653,103.850597
178902,715,1868,2583,1.296709,103.850094
178903,365,1324,1689,1.297598,103.84892
178905,316,82,398,1.293132,103.851439
178906,240,3665,3905,1.293508,103.851813
178907,79,3,82,1.29351,103.851318
178957,4115,2443,6558,1.289704,103.851285
178958,206,1742,1948,1.29068,103.851743
178959,170,1042,1212,1.292488,103.852315
179020,125,12,137,1.290373,103.844843
179021,361,26147,26508,1.291028,103.845262
179022,141,44,185,1.290833,103.846009
179023,66,117,183,1.289943,103.845707
179024,140,11049,11189,1.290668,103.846205
179030,7229,111875,119104,1.29178,103.844896
179031,6498,19337,25835,1.291202,103.844273
179032,3098,1050,4148,1.291777,103.845221
179033,53,3925,3978,1.292069,103.84398
179034,47,2134,2181,1.292669,103.844028
179037,169,3363,3532,1.291899,103.84567
179038,78,4378,4456,1.299509,103.837
179094,3565,7029,10594,1.28983,103.849601
179097,94,4244,4338,1.29133,103.850074
179098,371,16059,16430,1.292307,103.850442
179099,2798,37252,40050,1.292875,103.851386
179100,481,5024,5505,1.293171,103.852376
179101,19639,143418,163057,1.293497,103.852787
179102,566,11296,11862,1.294327,103.852436
179103,1293,2063,3356,1.294149,103.852807
179104,770,1719,2489,1.290132,103.849736
179225,32,1529,1561,1.293736,103.849796
179226,69,130,199,1.293773,103.849728
179227,3,15,18,1.293815,103.849654
179228,21,151,172,1.293844,103.84961
179229,15,69,84,1.293867,103.849567
179230,11,654,665,1.293888,103.849529
179290,94,1,95,1.292304,103.848387
179351,24,361,385,1.293898,103.850414
179352,81,8,89,1.293828,103.850372
179360,1753,226,1979,1.293457,103.849924
179364,28,945,973,1.293375,103.850119
179365,352,219,571,1.293309,103.850104
179366,60,1356,1416,1.292935,103.849662
179367,68,1056,1124,1.292462,103.849296
179369,2566,5966,8532,1.290863,103.84862
179429,475,169,644,1.288558,103.851072
179431,42,1211,1253,1.29025,103.849863
179432,4,215,219,1.290321,103.849745
179433,365,4015,4380,1.290516,103.849283
179434,4424,2625,7049,1.290576,103.849526
179435,27,529,556,1.290426,103.849624
179493,330,817,1147,1.29735,103.847447
179494,4464,2594,7058,1.297356,103.845205
179555,344,85,429,1.287408,103.851722
179556,842,4,846,1.288358,103.851278
179558,285,776,1061,1.288621,103.851462
179618,205,0,205,1.295382,103.846509
179619,1,19,20,1.295274,103.846524
179620,70,4,74,1.29517,103.846563
179622,180,456,636,1.295352,103.846214
179681,6279,5523,11802,1.288831,103.851995
179682,1808,3360,5168,1.292109,103.853703
179802,49,115,164,1.299509,103.837
179803,5979,16843,22822,1.291359,103.851346
179804,3829,21970,25799,1.29196,103.8502
179805,778,4377,5155,1.29194,103.849688
179806,617,919,1536,1.29234,103.849001
179807,293,294,587,1.292941,103.848701
179808,7,3,10,1.29282,103.848826
179809,2052,40306,42358,1.292896,103.850319
179868,329,550,879,1.293299,103.848598
179869,703,1422,2125,1.294358,103.848084
179870,20,207,227,1.295219,103.846794
179872,22,149,171,1.296183,103.846181
179932,199,283,482,1.293581,103.848699
179933,17,100,117,1.294065,103.849346
179934,275,204,479,1.294125,103.849387
179935,3,11,14,1.294238,103.849461
179936,153,552,705,1.2944,103.849339
179937,148,220,368,1.294452,103.849364
179938,135,352,487,1.294437,103.849567
179939,27,117,144,1.2945,103.849381
179940,402,763,1165,1.294624,103.849448
179941,565,394,959,1.29421,103.849198
179942,187,307,494,1.294176,103.849427
180001,70,1507,1577,1.302533,103.854911
180002,22,1118,1140,1.302418,103.855276
180008,254,371,625,1.303035,103.850449
180009,638,580,1218,1.303476,103.850154
180010,174,545,719,1.303729,103.85024
180231,762,3452,4214,1.297105,103.853681
180232,80,803,883,1.297033,103.853764
180233,120,1321,1441,1.296949,103.853896
180261,301,649,950,1.298717,103.851813
180262,114,645,759,1.29865,103.851657
180263,64,976,1040,1.298798,103.852002
180264,119,1081,1200,1.299144,103.852039
180269,92,15807,15899,1.300123,103.853827
180270,113,1168,1281,1.301057,103.854119
180271,87,145,232,1.300694,103.854318
180405,0,703,703,1.303168,103.85803
181003,40,611,651,1.302711,103.855211
181004,164,1056,1220,1.3025,103.854329
181008,24,201,225,1.303035,103.850449
181009,43,107,150,1.303476,103.850154
181269,25,3305,3330,1.300123,103.853827
182269,112,31106,31218,1.300123,103.853827
183269,22,476,498,1.300739,103.853553
187930,21,263,284,1.299509,103.837
187936,152,6626,6778,1.299509,103.837
187940,1658,219,1877,1.302902,103.8516
187945,9,52,61,1.302297,103.85087
187946,16,769,785,1.302251,103.851653
187947,57,138,195,1.301924,103.851337
187948,1615,2002,3617,1.300319,103.850843
187949,61,1534,1595,1.300064,103.850335
187950,403,555,958,1.298111,103.850713
187951,30,190,220,1.298372,103.850933
187952,10,101,111,1.298515,103.851104
187953,16,181,197,1.298601,103.85118
187954,79,195,274,1.298409,103.851298
187955,3,78,81,1.298429,103.851151
187956,17,238,255,1.298482,103.851186
187957,61,304,365,1.298637,103.851341
187958,96,637,733,1.298864,103.851531
187959,132,408,540,1.299071,103.851722
187960,28,7422,7450,1.299916,103.852597
187961,93,1532,1625,1.300604,103.852563
187962,41,5722,5763,1.30016,103.85279
187963,12,129,141,1.300761,103.852706
187964,79,12975,13054,1.300891,103.852837
187965,19,4574,4593,1.30108,103.852972
187966,21,4148,4169,1.301224,103.85317
187967,139,662,801,1.299247,103.85172
187968,37,475,512,1.298215,103.850807
187995,29,1028,1057,1.294146,103.851877
187996,5009,21861,26870,1.295262,103.851676
187997,72,2165,2237,1.29575,103.851322
187998,33,2227,2260,1.296061,103.851878
188016,553,990,1543,1.297116,103.852437
188017,50,1524,1574,1.29712,103.852434
188018,1841,7572,9413,1.297377,103.852691
188019,19,1054,1073,1.297797,103.853105
188020,135,790,925,1.298356,103.85315
188021,13667,113412,127079,1.299369,103.854921
188022,367,4562,4929,1.30031,103.855747
188023,80,5919,5999,1.300029,103.854933
188024,169,1028,1197,1.299617,103.855201
188025,10,646,656,1.30003,103.854926
188026,5,520,525,1.300061,103.854924
188027,2,237,239,1.300055,103.854931
188028,3,570,573,1.300026,103.854953
188029,81,2048,2129,1.300052,103.854927
188030,137,2263,2400,1.300458,103.855282
188031,21,3193,3214,1.300436,103.855311
188032,1,147,148,1.300452,103.855312
188033,12,1815,1827,1.300463,103.855304
188034,3,58,61,1.300453,103.855278
188035,6,711,717,1.300451,103.855304
188061,3840,36188,40028,1.302352,103.857864
188062,46,3936,3982,1.30073,103.856171
188063,3,805,808,1.297979,103.853004
188064,3124,7439,10563,1.297513,103.853937
188065,466,762,1228,1.29686,103.852202
188067,4393,2282,6675,1.299629,103.854302
188091,68,162,230,1.298131,103.856962
188092,15,90,105,1.298096,103.856958
188093,31,107,138,1.298146,103.856946
188094,56,9,65,1.298175,103.856925
188095,35,356,391,1.298203,103.856903
188096,4,2,6,1.298151,103.856905
188097,7,213,220,1.298239,103.856867
188098,217,1671,1888,1.298179,103.856879
188108,379,2242,2621,1.298343,103.856722
188115,0,17,17,1.299509,103.837
188116,2,424,426,1.299509,103.837
188117,46,166,212,1.29848,103.856591
188210,219,195,414,1.302865,103.850841
188211,37,179,216,1.302212,103.85041
188212,7,37,44,1.302094,103.850331
188213,23,122,145,1.302178,103.850349
188214,74,140,214,1.302143,103.850325
188216,204,2215,2419,1.303684,103.851552
188306,746,7194,7940,1.300126,103.849316
188307,4874,105907,110781,1.300626,103.849458
188308,103,3822,3925,1.302147,103.850222
188309,53,1881,1934,1.302735,103.849944
188310,7,932,939,1.302778,103.849948
188312,30,899,929,1.303048,103.849956
188313,12,189,201,1.302988,103.84995
188314,20,373,393,1.303012,103.849947
188315,3,627,630,1.303071,103.849956
188316,30,1091,1121,1.303108,103.849958
188317,4,530,534,1.303249,103.849999
188318,300,1810,2110,1.303532,103.849878
188319,5,1852,1857,1.303662,103.850038
188320,10,969,979,1.303278,103.85
188321,6,1124,1130,1.303288,103.849999
188322,32,557,589,1.303311,103.849999
188323,0,366,366,1.303529,103.850016
188324,0,562,562,1.303592,103.850027
188325,5,386,391,1.303643,103.850033
188326,0,213,213,1.303707,103.850057
188327,1,294,295,1.303736,103.850077
188328,0,21,21,1.303758,103.850076
188329,10,477,487,1.303262,103.849844
188330,1,271,272,1.303798,103.850079
188331,1,2269,2270,1.303824,103.850082
188332,170,1720,1890,1.30391,103.850088
188333,13,2060,2073,1.304309,103.85036
188334,4,1354,1358,1.304323,103.850365
188335,0,8,8,1.304351,103.850378
188336,31,80,111,1.304367,103.850388
188337,2,372,374,1.304392,103.850408
188338,0,7,7,1.304421,103.850426
188339,2,166,168,1.30444,103.850452
188340,5,1,6,1.304449,103.85046
188341,5,84,89,1.304461,103.850461
188343,7,476,483,1.304505,103.850494
188344,9,552,561,1.304517,103.850501
188345,4,551,555,1.304538,103.850514
188346,13,490,503,1.304553,103.850523
188347,28,396,424,1.304569,103.850537
188348,5,136,141,1.304584,103.850551
188349,1,240,241,1.304604,103.85056
188351,103,10114,10217,1.300158,103.849692
188379,33,63,96,1.29582,103.854808
188381,162,1627,1789,1.296264,103.854453
188382,120,339,459,1.296308,103.854394
188383,44,511,555,1.296246,103.854492
188384,20,250,270,1.296213,103.85453
188385,35,441,476,1.296179,103.854555
188386,34,586,620,1.296161,103.854581
188387,20,274,294,1.296144,103.854606
188388,47,234,281,1.296118,103.854641
188389,26,113,139,1.296101,103.854675
188390,11,313,324,1.296084,103.8547
188391,20,150,170,1.296041,103.854752
188392,28,210,238,1.296007,103.854803
188394,100,312,412,1.295947,103.85488
188395,70,237,307,1.295929,103.854897
188396,4072,1415,5487,1.295845,103.855091
188425,493,9012,9505,1.301531,103.854515
188426,84,2258,2342,1.301204,103.855007
188427,9,0,9,1.30128,103.854994
188428,0,1,1,1.281951,103.830253
188429,0,814,814,1.301189,103.85508
188430,0,535,535,1.301141,103.855128
188431,0,28,28,1.3011,103.855169
188432,4,0,4,1.301045,103.855213
188433,3,50,53,1.300997,103.855256
188434,3,0,3,1.281951,103.830253
188435,0,737,737,1.300892,103.855361
188436,1,1,2,1.285235,103.834784
188437,3,4,7,1.3008,103.855465
188438,5,0,5,1.300758,103.855498
188439,2,0,2,1.300841,103.855417
188440,1,1,2,1.300717,103.855546
188441,0,262,262,1.300695,103.855566
188451,20,322,342,1.299374,103.856809
188475,20,1606,1626,1.298728,103.857363
188476,67,1600,1667,1.300204,103.855919
188504,2729,47784,50513,1.302731,103.853171
188505,214,3646,3860,1.303001,103.853069
188533,137,78,215,1.29605,103.851232
188534,126,1408,1534,1.297176,103.851602
188535,55,214,269,1.297314,103.851683
188536,57,795,852,1.297925,103.852226
188537,1563,1724,3287,1.29806,103.852573
188538,110,2893,3003,1.299985,103.853885
188539,110,6594,6704,1.299985,103.853885
188540,11,4301,4312,1.300665,103.854407
188541,15,3328,3343,1.300614,103.854665
188542,8,670,678,1.300853,103.854571
188543,19,3340,3359,1.300887,103.854871
188544,5,120,125,1.301017,103.854694
188545,0,62,62,1.300888,103.854872
188546,33,1789,1822,1.301193,103.854884
188548,29,392,421,1.297925,103.852046
188549,419,1388,1807,1.297916,103.851863
188550,432,2443,2875,1.297637,103.851831
188551,207,76,283,1.297439,103.851668
188552,25,648,673,1.297367,103.851428
188553,3339,1496,4835,1.297675,103.85216
188555,46,5598,5644,1.30237,103.855928
188581,176,667,843,1.296834,103.854813
188582,15,75,90,1.296781,103.854881
188583,12,269,281,1.296747,103.854916
188584,374,29,403,1.296712,103.854962
188585,46,126,172,1.296683,103.855008
188586,50,213,263,1.296644,103.855053
188587,50,91,141,1.296617,103.855081
188588,165,154,319,1.296585,103.855119
188590,42,250,292,1.29656,103.855164
188591,100,59,159,1.296527,103.855202
188592,645,138,783,1.296499,103.85525
188593,496,80,576,1.296484,103.855266
188594,36,140,176,1.296448,103.855309
188595,64,41,105,1.296404,103.855368
188596,54,74,128,1.296369,103.855409
188597,43,51,94,1.296336,103.855461
188598,66,130,196,1.296301,103.855493
188600,51,364,415,1.296156,103.855496
188601,1,85,86,1.296154,103.855399
188602,10,88,98,1.296197,103.855314
188603,96,208,304,1.296249,103.855245
188605,5,66,71,1.296387,103.85524
188607,29,166,195,1.296422,103.855187
188608,51,339,390,1.296441,103.855159
188613,1586,77,1663,1.296587,103.854956
188647,45,8470,8515,1.299129,103.849211
188648,8,814,822,1.29926,103.849366
188649,55,1636,1691,1.301691,103.851148
188653,28,418,446,1.301628,103.851295
188654,2,385,387,1.301753,103.851421
188655,288,790,1078,1.301994,103.851601
188656,12,373,385,1.302243,103.851829
188657,98,677,775,1.302458,103.851997
188659,24,210,234,1.302195,103.851795
188660,49,388,437,1.299843,103.849782
188661,438,959,1397,1.299906,103.849866
188662,29,699,728,1.299946,103.8499
188663,21,303,324,1.300095,103.850042
188664,29,96,125,1.299792,103.849737
188665,14,429,443,1.299409,103.849519
188666,10,285,295,1.299439,103.849545
188667,67,1107,1174,1.299854,103.849815
188668,164,1273,1437,1.299877,103.849843
188669,21,1107,1128,1.300038,103.849991
188670,23,566,589,1.299463,103.849571
188671,100,1645,1745,1.299992,103.849946
188672,30,0,30,1.299638,103.84968
188673,12,53,65,1.299568,103.849627
188674,1,27,28,1.299575,103.849636
188675,24,1,25,1.299593,103.84965
188676,13,620,633,1.2996,103.849659
188677,17,0,17,1.299608,103.849661
188678,13,31,44,1.299625,103.84967
188679,1,281,282,1.299638,103.849685
188680,3,3,6,1.29965,103.849692
188682,10,7,17,1.299695,103.849717
188683,0,42,42,1.299705,103.849723
188684,12,567,579,1.299722,103.849732
188685,5,26,31,1.299639,103.849653
188686,7,113,120,1.299672,103.849671
188690,279,1817,2096,1.3031,103.855513
188719,1075,3809,4884,1.29583,103.854053
188720,4229,3075,7304,1.296265,103.853111
188721,301,9043,9344,1.295896,103.853543
188722,95,8159,8254,1.296577,103.854379
188725,34,2798,2832,1.296667,103.854354
188726,158,5698,5856,1.296835,103.854543
188727,240,4535,4775,1.297395,103.854914
188728,51,6279,6330,1.297597,103.855204
188729,12,838,850,1.297298,103.85474
188730,1,493,494,1.297347,103.854789
188731,9,1249,1258,1.29753,103.854919
188732,44,7701,7745,1.297796,103.85512
188733,10,723,733,1.297918,103.855233
188734,21,1142,1163,1.297884,103.855343
188735,375,36532,36907,1.298285,103.855493
188736,118,19100,19218,1.298373,103.855557
188737,21,1245,1266,1.29842,103.855601
188738,21,885,906,1.298466,103.855637
188739,50,2443,2493,1.298541,103.855687
188740,110,6714,6824,1.298718,103.855772
188742,23,1184,1207,1.298824,103.855844
188747,33,661,694,1.298958,103.855933
188749,87,8148,8235,1.298984,103.855957
188770,7504,11103,18607,1.301171,103.857198
188778,11033,4288,15321,1.300191,103.857614
188797,58,3461,3519,1.301389,103.85824
188798,48,758,806,1.301446,103.858291
188799,20,342,362,1.301471,103.858288
188800,23,247,270,1.301475,103.858341
188801,45,644,689,1.301525,103.85835
188802,37,892,929,1.301528,103.858384
188803,13,910,923,1.30156,103.85841
188804,83,2823,2906,1.301642,103.858468
188805,12,992,1004,1.301706,103.858466
188806,7,80,87,1.301741,103.858488
188807,52,2991,3043,1.301791,103.858519
188836,20,538,558,1.297226,103.858657
188865,6,0,6,1.300635,103.854873
188866,4,15,19,1.300574,103.854817
188867,13,4,17,1.300599,103.854893
188868,15,39,54,1.300467,103.854936
188869,0,3,3,1.300951,103.855315
188870,0,3,3,1.300554,103.854944
188899,54,3563,3617,1.296762,103.852924
188928,2,275,277,1.296784,103.856228
188929,2,61,63,1.297844,103.855758
188930,1,416,417,1.296823,103.856204
188931,451,288,739,1.296858,103.855824
188932,0,180,180,1.296892,103.85613
188933,0,4,4,1.296893,103.85576
188934,3,803,806,1.296933,103.85609
188935,0,11,11,1.299509,103.837
188936,9,596,605,1.296985,103.856046
188938,0,62,62,1.297026,103.85599
188939,0,97,97,1.297038,103.855616
188940,2,24,26,1.297082,103.855928
188941,0,26,26,1.297123,103.855877
188942,809,221,1030,1.297089,103.855505
188943,16,1027,1043,1.297163,103.855822
188945,1,665,666,1.297241,103.855737
188946,21,17,38,1.29712,103.855458
188947,5,122,127,1.29727,103.855695
188949,4,570,574,1.297293,103.855675
188950,26,1426,1452,1.29716,103.855406
188951,4,313,317,1.297322,103.855633
188952,5,3,8,1.297189,103.855348
188953,5,624,629,1.29734,103.855617
188954,17,12,29,1.29724,103.855276
188956,1,491,492,1.29737,103.855577
188958,2,206,208,1.297406,103.855543
188959,14,27,41,1.297269,103.855244
188960,2,461,463,1.297435,103.855501
188961,5,195,200,1.297305,103.855208
188962,2,179,181,1.297472,103.85547
188963,4,563,567,1.297509,103.855416
188966,4736,10286,15022,1.298141,103.854678
188967,53,2155,2208,1.298729,103.853878
188968,50,1007,1057,1.298833,103.853724
188969,268,6651,6919,1.298824,103.853511
188970,46,2046,2092,1.298944,103.85363
188971,61,3959,4020,1.299047,103.853477
188972,46,7474,7520,1.299167,103.853323
188973,13043,10531,23574,1.299523,103.853104
188974,230,2137,2367,1.299333,103.852923
188975,130,710,840,1.29943,103.852738
188976,74,421,495,1.299597,103.852556
188977,44,2603,2647,1.299862,103.852221
188978,73,759,832,1.299959,103.852077
188979,629,2103,2732,1.300405,103.852241
188980,5896,4239,10135,1.300743,103.851281
188983,48,4315,4363,1.301373,103.850672
188984,2,54,56,1.301294,103.850525
188985,2,2,4,1.301354,103.850446
188986,0,1,1,1.301233,103.855032
188987,5,13,18,1.301406,103.850491
188988,9,2302,2311,1.301504,103.850446
188989,4,610,614,1.30143,103.850373
188990,9,605,614,1.301482,103.850293
188991,7,726,733,1.301615,103.850247
188992,11,3512,3523,1.301539,103.85023
188993,30,12132,12162,1.301613,103.850156
188994,597,7290,7887,1.301251,103.851242
188995,579,718,1297,1.297075,103.855564
189022,370,403,773,1.297708,103.856581
189023,34,604,638,1.297787,103.85662
189025,0,44,44,1.297795,103.856605
189027,15,173,188,1.29781,103.85659
189029,131,1,132,1.29783,103.856574
189031,24,207,231,1.297855,103.856557
189033,26,48,74,1.297881,103.856535
189035,14,105,119,1.297902,103.856514
189037,6,115,121,1.297939,103.856473
189039,6,132,138,1.29796,103.856459
189041,2,176,178,1.297987,103.85644
189043,11,165,176,1.298017,103.856412
189045,6,179,185,1.298065,103.856377
189047,24,204,228,1.298108,103.856339
189049,10,190,200,1.298151,103.856301
189051,8,156,164,1.298188,103.856263
189053,35,13,48,1.298229,103.856215
189054,171,152,323,1.298309,103.856065
189055,17,395,412,1.298284,103.856164
189056,3,20,23,1.298353,103.856033
189057,67,121,188,1.298345,103.856114
189058,6,178,184,1.298398,103.855987
189059,6,189,195,1.298419,103.85606
189060,3,419,422,1.298474,103.856018
189195,24,12,36,1.300341,103.859518
189196,18,419,437,1.300228,103.859456
189197,6,4,10,1.300364,103.859484
189198,0,13,13,1.300287,103.859394
189200,7,90,97,1.300353,103.85933
189201,32,1,33,1.300398,103.859444
189202,8,5,13,1.300393,103.85929
189203,19,2,21,1.300421,103.859427
189204,5,5,10,1.300427,103.859256
189205,1,0,1,1.301383,103.850468
189206,0,1,1,1.300438,103.859415
189208,2,4,6,1.300467,103.859216
189209,0,1,1,1.300393,103.859286
189210,3,0,3,1.300478,103.855001
189211,0,1,1,1.30049,103.85937
189212,10,0,10,1.300536,103.859159
189213,5,2,7,1.30053,103.859324
189214,4,0,4,1.300576,103.859119
189215,0,1,1,1.300513,103.859347
189216,8,2,10,1.300616,103.859097
189217,1,2,3,1.300496,103.859188
189218,6,0,6,1.300662,103.859068
189219,8,1,9,1.30061,103.85925
189221,1,0,1,1.300559,103.859302
189222,1,0,1,1.300639,103.859222
189223,1,1,2,1.300913,103.855268
189224,2,0,2,1.300673,103.85921
189225,0,1,1,1.300725,103.859017
189226,0,2,2,1.300765,103.858988
189228,0,1,1,1.300696,103.859184
189229,6,0,6,1.300759,103.859142
189230,0,1,1,1.300856,103.858897
189231,1,2,3,1.300579,103.859272
189232,2,1,3,1.300794,103.859119
189233,0,1,1,1.300902,103.858869
189234,1,1,2,1.300816,103.858932
189235,5,0,5,1.300851,103.859074
189236,1,1,2,1.300977,103.858812
189237,5,1,6,1.300879,103.859057
189238,1,2,3,1.300931,103.858852
189239,1,2,3,1.301045,103.858732
189240,1,0,1,1.300828,103.859097
189242,1,0,1,1.301097,103.858709
189243,2,0,2,1.301005,103.858766
189244,1,0,1,1.301123,103.858683
189248,2,0,2,1.300971,103.858994
189250,1,0,1,1.301148,103.858652
189251,0,1,1,1.301269,103.858578
189252,2,0,2,1.301223,103.858607
189253,2,0,2,1.301297,103.858556
189254,1,0,1,1.301074,103.858903
189255,2,1,3,1.300908,103.85904
189256,6,0,6,1.301332,103.858521
189257,1,1,2,1.301097,103.85888
189260,1,1,2,1.30116,103.858829
189261,2,1,3,1.30112,103.858863
189262,19,0,19,1.301441,103.858453
189264,1,1,2,1.301406,103.858476
189265,0,1,1,1.301315,103.858544
189266,1,1,2,1.301458,103.858447
189268,3,0,3,1.301249,103.858745
189270,0,1,1,1.301315,103.858675
189271,5,0,5,1.301464,103.858573
189272,2,0,2,1.301475,103.858442
189273,1,0,1,1.301458,103.858578
189350,65,886,951,1.300213,103.857031
189352,1747,3477,5224,1.300158,103.857087
189354,31,1018,1049,1.300049,103.8572
189356,146,11762,11908,1.29994,103.857312
189554,4040,13731,17771,1.297919,103.850242
189555,651,1398,2049,1.296822,103.851099
189556,717,3973,4690,1.296869,103.851573
189557,582,780,1362,1.296451,103.851586
189558,3290,51692,54982,1.295621,103.852705
189559,4031,10802,14833,1.298775,103.848947
189560,6303,44807,51110,1.293396,103.853462
189561,71,1465,1536,1.296811,103.850884
189562,60,1303,1363,1.293179,103.855524
189619,1987,2714,4701,1.29865,103.849797
189620,66,3704,3770,1.298829,103.850083
189621,14,1345,1359,1.298567,103.850262
189623,3,211,214,1.29893,103.850167
189624,8,525,533,1.299103,103.850546
189626,1169,150,1319,1.2992,103.850312
189627,1557,341,1898,1.299162,103.850561
189628,6,167,173,1.299134,103.850532
189630,2438,259,2697,1.299349,103.850578
189631,4,86,90,1.299103,103.850546
189634,31,143,174,1.299297,103.850513
189637,27,2831,2858,1.300805,103.851756
189638,3,71,74,1.300852,103.851752
189639,31,5713,5744,1.300859,103.851828
189640,12,727,739,1.301517,103.85217
189641,20,370,390,1.301517,103.85217
189642,975,14179,15154,1.301546,103.852405
189643,6,248,254,1.299551,103.850586
189645,42,1239,1281,1.299545,103.850779
189646,1396,8897,10293,1.301883,103.853117
189647,829,4533,5362,1.301841,103.8529
189648,237,0,237,1.301841,103.8529
189649,631,6508,7139,1.302198,103.852494
189650,123,71,194,1.302018,103.852486
189651,2093,77,2170,1.302018,103.852486
189652,813,4964,5777,1.300287,103.851193
189653,113,301,414,1.29944,103.850675
189654,31,182,213,1.298964,103.850405
189655,171,360,531,1.299834,103.851217
189656,70,1297,1367,1.30111,103.85185
189657,3817,1577,5394,1.301374,103.852262
189658,7,280,287,1.299509,103.837
189673,4364,25341,29705,1.295791,103.854043
189675,328,2691,3019,1.295431,103.8552
189676,51,840,891,1.303821,103.863731
189677,392,2596,2988,1.295823,103.855565
189678,85,1855,1940,1.296,103.855918
189680,51,493,544,1.296085,103.855986
189681,12,22,34,1.296183,103.855945
189682,22,504,526,1.296183,103.855945
189683,38,847,885,1.296253,103.856058
189684,3,82,85,1.296277,103.856079
189685,61,915,976,1.296389,103.856182
189686,2,355,357,1.296724,103.856416
189687,4,209,213,1.296761,103.856431
189688,60,1549,1609,1.296827,103.85649
189689,43,2064,2107,1.296888,103.856537
189692,560,939,1499,1.297445,103.856401
189694,312,1702,2014,1.297057,103.856666
189695,69,288,357,1.297097,103.856693
189696,17,2351,2368,1.297156,103.856738
189697,1,47,48,1.297205,103.856769
189698,0,185,185,1.297249,103.85679
189699,145,1991,2136,1.29728,103.856818
189700,16,2557,2573,1.297317,103.856846
189701,36,925,961,1.296635,103.857251
189702,3994,18853,22847,1.296485,103.856559
189703,124,4695,4819,1.297604,103.85709
189704,1060,2716,3776,1.297719,103.857215
189705,103,3220,3323,1.296451,103.857387
189706,11,142,153,1.297221,103.85837
189707,1,348,349,1.297939,103.857412
189720,9312,7444,16756,1.298709,103.85862
189721,8656,11015,19671,1.299117,103.858961
189753,533,6145,6678,1.300116,103.860039
189754,47,2120,2167,1.300137,103.859678
189755,16,250,266,1.300183,103.859706
189756,48,66,114,1.300223,103.859752
189757,41,28,69,1.300262,103.859814
189761,28,1398,1426,1.295099,103.856159
189762,200,1227,1427,1.294407,103.856237
189763,18726,13306,32032,1.293776,103.855545
189764,181,3232,3413,1.299509,103.837
189765,190,1733,1923,1.299509,103.837
189766,451,8972,9423,1.295954,103.856265
189767,9927,35,9962,1.295839,103.856329
189768,24,1086,1110,1.295774,103.855863
189845,14,684,698,1.300576,103.8589
189846,21,330,351,1.300633,103.858862
189847,75,895,970,1.300509,103.858949
189848,552,924,1476,1.300575,103.858943
189849,32,1474,1506,1.300682,103.858841
189850,20,618,638,1.300737,103.858903
189851,16,755,771,1.300886,103.858668
189852,76,1198,1274,1.300763,103.85885
189853,47,1686,1733,1.300823,103.858792
189854,116,1897,2013,1.3007,103.858805
189855,5,1041,1046,1.30087,103.858767
189856,75,1701,1776,1.300773,103.858746
189857,22,293,315,1.300979,103.858599
189858,65,223,288,1.30083,103.8587
189859,12,79,91,1.301049,103.858528
189860,11,47,58,1.300918,103.858635
189861,6,38,44,1.301135,103.858449
189862,9,17,26,1.301,103.858554
189863,4,30,34,1.301229,103.858368
189864,8,9,17,1.301078,103.858494
189865,3,34,37,1.300811,103.858732
189866,12,26,38,1.301169,103.858409
189867,2,3,5,1.30131,103.858421
189868,3,4,7,1.30127,103.858334
189869,7,1,8,1.30137,103.858373
189969,215,7849,8064,1.302026,103.853648
189970,2247,2067,4314,1.303523,103.851267
189971,6480,2358,8838,1.304213,103.850834
190001,230,57616,57846,1.303492,103.864359
190002,240,9390,9630,1.30386,103.864834
190003,213,356,569,1.304415,103.865374
190004,318,3355,3673,1.304766,103.865086
190005,4,2,6,1.30436,103.864627
190006,9,597,606,1.30404,103.864256
190007,209,321,530,1.304595,103.863372
190008,21,353,374,1.304865,103.863661
190009,415,2890,3305,1.305141,103.864063
190010,220,11296,11516,1.30551,103.863471
190011,9,8068,8077,1.299509,103.837
190012,55,3371,3426,1.304397,103.862711
190013,90,195,285,1.304569,103.862728
190014,2,37,39,1.303684,103.863006
190015,72,162,234,1.303408,103.8633
190016,6,237,243,1.299509,103.837
190017,163,500,663,1.303645,103.8635
190018,89,244,333,1.303158,103.862272
190019,159,90,249,1.303593,103.862021
190461,197,1313,1510,1.305054,103.860832
190462,181,5805,5986,1.304635,103.861205
190463,184,326,510,1.305143,103.862027
190464,62,6702,6764,1.30495,103.862487
190465,87,301,388,1.305194,103.862594
190466,192,432,624,1.305131,103.862478
190467,56,41,97,1.305223,103.862775
190468,138,2337,2475,1.305462,103.863133
191004,2,114,116,1.304604,103.86475
191462,15,1946,1961,1.304901,103.860769
191465,57,6062,6119,1.305287,103.862963
198347,2,539,541,1.303849,103.858379
198348,0,4,4,1.302885,103.857786
198349,0,37,37,1.303022,103.857912
198350,0,1,1,1.301504,103.858556
198351,2,660,662,1.304509,103.85908
198352,0,113,113,1.304574,103.85915
198353,0,44,44,1.304559,103.859171
198354,0,52,52,1.304604,103.8592
198355,0,3,3,1.301475,103.858419
198356,2,44,46,1.304625,103.859259
198357,0,58,58,1.304672,103.859284
198358,0,22,22,1.304694,103.859296
198359,0,5,5,1.304723,103.859295
198360,0,51,51,1.304768,103.859375
198361,0,31,31,1.304773,103.859381
198362,0,58,58,1.304827,103.859416
198363,0,46,46,1.30485,103.859447
198364,0,66,66,1.30485,103.859487
198365,0,32,32,1.3049,103.859536
198366,0,57,57,1.304893,103.859573
198368,0,137,137,1.304974,103.859625
198369,0,299,299,1.304971,103.859637
198370,24,12777,12801,1.30509,103.859811
198371,1,413,414,1.305139,103.859814
198372,47,599,646,1.305655,103.861486
198423,223,2917,3140,1.303878,103.857586
198424,258,251,509,1.304481,103.8575
198474,122,1571,1693,1.301162,103.860932
198475,2,1,3,1.304627,103.859221
198476,0,5,5,1.301444,103.860742
198477,42,30,72,1.301468,103.860723
198478,3,14,17,1.301446,103.860832
198479,1,10,11,1.301492,103.860702
198480,0,3,3,1.301423,103.860752
198481,6,7,13,1.301524,103.860678
198482,0,2,2,1.301475,103.858578
198483,0,8,8,1.301551,103.860658
198484,0,12,12,1.301543,103.860767
198485,27,13,40,1.301443,103.860775
198486,2,7,9,1.301556,103.860753
198487,0,10,10,1.301496,103.860734
198488,3,25,28,1.301582,103.860737
198489,1,20,21,1.301541,103.860696
198490,2,100,102,1.301597,103.860728
198491,11,100,111,1.301623,103.860641
198492,2,156,158,1.301592,103.86067
198493,2,16,18,1.301795,103.860521
198496,41,103,144,1.302282,103.860306
198497,186,51,237,1.302243,103.860201
198498,15,35,50,1.302377,103.860293
198500,7,49,56,1.303018,103.86058
198501,25,54,79,1.303091,103.859858
198552,0,152,152,1.304997,103.857349
198553,6,352,358,1.305447,103.858142
198604,20,153,173,1.301798,103.860689
198605,2,6,8,1.301827,103.860742
198606,8,1,9,1.301857,103.860796
198607,0,4,4,1.301883,103.860842
198608,28,2,30,1.301911,103.860896
198609,23,2,25,1.301936,103.860936
198611,7,2,9,1.301983,103.861009
198612,3,9,12,1.302013,103.861045
198613,16,28,44,1.302042,103.861081
198614,161,70,231,1.302066,103.861114
198615,13,114,127,1.302128,103.861201
198617,44,10,54,1.302179,103.861231
198620,40,47,87,1.302223,103.861324
198623,1,80,81,1.301872,103.860937
198674,36,2701,2737,1.302045,103.858532
198675,39,1,40,1.302069,103.858557
198676,21,87,108,1.302114,103.858577
198677,29,607,636,1.302166,103.858603
198678,7,899,906,1.302214,103.858625
198679,10,550,560,1.302246,103.85863
198680,10,1086,1096,1.30245,103.858567
198681,27,1234,1261,1.302284,103.858656
198685,4,564,568,1.302492,103.858754
198686,51,877,928,1.302602,103.858969
198687,0,42,42,1.302522,103.858774
198688,1,115,116,1.302622,103.858989
198689,13,47,60,1.302546,103.858786
198690,1,148,149,1.302651,103.858968
198691,2,16,18,1.302609,103.858814
198692,1,127,128,1.302705,103.85902
198693,4,9,13,1.302644,103.858837
198694,7,925,932,1.302743,103.859003
198695,10,23,33,1.30269,103.858865
198696,2,0,2,1.3015,103.860791
198697,15,240,255,1.302718,103.858882
198698,2,0,2,1.302722,103.859081
198699,21,477,498,1.302751,103.858903
198700,8,68,76,1.302799,103.859136
198701,10,292,302,1.302911,103.858984
198702,38,496,534,1.302816,103.859195
198703,9,244,253,1.302932,103.859004
198704,24,587,611,1.302844,103.859218
198705,35,371,406,1.302947,103.859017
198706,21,53,74,1.302991,103.859135
198707,0,188,188,1.302965,103.859041
198708,2,1410,1412,1.302867,103.859221
198709,6,245,251,1.302987,103.859065
198710,21,635,656,1.303097,103.859237
198711,18,396,414,1.303014,103.859108
198712,3,464,467,1.303036,103.859386
198713,60,351,411,1.30304,103.859132
198714,9,387,396,1.303079,103.859416
198715,17,739,756,1.303067,103.859162
198716,30,107,137,1.303073,103.859429
198717,23,449,472,1.303214,103.859312
198718,7,82,89,1.303211,103.859378
198719,5,232,237,1.303219,103.859332
198720,11,157,168,1.303147,103.859522
198721,12,157,169,1.303229,103.859336
198722,5,42,47,1.303173,103.859559
198723,13,34,47,1.303241,103.859342
198724,1,190,191,1.303179,103.859578
198725,9,187,196,1.303275,103.859381
198726,5,48,53,1.303225,103.859587
198727,112,140,252,1.303315,103.859433
198728,1,23,24,1.303254,103.859628
198729,18,84,102,1.303355,103.859478
198730,4,10,14,1.303276,103.859708
198731,6,6,12,1.303371,103.859512
198732,0,13,13,1.303323,103.859714
198733,77,0,77,1.303396,103.859529
198734,8,39,47,1.303325,103.859757
198735,1,7,8,1.303436,103.859573
198736,18,99,117,1.303377,103.859821
198737,168,142,310,1.303531,103.859706
198738,12,147,159,1.303454,103.859661
198739,3,87,90,1.303538,103.859728
198740,4,101,105,1.303497,103.859705
198741,0,84,84,1.30355,103.859749
198742,6,114,120,1.303444,103.859893
198743,8,93,101,1.303569,103.859761
198744,8,123,131,1.303478,103.859926
198745,1,70,71,1.303574,103.859779
198746,15,1,16,1.303471,103.859986
198747,20,146,166,1.30359,103.859795
198748,6,103,109,1.303488,103.860012
198749,2,1,3,1.301474,103.860811
198750,4,178,182,1.303519,103.860024
198751,31,281,312,1.303627,103.859844
198752,0,96,96,1.303536,103.860088
198753,70,861,931,1.303664,103.859887
198754,27,409,436,1.303589,103.86012
198755,59,99,158,1.30369,103.859931
198756,9,265,274,1.303623,103.859895
198757,29,717,746,1.30371,103.859967
198758,14,902,916,1.303688,103.859994
198759,31,57,88,1.303807,103.860119
198761,1,156,157,1.303865,103.860176
198762,2,265,267,1.30369,103.860245
198763,9,73,82,1.303905,103.860227
198764,11,366,377,1.303714,103.860307
198765,50,136,186,1.303945,103.860278
198766,4,157,161,1.303789,103.86014
198767,1,0,1,1.30316,103.858038
198768,1,201,202,1.303828,103.860195
198769,7,293,300,1.304014,103.860375
198770,0,78,78,1.303881,103.860275
198771,0,1,1,1.303974,103.86033
198772,11,104,115,1.303946,103.86038
198773,4,211,215,1.304077,103.860472
198774,7,185,192,1.303981,103.860445
198775,3,316,319,1.304088,103.860517
198776,7,166,173,1.304034,103.860506
198777,15,2141,2156,1.304111,103.860546
198778,3,243,246,1.303873,103.86056
198779,5,60,65,1.303937,103.860669
198780,15,550,565,1.303897,103.860623
198781,23,6050,6073,1.303943,103.860674
198782,13,2747,2760,1.30618,103.863981
198783,32,4442,4474,1.305398,103.863889
198784,1564,6626,8190,1.305775,103.864343
198785,231,370,601,1.30591,103.864495
198786,0,176,176,1.303568,103.859941
198833,93,150,243,1.302378,103.859497
198884,73,302,375,1.302361,103.859668
198885,89,32,121,1.302321,103.8597
198886,5,41,46,1.302284,103.859724
198887,31,34,65,1.302253,103.859748
198888,4,30,34,1.302221,103.859771
198889,25,23,48,1.302176,103.859796
198890,36,24,60,1.302145,103.85982
198891,22,35,57,1.302109,103.859844
198892,51,15,66,1.302083,103.859863
198893,8,14,22,1.302051,103.859889
198894,8,8,16,1.303471,103.859986
198895,4,12,16,1.301951,103.859972
198896,15,23,38,1.30191,103.859988
198897,39,17,56,1.301882,103.860017
198898,9,18,27,1.301841,103.860041
198899,20,8,28,1.301803,103.860068
198900,18,13,31,1.301767,103.860089
198901,183,7,190,1.30172,103.860124
198902,10,15,25,1.301685,103.860153
198903,77,86,163,1.30202,103.859999
198904,22,70,92,1.301639,103.860186
198906,618,401,1019,1.301581,103.860228
198958,0,241,241,1.30184,103.861989
198959,4,138,142,1.3019,103.861929
198960,0,395,395,1.301927,103.861915
198962,0,6,6,1.301971,103.861884
198963,0,18,18,1.301998,103.86187
198964,5,57,62,1.30202,103.861862
198965,1506,150,1656,1.30205,103.861841
198966,1,142,143,1.302085,103.861823
198967,3,119,122,1.302112,103.861797
198968,2,107,109,1.302146,103.861779
198969,2,168,170,1.302169,103.861767
198970,4,221,225,1.302203,103.861743
198971,5,336,341,1.302228,103.86173
198972,3,365,368,1.302251,103.86171
198973,19,2251,2270,1.302283,103.86169
198975,15,1685,1700,1.302431,103.861625
198976,19,1310,1329,1.302452,103.861603
198977,8,664,672,1.302483,103.861582
198978,13,1338,1351,1.302516,103.861555
198979,14,571,585,1.302568,103.861495
198980,4,666,670,1.30261,103.86147
198981,4,459,463,1.30265,103.861442
198982,3,418,421,1.302684,103.861414
198983,6,442,448,1.302724,103.861394
198984,4,748,752,1.302759,103.861359
198985,208,54,262,1.302789,103.861332
198986,4,1488,1492,1.302824,103.861313
198987,3,1197,1200,1.302862,103.861293
198988,6,1017,1023,1.302897,103.861284
198989,6,1228,1234,1.302926,103.861262
198990,6,1015,1021,1.302963,103.861243
198991,6,905,911,1.302996,103.861218
198992,9,998,1007,1.303023,103.861194
198993,9,935,944,1.303056,103.861167
198994,2,231,233,1.303077,103.861157
198995,19,211,230,1.30311,103.86114
198997,0,7,7,1.303145,103.86112
198998,8,5,13,1.303172,103.861101
198999,5,2,7,1.303238,103.861062
199000,99,43214,43313,1.303273,103.861039
199001,998,12849,13847,1.302832,103.861969
199002,774,6,780,1.303311,103.861017
199003,0,134,134,1.303344,103.861
199004,3,168,171,1.303381,103.860977
199005,11,4378,4389,1.303426,103.860957
199006,42,66,108,1.303579,103.86074
199007,47,15,62,1.304414,103.860414
199008,62,1,63,1.304438,103.860395
199009,0,540,540,1.304475,103.860376
199010,1,532,533,1.304505,103.860354
199012,0,7,7,1.304563,103.860322
199014,1,83,84,1.304608,103.860295
199015,13,161,174,1.304652,103.860271
199016,0,11,11,1.304687,103.860249
199017,4,1208,1212,1.304726,103.860234
199018,1048,12012,13060,1.303499,103.861257
199019,44,1,45,1.299509,103.837
199020,1060,32763,33823,1.305787,103.86046
199069,41,5,46,1.302844,103.858834
199070,24,11,35,1.302884,103.8588
199071,39,18,57,1.303051,103.858758
199072,10,5,15,1.302925,103.858754
199073,6,22,28,1.303103,103.858724
199074,11,8,19,1.302965,103.858714
199075,6,24,30,1.303143,103.858684
199076,5,8,13,1.30301,103.858674
199077,16,14,30,1.303183,103.85865
199078,45,22,67,1.30305,103.85864
199079,23,20,43,1.303246,103.858598
199081,29,916,945,1.303309,103.858559
199082,26,10,36,1.303096,103.8586
199083,4,9,13,1.303148,103.85856
199084,32,1191,1223,1.303229,103.858523
199135,42,47,89,1.302525,103.85861
199136,0,12,12,1.302698,103.85851
199137,12,27,39,1.302577,103.858558
199138,2,18,20,1.302756,103.858465
199139,0,44,44,1.302622,103.858501
199140,3,16,19,1.302807,103.858408
199141,21,26,47,1.30268,103.858456
199142,2,12,14,1.30287,103.858351
199143,378,17,395,1.302726,103.858409
199144,0,8,8,1.302928,103.858311
199145,3,2,5,1.302817,103.858329
199146,0,11,11,1.302996,103.858254
199147,52,3,55,1.302834,103.858308
199148,12,1265,1277,1.303023,103.858215
199149,50,1,51,1.302897,103.858256
199150,16,33,49,1.302646,103.858566
199200,1,17,18,1.303763,103.859409
199201,90,1,91,1.303806,103.85938
199204,8,604,612,1.3039,103.859373
199205,21,8,29,1.303862,103.859348
199206,131,679,810,1.303882,103.859338
199207,735,101,836,1.303998,103.859303
199257,16,0,16,1.301951,103.859972
199258,1,17,18,1.303422,103.859034
199259,9,2,11,1.303376,103.858983
199260,19,99,118,1.303401,103.858963
199261,21,58,79,1.303439,103.859021
199263,2,0,2,1.302738,103.859094
199264,11,578,589,1.303516,103.858967
199313,7,7,14,1.304144,103.859806
199314,5,2,7,1.30402,103.859971
199315,87,10,97,1.304193,103.859792
199316,18,13,31,1.304073,103.859948
199317,2,7,9,1.304238,103.859781
199318,8,10,18,1.304118,103.859932
199319,5,2,7,1.304268,103.85975
199320,23,22,45,1.304181,103.859898
199321,2,3,5,1.304297,103.859734
199322,112,5,117,1.30425,103.859852
199323,78,1,79,1.304325,103.859722
199324,14,16,30,1.304319,103.859807
199325,9,93,102,1.304356,103.859709
199326,13,18,31,1.304381,103.859772
199327,5,1,6,1.304375,103.859692
199328,6,14,20,1.304432,103.85975
199329,49,1135,1184,1.304407,103.859676
199330,102,494,596,1.304458,103.859721
199432,10,13,23,1.301226,103.859913
199433,22,0,22,1.301067,103.860035
199434,142,1,143,1.301095,103.860018
199435,16,3,19,1.301135,103.859989
199436,56,3,59,1.30117,103.859955
199437,31,2,33,1.301305,103.859851
199438,46,79,125,1.301194,103.859931
199439,43,225,268,1.300991,103.859957
199440,2,7,9,1.301424,103.860024
199441,12,0,12,1.301436,103.860007
199442,0,6,6,1.301451,103.859984
199443,3,4,7,1.301458,103.859973
199444,6,0,6,1.30148,103.859957
199445,4,1,5,1.301487,103.859944
199446,3,0,3,1.303608,103.859822
199447,3,0,3,1.301325,103.859798
199448,2,0,2,1.303486,103.858994
199449,0,1,1,1.304048,103.860415
199450,6,4,10,1.301653,103.859825
199452,0,3,3,1.30155,103.859899
199453,0,1,1,1.301625,103.859847
199454,1,1,2,1.301584,103.85987
199455,0,1,1,1.301733,103.859768
199456,1,0,1,1.301802,103.859722
199457,0,1,1,1.301836,103.859682
199458,0,2,2,1.301762,103.859745
199459,0,1,1,1.301882,103.859648
199460,5,5,10,1.301962,103.859599
199463,3,2,5,1.302073,103.859515
199464,29,26,55,1.302102,103.85949
199465,6,3,9,1.30175,103.859214
199467,1,0,1,1.301911,103.859608
199469,2,0,2,1.301934,103.859604
199470,1,0,1,1.30163,103.8593
199471,2,0,2,1.301544,103.859385
199472,0,2,2,1.301504,103.859414
199473,5,0,5,1.30147,103.859445
199474,2,0,2,1.301483,103.859443
199475,4,2,6,1.301464,103.859453
199476,5,1,6,1.301396,103.859492
199477,4,0,4,1.30136,103.859513
199478,0,1,1,1.301633,103.859314
199479,31,3,34,1.301015,103.859909
199480,12,0,12,1.300837,103.860084
199481,8,50,58,1.300997,103.859843
199482,7,1,8,1.300957,103.859981
199483,37,5,42,1.300898,103.860031
199484,3,5,8,1.300875,103.860053
199485,100,9,109,1.300921,103.860014
199486,32,15,47,1.300823,103.860109
199487,20,70,90,1.300806,103.860116
199488,42,122,164,1.300992,103.860092
199539,136,7,143,1.300367,103.859957
199540,85,28,113,1.30036,103.859935
199541,8,82,90,1.300383,103.859975
199542,15,366,381,1.300411,103.860009
199544,22,289,311,1.30044,103.860043
199545,66,46,112,1.300474,103.860078
199546,209,7844,8053,1.300492,103.860112
199547,129,13244,13373,1.300532,103.860157
199548,116,2733,2849,1.300741,103.860503
199549,38,1153,1191,1.300803,103.860602
199550,63,441,504,1.300836,103.860638
199551,183,94,277,1.300865,103.860677
199552,457,6482,6939,1.300889,103.860711
199553,39,24,63,1.30093,103.860765
199554,2338,1172,3510,1.301105,103.862582
199555,5834,6787,12621,1.301012,103.862214
199556,795,5,800,1.300842,103.862491
199557,28,363,391,1.301087,103.861134
199558,4,1,5,1.30111,103.861163
199559,4,0,4,1.301139,103.861191
199560,9,0,9,1.301156,103.861219
199561,0,2,2,1.301427,103.859472
199562,6,78,84,1.301202,103.861259
199563,18,101,119,1.301202,103.861288
199564,2,45,47,1.301225,103.861316
199565,20,53,73,1.301242,103.86135
199566,15,157,172,1.301254,103.86139
199567,8,437,445,1.301406,103.861755
199568,19,2439,2458,1.301278,103.861469
199569,9,658,667,1.301301,103.861511
199570,23,919,942,1.301316,103.861569
199571,57,380,437,1.301388,103.861715
199572,3,64,67,1.301637,103.86173
199573,15,2,17,1.301542,103.862043
199575,11,2097,2108,1.301477,103.861861
199576,27,1396,1423,1.3015,103.861933
199577,6,1180,1186,1.301511,103.861979
199578,9,1708,1717,1.301569,103.862123
199579,9,2041,2050,1.301696,103.861973
199580,39,4262,4301,1.301553,103.86208
199581,117,12705,12822,1.302874,103.86351
199582,144,25182,25326,1.301855,103.86307
199583,283,12666,12949,1.302898,103.863909
199584,48,130,178,1.302914,103.862853
199585,105,882,987,1.304014,103.86608
199586,31,11063,11094,1.303563,103.86555
199587,10,219,229,1.303722,103.867627
199588,3285,104367,107652,1.302908,103.864945
199589,1431,646,2077,1.302128,103.864082
199590,6088,9707,15795,1.299673,103.86008
199591,831,0,831,1.299782,103.860659
199592,8850,0,8850,1.300011,103.860309
199593,4,0,4,1.300233,103.860632
199594,4,22,26,1.299926,103.861203
199595,115,2919,3034,1.299782,103.860668
199596,15,149,164,1.303984,103.863443
199597,50,2018,2068,1.302638,103.86222
199598,2887,19515,22402,1.302538,103.864219
199599,5780,590,6370,1.300258,103.861854
199600,49,1952,2001,1.301371,103.861664
199646,37,1751,1788,1.300954,103.859456
199647,2,17,19,1.30097,103.859473
199648,1,13,14,1.300986,103.859495
199649,1,5,6,1.301022,103.859543
199650,2,6,8,1.301039,103.859573
199651,0,1,1,1.301341,103.859536
199652,1,3,4,1.301074,103.859612
199653,9,9,18,1.301044,103.859654
199654,10,36,46,1.301079,103.859628
199655,2,10,12,1.301066,103.859688
199656,17,20,37,1.301124,103.859678
199657,10,0,10,1.301091,103.859722
199658,3,4,7,1.301134,103.859705
199659,51,118,169,1.301129,103.859751
199660,1,4,5,1.301159,103.859738
199661,1,142,143,1.301145,103.859789
199662,5,15,20,1.301178,103.859764
199663,2,27,29,1.301437,103.860229
199664,8,0,8,1.301198,103.859788
199665,2,15,17,1.301163,103.859826
199666,0,3,3,1.301705,103.859791
199667,0,17,17,1.30148,103.86031
199668,3,105,108,1.301503,103.860359
199669,5,10,15,1.301016,103.859632
199719,89,9692,9781,1.300655,103.859678
199720,8,255,263,1.300682,103.859656
199721,4,181,185,1.300705,103.859641
199722,32,176,208,1.300588,103.859569
199723,3,95,98,1.300696,103.859651
199724,61,98,159,1.30061,103.859558
199725,9,62,71,1.30117,103.859297
199726,21,85,106,1.300628,103.859546
199727,7,93,100,1.301205,103.859263
199728,23,107,130,1.30065,103.859535
199729,5,39,44,1.301228,103.859245
199730,43,11,54,1.300668,103.859523
199731,11,239,250,1.301239,103.859234
199732,12,59,71,1.300691,103.859506
199733,63,7,70,1.300666,103.859856
199734,2,71,73,1.300708,103.859495
199735,25,74,99,1.300659,103.8598
199737,3,3,6,1.300707,103.859796
199738,45,185,230,1.300759,103.859455
199739,1,20,21,1.30077,103.85977
199740,23,101,124,1.300771,103.859438
199741,8,19,27,1.300757,103.859721
199742,12,105,117,1.300788,103.859415
199743,11,95,106,1.300811,103.859404
199744,28,102,130,1.300834,103.859387
199745,62,71,133,1.300784,103.859721
199746,19,146,165,1.300845,103.859375
199747,44,212,256,1.300854,103.85965
199748,121,199,320,1.300862,103.859358
199749,11,12,23,1.300896,103.859624
199750,26,208,234,1.30088,103.859341
199751,32,206,238,1.300934,103.859619
199752,17,109,126,1.300902,103.859318
199753,78,208,286,1.300982,103.859557
199754,12,70,82,1.300931,103.859307
199755,55,2,57,1.30144,103.859069
199756,3,72,75,1.300965,103.859284
199757,11,3,14,1.301451,103.859063
199758,10,85,95,1.300988,103.859262
199759,5,21,26,1.301468,103.859052
199760,9,104,113,1.301,103.859244
199761,2,44,46,1.301468,103.859052
199762,2,69,71,1.301023,103.859227
199763,3,24,27,1.301474,103.859046
199764,7,72,79,1.301034,103.85921
199765,2,30,32,1.301491,103.859035
199766,2,75,77,1.30104,103.859199
199767,2,16,18,1.301503,103.859018
199768,3,45,48,1.301057,103.859182
199769,8,36,44,1.301525,103.858995
199770,35,60,95,1.301292,103.858994
199771,11,11,22,1.301548,103.858972
199772,4,31,35,1.301309,103.858988
199773,0,15,15,1.301565,103.858949
199774,0,62,62,1.30132,103.858971
199775,2,22,24,1.301571,103.858938
199776,0,36,36,1.301338,103.858965
199777,3,42,45,1.301634,103.858887
199778,8,70,78,1.301349,103.858943
199779,6,52,58,1.301361,103.858937
199780,34,12,46,1.301646,103.858881
199781,3,36,39,1.301378,103.858914
199782,5,24,29,1.301663,103.85887
199783,5,129,134,1.301401,103.858897
199784,13,24,37,1.301686,103.858847
199785,4,80,84,1.301406,103.85888
199786,2,20,22,1.301703,103.858824
199787,10,65,75,1.301418,103.858874
199788,11,23,34,1.30172,103.858807
199789,39,110,149,1.301429,103.858869
199790,10,1,11,1.301737,103.85879
199791,4,101,105,1.301441,103.858852
199792,12,1,13,1.301754,103.858767
199793,3,76,79,1.301458,103.858846
199794,11,2,13,1.301777,103.85875
199795,4,68,72,1.301481,103.858823
199796,8,26,34,1.3018,103.858733
199797,8,33,41,1.301504,103.858806
199798,11,56,67,1.301817,103.85871
199799,3,21,24,1.301521,103.858783
199800,3,36,39,1.30184,103.858693
199801,3,14,17,1.301538,103.858778
199802,5,44,49,1.301863,103.85867
199803,1,18,19,1.301555,103.858766
199804,7,38,45,1.30188,103.858648
199805,0,23,23,1.301572,103.858749
199806,20,750,770,1.301898,103.85863
199807,8,72,80,1.30159,103.858738
199808,1,159,160,1.301601,103.858715
199809,3,426,429,1.302087,103.858419
199810,2,112,114,1.301624,103.858692
199811,4,468,472,1.302048,103.858458
199812,14,1,15,1.301647,103.858675
199813,22,523,545,1.302064,103.858438
199814,12,662,674,1.301658,103.858658
199815,22,1357,1379,1.302113,103.858389
199816,4,39,43,1.301681,103.858646
199817,4,24,28,1.302431,103.85806
199818,58,1927,1985,1.301704,103.858624
199819,3,275,278,1.302148,103.858359
199820,11,662,673,1.302224,103.85827
199821,8,1115,1123,1.302251,103.858232
199822,18,2619,2637,1.302282,103.858205
199823,42,4524,4566,1.302318,103.858172
199824,7,2897,2904,1.302347,103.858141
199825,28,5811,5839,1.302383,103.8581
199826,33,5253,5286,1.302548,103.858171
199827,35,2452,2487,1.302196,103.8583
199828,4,1085,1089,1.302406,103.85808
199829,19,779,798,1.302467,103.858021
199830,34,585,619,1.302503,103.857983
199831,6,519,525,1.302538,103.857935
199832,34,5473,5507,1.302624,103.857855
199844,283,9971,10254,1.30057,103.859575
199894,13,122,135,1.301684,103.861407
199895,77,635,712,1.301703,103.861487
199896,11,152,163,1.301714,103.861379
199898,4,32,36,1.301742,103.861356
199900,4,7,11,1.301765,103.861329
199901,9,82,91,1.30182,103.86143
199902,5,177,182,1.301802,103.861305
199903,227,20,247,1.30186,103.861401
199904,5,3,8,1.301811,103.861306
199905,3,9,12,1.3019,103.861367
199906,5,81,86,1.301822,103.861298
199907,165,48,213,1.301946,103.861333
199908,21,66,87,1.30184,103.861291
199909,35,565,600,1.301988,103.861258
199910,0,10,10,1.301855,103.86127
199911,0,25,25,1.302304,103.861102
199912,8,30,38,1.302325,103.860938
199913,0,6,6,1.302332,103.861092
199915,5,14,19,1.302358,103.861077
199916,6,13,19,1.302389,103.861065
199917,16,67,83,1.302381,103.860887
199918,356,0,356,1.302407,103.861058
199919,10,30,40,1.302411,103.860877
199920,2,6,8,1.302446,103.861036
199921,7,25,32,1.302442,103.860831
199922,2,6,8,1.302495,103.860999
199923,2,25,27,1.30252,103.860756
199924,1,25,26,1.302491,103.860773
199925,2,17,19,1.302559,103.860758
199926,5,26,31,1.302616,103.860896
199927,1,44,45,1.302617,103.860727
199929,2,2,4,1.302654,103.860705
199930,0,1,1,1.301061,103.859597
199931,0,5,5,1.302697,103.860671
199932,2,3,5,1.302965,103.860752
199933,2,2,4,1.302746,103.860646
199934,0,1,1,1.302931,103.860786
199935,6,0,6,1.302794,103.86061
199937,0,1,1,1.303001,103.860712
199938,0,4,4,1.303086,103.860649
199940,3,76,79,1.303114,103.860627
199941,3,0,3,1.301456,103.860266
199942,39,8,47,1.302994,103.86045
199943,1,9,10,1.30312,103.860388
199944,0,10,10,1.303172,103.860353
199945,1,9,10,1.303229,103.860314
199946,1,3,4,1.303292,103.860262
199948,79,23,102,1.303419,103.860242
199949,283,30,313,1.303478,103.860221
200001,215,592,807,1.307613,103.858932
200002,290,3608,3898,1.307753,103.859096
200008,279,280,559,1.307297,103.860693
200025,610,115,725,1.306385,103.857933
200026,403,201,604,1.3063,103.857566
200027,62,648,710,1.306498,103.857632
200028,370,157,527,1.30603,103.857247
200029,356,146,502,1.305827,103.856885
200030,290,307,597,1.305646,103.856717
200031,86,270,356,1.306432,103.856727
200632,670,306,976,1.30617,103.85446
200633,102,155,257,1.305783,103.854852
200634,670,65,735,1.306089,103.854798
200635,258,395,653,1.306441,103.855089
200636,12,8,20,1.306342,103.85542
200637,72,185,257,1.30699,103.855851
200638,77,111,188,1.307079,103.855141
200639,526,367,893,1.307698,103.855184
200640,752,118,870,1.307482,103.854996
200641,255,215,470,1.308209,103.855012
200642,238,2529,2767,1.307542,103.856473
200801,242,211,453,1.307437,103.860453
200802,19,35,54,1.307345,103.860105
200803,88,1688,1776,1.307798,103.860875
200804,142,1862,2004,1.308034,103.860594
200805,77,116,193,1.308186,103.860836
200806,54,1103,1157,1.308471,103.861059
200807,133,2622,2755,1.309387,103.861257
200808,141,489,630,1.308475,103.862009
200809,64,10347,10411,1.308384,103.861858
200811,78,954,1032,1.307732,103.861111
200813,304,24271,24575,1.307427,103.862054
200814,7,6315,6322,1.307266,103.861624
200815,494,3660,4154,1.306939,103.861541
200816,319,209,528,1.306872,103.861097
200817,2,812,814,1.306766,103.860865
201007,156,4120,4276,1.307891,103.86004
201028,2,219,221,1.306194,103.857377
207223,1596,9631,11227,1.310965,103.856944
207224,1251,418,1669,1.310369,103.857326
207225,2323,641,2964,1.310372,103.857501
207226,1024,16,1040,1.310721,103.858054
207227,1658,91,1749,1.310929,103.857804
207228,464,26,490,1.310479,103.857842
207229,2272,7634,9906,1.31134,103.857207
207230,5,638,643,1.304323,103.85613
207231,0,132,132,1.304344,103.85611
207232,0,203,203,1.304384,103.856068
207233,1,0,1,1.302839,103.860576
207234,0,45,45,1.304466,103.855986
207235,0,60,60,1.304507,103.855945
207236,2,48,50,1.304547,103.855903
207237,0,13,13,1.304588,103.855862
207239,2,257,259,1.30467,103.85578
207241,1,334,335,1.304751,103.855697
207242,0,131,131,1.304776,103.855671
207243,2,76,78,1.304801,103.855645
207245,1,63,64,1.3049,103.85554
207246,0,17,17,1.30495,103.855488
207248,0,154,154,1.305018,103.855416
207250,0,3,3,1.302931,103.860496
207251,4,220,224,1.30511,103.855316
207252,1,40,41,1.305147,103.855276
207253,3,36,39,1.305183,103.855236
207254,0,631,631,1.30522,103.855196
207274,329,4566,4895,1.310065,103.85608
207275,51,793,844,1.309677,103.855912
207276,23,1623,1646,1.309801,103.856015
207277,16,226,242,1.309842,103.856136
207278,48,2168,2216,1.309897,103.856085
207279,11,1524,1535,1.31008,103.856282
207280,26,669,695,1.310157,103.856327
207281,6,1128,1134,1.310221,103.856386
207282,11,26,37,1.310268,103.856438
207283,4,692,696,1.310312,103.856468
207284,0,188,188,1.310364,103.8565
207285,2,229,231,1.3104,103.856536
207305,29,1,30,1.307674,103.852951
207306,7,9,16,1.307665,103.852987
207307,0,1,1,1.304425,103.856027
207308,3,11,14,1.307642,103.853085
207309,179,15,194,1.307738,103.853055
207310,0,134,134,1.307807,103.853078
207312,0,4,4,1.307634,103.853125
207313,1,2,3,1.305073,103.855356
207314,7,7,14,1.307617,103.853182
207315,4,15,19,1.307803,103.853182
207316,13,6,19,1.307606,103.853239
207317,0,15,15,1.307823,103.853234
207318,0,9,9,1.307589,103.85329
207319,5,14,19,1.307792,103.853269
207320,0,10,10,1.307583,103.853347
207321,22,22,44,1.307584,103.853859
207322,1,1,2,1.301173,103.861242
207323,0,17,17,1.307589,103.853802
207324,3,7,10,1.30756,103.853455
207325,1,25,26,1.307589,103.853745
207326,1,3,4,1.30756,103.853507
207327,2,15,17,1.307549,103.853558
207328,6,11,17,1.307537,103.853615
207329,0,4,4,1.307526,103.85366
207330,0,6,6,1.307509,103.8537
207331,2,56,58,1.307632,103.853483
207332,3,6,9,1.307514,103.853746
207333,1,23,24,1.30765,103.853426
207334,24,10,34,1.307496,103.853772
207335,3,21,24,1.307667,103.853364
207336,6,0,6,1.307491,103.853786
207337,0,15,15,1.307695,103.853916
207338,6,63,69,1.307486,103.853825
207339,4,37,41,1.307655,103.853955
207340,33,65,98,1.307685,103.854044
207341,4,339,343,1.307347,103.854414
207342,2,93,95,1.307327,103.854441
207343,0,77,77,1.307308,103.854473
207344,1,85,86,1.307289,103.854498
207345,0,51,51,1.307274,103.854527
207346,1,28,29,1.307261,103.854553
207347,0,31,31,1.307229,103.854602
207348,2,98,100,1.307201,103.854658
207349,0,261,261,1.30718,103.854693
207350,11,17,28,1.307595,103.853694
207372,308,7,315,1.305484,103.85485
207373,0,1,1,1.307657,103.853034
207374,0,2,2,1.307577,103.853398
207375,1,0,1,1.305554,103.854714
207376,0,3,3,1.307841,103.853126
207377,3,5,8,1.305697,103.854549
207378,11,7,18,1.30572,103.854515
207379,11,0,11,1.305748,103.854481
207380,1,25,26,1.305777,103.854453
207381,8,0,8,1.305806,103.85443
207382,3,1,4,1.305834,103.854401
207383,15,8,23,1.305857,103.854379
207384,11,6,17,1.30588,103.85435
207385,5,6,11,1.3059,103.854322
207386,29,2,31,1.30591,103.854307
207387,12,31,43,1.305924,103.854291
207388,3,35,38,1.306037,103.854111
207390,1,11,12,1.306084,103.854054
207391,2,6,8,1.306118,103.854008
207392,1,4,5,1.306152,103.853963
207393,7,11,18,1.306204,103.853917
207394,2,2,4,1.306238,103.853866
207395,10,11,21,1.306278,103.853814
207396,2,9,11,1.306307,103.853752
207398,3,18,21,1.306358,103.853652
207401,123,38,161,1.306328,103.853515
207402,6,5,11,1.306328,103.853481
207403,7,0,7,1.306322,103.853436
207404,1,5,6,1.30631,103.853396
207405,0,11,11,1.306316,103.853362
207406,1,13,14,1.306316,103.853333
207407,1,8,9,1.30631,103.853299
207408,39,14,53,1.306316,103.853265
207409,10,210,220,1.306302,103.853225
207410,0,65,65,1.306362,103.853257
207411,2,27,29,1.306371,103.853304
207412,9,52,61,1.30638,103.853358
207413,29,237,266,1.306397,103.853543
207433,3,115,118,1.30763,103.85549
207434,0,11,11,1.307677,103.855523
207435,0,1,1,1.305657,103.854629
207437,2,0,2,1.305634,103.854663
207438,1,4,5,1.307855,103.855596
207439,0,3,3,1.305674,103.854589
207440,0,94,94,1.307963,103.85572
207460,15,18,33,1.306538,103.852182
207461,4,19,23,1.306496,103.852147
207463,5,21,26,1.306517,103.852201
207464,8,19,27,1.306464,103.852208
207465,27,0,27,1.30651,103.852216
207466,79,33,112,1.306451,103.852241
207467,3,7,10,1.306493,103.85224
207468,31,2,33,1.306439,103.852259
207469,5,20,25,1.306481,103.852256
207470,3,1,4,1.306431,103.852289
207471,29,0,29,1.306464,103.852307
207472,150,47,197,1.306423,103.852304
207473,7,0,7,1.306447,103.852364
207474,100,50,150,1.306411,103.852328
207475,1,11,12,1.306418,103.852415
207476,6,2,8,1.306395,103.852455
207477,7,0,7,1.306397,103.852346
207478,83,0,83,1.306361,103.852495
207479,3,0,3,1.307917,103.855681
207480,6,41,47,1.306344,103.852535
207481,3,8,11,1.306369,103.852414
207483,5,8,13,1.306351,103.852448
207484,4,54,58,1.306304,103.85262
207485,0,1,1,1.3077,103.855563
207486,14,20,34,1.306292,103.852654
207487,1,4,5,1.306306,103.852534
207488,3,3,6,1.306281,103.852705
207489,2,2,4,1.306283,103.852579
207490,1,16,17,1.306275,103.852745
207491,31,1,32,1.306266,103.852608
207492,51,14,65,1.306258,103.852791
207493,0,1,1,1.306334,103.852488
207494,8,6,14,1.306227,103.852829
207496,13,340,353,1.306214,103.852857
207497,1,3,4,1.306226,103.852716
207498,26,1,27,1.306203,103.85275
207499,4,1,5,1.30618,103.852784
207500,9,3,12,1.306157,103.852824
207501,2,3,5,1.30614,103.852853
207502,26,426,452,1.306125,103.852881
207522,62,1945,2007,1.309029,103.858426
207523,6,68,74,1.30927,103.858702
207524,6,196,202,1.309052,103.858442
207526,3,216,219,1.309099,103.858474
207528,7,239,246,1.309192,103.858538
207529,6,10,16,1.307665,103.852987
207530,155,415,570,1.309471,103.85873
207531,3,168,171,1.309516,103.858759
207532,0,8,8,1.309562,103.858788
207535,0,35,35,1.309833,103.85896
207536,7,47,54,1.309924,103.859018
207537,0,49,49,1.310014,103.859075
207538,0,46,46,1.310105,103.859133
207539,22,104,126,1.310195,103.85919
207540,1,201,202,1.310286,103.859248
207542,542,331,873,1.309751,103.860054
207543,9,1329,1338,1.310356,103.859433
207544,3,568,571,1.310864,103.859632
207545,6,964,970,1.310883,103.859646
207546,1,7,8,1.310923,103.859675
207547,83,613,696,1.310962,103.859704
207548,36,12,48,1.311002,103.859733
207549,28,513,541,1.311041,103.859762
207550,5,3,8,1.31108,103.859791
207551,41,722,763,1.31112,103.859821
207552,27,6,33,1.311159,103.85985
207553,15,1463,1478,1.311198,103.859879
207554,31,563,594,1.311238,103.859908
207555,0,22,22,1.311277,103.859937
207556,1,439,440,1.311317,103.859966
207557,193,219,412,1.311356,103.859995
207558,0,179,179,1.311391,103.860024
207560,3,224,227,1.311495,103.860111
207561,15,503,518,1.311564,103.860169
207562,15,5,20,1.311634,103.860228
207563,90,143,233,1.311356,103.860015
207564,63,475,538,1.311703,103.860286
207566,114,31,145,1.311773,103.860344
207567,20,700,720,1.311832,103.860412
207568,0,176,176,1.311842,103.860402
207569,4521,1940,6461,1.311852,103.860412
207570,8,117,125,1.311881,103.860457
207571,1,312,313,1.312699,103.861175
207572,4,393,397,1.31192,103.860492
207573,3,19,22,1.311998,103.860563
207574,40,687,727,1.312076,103.860633
207575,7,350,357,1.312154,103.860703
207576,1133,621,1754,1.312232,103.860773
207577,3,667,670,1.312309,103.860844
207578,0,16,16,1.312387,103.860914
207579,1,682,683,1.312465,103.860984
207581,831,277,1108,1.311775,103.860476
207599,1,45,46,1.307419,103.858112
207600,0,21,21,1.307419,103.858132
207601,1,4,5,1.307487,103.858156
207602,0,8,8,1.307487,103.858176
207603,0,7,7,1.307622,103.858244
207604,1,20,21,1.307622,103.858264
207605,4,37,41,1.307756,103.858331
207606,1170,18,1188,1.307756,103.858351
207607,5,289,294,1.307891,103.858419
207608,6,321,327,1.307881,103.858429
207628,152,2853,3005,1.306227,103.85858
207629,41,6,47,1.306735,103.858044
207630,2000,522,2522,1.306997,103.858443
207631,8,151,159,1.307031,103.858415
207632,4,72,76,1.30706,103.858381
207633,6,370,376,1.307076,103.858361
207634,1,106,107,1.307138,103.858209
207635,2,308,310,1.307111,103.858321
207636,29,39,68,1.307133,103.858299
207637,1,282,283,1.307159,103.858279
207639,6,1206,1212,1.307212,103.858211
207641,54,625,679,1.307676,103.857628
207642,9,643,652,1.30771,103.8576
207643,3,98,101,1.307739,103.857565
207644,1,553,554,1.307768,103.85752
207645,8,269,277,1.307808,103.857486
207646,0,362,362,1.307842,103.857451
207647,0,56,56,1.307876,103.857417
207648,10,1947,1957,1.307939,103.857355
207651,36,48,84,1.308691,103.856509
207652,54,4,58,1.308722,103.856471
207653,12,2,14,1.308748,103.856428
207654,85,14,99,1.308773,103.856392
207655,103,36,139,1.3088,103.856365
207656,19,23,42,1.30883,103.856311
207657,194,5,199,1.308862,103.856265
207658,85,40,125,1.308893,103.856233
207659,76,522,598,1.308961,103.856181
207660,49,5,54,1.308992,103.856131
207661,13,53,66,1.309036,103.8561
207662,442,304,746,1.309095,103.856045
207663,59,62,121,1.309165,103.855968
207664,86,41,127,1.30922,103.855918
207665,143,4260,4403,1.309247,103.855867
207666,50,214,264,1.309305,103.8558
207667,340,136,476,1.309337,103.855774
207668,260,8146,8406,1.309516,103.855602
207669,78,27,105,1.309596,103.855499
207670,12,382,394,1.309655,103.855444
207671,30,88,118,1.309679,103.855414
207672,8,89,97,1.309732,103.855371
207673,3,143,146,1.309755,103.855342
207674,176,2903,3079,1.309778,103.85532
207675,2,30,32,1.309801,103.855291
207676,54,111,165,1.309835,103.855263
207677,19,1045,1064,1.309873,103.855208
207678,65,1638,1703,1.309914,103.855172
207679,34,876,910,1.309942,103.855143
207680,33,724,757,1.309964,103.855121
207681,34,5,39,1.309926,103.855155
207682,59,1630,1689,1.310017,103.855057
207683,32,1416,1448,1.310039,103.855029
207684,20,1093,1113,1.310062,103.855006
207685,13,516,529,1.310091,103.854977
207686,42,1735,1777,1.310114,103.854949
207687,34,2487,2521,1.310137,103.854921
207688,117,5356,5473,1.31016,103.854898
207689,96,13362,13458,1.310273,103.854823
207690,6,954,960,1.310285,103.85479
207691,17,688,705,1.310309,103.854763
207692,7,675,682,1.310329,103.854738
207693,16,772,788,1.310352,103.85471
207694,28,2416,2444,1.310369,103.854687
207695,102,5979,6081,1.310354,103.854847
207696,104,6986,7090,1.310302,103.854895
207704,14995,68477,83472,1.310173,103.855115
207706,383,6435,6818,1.309758,103.855448
207710,92,826,918,1.30933,103.855909
207713,101,40,141,1.308951,103.856286
207715,75,567,642,1.308742,103.856524
207716,27,199,226,1.30887,103.856463
207718,21,71,92,1.308805,103.856527
207719,11,264,275,1.308532,103.856762
207720,14,45,59,1.308745,103.856589
207721,33,108,141,1.30848,103.856822
207722,11,11,22,1.299509,103.837
207723,3,620,623,1.308428,103.856881
207724,0,97,97,1.299509,103.837
207725,0,113,113,1.308376,103.85694
207726,1,12,13,1.308588,103.856763
207727,8,198,206,1.308324,103.857
207728,3,203,206,1.308474,103.856878
207729,1,175,176,1.308271,103.857059
207730,1,109,110,1.308416,103.856934
207731,9,107,116,1.308219,103.857119
207732,5,92,97,1.308374,103.856996
207733,28,3166,3194,1.308329,103.857041
207734,29,7446,7475,1.308148,103.857198
207735,12,1049,1061,1.308186,103.857214
207736,4,421,425,1.308087,103.857266
207737,0,92,92,1.308146,103.857261
207738,0,178,178,1.307964,103.857403
207739,0,115,115,1.308108,103.857296
207740,1,95,96,1.307842,103.85754
207741,0,229,229,1.30807,103.857336
207742,3,384,387,1.307719,103.857677
207743,2,275,277,1.308036,103.857376
207744,2,240,242,1.307597,103.857814
207745,61,262,323,1.307989,103.857434
207746,1,159,160,1.307474,103.857951
207747,17,52,69,1.307922,103.857519
207748,2,219,221,1.307362,103.858078
207749,31,173,204,1.307835,103.857636
207751,3,386,389,1.307835,103.857636
207752,5,384,389,1.307835,103.857636
207753,0,326,326,1.307835,103.857636
207754,6,218,224,1.307835,103.857636
207755,0,1,1,1.30626,103.852642
207756,0,271,271,1.307835,103.857636
207776,19,502,521,1.307283,103.858165
207777,4,480,484,1.307285,103.858263
207778,0,101,101,1.307215,103.858242
207779,21,100,121,1.307169,103.858387
207780,23,139,162,1.307078,103.858396
207781,1,176,177,1.307232,103.858334
207783,5,292,297,1.306939,103.85855
207799,11,1670,1681,1.307554,103.857956
207819,22,38,60,1.303978,103.853325
207838,4,27,31,1.312369,103.859163
207839,1,61,62,1.312404,103.859094
207840,2,2,4,1.312507,103.858969
207841,12,42,54,1.312553,103.858901
207842,9,38,47,1.312595,103.858817
207843,21,25,46,1.312658,103.858755
207844,32,71,103,1.312721,103.858692
207845,2,2,4,1.312769,103.858629
207846,11,35,46,1.312808,103.858559
207847,11,322,333,1.312848,103.858502
207850,33,17,50,1.312449,103.859026
207851,253,341,594,1.313811,103.857569
207852,1742,112,1854,1.313099,103.857673
207853,1651,32,1683,1.312832,103.858175
207854,154,364,518,1.313421,103.857848
207855,2235,153,2388,1.313011,103.858359
207869,10,3,13,1.310954,103.85812
207870,1,9,10,1.31102,103.85815
207871,1,0,1,1.307835,103.857636
207872,15,20,35,1.311111,103.85822
207873,4,0,4,1.311151,103.858255
207874,1,13,14,1.311194,103.858286
207875,0,2,2,1.307824,103.855594
207876,75,27,102,1.311301,103.858359
207877,130,67,197,1.311353,103.858569
207896,13,0,13,1.308787,103.857456
207897,5,46,51,1.308818,103.857425
207898,1,11,12,1.308878,103.857362
207899,1,49,50,1.308869,103.857326
207901,2,27,29,1.308915,103.857274
207902,1,5,6,1.308999,103.857235
207903,5,14,19,1.308961,103.857223
207904,3,0,3,1.30638,103.85238
207905,0,2,2,1.311243,103.858315
207906,2,9,11,1.309001,103.857189
207907,3,13,16,1.312387,103.860914
207908,3,6,9,1.309041,103.857155
207909,7,4,11,1.309241,103.856982
207910,11,35,46,1.309087,103.857121
207912,3,5,8,1.309121,103.857075
207913,23,14,37,1.309362,103.856856
207914,6,3,9,1.309161,103.85703
207915,47,19,66,1.309423,103.856793
207917,0,26,26,1.309723,103.856417
207919,0,10,10,1.309196,103.856988
207920,1,3,4,1.309604,103.856603
207921,3,8,11,1.30923,103.856954
207922,6,19,25,1.309665,103.85654
207923,7,6,13,1.309276,103.856914
207924,3,19,22,1.309725,103.856477
207925,0,46,46,1.309304,103.85688
207926,15,12,27,1.309786,103.856414
207927,3,9,12,1.309676,103.856481
207928,5,19,24,1.309846,103.856351
207929,0,19,19,1.309586,103.856556
207930,1,14,15,1.309907,103.856287
207931,3,16,19,1.309339,103.856846
207932,0,11,11,1.309967,103.856224
207933,0,21,21,1.309475,103.856703
207934,9,45,54,1.310028,103.856161
207935,23,70,93,1.309419,103.85676
207955,7,66,73,1.309203,103.853967
207956,2,38,40,1.309202,103.853966
207957,0,42,42,1.309202,103.853966
207958,2,0,2,1.30912,103.857109
207959,4,0,4,1.309202,103.853966
207960,8,12,20,1.309167,103.853901
207961,11,42,53,1.309047,103.8542
207962,7,2,9,1.309134,103.853943
207963,0,23,23,1.309019,103.854231
207964,1,6,7,1.309127,103.853983
207965,0,5,5,1.30899,103.854281
207966,15,7,22,1.309107,103.853999
207967,0,9,9,1.308968,103.854312
207968,2,10,12,1.309074,103.854038
207969,1,25,26,1.308953,103.854336
207970,1,14,15,1.309037,103.854091
207971,26,11,37,1.30893,103.854368
207972,1,3,4,1.309022,103.854115
207973,4,35,39,1.308903,103.854409
207974,1,5,6,1.309008,103.854143
207975,0,10,10,1.308875,103.85445
207976,2,4,6,1.308957,103.854221
207977,0,16,16,1.308854,103.854489
207978,19,1,20,1.308975,103.854221
207979,0,8,8,1.308835,103.854514
207980,14,10,24,1.308933,103.854284
207981,2,25,27,1.308891,103.854347
207982,3,5,8,1.308849,103.85441
207983,2,13,15,1.308806,103.854473
207984,1,13,14,1.308879,103.854395
207985,3,6,9,1.308764,103.854536
207986,0,12,12,1.308843,103.854448
207987,1,17,18,1.308722,103.854599
207988,1,15,16,1.308854,103.854489
207989,0,7,7,1.308772,103.854554
207990,5,20,25,1.308737,103.854607
207991,0,5,5,1.308701,103.854659
207992,3,51,54,1.308666,103.854712
207993,191,27,218,1.30851,103.854914
207994,0,5,5,1.30863,103.854765
207995,24,369,393,1.308478,103.854967
207996,0,39,39,1.308595,103.854818
207997,2,66,68,1.308559,103.854871
207998,0,83,83,1.308524,103.854924
207999,9,1319,1328,1.308488,103.854977
208000,14,400,414,1.308486,103.85498
208001,3,130,133,1.308485,103.854982
208002,0,4,4,1.308482,103.854987
208003,7,28,35,1.308478,103.854992
208004,0,21,21,1.308475,103.854997
208005,1,15,16,1.308472,103.855003
208006,0,13,13,1.308469,103.855008
208007,1,8,9,1.308466,103.855013
208008,2,25,27,1.308463,103.855018
208009,0,18,18,1.308459,103.855023
208010,7,10,17,1.308456,103.855028
208011,3,17,20,1.308453,103.855033
208012,0,20,20,1.308262,103.855638
208013,0,18,18,1.308235,103.855697
208014,0,14,14,1.308245,103.855745
208015,0,10,10,1.308189,103.855752
208016,0,2,2,1.309202,103.853966
208017,3,2,5,1.30815,103.855819
208018,3,2,5,1.308153,103.855886
208019,0,5,5,1.308103,103.855893
208021,0,29,29,1.308065,103.855944
208022,1,0,1,1.311072,103.858189
208023,0,2,2,1.308176,103.85578
208024,3,15,18,1.307795,103.855832
208025,0,4,4,1.307994,103.856089
208026,0,4,4,1.307736,103.855886
208027,7,11,18,1.307996,103.856131
208028,1,6,7,1.3077,103.855973
208029,1,6,7,1.307978,103.856136
208030,1,10,11,1.307691,103.856
208031,0,17,17,1.307919,103.856165
208032,4,5,9,1.307666,103.856064
208033,0,63,63,1.307897,103.856205
208034,3,14,17,1.307605,103.856082
208035,3,12,15,1.307571,103.856152
208036,5,29,34,1.307541,103.856207
208037,2,27,29,1.307503,103.856231
208060,0,5,5,1.305415,103.855938
208062,0,2,2,1.308008,103.856055
208063,2,8,10,1.30533,103.856032
208064,0,11,11,1.305274,103.856094
208065,1,58,59,1.305228,103.856146
208085,25,32,57,1.311806,103.858949
208086,4,21,25,1.31184,103.858915
208087,1,21,22,1.311875,103.858881
208088,10,19,29,1.311909,103.858847
208089,41,38,79,1.311938,103.858801
208090,5,45,50,1.311972,103.858756
208091,21,0,21,1.311995,103.858727
208092,3,46,49,1.312029,103.858704
208093,15,40,55,1.312058,103.858653
208094,86,40,126,1.312087,103.858619
208095,10,36,46,1.312115,103.858573
208096,5,32,37,1.312144,103.858534
208097,109,43,152,1.312178,103.858494
208098,9,45,54,1.312207,103.85846
208099,24,180,204,1.312224,103.858431
208100,17,0,17,1.312241,103.858403
208101,41,6,47,1.31227,103.858368
208102,5,2,7,1.312293,103.858346
208103,4,37,41,1.312316,103.858311
208104,21,95,116,1.312333,103.858283
208105,52,186,238,1.312356,103.858249
208106,89,269,358,1.312396,103.858192
208108,211,414,625,1.311652,103.858776
208127,43,53,96,1.304388,103.852902
208128,7,15,22,1.304499,103.852968
208129,5,6,11,1.304457,103.85297
208130,8,6,14,1.304514,103.853039
208131,0,4,4,1.304537,103.853123
208132,2,4,6,1.304629,103.853158
208133,490,19,509,1.304686,103.853209
208136,300,173,473,1.305518,103.853992
208142,115,331,446,1.305328,103.853852
208143,7,10,17,1.304773,103.853408
208144,1,16,17,1.30475,103.853391
208145,11,12,23,1.304727,103.853368
208146,3,6,9,1.30471,103.853345
208147,8,81,89,1.304465,103.853173
208148,1,12,13,1.304427,103.853144
208149,2,11,13,1.304402,103.853114
208150,6,18,24,1.304369,103.853088
208151,34,1305,1339,1.304343,103.853066
208178,0,43,43,1.309571,103.862923
208179,2,103,105,1.309517,103.862859
208180,19,36,55,1.309473,103.862804
208182,16,15,31,1.309442,103.862747
208184,38,88,126,1.30938,103.862698
208187,391,23,414,1.309631,103.862676
208188,82,141,223,1.309289,103.862594
208191,59,13,72,1.309235,103.862525
208220,1,0,1,1.308059,103.856001
208222,2,0,2,1.305387,103.855969
208226,0,75,75,1.305703,103.856135
208227,1,363,364,1.305433,103.855897
208247,1,11,12,1.308045,103.85322
208248,149,110,259,1.308136,103.853316
208249,1,17,18,1.308027,103.853302
208250,12,5,17,1.308021,103.853348
208251,1,9,10,1.308015,103.853405
208252,77,6,83,1.308105,103.853392
208253,29,14,43,1.308004,103.853456
208254,12,20,32,1.308011,103.853483
208255,6,21,27,1.308091,103.853473
208256,0,13,13,1.307998,103.853507
208257,6,13,19,1.308077,103.853534
208259,12,2,14,1.308071,103.853602
208261,2,8,10,1.308044,103.853663
208262,1,0,1,1.305469,103.855912
208263,1,8,9,1.30803,103.853713
208264,1,13,14,1.307964,103.853706
208265,0,1,1,1.30797,103.853661
208266,1,2,3,1.30906,103.857172
208267,1,8,9,1.308011,103.853808
208268,0,6,6,1.307952,103.853798
208269,11,1,12,1.308002,103.853853
208270,50,11,61,1.307947,103.853843
208271,7,6,13,1.30799,103.853888
208272,15,11,26,1.307941,103.853889
208273,2,7,9,1.307976,103.853934
208274,5,8,13,1.30793,103.85394
208275,0,9,9,1.307974,103.853968
208276,3,10,13,1.307924,103.853985
208277,9,7,16,1.308472,103.855003
208278,19,14,33,1.307924,103.854025
208279,0,16,16,1.307947,103.854055
208280,15,25,40,1.307912,103.854076
208281,1,11,12,1.30794,103.854091
208282,129,188,317,1.307988,103.854124
208302,0,21,21,1.303988,103.853909
208303,17,69,86,1.303842,103.854023
208305,7,52,59,1.303885,103.853972
208306,0,4,4,1.304041,103.853853
208307,5,34,39,1.303919,103.853921
208308,5,7,12,1.304054,103.853837
208309,0,9,9,1.304092,103.853791
208310,0,9,9,1.304117,103.85377
208312,43,28,71,1.303976,103.853827
208313,2,23,25,1.303993,103.853809
208314,7,19,26,1.304053,103.853741
208315,373,48,421,1.304117,103.853662
208316,15,29,44,1.304207,103.853562
208317,0,56,56,1.304264,103.853454
208318,0,7,7,1.304388,103.853398
208319,6,1,7,1.304454,103.853317
208321,0,1,1,1.308021,103.853755
208322,1,122,123,1.304512,103.853247
208323,2,23,25,1.304027,103.853767
208342,1,254,255,1.307302,103.858962
208343,0,385,385,1.307389,103.858867
208344,60,22,82,1.307607,103.858658
208346,27,285,312,1.308022,103.858338
208347,54,0,54,1.307962,103.858286
208348,21,86,107,1.308126,103.858109
208349,2,61,63,1.308025,103.858209
208350,7,76,83,1.308175,103.858064
208351,4,60,64,1.308219,103.858011
208352,1,49,50,1.30829,103.857925
208353,40,62,102,1.308334,103.857876
208354,43,38,81,1.308377,103.857828
208355,1,73,74,1.308422,103.857797
208356,5,28,33,1.308453,103.857758
208357,49,44,93,1.308492,103.85771
208358,3,43,46,1.308527,103.857668
208359,19,2,21,1.308572,103.857616
208360,10,176,186,1.308603,103.857578
208380,1,222,223,1.312735,103.857476
208381,1,1,2,1.305495,103.855937
208382,0,7,7,1.312666,103.857414
208383,0,2,2,1.312706,103.857448
208384,0,3,3,1.307964,103.853746
208385,0,1,1,1.304499,103.853266
208387,0,3,3,1.312603,103.857351
208388,1,16,17,1.312437,103.857208
208389,8,397,405,1.312478,103.857202
208390,0,9,9,1.312579,103.857284
208391,2,1,3,1.312477,103.857254
208393,227,5,232,1.312679,103.857365
208409,5,2120,2125,1.304661,103.8526
208410,1,9,10,1.304716,103.852635
208411,21,14,35,1.304768,103.852681
208412,13,33,46,1.304819,103.852732
208413,279,19,298,1.304867,103.852781
208414,1,116,117,1.304778,103.852589
208415,3,22,25,1.304806,103.852612
208416,2,20,22,1.304829,103.85264
208417,7,5,12,1.304911,103.852846
208418,15,25,40,1.304858,103.852663
208419,11,6,17,1.304927,103.852877
208420,4,138,142,1.304881,103.852686
208421,8,16,24,1.304936,103.852889
208422,1,27,28,1.304976,103.852917
208423,1,1,2,1.312637,103.85738
208424,1,20,21,1.305024,103.852949
208444,16,485,501,1.309701,103.854387
208445,0,29,29,1.309718,103.85441
208446,4,24,28,1.309741,103.854427
208447,4,14,18,1.309783,103.854464
208448,0,22,22,1.30981,103.854479
208449,3,18,21,1.309856,103.854501
208450,2,27,29,1.309885,103.854524
208451,2,19,21,1.309913,103.854552
208452,55,36,91,1.309936,103.854575
208453,1,4,5,1.309976,103.854598
208454,0,41,41,1.310005,103.854621
208455,22,34,56,1.310034,103.854638
208456,4,41,45,1.310057,103.854672
208482,1,2,3,1.312545,103.857254
208484,0,2,2,1.304996,103.852935
208510,37,1596,1633,1.308423,103.858577
208511,398,452,850,1.308783,103.85821
208512,21,1317,1338,1.309476,103.85751
208513,1,214,215,1.309523,103.85747
208514,168,543,711,1.309568,103.85742
208515,20,723,743,1.309603,103.857394
208516,3,154,157,1.309656,103.857351
208517,19,614,633,1.309701,103.857302
208518,596,66,662,1.309745,103.857264
208519,4,15,19,1.309552,103.857332
208520,21,909,930,1.309788,103.857222
208521,2,20,22,1.309825,103.857185
208522,3,550,553,1.309874,103.857148
208523,1,9,10,1.309915,103.857118
208524,6,671,677,1.309945,103.85708
208525,5,98,103,1.310009,103.857001
208526,0,20,20,1.31008,103.856939
208527,4,301,305,1.310149,103.856877
208528,0,186,186,1.310221,103.856829
208529,7,26,33,1.310276,103.856755
208530,2,746,748,1.310341,103.85669
208531,22,1400,1422,1.31041,103.856639
208532,457,29611,30068,1.310553,103.856475
208533,3549,31265,34814,1.310676,103.855615
208534,26,3178,3204,1.311026,103.855908
208535,24,34,58,1.311175,103.855756
208536,33,357,390,1.311324,103.855733
208537,5,1237,1242,1.311403,103.855666
208538,169,7616,7785,1.310456,103.856588
208539,10226,21667,31893,1.311403,103.85662
208557,233,949,1182,1.307164,103.858633
208558,2,423,425,1.307083,103.858943
208559,333,808,1141,1.31055,103.861897
208560,1,14,15,1.310009,103.861855
208561,236,105,341,1.310342,103.862283
208562,7,62,69,1.310665,103.862702
208563,20,1593,1613,1.309685,103.861464
208564,4,95,99,1.309715,103.861502
208565,5,39,44,1.309774,103.861577
208566,28,110,138,1.309832,103.861653
208567,7,29,36,1.309891,103.861729
208568,7,73,80,1.30995,103.861804
208569,4,28,32,1.310009,103.86188
208570,5,45,50,1.310067,103.861956
208571,11,16,27,1.310126,103.862031
208572,13,91,104,1.310185,103.862107
208573,4,8,12,1.310244,103.862182
208574,91,59,150,1.310302,103.862258
208575,85,176,261,1.310361,103.862334
208576,18,37,55,1.31042,103.862409
208577,67,56,123,1.310479,103.862485
208578,16,61,77,1.310537,103.862561
208579,1,5,6,1.310596,103.862636
208580,21,1232,1253,1.310655,103.862712
208581,561,86,647,1.308558,103.859314
208582,2,615,617,1.307022,103.858858
208600,4,4,8,1.30606,103.856003
208601,4,7,11,1.306043,103.856031
208602,0,5,5,1.306011,103.856055
208603,12,114,126,1.30599,103.856081
208604,3,287,290,1.305817,103.856375
208625,21,96,117,1.306158,103.856336
208628,271,46,317,1.306273,103.856447
208634,4,32,36,1.306372,103.856538
208642,37,30,67,1.306454,103.856599
208646,3,1,4,1.306523,103.856683
208648,99,1,100,1.306583,103.856723
208651,26,35,61,1.306669,103.856812
208652,91,596,687,1.306717,103.856851
208654,40,19,59,1.306623,103.856769
208673,119,280,399,1.306975,103.853965
208674,8,21,29,1.306354,103.854243
208675,1,18,19,1.306353,103.854272
208676,13,17,30,1.299509,103.837
208678,411,1204,1615,1.307699,103.854298
208699,340,18944,19284,1.307527,103.863101
208718,1310,13257,14567,1.306686,103.862452
208736,3,985,988,1.307629,103.861971
208737,12,416,428,1.308018,103.861731
208738,80,32656,32736,1.308491,103.86272
208741,152,221,373,1.308489,103.862926
208743,44,600,644,1.308489,103.862926
208745,913,1338,2251,1.309416,103.863189
208747,1055,588,1643,1.309216,103.862929
208749,1164,473,1637,1.308489,103.862926
208766,1619,4506,6125,1.308489,103.862926
208767,2202,12094,14296,1.307878,103.862653
208785,390,2623,3013,1.303595,103.854072
208786,49,1541,1590,1.30382,103.854246
208787,1445,1381,2826,1.304039,103.854672
208788,1,1839,1840,1.303924,103.854328
208789,1,250,251,1.303947,103.854342
208790,3,392,395,1.303964,103.854352
208791,0,454,454,1.303985,103.854366
208792,0,388,388,1.304009,103.854379
208793,4,997,1001,1.30404,103.854404
208794,18,1849,1867,1.304065,103.854417
208795,40,8409,8449,1.30419,103.854508
208796,6,1,7,1.304214,103.854521
208797,6,1,7,1.304244,103.854539
208798,3,25,28,1.304269,103.854554
208799,8,1649,1657,1.304295,103.854573
208800,26,3141,3167,1.304327,103.854589
208801,22,1386,1408,1.30435,103.854605
208802,10,1842,1852,1.304435,103.854656
208803,0,2,2,1.305062,103.855983
208804,30,4669,4699,1.304508,103.854706
208805,11,3761,3772,1.304789,103.854881
208806,3,885,888,1.30481,103.8549
208807,6,396,402,1.304837,103.854923
208808,4,531,535,1.304872,103.854938
208809,11,179,190,1.304903,103.854959
208810,12,217,229,1.304941,103.854983
208811,1,464,465,1.304978,103.855012
208812,0,122,122,1.305013,103.855034
208813,5,0,5,1.305039,103.855053
208814,5,0,5,1.305074,103.855068
208815,2,1425,1427,1.30511,103.855092
208816,2,522,524,1.305137,103.855105
208817,15,495,510,1.305159,103.855122
208819,0,97,97,1.305354,103.855276
208820,0,49,49,1.305413,103.855313
208821,0,389,389,1.305472,103.85535
208822,0,164,164,1.305531,103.855388
208823,0,119,119,1.30559,103.855425
208824,1,115,116,1.305649,103.855462
208825,7,1039,1046,1.305708,103.855499
208826,6,0,6,1.305767,103.855536
208827,13,1446,1459,1.306302,103.855909
208828,6,972,978,1.306302,103.855909
208829,15,1363,1378,1.306171,103.855712
208830,0,272,272,1.306365,103.855936
208831,6,175,181,1.306199,103.855729
208832,0,158,158,1.30643,103.855974
208833,10,202,212,1.306234,103.855757
208834,0,118,118,1.306457,103.85599
208835,5,617,622,1.306342,103.855734
208836,2,191,193,1.306548,103.856056
208837,25,871,896,1.306303,103.855814
208838,0,223,223,1.306587,103.856074
208839,0,310,310,1.306622,103.856101
208840,0,144,144,1.306663,103.85612
208841,7,400,407,1.306482,103.855935
208842,0,180,180,1.306703,103.856139
208843,8,353,361,1.306528,103.855971
208844,2,87,89,1.306744,103.856164
208845,1,290,291,1.306589,103.855999
208846,1,171,172,1.306771,103.856185
208847,8,341,349,1.306626,103.856026
208848,0,174,174,1.306809,103.856208
208849,7,199,206,1.306659,103.856045
208850,0,434,434,1.30683,103.856227
208851,2,368,370,1.306695,103.856073
208852,21,1,22,1.306866,103.856254
208853,3,236,239,1.306728,103.856093
208855,7,245,252,1.306757,103.856113
208856,9,622,631,1.306943,103.856301
208857,8,326,334,1.306795,103.856139
208858,1,0,1,1.312563,103.857317
208859,116,602,718,1.306831,103.856163
208860,7,371,378,1.306998,103.856334
208861,40,944,984,1.306863,103.856187
208862,1,254,255,1.307023,103.856354
208863,21,978,999,1.307048,103.856329
208864,7,228,235,1.307048,103.856374
208865,13,387,400,1.307075,103.856346
208866,3,465,468,1.307073,103.856381
208867,1,277,278,1.307145,103.856322
208868,4,598,602,1.307088,103.856394
208869,7,250,257,1.307174,103.856344
208870,43,2270,2313,1.30712,103.856421
208871,4,263,267,1.307203,103.856367
208872,14,3522,3536,1.307153,103.856456
208873,0,370,370,1.307226,103.85639
208874,1,601,602,1.30726,103.856413
208875,18,1204,1222,1.307288,103.856439
208876,9,2360,2369,1.307397,103.856439
208877,212,6985,7197,1.307428,103.856771
208878,41,11828,11869,1.307941,103.856944
208879,14,2307,2321,1.307966,103.856961
208880,12,3002,3014,1.307989,103.856976
208881,7,3093,3100,1.308017,103.856987
208882,197,6215,6412,1.308043,103.857002
208883,20,1741,1761,1.308065,103.857018
208884,3,180,183,1.3083,103.857155
208885,0,414,414,1.30835,103.857187
208886,4,1034,1038,1.308333,103.85725
208887,10,162,172,1.30841,103.857218
208888,5,528,533,1.308418,103.857303
208889,1,1012,1013,1.308494,103.857262
208890,0,591,591,1.308522,103.857376
208891,2,147,149,1.308598,103.857325
208892,1,661,662,1.3086,103.857427
208893,2,1333,1335,1.308708,103.857388
208894,29,6822,6851,1.308651,103.857465
208895,35,5995,6030,1.308834,103.857494
208896,6,62,68,1.308892,103.857512
208897,4,11,15,1.308948,103.857547
208898,2,0,2,1.304469,103.854674
208899,12,5228,5240,1.309059,103.857615
208900,0,2,2,1.309003,103.857581
208901,3,4,7,1.30917,103.857684
208902,0,343,343,1.309197,103.857706
208903,7,544,551,1.309225,103.857726
208904,2,1553,1555,1.309253,103.857757
208905,30,2573,2603,1.309344,103.857797
208906,411,3166,3577,1.309256,103.857867
208907,3,766,769,1.309388,103.857822
208908,3,680,683,1.30944,103.857858
208909,24,698,722,1.309493,103.857893
208910,0,43,43,1.309513,103.857917
208911,2,709,711,1.309545,103.857929
208912,4,618,622,1.309597,103.857964
208913,194,1445,1639,1.3094,103.857939
208914,2,478,480,1.30965,103.858
208916,4,307,311,1.309702,103.858035
208918,1,199,200,1.309754,103.85807
208919,1,1434,1435,1.309534,103.85803
208920,2,506,508,1.309806,103.858106
208921,1,468,469,1.309579,103.85806
208922,1,52,53,1.309858,103.858141
208923,3,278,281,1.309624,103.858091
208924,1,243,244,1.309911,103.858177
208925,7,229,236,1.309669,103.858121
208927,2,1322,1324,1.309713,103.858151
208928,15,269,284,1.310006,103.858258
208929,0,8,8,1.309947,103.858301
208930,65,16,81,1.310051,103.858289
208931,6,780,786,1.310074,103.858311
208933,4,28,32,1.310013,103.858349
208934,25,805,830,1.31012,103.85833
208935,14,1369,1383,1.310057,103.858391
208936,0,1,1,1.30697,103.856315
208937,3,433,436,1.310238,103.858387
208938,0,31,31,1.310307,103.858431
208939,5,1089,1094,1.310376,103.858475
208940,3,12,15,1.310444,103.858519
208941,11,1734,1745,1.310513,103.858563
208942,33,757,790,1.310616,103.858628
208943,2,19,21,1.310673,103.858672
208944,10,218,228,1.31073,103.858712
208945,21,874,895,1.310487,103.858639
208946,1,5,6,1.310785,103.858747
208947,1,604,605,1.31057,103.858693
208948,3,293,296,1.310847,103.858787
208949,11,662,673,1.310653,103.858746
208950,3,1,4,1.310896,103.858817
208951,4,116,120,1.310817,103.858879
208952,1,96,97,1.310947,103.858847
208953,32,3572,3604,1.310873,103.858904
208954,0,2,2,1.309114,103.85765
208955,4,169,173,1.311015,103.858897
208956,1,31,32,1.311051,103.858924
208958,1,1,2,1.310977,103.858877
208959,88,4725,4813,1.311214,103.859116
208960,0,42,42,1.311147,103.858985
208962,5,702,707,1.311187,103.859014
208963,32,1600,1632,1.311382,103.859206
208964,1,846,847,1.311226,103.859035
208966,2,3,5,1.311271,103.85906
208968,6,3457,3463,1.311305,103.859083
208969,2,1760,1762,1.311449,103.859264
208970,9,86,95,1.311343,103.859107
208971,1,39,40,1.311474,103.859279
208972,0,426,426,1.311499,103.859295
208973,9,809,818,1.311409,103.859163
208974,0,748,748,1.311555,103.859337
208975,6,1021,1027,1.311441,103.859183
208976,4,745,749,1.311575,103.859351
208977,3,144,147,1.311473,103.859212
208978,4,0,4,1.311596,103.859366
208979,4,1,5,1.311514,103.859246
208980,2,941,943,1.311617,103.859381
208981,2,371,373,1.311591,103.859287
208982,3,172,175,1.311632,103.859315
208983,17,26,43,1.311691,103.859358
208984,15,166,181,1.311768,103.859417
208985,1,376,377,1.311847,103.85944
208986,1,305,306,1.311895,103.859458
208987,9,644,653,1.31194,103.859467
208988,5,2765,2770,1.312304,103.859592
208989,5,2548,2553,1.312359,103.85961
208990,2,2,4,1.312418,103.859629
208991,0,5,5,1.312453,103.859637
208992,0,1,1,1.310169,103.858343
208993,9,2523,2532,1.312521,103.859652
208994,25,0,25,1.312556,103.85966
208995,9,572,581,1.31259,103.859668
208996,4,201,205,1.312625,103.859675
208997,62,591,653,1.312659,103.859683
208998,29,695,724,1.312693,103.859691
208999,19,3822,3841,1.312796,103.859714
209000,6,1249,1255,1.313077,103.859851
209001,376,891,1267,1.312899,103.859737
209002,5,109,114,1.312922,103.859743
209003,3,0,3,1.304959,103.855881
209004,6,698,704,1.312991,103.859758
209005,4,9,13,1.313025,103.859766
209006,3,227,230,1.31306,103.859774
209007,2,12,14,1.313263,103.85981
209008,0,280,280,1.313318,103.859821
209009,3,52,55,1.313397,103.859841
209010,4,0,4,1.313456,103.859857
209011,15,221,236,1.31354,103.859859
209012,361,0,361,1.313609,103.85987
209013,8,101,109,1.31369,103.859882
209014,4,11,15,1.313798,103.859927
209015,9,13,22,1.313887,103.859941
209016,1,51,52,1.31398,103.859971
209017,6,58,64,1.314102,103.859994
209018,1,1,2,1.31111,103.858958
209019,171,1536,1707,1.31022,103.858478
209037,268,439,707,1.307152,103.857875
209062,8,3239,3247,1.308298,103.862612
209065,246,5255,5501,1.308969,103.862056
209066,156,644,800,1.309068,103.861967
209067,17,577,594,1.309268,103.86179
209068,9,456,465,1.309467,103.861613
209069,5,1006,1011,1.309666,103.861436
209071,29,1008,1037,1.309744,103.861373
209072,6,328,334,1.310214,103.860992
209073,43,355,398,1.310292,103.860929
209074,6,323,329,1.310449,103.860802
209075,38,503,541,1.31048,103.860777
209076,14,234,248,1.310511,103.860751
209077,5,128,133,1.310572,103.860701
209078,14,31,45,1.310634,103.86065
209079,8,0,8,1.310696,103.860599
209080,60,652,712,1.310757,103.860549
209081,1,0,1,1.312487,103.859644
209082,6,3,9,1.310881,103.860447
209083,33,201,234,1.310942,103.860397
209084,20,913,933,1.311004,103.860346
209105,33,20,53,1.308751,103.853627
209106,7,8,15,1.30871,103.853677
209107,39,31,70,1.308681,103.85372
209108,11,7,18,1.308641,103.85378
209110,37,79,116,1.308559,103.853873
209111,3,24,27,1.308401,103.854142
209112,4,4,8,1.308317,103.85426
209113,12,36,48,1.308294,103.854299
209114,7,0,7,1.308266,103.854334
209115,12,27,39,1.308243,103.854373
209116,1,0,1,1.310819,103.860498
209117,8,109,117,1.308197,103.854448
209118,11,1,12,1.308174,103.854499
209119,43,1517,1560,1.30814,103.854544
209120,4,31,35,1.30744,103.855575
209121,5,21,26,1.307432,103.855594
209122,7,14,21,1.3074,103.85563
209123,0,13,13,1.307371,103.855677
209124,7,18,25,1.307334,103.855726
209125,3,18,21,1.307304,103.855778
209126,5,13,18,1.307276,103.855824
209127,2,23,25,1.30724,103.855878
209148,212,347,559,1.305385,103.851554
209149,34,1120,1154,1.305358,103.85159
209150,36,1947,1983,1.305334,103.851624
209151,53,760,813,1.305313,103.851652
209152,17,201,218,1.305283,103.851696
209153,4,68,72,1.305256,103.851743
209154,5,102,107,1.30523,103.851791
209155,14,263,277,1.305198,103.851839
209175,44,1258,1302,1.311027,103.860361
209176,5,32,37,1.311051,103.860397
209177,45,2,47,1.311097,103.860467
209178,57,0,57,1.311144,103.860538
209179,10,27,37,1.311035,103.860468
209180,28,39,67,1.311191,103.860608
209181,32,57,89,1.311079,103.860541
209182,1,0,1,1.30822,103.854408
209183,7,0,7,1.311184,103.860693
209184,83,49,132,1.311236,103.86077
209185,2,4,6,1.311331,103.86082
209186,1,3,4,1.31128,103.860828
209187,1,21,22,1.311377,103.860891
209188,7,25,32,1.311328,103.860924
209190,4,5,9,1.311388,103.861003
209191,0,1,1,1.311237,103.860679
209192,0,4,4,1.311454,103.861099
209193,4,9,13,1.311517,103.861103
209194,2,6,8,1.311502,103.861164
209195,1,19,20,1.311548,103.86124
209196,0,1,1,1.31147,103.861032
209197,80,4,84,1.311608,103.8613
209198,0,9,9,1.311657,103.861314
209199,11,29,40,1.311652,103.861357
209200,5,13,18,1.311704,103.861385
209201,524,1,525,1.311678,103.861411
209202,3,24,27,1.31175,103.861456
209203,10,54,64,1.311708,103.861472
209204,0,4,4,1.311797,103.861526
209206,2,1,3,1.312956,103.859751
209208,7,38,45,1.311825,103.861656
209210,192,358,550,1.311397,103.861096
209232,12,828,840,1.30703,103.860364
209252,8,894,902,1.311808,103.859481
209253,0,30,30,1.311824,103.859497
209254,0,1458,1458,1.311857,103.859528
209255,0,1412,1412,1.311889,103.85956
209256,3,230,233,1.311922,103.859592
209258,2,260,262,1.311987,103.859655
209259,10,1218,1228,1.312019,103.859686
209260,3,5,8,1.312052,103.859718
209261,20,1016,1036,1.312084,103.85975
209262,2,187,189,1.312117,103.859781
209263,31,5392,5423,1.312149,103.859813
209264,282,3604,3886,1.312342,103.85994
209265,30,1499,1529,1.312585,103.860228
209266,7,1553,1560,1.312644,103.860271
209267,7,1392,1399,1.312681,103.860316
209268,8,151,159,1.312719,103.860352
209269,17,1296,1313,1.312758,103.860398
209270,2,57,59,1.312764,103.860516
209271,1,0,1,1.31161,103.861244
209272,4,759,763,1.312806,103.860444
209273,7,271,278,1.312848,103.860486
209274,126,774,900,1.312883,103.860533
209276,706,621,1327,1.312405,103.860189
209295,3,510,513,1.31254,103.857716
209296,1,6,7,1.312464,103.857654
209297,3,7,10,1.312394,103.857597
209298,2,0,2,1.311721,103.859392
209299,0,5,5,1.312274,103.857501
209300,0,2,2,1.312333,103.857548
209301,1,18,19,1.312156,103.857399
209303,5,2,7,1.312095,103.857354
209304,2,19,21,1.312036,103.857304
209305,0,4,4,1.311998,103.857267
209306,1,14,15,1.311952,103.85723
209307,0,3,3,1.311773,103.861575
209308,0,14,14,1.311873,103.857169
209309,0,16,16,1.311833,103.857135
209310,5,805,810,1.311796,103.857106
209331,2,126,128,1.304143,103.854454
209332,3,99,102,1.304146,103.854469
209333,0,33,33,1.304156,103.854438
209334,3,7,10,1.304164,103.854449
209335,8,56,64,1.304183,103.854408
209336,0,21,21,1.304199,103.85441
209337,0,36,36,1.30421,103.854377
209338,0,29,29,1.304234,103.85437
209339,6,35,41,1.304237,103.854347
209340,3,43,46,1.304269,103.854331
209341,0,23,23,1.304264,103.854316
209342,0,12,12,1.304304,103.854291
209343,0,25,25,1.304338,103.854252
209344,0,4,4,1.304318,103.854255
209345,0,27,27,1.304373,103.854212
209346,1,88,89,1.304345,103.854224
209347,0,11,11,1.304408,103.854173
209348,6,13,19,1.304443,103.854133
209349,1,0,1,1.299509,103.837
209350,61,11,72,1.304478,103.854094
209351,6,0,6,1.304426,103.854132
209352,2,7,9,1.304513,103.854054
209353,1,0,1,1.304399,103.854163
209354,1,20,21,1.304548,103.854014
209355,0,1,1,1.304453,103.854102
209356,134,23,157,1.304583,103.853975
209357,0,1,1,1.30448,103.854071
209358,1,7,8,1.304618,103.853935
209360,0,11,11,1.304653,103.853896
209361,0,1,1,1.304507,103.85404
209362,1,17,18,1.304688,103.853856
209363,0,7,7,1.304589,103.853949
209364,90,14,104,1.304723,103.853817
209366,3,8,11,1.304758,103.853777
209368,2,8,10,1.304792,103.853738
209369,18,256,274,1.30467,103.853857
209370,0,19,19,1.304827,103.853698
209371,2,242,244,1.304697,103.853826
209373,7,11,18,1.304862,103.853659
209374,2,0,2,1.312219,103.857451
209375,1,17,18,1.304897,103.853619
209376,1,126,127,1.304751,103.853765
209377,3,34,37,1.304932,103.85358
209378,8,93,101,1.304778,103.853734
209379,43,376,419,1.304967,103.85354
209381,9,671,680,1.304983,103.853523
209382,1,206,207,1.304832,103.853673
209384,6,115,121,1.304999,103.853506
209386,1,86,87,1.305031,103.853473
209388,49,264,313,1.305062,103.853439
209389,2,112,114,1.305094,103.853405
209390,30,211,241,1.305126,103.853372
209391,235,1032,1267,1.304957,103.85353
209392,3,148,151,1.305158,103.853338
209393,29,517,546,1.304977,103.85351
209394,42,114,156,1.30519,103.853305
209395,34,393,427,1.304986,103.853499
209396,39,110,149,1.305222,103.853271
209397,12,98,110,1.305006,103.853479
209398,6,67,73,1.305253,103.853237
209399,48,215,263,1.305025,103.853458
209400,21,79,100,1.305285,103.853204
209401,82,223,305,1.305045,103.853438
209402,10,175,185,1.305317,103.85317
209403,32,4,36,1.305334,103.853152
209404,6,269,275,1.305084,103.853397
209405,0,48,48,1.305351,103.853133
209406,23,308,331,1.305103,103.853376
209407,4,50,54,1.305385,103.853096
209408,30,630,660,1.305123,103.853356
209409,2,37,39,1.305419,103.853059
209411,2,21,23,1.305454,103.853022
209412,31,49,80,1.305488,103.852985
209413,8,21,29,1.305522,103.852948
209414,15,50,65,1.305556,103.852911
209415,3,33,36,1.30559,103.852874
209416,3,69,72,1.305624,103.852837
209417,9,43,52,1.305659,103.8528
209418,7,54,61,1.305693,103.852763
209419,11,42,53,1.305727,103.852726
209420,146,683,829,1.305307,103.85316
209421,20,498,518,1.305761,103.852689
209422,7,181,188,1.305337,103.853128
209423,19,18,37,1.305775,103.852665
209424,4,143,147,1.305357,103.853106
209425,1,253,254,1.305789,103.852641
209426,5,75,80,1.305398,103.853063
209428,19,132,151,1.305438,103.853019
209429,51,0,51,1.305845,103.852545
209430,7,107,114,1.305478,103.852975
209431,2,8,10,1.305873,103.852498
209432,11,100,111,1.305519,103.852931
209434,1,1,2,1.304724,103.853796
209436,5,265,270,1.3056,103.852844
209437,7,0,7,1.305957,103.852354
209438,1,94,95,1.30564,103.8528
209439,2,0,2,1.305559,103.852888
209440,4,100,104,1.30568,103.852756
209441,1,42,43,1.306013,103.852258
209442,5,1,6,1.305721,103.852713
209443,13,28,41,1.30604,103.85221
209444,31,1093,1124,1.305751,103.852679
209445,12,30,42,1.306068,103.852163
209446,65,298,363,1.305776,103.852644
209447,9,43,52,1.306096,103.852115
209448,5,137,142,1.30579,103.852619
209449,3,52,55,1.30582,103.852568
209450,3,42,45,1.306152,103.852019
209451,1,0,1,1.304562,103.853979
209452,1,49,50,1.30618,103.851971
209454,39,43,82,1.306208,103.851923
209455,1,0,1,1.305849,103.852518
209456,25,26,51,1.306236,103.851876
209457,3,105,108,1.305938,103.852367
209458,10,39,49,1.306264,103.851828
209459,3,17,20,1.305967,103.852316
209460,22,29,51,1.306292,103.85178
209461,7,74,81,1.305996,103.852266
209462,5,48,53,1.30632,103.851732
209463,6,34,40,1.306026,103.852216
209464,3,3,6,1.306055,103.852165
209465,0,1,1,1.305908,103.852417
209466,46,127,173,1.306114,103.852065
209467,8,170,178,1.306143,103.852014
209470,8,101,109,1.306232,103.851863
209471,3,31,34,1.306261,103.851813
209472,0,105,105,1.306291,103.851762
209473,4,141,145,1.30631,103.851722
209493,2,34,36,1.304729,103.854811
209494,986,588,1574,1.304747,103.854814
209495,0,1,1,1.306085,103.852115
209496,3,157,160,1.304879,103.854642
209498,1,56,57,1.304932,103.854573
209499,4,82,86,1.304984,103.854505
209500,1,77,78,1.305037,103.854436
209502,13,74,87,1.305142,103.854299
209503,4,43,47,1.305211,103.854183
209504,2,19,21,1.305195,103.85423
209505,4,22,26,1.305268,103.854109
209506,46,16,62,1.305247,103.854162
209507,163,10,173,1.305325,103.854035
209508,3,1,4,1.3053,103.854093
209509,17,212,229,1.305353,103.854024
209510,1,16,17,1.305438,103.853887
209511,0,1,1,1.304871,103.854626
209512,14,40,54,1.305448,103.853897
209513,24,14,38,1.305469,103.853846
209518,84,132,216,1.3055,103.853804
209520,3,83,86,1.305562,103.853721
209521,1,32,33,1.305623,103.853638
209522,0,7,7,1.305685,103.853555
209524,0,9,9,1.305747,103.853472
209525,1,30,31,1.305809,103.853389
209526,1,15,16,1.305871,103.853306
209527,8,50,58,1.305994,103.85314
209528,49,121,170,1.306056,103.853057
209530,1957,216,2173,1.304758,103.854774
209531,4,66,70,1.304984,103.854478
209549,5,79,84,1.309623,103.854179
209550,5,16,21,1.309598,103.854224
209552,1,43,44,1.309547,103.854299
209553,28,64,92,1.309526,103.854334
209554,0,168,168,1.309525,103.85438
209555,3,132,135,1.309488,103.854435
209556,3,52,55,1.309463,103.854471
209557,7,65,72,1.309438,103.854508
209558,6,0,6,1.309413,103.854544
209559,0,2,2,1.305985,103.852306
209560,13,72,85,1.309364,103.854617
209561,0,33,33,1.309339,103.854654
209562,7,30,37,1.309344,103.854667
209563,5,66,71,1.309315,103.85469
209564,1,27,28,1.30929,103.854726
209565,5,2,7,1.309267,103.854781
209566,1,47,48,1.309265,103.854763
209567,0,13,13,1.309228,103.854838
209568,1,41,42,1.30924,103.854799
209569,7,24,31,1.309189,103.854894
209570,0,67,67,1.309216,103.854836
209571,0,34,34,1.309191,103.854872
209572,1,29,30,1.309112,103.855008
209573,0,1,1,1.305405,103.853956
209574,2,11,13,1.309074,103.855065
209575,1,3,4,1.309141,103.854945
209576,26,14,40,1.309035,103.855122
209577,1,167,168,1.309117,103.854981
209578,0,28,28,1.308996,103.855179
209579,3,1,4,1.309092,103.855018
209581,3,29,32,1.309067,103.855054
209582,2,53,55,1.309043,103.855091
209583,0,32,32,1.309018,103.855127
209584,0,60,60,1.308993,103.855164
209585,1,98,99,1.308968,103.8552
209586,22,589,611,1.308944,103.855237
209587,3,853,856,1.308919,103.855273
209588,379,2370,2749,1.308903,103.855319
209589,7,1195,1202,1.308846,103.855357
209590,6,248,254,1.308887,103.855344
209591,50,301,351,1.308823,103.855392
209592,2,54,56,1.308855,103.855396
209593,225,252,477,1.308795,103.855444
209594,2,42,44,1.308823,103.855447
209595,0,2,2,1.309389,103.854581
209596,3,43,46,1.30879,103.855498
209597,5,99,104,1.308767,103.855516
209598,7,11,18,1.308758,103.855549
209599,0,49,49,1.308728,103.855577
209600,7,37,44,1.308726,103.855601
209601,3,34,37,1.30869,103.855637
209602,0,12,12,1.308694,103.855652
209603,4,29,33,1.299509,103.837
209604,0,19,19,1.308662,103.855703
209605,6,25,31,1.30864,103.855705
209606,1,20,21,1.30863,103.855754
209607,1,16,17,1.308614,103.855759
209608,38,38,76,1.308588,103.855792
209609,0,16,16,1.308565,103.855857
209610,0,25,25,1.308558,103.85584
209611,1,18,19,1.308533,103.855908
209612,0,27,27,1.308526,103.855878
209613,2,19,21,1.308501,103.855959
209614,0,28,28,1.308507,103.855909
209615,0,26,26,1.308469,103.85601
209616,4,20,24,1.308477,103.855945
209617,0,23,23,1.308437,103.856062
209618,0,22,22,1.308445,103.855992
209619,0,20,20,1.308404,103.856113
209620,0,19,19,1.308427,103.856023
209621,12,20,32,1.308372,103.856164
209622,1,30,31,1.308411,103.856057
209623,0,19,19,1.30834,103.856216
209624,105,22,127,1.308391,103.85608
209625,1,13,14,1.308308,103.856267
209626,0,28,28,1.308369,103.856108
209627,17,19,36,1.308276,103.856318
209628,1,25,26,1.308345,103.856135
209629,3,24,27,1.308244,103.856369
209630,18,26,44,1.308312,103.856177
209631,14,25,39,1.308212,103.85642
209632,0,37,37,1.308285,103.856213
209633,4,28,32,1.308179,103.856472
209634,4,27,31,1.308268,103.856251
209635,0,20,20,1.308236,103.856288
209636,0,38,38,1.308199,103.856338
209637,4,45,49,1.308185,103.856366
209638,33,58,91,1.308257,103.856399
209639,169,233,402,1.308158,103.856402
209640,15,110,125,1.308205,103.856467
209641,1,110,111,1.308175,103.856512
209642,4,89,93,1.308146,103.856558
209643,4,77,81,1.308116,103.856615
209644,15,262,277,1.308088,103.856655
209645,97,354,451,1.308929,103.855283
209646,5,30,35,1.308597,103.855806
209647,8,139,147,1.309437,103.854555
209648,1,31,32,1.309305,103.854724
209664,27,85,112,1.305113,103.851949
209665,0,71,71,1.305112,103.851948
209666,0,13,13,1.305112,103.851948
209670,0,99,99,1.305112,103.851948
209671,30,4330,4360,1.305089,103.85196
209673,18,107,125,1.305048,103.852012
209674,12,55,67,1.305064,103.852011
209675,41,122,163,1.304965,103.852116
209676,1,69,70,1.305031,103.852053
209677,1,213,214,1.304882,103.852219
209678,2,1,3,1.311913,103.8572
209679,3,58,61,1.3048,103.852323
209680,5,2,7,1.304965,103.852136
209681,6,173,179,1.304718,103.852427
209682,33,11,44,1.304932,103.852177
209683,13,1716,1729,1.304635,103.852531
209684,1,4,5,1.304899,103.852219
209685,1,17,18,1.304866,103.85226
209686,0,32,32,1.304833,103.852302
209687,7,29,36,1.3048,103.852343
209688,2,23,25,1.304767,103.852385
209689,3,24,27,1.304734,103.852426
209690,3,21,24,1.304701,103.852468
209691,6,60,66,1.304668,103.852509
209692,21,324,345,1.304645,103.852541
209712,27,72,99,1.307058,103.852573
209713,1,12,13,1.30702,103.852479
209714,3,0,3,1.304998,103.852094
209715,0,15,15,1.307003,103.852542
209716,3,1,4,1.307064,103.852616
209717,3,0,3,1.307054,103.85259
209718,0,10,10,1.307041,103.852656
209719,10,7,17,1.30698,103.852678
209720,1,0,1,1.309166,103.854909
209721,2,4,6,1.306975,103.852716
209722,0,11,11,1.307031,103.852701
209723,2,13,15,1.306963,103.852759
209724,15,0,15,1.307034,103.852733
209725,11,24,35,1.306958,103.852792
209726,5,29,34,1.307035,103.852758
209727,1,14,15,1.306952,103.852855
209728,2,4,6,1.307035,103.852809
209730,0,3,3,1.306992,103.852616
209731,2,39,41,1.30694,103.852917
209732,0,8,8,1.307024,103.852912
209733,5,24,29,1.306923,103.85298
209734,3,8,11,1.307041,103.852975
209735,8,13,21,1.306916,103.853006
209736,1,10,11,1.306912,103.853043
209737,4,3,7,1.306906,103.853105
209738,10,6,16,1.308565,103.855857
209739,3,16,19,1.307023,103.853006
209740,3,3,6,1.306899,103.853177
209741,0,5,5,1.307018,103.853031
209742,19,12,31,1.306898,103.853206
209743,1,15,16,1.30703,103.853083
209744,1,16,17,1.306886,103.853272
209745,2,12,14,1.306883,103.853293
209747,2,10,12,1.307012,103.853128
209748,2,15,17,1.306883,103.85335
209749,4,5,9,1.306995,103.853168
209750,2,13,15,1.306883,103.853402
209751,9,8,17,1.306995,103.853225
209752,6,39,45,1.306876,103.853472
209753,165,11,176,1.306995,103.853282
209754,5,5,10,1.306978,103.853333
209755,26,8,34,1.306972,103.85339
209756,0,36,36,1.306944,103.853447
209757,2,20,22,1.306866,103.853509
209776,11,0,11,1.305302,103.852172
209777,1,0,1,1.30704,103.852678
209778,22,25,47,1.305329,103.852191
209779,9,5,14,1.305358,103.852225
209780,10,13,23,1.305386,103.852253
209781,12,224,236,1.305415,103.852276
209782,4,0,4,1.305543,103.852442
209783,2,6,8,1.305866,103.852763
209784,5,287,292,1.30586,103.852851
209785,103,1,104,1.305901,103.852763
209786,2,44,46,1.305895,103.852845
209787,3,3,6,1.305929,103.852763
209788,3,33,36,1.305929,103.852845
209789,2,0,2,1.308763,103.855491
209790,1,21,22,1.305964,103.852845
209791,4,2,6,1.305998,103.852763
209792,8,2,10,1.305998,103.852845
209793,0,2,2,1.305969,103.852769
209794,23,2,25,1.306032,103.852851
209814,2,57,59,1.306768,103.854348
209815,0,7,7,1.306791,103.854319
209816,0,1,1,1.305313,103.852185
209818,0,2,2,1.306032,103.852763
209819,0,2,2,1.306847,103.854229
209820,0,2,2,1.306871,103.854205
209821,0,4,4,1.306908,103.854149
209822,0,75,75,1.306929,103.854129
209842,54,54,108,1.310712,103.861088
209843,5,49,54,1.310675,103.861175
209844,44,1,45,1.310754,103.861154
209845,2,22,24,1.310793,103.861216
209846,1,0,1,1.306811,103.854288
209847,1,22,23,1.310863,103.861337
209848,172,4,176,1.310927,103.861407
209849,1,28,29,1.310988,103.861517
209850,0,18,18,1.31105,103.861589
209851,84,71,155,1.310897,103.861465
209852,121,22,143,1.311092,103.861649
209853,11,22,33,1.31095,103.861566
209854,176,12,188,1.310994,103.861624
209855,7,43,50,1.311036,103.861666
209856,4,11,15,1.311066,103.861717
209857,11,81,92,1.311143,103.861721
209858,11,38,49,1.311108,103.861773
209859,5,0,5,1.311185,103.861798
209860,0,36,36,1.311152,103.861833
209861,4,19,23,1.31124,103.861875
209862,4,22,26,1.31131,103.861929
209882,17,0,17,1.305883,103.851843
209883,9,3,12,1.3058,103.851773
209884,0,1,1,1.310833,103.861275
209885,5,3,8,1.305777,103.851801
209886,4,2,6,1.305754,103.85183
209887,0,1,1,1.305854,103.851877
209888,122,2,124,1.305703,103.851887
209889,9,1,10,1.305687,103.851902
209890,8,0,8,1.30568,103.851915
209891,2,1,3,1.307018,103.852861
209892,4,0,4,1.30564,103.851984
209893,3,1,4,1.305617,103.852012
209894,9,192,201,1.305333,103.852458
209895,4,5,9,1.305595,103.85206
209896,5,0,5,1.305321,103.852472
209897,6,189,195,1.305362,103.852358
209898,9,5,14,1.305305,103.852489
209899,0,3,3,1.305663,103.851949
209900,3,0,3,1.305271,103.852529
209901,6,5,11,1.305242,103.852563
209902,0,3,3,1.305348,103.852371
209903,2,23,25,1.305571,103.852185
209904,3,3,6,1.305286,103.852425
209905,33,16,49,1.305208,103.852597
209906,0,10,10,1.305257,103.852465
209907,1,1,2,1.306884,103.854182
209908,0,6,6,1.305229,103.852499
209909,9,3,12,1.305145,103.85266
209910,2,10,12,1.3052,103.852533
209911,6,7,13,1.305122,103.852689
209912,0,4,4,1.305183,103.852567
209913,3,4,7,1.305093,103.852717
209914,0,6,6,1.305149,103.852602
209915,0,1,1,1.305732,103.851858
209916,2,7,9,1.30512,103.852636
209917,1,77,78,1.305053,103.852763
209918,193,4,197,1.30511,103.852661
209920,3,7,10,1.30508,103.852698
209922,5,0,5,1.305057,103.852727
209924,90,18,108,1.305681,103.852261
209943,749,137,886,1.313781,103.859118
209945,44,1030,1074,1.312151,103.860352
209946,36,287,323,1.314175,103.858242
209947,2,29,31,1.314036,103.859327
209948,4,7,11,1.313844,103.859388
209949,3,7,10,1.313838,103.859157
209950,2,0,2,1.305174,103.852626
209951,8,20,28,1.314093,103.859382
209952,5,59,64,1.313969,103.859277
209954,205,25,230,1.314384,103.859036
209973,132,509,641,1.310366,103.859204
209974,0,365,365,1.310341,103.859186
210009,475,1258,1733,1.313607,103.85165
210010,833,196,1029,1.313847,103.852141
210011,1223,1855,3078,1.312358,103.851818
210012,1624,501,2125,1.312113,103.851582
210013,1721,176,1897,1.311672,103.851167
210014,122,66,188,1.311182,103.851281
210015,619,110,729,1.311033,103.851581
210025,1,56,57,1.314626,103.85218
210037,274,2121,2395,1.316743,103.84927
210038,577,148,725,1.316452,103.84888
210039,371,422,793,1.316203,103.848439
210040,481,300,781,1.315733,103.848231
210041,170,100,270,1.315629,103.849895
210042,98,620,718,1.315803,103.849673
210043,243,298,541,1.315347,103.849427
210044,246,152,398,1.315454,103.850383
210045,17,2101,2118,1.315617,103.850834
210046,421,638,1059,1.315125,103.850789
210047,157,522,679,1.314897,103.850096
210048,309,1393,1702,1.314306,103.850491
210049,243,14,257,1.312476,103.85009
210050,802,249,1051,1.313728,103.850795
210051,432,535,967,1.316681,103.851072
210052,291,4437,4728,1.316346,103.85135
210053,161,145,306,1.316682,103.852162
210054,403,724,1127,1.317048,103.852406
210661,9063,78298,87361,1.306964,103.850357
210662,119,2454,2573,1.306202,103.85012
210663,71,1415,1486,1.305672,103.850873
210664,84,1310,1394,1.306317,103.85119
210665,85,72,157,1.306197,103.850551
210668,438,153,591,1.307745,103.851086
210671,39,48,87,1.308662,103.852339
210672,11,38,49,1.308571,103.852361
210677,409,4153,4562,1.312467,103.854973
210678,10,77,87,1.312804,103.85544
210681,591,92,683,1.313998,103.855302
210682,347,411,758,1.314203,103.855565
210683,958,367,1325,1.314521,103.855865
210684,447,280,727,1.314051,103.856353
210685,513,575,1088,1.314244,103.856862
211014,23,37,60,1.311983,103.852107
211037,7,114,121,1.316371,103.848945
211039,17,271,288,1.316564,103.848637
211041,143,11584,11727,1.316263,103.849928
211048,485,5974,6459,1.314589,103.850956
211050,6,135,141,1.299509,103.837
211671,179,306,485,1.308777,103.8522
211672,240,64,304,1.308542,103.852407
212671,89,61,150,1.309293,103.85259
212672,135,99,234,1.309091,103.852781
217562,11670,711,12381,1.312316,103.854285
217564,487,749,1236,1.312039,103.854636
217565,7,139,146,1.299509,103.837
217567,304,101,405,1.312139,103.850992
217568,0,5,5,1.31372,103.84997
217569,11,24,35,1.313763,103.849798
217570,50,2,52,1.313684,103.84997
217571,0,14,14,1.313813,103.849763
217572,4,2,6,1.313667,103.849988
217573,0,1,1,1.30507,103.85274
217574,1,0,1,1.313633,103.850024
217575,1,9,10,1.31399,103.849638
217576,1,0,1,1.3136,103.850061
217577,54,1,55,1.314013,103.849613
217578,2,1,3,1.305326,103.852391
217579,0,2,2,1.313905,103.859214
217580,0,210,210,1.314116,103.849813
217581,0,2,2,1.314058,103.849562
217583,10,0,10,1.31415,103.84946
217584,61,5,66,1.314218,103.8497
217585,1,2,3,1.313498,103.850169
217587,2,3,5,1.314287,103.849307
217588,2,11,13,1.314333,103.849256
217589,2,15,17,1.313998,103.849649
217591,8,0,8,1.314424,103.849154
217592,18,102,120,1.314093,103.849544
217601,5,1,6,1.314156,103.849474
217602,161,1,162,1.314155,103.849473
217603,6,1,7,1.314516,103.849052
217604,1,28,29,1.314218,103.849404
217605,0,54,54,1.314218,103.849402
217606,1,7,8,1.314281,103.849333
217607,0,56,56,1.314344,103.849263
217608,53,5,58,1.314407,103.849193
217609,94,11,105,1.31447,103.849123
217616,0,1,1,1.313532,103.850133
217646,556,1053,1609,1.31652,103.85713
217647,2,0,2,1.314104,103.849511
217648,10,192,202,1.316257,103.857242
217649,0,75,75,1.316177,103.857151
217650,0,11,11,1.316125,103.857094
217651,0,5,5,1.316091,103.857071
217652,0,3,3,1.314196,103.849409
217653,3,0,3,1.316056,103.857026
217654,1,0,1,1.31491,103.848632
217655,5,0,5,1.316064,103.857106
217656,47,129,176,1.315753,103.856764
217658,3,0,3,1.316022,103.856986
217659,2,8,10,1.315627,103.856633
217660,6,93,99,1.315598,103.856605
217661,43,0,43,1.315569,103.856571
217662,7,159,166,1.315535,103.856542
217663,59,98,157,1.315506,103.856508
217664,1313,2112,3425,1.315722,103.856214
217665,1,2,3,1.315661,103.856662
217666,108,377,485,1.315437,103.856446
217667,17,2,19,1.315409,103.856423
217668,18,641,659,1.315268,103.85635
217669,11,280,291,1.315374,103.856389
217670,14,41,55,1.315208,103.855934
217671,0,791,791,1.315208,103.855934
217673,0,81,81,1.315132,103.855858
217674,1,0,1,1.315822,103.856827
217675,0,270,270,1.315054,103.85577
217676,0,220,220,1.314901,103.855672
217677,2,97,99,1.314881,103.85565
217678,2,48,50,1.31484,103.855605
217679,0,124,124,1.3148,103.85556
217680,1,118,119,1.31476,103.855514
217681,1,167,168,1.31472,103.855469
217682,0,102,102,1.314679,103.855424
217683,0,169,169,1.314639,103.855379
217685,0,133,133,1.314604,103.855341
217686,2,27,29,1.314572,103.855305
217687,1,79,80,1.314504,103.85523
217688,0,20,20,1.314437,103.855156
217689,2,94,96,1.31437,103.855081
217690,0,41,41,1.314303,103.855007
217691,0,112,112,1.314235,103.854932
217692,2,701,703,1.314168,103.854858
217694,2,288,290,1.315098,103.856137
217695,6,2466,2472,1.315098,103.856137
217696,3,685,688,1.314044,103.854716
217698,1,0,1,1.315054,103.85577
217699,34,321,355,1.313671,103.854289
217724,8,11,19,1.313793,103.854226
217725,6,6,12,1.313628,103.853777
217754,10,151,161,1.313945,103.853556
217755,386,83,469,1.314077,103.853478
217757,1,37,38,1.314056,103.853489
217758,10,42,52,1.313883,103.853583
217759,25,4,29,1.314037,103.853498
217760,5,3,8,1.313852,103.853599
217761,0,7,7,1.314007,103.853507
217762,26,38,64,1.31382,103.853617
217763,11,12,23,1.313975,103.85352
217764,4,0,4,1.31395,103.853535
217765,1,14,15,1.313912,103.853553
217766,0,6,6,1.313831,103.853596
217768,0,6,6,1.313706,103.85369
217769,10,2,12,1.313657,103.853728
217770,169,1024,1193,1.313609,103.853769
217809,1,61,62,1.315148,103.85528
217810,0,6,6,1.314971,103.855299
217811,286,12,298,1.315069,103.855052
217812,9,34,43,1.315101,103.855239
217814,7,54,61,1.314995,103.854972
217815,1,0,1,1.315896,103.856895
217816,32,0,32,1.315077,103.855194
217817,3,0,3,1.315466,103.85648
217818,48,11,59,1.315027,103.855153
217820,168,36,204,1.31481,103.854756
217822,0,7,7,1.314941,103.855056
217823,0,6,6,1.314941,103.855056
217827,0,121,121,1.314875,103.854974
217829,0,9,9,1.314824,103.854913
217830,3,32,35,1.314791,103.854867
217831,4,1,5,1.314756,103.854839
217832,1,17,18,1.314719,103.854795
217833,2,1,3,1.314886,103.854847
217834,1,27,28,1.31465,103.854723
217835,17,19,36,1.314609,103.85468
217864,1,4,5,1.314491,103.854585
217865,3,0,3,1.314684,103.854769
217866,0,9,9,1.314625,103.854517
217867,1,1,2,1.316286,103.857299
217869,0,11,11,1.314859,103.854421
217870,0,26,26,1.31492,103.854391
217871,1,2,3,1.314556,103.85454
217872,1,8,9,1.315036,103.854345
217873,0,5,5,1.315105,103.854318
217881,1,8,9,1.315276,103.854274
217882,4,12,16,1.315266,103.854244
217884,1,8,9,1.315334,103.854251
217888,0,3,3,1.314982,103.854372
217890,1,4,5,1.315437,103.8542
217895,1,0,1,1.315077,103.855194
217897,2,0,2,1.314713,103.85449
217898,3,0,3,1.315397,103.854228
217899,60,1,61,1.315637,103.854114
217900,5,0,5,1.315637,103.854114
217901,1,3,4,1.315677,103.854108
217902,1,1,2,1.31558,103.854137
217903,3,4,7,1.315549,103.854213
217904,0,7,7,1.315549,103.854213
217907,0,1,1,1.315528,103.854154
217908,2,0,2,1.315677,103.854103
217909,5,2,7,1.315769,103.854063
217910,1,0,1,1.315617,103.854182
217912,1,21,22,1.315818,103.854046
217917,1,0,1,1.315666,103.854161
217918,0,2,2,1.315617,103.854182
217919,1,1,2,1.3158,103.854118
217920,140,2,142,1.31612,103.854325
217921,2,0,2,1.315849,103.854091
217922,0,2,2,1.316092,103.854267
217923,0,1,1,1.3158,103.854118
217924,1,2,3,1.31558,103.854131
217956,151,16173,16324,1.305678,103.851299
217957,57,11410,11467,1.305707,103.851328
217958,15,5342,5357,1.305735,103.851362
217959,112,4345,4457,1.305532,103.851492
217960,268,3559,3827,1.305804,103.851413
217961,89,3501,3590,1.305838,103.851441
217962,46,1514,1560,1.305892,103.851461
217963,39,2337,2376,1.306122,103.851589
217964,25,774,799,1.306097,103.851647
217965,13,691,704,1.306168,103.851634
217966,37,3036,3073,1.305744,103.851273
217967,1,1,2,1.316069,103.854215
217968,1,397,398,1.306282,103.851593
217969,4,1612,1616,1.306213,103.851686
217970,4,296,300,1.306305,103.851622
217971,15,588,603,1.306236,103.851703
217972,1,237,238,1.306328,103.851639
217973,6,1553,1559,1.306259,103.851717
217974,1,327,328,1.306356,103.851673
217975,10,1245,1255,1.306346,103.851745
217976,5,310,315,1.306385,103.851702
217977,24,2186,2210,1.306386,103.851774
217978,1,213,214,1.306414,103.851724
217979,3,355,358,1.30642,103.851802
217980,3,143,146,1.306442,103.851747
217981,67,352,419,1.306443,103.85183
217982,10,289,299,1.306471,103.851775
217983,53,551,604,1.306454,103.851903
217984,26,181,207,1.306499,103.851798
217985,44,1211,1255,1.306512,103.851893
217986,31,733,764,1.306527,103.85182
217987,10,1217,1227,1.306553,103.851904
217988,11,119,130,1.306724,103.851925
217989,113,562,675,1.30666,103.851965
217990,13,486,499,1.306758,103.851954
217991,66,570,636,1.306697,103.85198
217992,1,0,1,1.316039,103.854161
217993,20,1336,1356,1.306737,103.852008
217994,7,4,11,1.30681,103.851999
217995,7,384,391,1.306789,103.852042
217996,0,23,23,1.306844,103.852022
217997,19,1191,1210,1.306834,103.852082
217998,3,22,25,1.306873,103.85205
217999,102,1336,1438,1.306888,103.85211
218000,2,17,19,1.306901,103.852062
218001,2,1,3,1.316013,103.8541
218002,0,22,22,1.306936,103.852079
218003,0,15,15,1.306958,103.852152
218004,4,15,19,1.306948,103.852096
218005,17,15,32,1.306979,103.852169
218006,16,1,17,1.306964,103.852107
218007,23,1,24,1.307002,103.85218
218008,4,2,6,1.307022,103.852142
218009,14,2271,2285,1.307028,103.8522
218010,1,0,1,1.306781,103.851977
218011,4,390,394,1.307053,103.852215
218012,1,17,18,1.307102,103.852176
218013,17,1997,2014,1.307097,103.852236
218014,1,4,5,1.307142,103.852193
218015,103,2037,2140,1.307171,103.85228
218016,14,11,25,1.307182,103.852215
218017,3,410,413,1.307206,103.852303
218018,10,33,43,1.307211,103.852232
218019,10,950,960,1.307234,103.852331
218020,12,67,79,1.307245,103.85225
218021,2,327,329,1.307269,103.852354
218022,1,50,51,1.307279,103.852267
218023,3,262,265,1.307303,103.852377
218024,4,52,56,1.307314,103.852289
218025,14,314,328,1.307338,103.8524
218026,1,36,37,1.307348,103.852312
218027,3,332,335,1.307378,103.852428
218028,7,50,57,1.307383,103.852335
218029,0,325,325,1.307424,103.852456
218030,4,55,59,1.3074,103.852352
218031,12,510,522,1.307458,103.852485
218032,3,38,41,1.307429,103.852375
218034,13,246,259,1.307451,103.852392
218035,16,555,571,1.307532,103.852536
218036,67,1240,1307,1.30748,103.852415
218037,12,709,721,1.307555,103.852559
218038,20,454,474,1.307572,103.85257
218039,5,966,971,1.307601,103.852593
218040,20,686,706,1.30763,103.852616
218041,48,1433,1481,1.307658,103.852644
218042,202,798,1000,1.307792,103.852583
218043,25,2609,2634,1.307874,103.852741
218044,25,1114,1139,1.307903,103.852758
218045,15,814,829,1.307943,103.852786
218046,6,467,473,1.307977,103.852809
218047,10,554,564,1.308012,103.852831
218048,5,526,531,1.30804,103.852854
218049,14,764,778,1.308075,103.852883
218050,216,1371,1587,1.308109,103.852911
218051,79,1621,1700,1.308314,103.853004
218052,4,905,909,1.308354,103.853042
218053,0,506,506,1.308366,103.853048
218054,11,421,432,1.308393,103.853072
218055,2,594,596,1.308422,103.853084
218056,4,1108,1112,1.308459,103.85312
218057,7,236,243,1.308457,103.853112
218058,9,501,510,1.308491,103.853141
218059,2,0,2,1.30619,103.851657
218061,30,520,550,1.308543,103.853177
218062,7,453,460,1.30856,103.853192
218063,6,421,427,1.308589,103.853215
218064,39,857,896,1.30864,103.85327
218066,48,3184,3232,1.30868,103.853275
218067,919,452,1371,1.309049,103.853325
218068,73,4981,5054,1.309029,103.853407
218069,74,260,334,1.309004,103.853489
218074,9,2318,2327,1.309155,103.853557
218075,6,1133,1139,1.309192,103.853576
218076,9,1065,1074,1.309227,103.853607
218077,11,2820,2831,1.309275,103.853639
218078,11,1298,1309,1.309466,103.853729
218079,18,2826,2844,1.309506,103.853763
218080,3,166,169,1.309541,103.853791
218081,9,1262,1271,1.309575,103.853831
218082,6,182,188,1.309604,103.853854
218083,8,1915,1923,1.309644,103.853882
218084,12,413,425,1.309673,103.853905
218085,87,4067,4154,1.309701,103.853933
218086,17,2162,2179,1.309914,103.854041
218087,4,1111,1115,1.309971,103.854069
218088,10,740,750,1.310017,103.854109
218089,3,625,628,1.310069,103.854126
218090,2,580,582,1.310109,103.854154
218091,6,487,493,1.310137,103.854183
218092,3,480,483,1.31016,103.854206
218093,3,757,760,1.310183,103.854228
218094,5,435,440,1.310206,103.854251
218095,2,455,457,1.310229,103.854268
218096,14,538,552,1.310258,103.854285
218097,2,382,384,1.310286,103.854302
218098,6,996,1002,1.310309,103.854325
218099,93,1062,1155,1.310384,103.854278
218101,8,481,489,1.310349,103.854371
218102,4,522,526,1.310387,103.854388
218103,0,223,223,1.310405,103.854402
218104,6,834,840,1.310451,103.854421
218105,254,13116,13370,1.310478,103.854428
218106,16,1190,1206,1.310171,103.854215
218107,659,4597,5256,1.311152,103.85469
218108,6314,40114,46428,1.310986,103.855056
218109,10,1582,1592,1.31136,103.85502
218110,1,5,6,1.311411,103.855059
218111,13,2176,2189,1.311512,103.855136
218112,12,72,84,1.311614,103.855212
218113,0,964,964,1.311715,103.855289
218114,65,4923,4988,1.311807,103.855356
218115,41,3920,3961,1.312197,103.855509
218116,5,73,78,1.312295,103.855623
218117,27,1563,1590,1.312339,103.855773
218118,1,24,25,1.31234,103.855774
218119,3,116,119,1.312342,103.855775
218120,10,128,138,1.312345,103.855777
218121,2,595,597,1.312347,103.855779
218122,8,470,478,1.312349,103.855781
218123,616,246,862,1.313351,103.855794
218124,185,2680,2865,1.3124,103.855842
218127,11,154,165,1.312697,103.856079
218129,43,2058,2101,1.312763,103.856134
218130,13,1199,1212,1.312818,103.856179
218131,13,0,13,1.312874,103.856224
218132,172,1210,1382,1.31293,103.856269
218133,148,14,162,1.312986,103.856314
218134,37,1506,1543,1.313042,103.856358
218135,23,3,26,1.313097,103.856403
218136,56,975,1031,1.313153,103.856448
218137,26,758,784,1.313209,103.856493
218138,27,3,30,1.313264,103.856538
218139,31,2022,2053,1.31332,103.856583
218140,67,1107,1174,1.313366,103.856618
218141,65,4274,4339,1.313404,103.85665
218142,12,664,676,1.313543,103.856762
218143,1,245,246,1.313598,103.856807
218144,3,210,213,1.313654,103.856852
218145,1,211,212,1.31371,103.856896
218146,0,148,148,1.313765,103.856941
218147,1,142,143,1.313821,103.856986
218148,6,105,111,1.299509,103.837
218149,52,454,506,1.313932,103.857076
218150,1,225,226,1.299509,103.837
218151,33,1756,1789,1.314033,103.857155
218152,61,804,865,1.314499,103.85717
218153,16,1309,1325,1.314623,103.85734
218154,20,22,42,1.314668,103.857401
218155,13,2461,2474,1.31479,103.857438
218156,15,90,105,1.314833,103.857496
218157,13,1163,1176,1.31484,103.85752
218158,2,39,41,1.314898,103.857551
218159,11,1882,1893,1.314928,103.857597
218160,15,909,924,1.314933,103.857628
218161,2,15,17,1.315008,103.857653
218162,6,0,6,1.315051,103.857692
218163,172,2856,3028,1.315107,103.857719
218165,1,34,35,1.31517,103.857791
218166,69,1233,1302,1.314044,103.857166
218167,0,238,238,1.315179,103.857824
218168,4,648,652,1.314045,103.857167
218169,2,866,868,1.315239,103.857831
218170,0,229,229,1.314047,103.857169
218171,0,131,131,1.31405,103.857171
218172,3,163,166,1.314052,103.857173
218173,6,207,213,1.314054,103.857175
218174,333,1202,1535,1.315363,103.857981
218175,0,130,130,1.314056,103.857176
218176,2,590,592,1.314058,103.857178
218177,13,5,18,1.314061,103.85718
218178,38,131,169,1.314063,103.857182
218179,2,332,334,1.315482,103.85806
218180,2,558,560,1.315554,103.858086
218181,22,983,1005,1.314407,103.857743
218182,13,5,18,1.315582,103.858115
218183,25,742,767,1.314553,103.857839
218184,13,737,750,1.315587,103.858168
218185,7,834,841,1.314602,103.857871
218186,8,166,174,1.315639,103.858167
218187,9,583,592,1.314653,103.857934
218188,2,219,221,1.315678,103.858185
218189,6,184,190,1.315712,103.858217
218190,6,24,30,1.314655,103.857968
218191,0,164,164,1.315716,103.858273
218192,2,329,331,1.314734,103.857998
218193,6,143,149,1.315762,103.858266
218194,0,101,101,1.314804,103.858036
218195,0,173,173,1.3158,103.858301
218196,10,131,141,1.31484,103.85809
218197,7,254,261,1.315837,103.858336
218198,6,5,11,1.314854,103.858091
218199,11,260,271,1.315898,103.858386
218200,2,223,225,1.31491,103.85812
218201,1,309,310,1.315925,103.858431
218202,11,706,717,1.314947,103.858157
218203,2,275,277,1.315954,103.85843
218204,7,179,186,1.315056,103.858276
218205,0,326,326,1.316006,103.85849
218206,5,336,341,1.315105,103.858303
218207,12,790,802,1.316086,103.858494
218208,5,155,160,1.315164,103.858361
218209,6,182,188,1.315184,103.858385
218210,0,128,128,1.31524,103.858385
218211,6,123,129,1.315279,103.858416
218212,0,143,143,1.315285,103.858474
218213,1,106,107,1.315321,103.858501
218214,0,96,96,1.315363,103.858532
218215,1,83,84,1.315398,103.858531
218216,1,87,88,1.315457,103.858594
218217,2,96,98,1.315499,103.858616
218218,1,92,93,1.315502,103.858615
218219,1,112,113,1.315539,103.858675
218220,1,113,114,1.315605,103.8587
218221,2,101,103,1.315613,103.858711
218222,11,187,198,1.31567,103.858761
218223,79,268,347,1.31571,103.85879
218224,264,2066,2330,1.311266,103.854786
218225,271,87,358,1.313487,103.856718
218226,8,48,56,1.314344,103.858753
218227,5060,7838,12898,1.305334,103.851162
218252,60,17,77,1.311456,103.849107
218253,301,3822,4123,1.311619,103.84857
218254,36,6,42,1.311185,103.849076
218284,5,369,374,1.310114,103.854015
218285,50,39,89,1.310111,103.85401
218286,1,33,34,1.299509,103.837
218287,0,37,37,1.31025,103.853878
218288,4,11,15,1.31032,103.853812
218289,62,44,106,1.310086,103.854053
218290,0,7,7,1.31039,103.853745
218291,7,32,39,1.310131,103.854011
218292,6,5,11,1.31046,103.853679
218293,2,5,7,1.31022,103.853926
218294,0,12,12,1.310529,103.853613
218296,0,6,6,1.310599,103.853547
218297,89,47,136,1.3104,103.853756
218298,6,11,17,1.310669,103.853481
218300,3,6,9,1.310739,103.853415
218301,15,1,16,1.310579,103.853586
218302,7,11,18,1.310809,103.853349
218303,7,23,30,1.310669,103.853501
218304,1,3,4,1.310878,103.853283
218306,0,6,6,1.310948,103.853217
218307,3,15,18,1.310848,103.853331
218308,0,10,10,1.311018,103.85315
218309,5,14,19,1.310938,103.853246
218310,2,3,5,1.311088,103.853084
218311,0,7,7,1.311028,103.853161
218312,2,11,13,1.311157,103.853018
218313,3,20,23,1.311118,103.853076
218314,101,39,140,1.311227,103.852952
218315,79,20,99,1.311207,103.852991
218317,63,17,80,1.311297,103.852906
218319,0,32,32,1.31073,103.85349
218350,52,1225,1277,1.313811,103.854238
218352,33,31,64,1.313828,103.854231
218354,55,0,55,1.313864,103.854216
218356,75,167,242,1.313899,103.854201
218358,5,1008,1013,1.313934,103.854185
218359,29,4,33,1.313542,103.854347
218361,0,263,263,1.314005,103.854155
218363,3,539,542,1.31404,103.85414
218365,64,799,863,1.31396,103.854154
218366,4,251,255,1.314016,103.85413
218367,3,175,178,1.314072,103.854106
218368,4,883,887,1.314181,103.854079
218369,5,162,167,1.314128,103.854082
218370,5,91,96,1.314216,103.854064
218371,1,177,178,1.314184,103.854058
218372,4,234,238,1.314251,103.854049
218373,1,24,25,1.31424,103.854034
218374,488,6,494,1.314287,103.854034
218375,79,137,216,1.314296,103.85401
218376,3,656,659,1.314322,103.854019
218377,5,158,163,1.314351,103.853986
218378,4,425,429,1.314357,103.854003
218379,8,770,778,1.314392,103.853988
218380,6,397,403,1.314453,103.853948
218381,27,99,126,1.314428,103.853973
218382,8,114,122,1.314498,103.853923
218383,3,621,624,1.314463,103.853958
218384,36,231,267,1.314534,103.853908
218385,0,1,1,1.307068,103.852153
218386,70,86,156,1.314675,103.853848
218387,11,181,192,1.314628,103.853888
218388,4,321,325,1.314793,103.853817
218389,4,618,622,1.314958,103.853747
218390,6,137,143,1.314887,103.853757
218391,4,152,156,1.314948,103.853737
218392,329,2,331,1.314989,103.853716
218393,2,250,252,1.315019,103.853704
218394,19,105,124,1.314991,103.853735
218395,0,4,4,1.315081,103.853682
218396,2,0,2,1.308473,103.853128
218397,2,183,185,1.315142,103.853659
218398,4,284,288,1.315091,103.853698
218399,4,2,6,1.315203,103.853637
218400,4,197,201,1.315157,103.853674
218401,105,62,167,1.315265,103.853614
218402,4,97,101,1.315224,103.853649
218403,1,18,19,1.315326,103.853591
218404,4,638,642,1.31529,103.853624
218405,6,154,160,1.315387,103.853569
218406,9,268,277,1.315356,103.8536
218407,101,4,105,1.315448,103.853546
218408,2,0,2,1.315024,103.853722
218409,8,100,108,1.31551,103.853523
218410,2,358,360,1.315489,103.853551
218411,0,60,60,1.315571,103.853501
218413,2,56,58,1.315632,103.853478
218414,2,0,2,1.315423,103.853576
218415,5,45,50,1.315694,103.853456
218416,2,426,428,1.315689,103.853478
218417,9,286,295,1.315745,103.853443
218418,4,665,669,1.315755,103.853453
218419,10,742,752,1.315797,103.853438
218421,5,23,28,1.31584,103.853422
218425,2,0,2,1.315622,103.853502
218427,2,385,387,1.316094,103.853329
218429,14,1098,1112,1.316179,103.853298
218431,70,1013,1083,1.316264,103.853267
218433,95,1345,1440,1.316451,103.853196
218434,3,687,690,1.316478,103.853187
218435,8,367,375,1.316533,103.85317
218436,0,4,4,1.316642,103.853135
218437,68,84,152,1.316696,103.853117
218438,5,527,532,1.31681,103.853057
218439,1,5,6,1.316817,103.853074
218440,2,1,3,1.306932,103.852145
218441,1,0,1,1.314546,103.853923
218442,133,1388,1521,1.317106,103.852964
218443,0,856,856,1.299509,103.837
218444,2,3,5,1.317245,103.852897
218446,0,2,2,1.31601,103.85336
218447,63,608,671,1.317524,103.852761
218451,53,579,632,1.317533,103.852987
218452,6,87,93,1.317591,103.852975
218453,340,1349,1689,1.317674,103.852924
218454,17,60,77,1.317579,103.852485
218455,9,99,108,1.317214,103.852892
218457,3,36,39,1.317524,103.852741
218458,17,41,58,1.317609,103.852688
218459,12,39,51,1.317754,103.852552
218460,44,99,143,1.317803,103.852488
218462,0,9,9,1.317966,103.852268
218463,0,52,52,1.318006,103.85222
218464,0,5,5,1.318029,103.85219
218465,1,71,72,1.318056,103.852157
218466,4,11,15,1.318075,103.85213
218467,3,123,126,1.318106,103.852092
218468,9,124,133,1.318135,103.852057
218469,5,4,9,1.299509,103.837
218497,6,55,61,1.316296,103.853317
218499,0,6,6,1.316319,103.853378
218500,2,24,26,1.316333,103.853468
218501,3,1,4,1.316364,103.853498
218502,3,24,27,1.316411,103.85368
218503,1,2,3,1.316938,103.85303
218504,0,9,9,1.316489,103.853891
218505,1,2,3,1.316409,103.853619
218506,21,9,30,1.316568,103.854102
218507,3,12,15,1.316498,103.853861
218508,0,8,8,1.317203,103.854123
218547,80,866,946,1.307786,103.850486
218548,46,761,807,1.307825,103.850514
218549,36,385,421,1.307864,103.850541
218550,142,421,563,1.307903,103.850569
218551,40,242,282,1.307942,103.850596
218552,155,122,277,1.307981,103.850624
218553,11,150,161,1.30802,103.850652
218554,14,231,245,1.308059,103.850679
218555,33,204,237,1.308098,103.850707
218556,37,281,318,1.308137,103.850734
218557,7,212,219,1.308176,103.850762
218558,14,315,329,1.308215,103.850789
218559,36,390,426,1.308254,103.850817
218560,31,774,805,1.308293,103.850844
218561,1,0,1,1.316791,103.853678
218562,20,778,798,1.308332,103.850872
218563,48,909,957,1.308358,103.850892
218564,573,1300,1873,1.308384,103.850912
218565,48,902,950,1.308437,103.850953
218566,56,635,691,1.308489,103.850993
218567,52,484,536,1.308542,103.851034
218568,10,321,331,1.308594,103.851074
218569,89,351,440,1.308646,103.851114
218570,98,531,629,1.308699,103.851155
218571,9,351,360,1.308751,103.851195
218572,12,218,230,1.308803,103.851235
218573,20,277,297,1.308856,103.851276
218574,13,261,274,1.308908,103.851316
218575,284,733,1017,1.308961,103.851357
218576,91,3425,3516,1.309013,103.851397
218577,141,7,148,1.309035,103.851414
218578,25,224,249,1.309459,103.851732
218579,17,220,237,1.309548,103.851799
218580,21,7,28,1.309592,103.851832
218581,20,369,389,1.309637,103.851866
218583,241,621,862,1.309726,103.851933
218585,58,6,64,1.309815,103.852
218586,82,529,611,1.309859,103.852033
218587,28,901,929,1.309904,103.852067
218591,409,426,835,1.310082,103.852201
218592,16,150,166,1.310127,103.852234
218593,0,1,1,1.308293,103.850844
218594,32,3263,3295,1.310216,103.852301
218595,73,20,93,1.31026,103.852335
218596,8,38,46,1.310305,103.852368
218597,11,953,964,1.310342,103.85239
218598,1,136,137,1.310378,103.852413
218599,14,390,404,1.310451,103.852457
218600,1,200,201,1.310524,103.852502
218601,10,257,267,1.310598,103.852546
218602,5,253,258,1.310671,103.852591
218603,20,282,302,1.310744,103.852635
218604,2,92,94,1.310817,103.85268
218605,233,1005,1238,1.310856,103.852698
218607,17,331,348,1.310974,103.852752
218608,7,135,142,1.311052,103.852788
218609,6,246,252,1.31113,103.852824
218610,1,244,245,1.311209,103.85286
218611,7,1267,1274,1.311287,103.852896
218612,171,166,337,1.31134,103.852805
218613,8,1579,1587,1.311332,103.852802
218615,4,1483,1487,1.311303,103.852789
218616,1,15,16,1.311288,103.852782
218617,2,1,3,1.316453,103.85374
218618,16,739,755,1.311379,103.853448
218628,3,112,115,1.313361,103.855198
218629,2,126,128,1.313439,103.855281
218630,1,55,56,1.313595,103.855446
218631,1,42,43,1.313751,103.85561
218632,59,99,158,1.313907,103.855775
218633,15,370,385,1.31463,103.856519
218634,0,65,65,1.314657,103.856548
218635,0,62,62,1.314713,103.856606
218636,224,0,224,1.314768,103.856664
218637,0,37,37,1.314823,103.856722
218638,17,177,194,1.314624,103.856533
218639,0,118,118,1.314879,103.856779
218640,6,5,11,1.314748,103.856664
218641,57,222,279,1.314989,103.856895
218643,0,2,2,1.317431,103.852806
218644,0,68,68,1.31509,103.857001
218645,1,111,112,1.314997,103.856924
218646,313,218,531,1.31508,103.857011
218647,10,81,91,1.315132,103.857062
218648,6,21,27,1.315141,103.85707
218649,4,21,25,1.315149,103.857078
218650,0,12,12,1.315158,103.857086
218651,0,6,6,1.315166,103.857094
218652,3,7,10,1.315095,103.857005
218653,1,190,191,1.315099,103.85701
218654,5,0,5,1.315108,103.857018
218656,0,1,1,1.310171,103.852268
218657,57,0,57,1.315126,103.857036
218658,0,3,3,1.31131,103.853395
218659,39,6,45,1.315135,103.857044
218660,0,21,21,1.315226,103.857154
218661,4,55,59,1.315235,103.857162
218662,0,36,36,1.3158,103.857418
218663,4,0,4,1.315242,103.857167
218664,3,10,13,1.315768,103.857443
218665,37,9,46,1.31525,103.857175
218666,6,0,6,1.315774,103.857445
218667,4,16,20,1.315259,103.857183
218668,2,0,2,1.314914,103.856837
218669,3,23,26,1.315569,103.857783
218670,60,26,86,1.315606,103.857784
218671,182,34,216,1.315889,103.857542
218672,10,17,27,1.315675,103.857816
218673,21,30,51,1.315904,103.857576
218674,8,24,32,1.315683,103.857848
218675,32,12,44,1.315938,103.857614
218676,1,21,22,1.315707,103.857898
218677,3,21,24,1.31597,103.857638
218678,1,30,31,1.315743,103.857899
218679,55,34,89,1.316037,103.857666
218680,4,30,34,1.315799,103.857955
218681,136,0,136,1.316043,103.857673
218682,0,26,26,1.315801,103.857954
218683,24,40,64,1.316092,103.85773
218684,5,28,33,1.315835,103.858014
218685,4,15,19,1.315858,103.858038
218686,16,16,32,1.315897,103.85804
218687,56,128,184,1.316161,103.857856
218688,0,18,18,1.315954,103.858068
218689,7,17,24,1.315963,103.858117
218690,7,1,8,1.31625,103.857859
218692,0,9,9,1.315998,103.858136
218693,1,11,12,1.316254,103.857889
218694,3,20,23,1.316069,103.858194
218695,44,20,64,1.316296,103.85792
218696,4,16,20,1.316074,103.858199
218697,2,6,8,1.316113,103.858262
218698,14,17,31,1.316156,103.858299
218699,18,210,228,1.316243,103.858355
218700,7,838,845,1.316209,103.85835
218702,285,175,460,1.315094,103.857025
218703,1271,16293,17564,1.312604,103.854359
218704,26,212,238,1.309589,103.851654
218730,7,90,97,1.30935,103.853198
218731,18,72,90,1.309422,103.853143
218732,30,106,136,1.309464,103.853104
218733,24,40,64,1.309486,103.853055
218734,9,22,31,1.309581,103.852981
218735,2,6,8,1.309625,103.852936
218736,7,36,43,1.309687,103.852886
218737,10,19,29,1.3101,103.852565
218738,0,11,11,1.309141,103.853508
218739,0,27,27,1.310207,103.852462
218740,3,13,16,1.310315,103.852378
218741,1,21,22,1.310029,103.852688
218744,5,59,64,1.309887,103.852821
218745,75,0,75,1.310072,103.852651
218746,62,31,93,1.309922,103.852904
218773,3,17,20,1.312723,103.855542
218774,16,2,18,1.312766,103.855517
218775,0,16,16,1.312809,103.855487
218776,40,2,42,1.31286,103.855458
218777,6,10,16,1.312906,103.855422
218778,8,3,11,1.312972,103.855393
218779,20,4,24,1.313035,103.855343
218780,1,48,49,1.313134,103.855217
218781,0,15,15,1.312975,103.855328
218782,1,555,556,1.312656,103.85555
218783,3,1635,1638,1.313105,103.855089
218813,9,454,463,1.315545,103.852199
218814,910,357,1267,1.315983,103.852875
218815,1151,126,1277,1.315878,103.852279
218816,568,474,1042,1.315499,103.852113
218817,694,293,987,1.315729,103.852429
218842,602,1078,1680,1.311614,103.854788
218843,9,101,110,1.31162,103.854699
218844,4,41,45,1.311757,103.854596
218845,190,361,551,1.311897,103.854493
218846,1,423,424,1.311792,103.854692
218847,2,32,34,1.311815,103.854675
218848,1,190,191,1.311839,103.854651
218849,0,31,31,1.311879,103.854619
218850,5,43,48,1.311909,103.854595
218851,2,34,36,1.311946,103.854573
218852,0,64,64,1.311983,103.85454
218853,6,97,103,1.312019,103.854516
218854,12,1839,1851,1.312048,103.854488
218889,7,419,426,1.313173,103.853459
218891,10,237,247,1.313156,103.853484
218893,2,73,75,1.313206,103.853447
218894,0,61,61,1.313227,103.853429
218895,3,58,61,1.31325,103.853408
218896,62,508,570,1.313305,103.853412
218897,2,54,56,1.3133,103.853369
218898,0,24,24,1.31334,103.853334
218899,2,51,53,1.313359,103.853312
218900,0,8,8,1.313396,103.85328
218901,306,72,378,1.313345,103.853371
218902,5,106,111,1.313431,103.853246
218903,18,56,74,1.313473,103.853204
218904,3,94,97,1.313483,103.853285
218905,3,41,44,1.313528,103.853162
218906,1,60,61,1.313514,103.853256
218907,6,105,111,1.313554,103.853143
218908,72,44,116,1.313544,103.853232
218909,3,39,42,1.313567,103.853209
218910,0,41,41,1.313656,103.853153
218911,0,89,89,1.313688,103.853137
218912,1,4,5,1.313713,103.853092
218913,15,42,57,1.313763,103.853049
218914,29,25,54,1.31357,103.853058
218915,103,32,135,1.31382,103.853029
218916,0,84,84,1.313629,103.853007
218917,6,31,37,1.313865,103.852995
218918,7,51,58,1.313672,103.85297
218919,188,69,257,1.313908,103.852957
218920,0,8,8,1.313713,103.852936
218921,43,0,43,1.313958,103.852925
218922,9,64,73,1.313759,103.852895
218923,1,17,18,1.313808,103.852855
218924,24,49,73,1.313908,103.852777
218925,0,8,8,1.31403,103.852679
218926,137,36,173,1.314062,103.852844
218927,8,24,32,1.31417,103.85257
218928,0,59,59,1.314103,103.8528
218929,0,7,7,1.314278,103.852477
218930,2,17,19,1.314142,103.852759
218931,9,23,32,1.31441,103.852361
218932,0,17,17,1.314179,103.85273
218933,0,4,4,1.31454,103.852257
218934,0,7,7,1.31422,103.852687
218935,22,19,41,1.314252,103.852661
218936,4,95,99,1.314086,103.85264
218937,0,28,28,1.314281,103.852639
218938,2,25,27,1.314318,103.852607
218939,47,29,76,1.314348,103.852568
218940,1,13,14,1.314379,103.852547
218941,12,24,36,1.31442,103.85252
218942,1,16,17,1.314453,103.852489
218943,1,12,13,1.314478,103.85246
218944,2,30,32,1.314512,103.852428
218945,1,58,59,1.314541,103.852399
218946,6,2153,2159,1.314937,103.851897
218947,3,0,3,1.315217,103.857143
218948,1,775,776,1.314983,103.851845
218949,1,0,1,1.315208,103.857135
218950,6,1142,1148,1.315033,103.851798
218953,32,429,461,1.314715,103.852263
219013,10,414,424,1.314319,103.845892
219014,162,693,855,1.3145,103.846004
219015,21,567,588,1.314725,103.846159
219016,4,42,46,1.315013,103.846384
219017,25,36,61,1.315191,103.846586
219049,2,137,139,1.317068,103.852227
219052,2,105,107,1.317236,103.85214
219053,359,33,392,1.317116,103.85219
219054,569,361,930,1.317289,103.852068
219055,3,79,82,1.317234,103.852079
219056,3,12,15,1.317374,103.851993
219057,172,62,234,1.317308,103.852006
219058,7,12,19,1.317421,103.851944
219059,10,17,27,1.317441,103.851553
219060,2,19,21,1.317494,103.851878
219061,1,52,53,1.317541,103.85183
219062,324,139,463,1.317626,103.851754
219063,0,77,77,1.317701,103.851683
219064,9,703,712,1.317884,103.851526
219065,2,117,119,1.317693,103.851638
219066,3,3,6,1.317759,103.851579
219067,2803,20,2823,1.317827,103.851301
219068,6,147,153,1.317948,103.851184
219097,88,108,196,1.310347,103.853167
219098,49,73,122,1.31027,103.853172
219099,2,50,52,1.31037,103.853139
219100,2,20,22,1.310293,103.853151
219102,2,14,16,1.310339,103.853116
219104,0,13,13,1.310388,103.853079
219106,1,43,44,1.31042,103.853032
219107,131,50,181,1.310449,103.85306
219108,10,1287,1297,1.31056,103.852877
219110,0,48,48,1.310499,103.853007
219111,2,49,51,1.310517,103.852985
219140,12,4,16,1.306742,103.851613
219141,16,23,39,1.306728,103.851752
219142,0,2,2,1.315797,103.857419
219143,0,25,25,1.306746,103.851718
219144,12,1,13,1.306781,103.851535
219145,6,27,33,1.306762,103.851687
219146,1,0,1,1.314611,103.852335
219148,5,0,5,1.306828,103.851483
219150,34,2,36,1.306842,103.851441
219151,9,5,14,1.306815,103.851599
219152,0,1,1,1.306804,103.851508
219153,2,8,10,1.306831,103.851564
219154,2,1,3,1.314583,103.852365
219155,4,4,8,1.306865,103.851504
219156,23,0,23,1.306898,103.851353
219157,0,3,3,1.306884,103.851383
219158,1,3,4,1.306898,103.851353
219159,7,110,117,1.306908,103.851424
219160,2,3,5,1.306922,103.851301
219161,1,2,3,1.30688,103.851468
219162,0,3,3,1.306943,103.851271
219163,6,0,6,1.306985,103.8512
219164,4,0,4,1.306985,103.8512
219165,0,2,2,1.306763,103.851572
219166,2,2,4,1.307023,103.851152
219167,1,0,1,1.30686,103.851408
219168,0,4,4,1.307168,103.850992
219169,1,1,2,1.307023,103.851152
219170,7,2,9,1.307223,103.850934
219172,2,0,2,1.307182,103.850962
219173,32,0,32,1.307316,103.850847
219177,1,1,2,1.307288,103.85087
219178,23,110,133,1.307519,103.850697
219179,13,5,18,1.307439,103.850713
219180,3,94,97,1.307528,103.850683
219181,6,9,15,1.307475,103.850685
219182,1,44,45,1.307536,103.85067
219183,2,2,4,1.307499,103.850657
219184,508,19,527,1.307547,103.850662
219185,26,0,26,1.307529,103.850634
219186,2,30,32,1.307547,103.850662
219187,0,2,2,1.307416,103.850737
219188,3,1,4,1.307578,103.850568
219189,56,3068,3124,1.307605,103.850536
219219,122,286,408,1.316193,103.85204
219248,33,807,840,1.312252,103.847254
219249,28,307,335,1.312396,103.847102
219250,203,3,206,1.313079,103.847609
219251,9,238,247,1.312813,103.84667
219252,4,134,138,1.313533,103.846136
219253,1,3,4,1.31359,103.846187
219254,48,31,79,1.313646,103.846239
219255,11,2,13,1.313703,103.846294
219256,5,3,8,1.31376,103.846337
219257,1,0,1,1.307045,103.851124
219259,0,4,4,1.313928,103.846469
219260,7,28,35,1.314004,103.846502
219261,635,5,640,1.31408,103.846509
219262,8,20,28,1.314062,103.846502
219263,0,43,43,1.314042,103.846521
219264,0,4,4,1.314074,103.846532
219265,3,4,7,1.314109,103.84652
219266,1,2,3,1.306958,103.851235
219267,1,7,8,1.313971,103.846462
219268,187,216,403,1.313928,103.846442
219297,2,15,17,1.3151,103.855539
219298,12,1,13,1.315087,103.855552
219299,1,0,1,1.313814,103.84638
219300,0,30,30,1.315115,103.855526
219301,0,13,13,1.315161,103.855473
219302,2,0,2,1.307552,103.850606
219303,0,3,3,1.314031,103.846491
219304,0,2,2,1.315144,103.855488
219305,22,9,31,1.315215,103.855392
219306,0,4,4,1.315202,103.855411
219307,6,12,18,1.315251,103.855343
219308,3,8,11,1.315234,103.855364
219309,19,1,20,1.315285,103.855286
219310,28,9,37,1.31527,103.855307
219311,1,16,17,1.31531,103.855248
219312,0,4,4,1.3153,103.855262
219313,1,0,1,1.315129,103.855508
219314,0,1,1,1.315336,103.8552
219315,11,2,13,1.315372,103.855123
219316,0,3,3,1.315187,103.855428
219317,1,3,4,1.315405,103.855068
219319,1,5,6,1.315441,103.855009
219320,36,1,37,1.315425,103.855031
219321,51,0,51,1.315476,103.854949
219322,14,2,16,1.315459,103.854972
219324,0,1,1,1.315325,103.855217
219325,3,5,8,1.315553,103.854833
219327,0,3,3,1.31536,103.855151
219328,1,0,1,1.3155,103.854906
219329,0,1,1,1.315579,103.85479
219330,0,1,1,1.315625,103.854712
219331,1,3,4,1.315641,103.854645
219333,2,3,5,1.315644,103.854583
219334,6,0,6,1.315643,103.854613
219335,158,0,158,1.315623,103.854529
219336,3,3,6,1.315635,103.854547
219337,9,8,17,1.315606,103.854472
219342,0,1,1,1.315612,103.854735
219343,5,4,9,1.315585,103.854409
219344,0,3,3,1.315596,103.854769
219346,7,0,7,1.31556,103.854326
219347,3,2,5,1.315532,103.854252
219348,0,34,34,1.315546,103.854289
219378,55,7,62,1.312894,103.848178
219379,23,11,34,1.312957,103.848252
219380,15,3,18,1.312892,103.848199
219381,125,20,145,1.31296,103.848278
219382,10,44,54,1.313212,103.848549
219383,1,33,34,1.313282,103.848607
219384,417,9,426,1.313339,103.848697
219385,129,5,134,1.313301,103.848676
219386,10,4,14,1.313403,103.848771
219387,4,6,10,1.313467,103.848846
219388,13,0,13,1.313424,103.84883
219389,7,114,121,1.31353,103.84892
219390,16,5,21,1.313462,103.848874
219391,270,0,270,1.313574,103.848994
219392,4,7,11,1.313494,103.848913
219393,18,0,18,1.313632,103.849062
219394,1,25,26,1.313671,103.84913
219395,8,0,8,1.313747,103.849266
219396,0,1,1,1.315468,103.854394
219397,0,1,1,1.313824,103.849402
219399,1,1,2,1.315173,103.855449
219400,84,161,245,1.313369,103.848756
219401,16,31,47,1.312653,103.847921
219402,1,19,20,1.312687,103.84796
219403,9,3,12,1.312755,103.84804
219404,10,40,50,1.312824,103.84812
219405,50,48,98,1.312671,103.847918
219406,88,8,96,1.312703,103.847955
219407,8,23,31,1.313584,103.848984
219408,114,18,132,1.313494,103.848913
219428,2209,327,2536,1.307297,103.849171
219429,532,3735,4267,1.31008,103.848526
219457,8,185,193,1.312223,103.851228
219458,111,1258,1369,1.313059,103.851369
219486,65,4808,4873,1.312222,103.847669
219487,1,102,103,1.312371,103.848746
219490,1,107,108,1.312694,103.849207
219491,0,1059,1059,1.312832,103.849402
219492,7,662,669,1.313128,103.849819
219493,10,0,10,1.313248,103.849984
219494,13,85,98,1.313582,103.850446
219495,3,774,777,1.313614,103.850256
219496,4,276,280,1.31352,103.850331
219497,2,320,322,1.31352,103.850331
219498,104,2751,2855,1.31352,103.850331
219499,20,52,72,1.31352,103.850331
219528,199,44,243,1.307751,103.851008
219529,4,5,9,1.307714,103.850973
219530,0,36,36,1.30777,103.851034
219531,0,13,13,1.307804,103.851051
219532,0,31,31,1.307839,103.851076
219533,1,22,23,1.307868,103.851109
219534,1,2,3,1.315576,103.854376
219535,1,44,45,1.307946,103.851161
219536,2,35,37,1.307986,103.851181
219537,11,14,25,1.308036,103.851218
219538,20,22,42,1.308081,103.851249
219539,8,4,12,1.308125,103.85128
219540,29,108,137,1.308167,103.851305
219541,43,1,44,1.308202,103.851329
219542,13,17,30,1.30825,103.851353
219543,15,3,18,1.308289,103.851386
219544,26,415,441,1.308323,103.851423
219545,6,8,14,1.308365,103.851448
219546,48,191,239,1.308402,103.851484
219547,4,6,10,1.308443,103.851519
219548,70,215,285,1.308479,103.851552
219549,20,200,220,1.308511,103.851566
219550,8,118,126,1.308546,103.851606
219551,2,77,79,1.308908,103.851853
219552,6,617,623,1.309004,103.851916
219557,9,10,19,1.307493,103.850921
219587,104,51,155,1.313053,103.849669
219588,7,18,25,1.313382,103.849249
219589,5,17,22,1.313422,103.849202
219590,6,8,14,1.313465,103.849147
219591,0,13,13,1.313509,103.849094
219592,5,0,5,1.313895,103.848734
219593,1,0,1,1.3139,103.849538
219594,1,0,1,1.313678,103.848771
219595,4,0,4,1.314275,103.848275
219596,30,4,34,1.313811,103.848796
219597,1,1,2,1.313967,103.849664
219598,5,0,5,1.314028,103.84858
219599,9,1,10,1.313384,103.847874
219600,1,2,3,1.307912,103.851125
219601,66,1,67,1.313366,103.848092
219602,3,0,3,1.31409,103.848495
219603,35,111,146,1.314195,103.848223
219604,394,11,405,1.313666,103.848249
219605,4,192,196,1.314911,103.848292
219606,47,2,49,1.313493,103.848038
219607,7,17,24,1.314009,103.848339
219608,17,0,17,1.314195,103.848223
219609,111,3,114,1.313921,103.848211
219610,3,2,5,1.314195,103.848223
219611,3,0,3,1.314158,103.84842
219613,1,3,4,1.314195,103.848223
219614,50,10,60,1.314195,103.848223
219615,37,9,46,1.314195,103.848223
219616,4,3,7,1.313667,103.847836
219617,0,1,1,1.313964,103.848636
219618,1,16,17,1.313565,103.847741
219619,0,3,3,1.314195,103.848223
219620,78,47,125,1.313509,103.84764
219621,12,14,26,1.313452,103.847612
219622,78,49,127,1.314245,103.847877
219623,79,58,137,1.31438,103.847819
219624,1,0,1,1.313606,103.847814
219625,13,23,36,1.314486,103.847868
219626,4,0,4,1.314508,103.847838
219627,0,2,2,1.313784,103.848402
219628,7,6,13,1.314572,103.847768
219629,14,22,36,1.31473,103.847602
219631,0,35,35,1.31476,103.847566
219633,2,0,2,1.31454,103.847807
219634,9,0,9,1.31473,103.847602
219635,1,0,1,1.314449,103.847928
219636,5,10,15,1.31476,103.847566
219637,1,2,3,1.31354,103.847688
219639,8,6,14,1.314925,103.84737
219641,61,24,85,1.314898,103.847297
219642,2,0,2,1.314797,103.847513
219647,1365,40,1405,1.315245,103.846979
219648,941,316,1257,1.315288,103.846929
219649,0,3,3,1.314886,103.847415
219650,9,887,896,1.315373,103.846845
219652,0,9,9,1.313861,103.84858
219653,12,8,20,1.314211,103.848354
219677,46,70,116,1.313296,103.846493
219679,398,23,421,1.313147,103.847313
219680,1,4,5,1.314086,103.847839
219681,1,0,1,1.31484,103.847471
219682,7,18,25,1.314206,103.84671
219683,45,20,65,1.314302,103.846741
219684,4,6,10,1.313829,103.847489
219685,0,3,3,1.31375,103.848659
219686,0,1,1,1.31379,103.847441
219687,0,4,4,1.313868,103.847541
219689,0,1,1,1.31427,103.846799
219690,0,6,6,1.31391,103.847595
219691,2,2,4,1.31408,103.846823
219692,0,1,1,1.314206,103.84671
219693,0,1,1,1.314166,103.846755
219694,10,0,10,1.314041,103.846863
219696,2,1,3,1.314221,103.846693
219697,3,4,7,1.313751,103.847378
219699,0,6,6,1.314015,103.847747
219700,15,0,15,1.314041,103.846863
219702,6,3,9,1.313957,103.846928
219704,37,1,38,1.313895,103.846988
219705,8,13,21,1.314226,103.847987
219706,4,8,12,1.313855,103.847039
219708,84,3,87,1.313811,103.847077
219709,5,20,25,1.314047,103.84779
219710,4,48,52,1.313754,103.847126
219711,5,20,25,1.31429,103.847263
219712,0,2,2,1.314865,103.847304
219713,0,1,1,1.313948,103.847654
219714,1,12,13,1.314083,103.847433
219715,0,9,9,1.314127,103.847387
219716,18,24,42,1.314163,103.847359
219717,89,20,109,1.314217,103.847314
219718,44,3,47,1.314286,103.847378
219719,1,11,12,1.31424,103.847428
219720,12,0,12,1.314184,103.847472
219721,10,1,11,1.314138,103.847521
219722,0,5,5,1.314092,103.847551
219723,2,78,80,1.314599,103.846999
219724,1,98,99,1.314568,103.84703
219725,33,45,78,1.31433,103.847237
219726,1,3,4,1.314666,103.847018
219727,1,26,27,1.314541,103.847051
219728,4,2,6,1.314436,103.847145
219729,0,2,2,1.313992,103.847397
219730,55,5,60,1.314464,103.847118
219731,0,1,1,1.314051,103.847456
219732,2,15,17,1.314407,103.847169
219733,11,3,14,1.314366,103.847197
219734,0,10,10,1.314275,103.847147
219735,2,37,39,1.314372,103.847304
219736,1,38,39,1.314596,103.847084
219737,0,2,2,1.314508,103.847074
219738,1,25,26,1.314625,103.847167
219739,0,6,6,1.314621,103.847062
219740,6,1,7,1.314574,103.847116
219741,0,5,5,1.314551,103.847142
219742,3,0,3,1.313981,103.847702
219743,2,0,2,1.314638,103.847041
219744,0,18,18,1.314472,103.847219
219745,1,0,1,1.314485,103.847097
219746,0,2,2,1.314503,103.847193
219748,12,12,24,1.315163,103.848778
219749,1,67,68,1.315204,103.848817
219750,6,1668,1674,1.315249,103.848853
219751,4,239,243,1.316053,103.849287
219752,1,74,75,1.315297,103.84889
219753,0,39,39,1.315003,103.848824
219755,5,31,36,1.315121,103.848745
219757,377,1,378,1.315031,103.848653
219758,48,15,63,1.314721,103.848402
219780,4,2,6,1.306191,103.851421
219781,2,35,37,1.306208,103.851404
219782,3,36,39,1.306226,103.851386
219783,1,13,14,1.306243,103.851369
219784,6,20,26,1.306391,103.851219
219785,5,26,31,1.30626,103.851352
219786,3,50,53,1.306283,103.851324
219787,31,43,74,1.306306,103.851295
219788,28,57,85,1.306329,103.851273
219789,52,186,238,1.306352,103.85125
219790,9,90,99,1.306369,103.851227
219791,5,78,83,1.306386,103.851204
219792,2,58,60,1.306409,103.851187
219793,8,82,90,1.306437,103.851142
219794,11,104,115,1.306466,103.85113
219795,20,50,70,1.306506,103.851079
219796,135,95,230,1.306518,103.851062
219797,10,201,211,1.306529,103.851045
219798,3,1,4,1.306632,103.850912
219799,32,358,390,1.306835,103.850692
219800,31,203,234,1.30687,103.85066
219801,7,126,133,1.306892,103.850633
219802,3,75,78,1.306907,103.850613
219803,1,177,178,1.306922,103.850596
219804,0,167,167,1.306942,103.850574
219805,4,71,75,1.306952,103.850552
219806,1,60,61,1.306972,103.850525
219807,15,98,113,1.306995,103.850504
219808,4,52,56,1.307017,103.850476
219809,6,72,78,1.307164,103.850429
219810,4,82,86,1.307058,103.850428
219811,8,42,50,1.307077,103.850414
219812,106,3440,3546,1.307259,103.85033
219813,30,490,520,1.30685,103.850797
219841,1,1,2,1.314413,103.847275
219842,0,544,544,1.313406,103.84955
219843,2,29,31,1.312618,103.848477
219845,1,3,4,1.312426,103.848263
219846,9,492,501,1.312761,103.848635
219847,8,6,14,1.312826,103.848711
219848,3,1,4,1.312756,103.848447
219849,91,5,96,1.313116,103.849049
219850,14,30,44,1.312793,103.848836
219851,5,9,14,1.312827,103.848921
219852,3,3,6,1.312962,103.848836
219853,8,55,63,1.312935,103.849005
219854,1,27,28,1.313018,103.849106
219855,143,8,151,1.31346,103.849491
219856,24,0,24,1.31354,103.84961
219857,2,5,7,1.31263,103.848619
219858,0,7,7,1.312737,103.848779
219859,13,0,13,1.312503,103.848358
219860,75,6,81,1.312505,103.84848
219861,4,1,5,1.313089,103.849236
219862,3,46,49,1.312564,103.848759
219885,8,297,305,1.310648,103.854144
219886,10,206,216,1.310701,103.854085
219887,0,1,1,1.314444,103.847246
219888,2,132,134,1.310849,103.853947
219889,0,4,4,1.310916,103.853889
219890,8,315,323,1.310964,103.853831
219891,0,18,18,1.311019,103.853787
219892,0,319,319,1.311087,103.853728
219893,2,5,7,1.311155,103.853671
219894,537,207,744,1.311107,103.853702
219895,3,87,90,1.311215,103.853628
219923,15,187,202,1.30775,103.852215
219924,314,98,412,1.308225,103.852033
219952,8,22,30,1.307149,103.851509
219953,18,47,65,1.307179,103.851534
219954,33,1,34,1.307207,103.85156
219955,21,0,21,1.307235,103.851589
219956,13,6,19,1.307286,103.851631
219957,7,5,12,1.307314,103.851649
219958,20,8,28,1.307343,103.851675
219959,0,4,4,1.307376,103.851703
219960,0,2,2,1.313507,103.849749
219961,0,1,1,1.310761,103.85402
219962,2,10,12,1.307447,103.85177
219963,0,4,4,1.307492,103.851802
219964,1,8,9,1.307524,103.851831
219965,1,5,6,1.307552,103.851849
219966,0,5,5,1.30759,103.851887
219967,0,8,8,1.307626,103.851916
219968,0,5,5,1.30767,103.851949
219969,1,10,11,1.307699,103.851977
219970,0,32,32,1.307735,103.852013
219971,2,41,43,1.307767,103.852054
226260,9,0,9,1.299509,103.837
227963,11,1117,1128,1.305984,103.848491
227968,732,2793,3525,1.298907,103.84871
227973,1553,706,2259,1.305647,103.836893
227974,14,0,14,1.309441,103.84015
227976,73,614,687,1.310434,103.841407
227977,1297,284,1581,1.310106,103.841466
227978,34,79,113,1.310389,103.841762
227979,4,69,73,1.309481,103.840062
227980,30,0,30,1.309481,103.840062
227981,5,109,114,1.309481,103.840062
227982,0,92,92,1.309481,103.840062
227983,3,85,88,1.309488,103.840135
227984,0,2,2,1.307402,103.851719
227985,41,0,41,1.309488,103.840135
227986,21,5,26,1.309488,103.840135
227987,19,73,92,1.310993,103.842085
227988,560,20,580,1.309454,103.841372
228022,32,57,89,1.302344,103.848694
228024,6,2,8,1.302371,103.84876
228025,1,4,5,1.302451,103.848827
228026,1,21,22,1.302531,103.848894
228028,0,4,4,1.30269,103.849028
228029,18,12,30,1.30277,103.849095
228030,99,135,234,1.302636,103.849067
228031,4,368,372,1.302333,103.848813
228051,113,4723,4836,1.302048,103.848837
228052,4,531,535,1.302138,103.848579
228053,16,270,286,1.302135,103.84859
228054,0,352,352,1.302131,103.8486
228055,3,203,206,1.302111,103.848472
228056,0,260,260,1.302145,103.848306
228059,88,299,387,1.302323,103.848207
228064,35,72,107,1.302446,103.84779
228065,21,3,24,1.302611,103.848198
228066,5,125,130,1.302654,103.848134
228067,20,919,939,1.30263,103.848056
228068,229,64,293,1.302611,103.847598
228069,1,179,180,1.299509,103.837
228070,119,161,280,1.302801,103.847925
228071,450,357,807,1.302799,103.847458
228073,178,165,343,1.30273,103.847485
228077,3,204,207,1.302052,103.848828
228078,1,0,1,1.307439,103.851754
228079,145,3,148,1.303097,103.847674
228080,21,12,33,1.302925,103.847279
228081,0,9,9,1.303066,103.847156
228083,29,2,31,1.303119,103.847098
228084,87,327,414,1.30328,103.847049
228085,4,182,186,1.303533,103.847102
228086,70,211,281,1.303804,103.847011
228087,0,47,47,1.303817,103.846799
228088,2,16,18,1.303886,103.846754
228089,273,85,358,1.303472,103.846753
228090,113,39,152,1.303912,103.846696
228091,310,89,399,1.304444,103.845851
228092,25,463,488,1.30398,103.846643
228094,1,422,423,1.302067,103.848787
228095,5395,65605,71000,1.302102,103.849615
228096,875,553,1428,1.303281,103.847458
228114,8,13,21,1.303996,103.846914
228115,0,1,1,1.303038,103.847184
228116,1,4,5,1.304042,103.846852
228117,2,7,9,1.304082,103.8468
228118,6,23,29,1.304121,103.846781
228119,2000,312,2312,1.303531,103.847826
228120,938,123,1061,1.303371,103.848233
228123,7,17,24,1.304547,103.846974
228126,70,55,125,1.303737,103.847818
228149,671,2648,3319,1.301511,103.849561
228150,8,1613,1621,1.301884,103.848662
228151,60,722,782,1.301698,103.848805
228152,277,218,495,1.301744,103.848508
228153,177,50,227,1.301992,103.848008
228154,31,45,76,1.301899,103.847965
228155,0,100,100,1.301924,103.847911
228156,25,109,134,1.301946,103.847836
228157,137,185,322,1.301985,103.847609
228158,1,15,16,1.30206,103.847684
228160,6,50,56,1.302068,103.847529
228161,4,45,49,1.302075,103.84749
228162,11,75,86,1.302086,103.847434
228163,378,135,513,1.302098,103.84719
228164,49,125,174,1.302143,103.847288
228165,48,27,75,1.302218,103.847076
228168,161,306,467,1.302463,103.846587
228170,45,89,134,1.302663,103.84628
228172,117,109,226,1.30218,103.845741
228173,36,91,127,1.302292,103.846939
228174,9,421,430,1.302308,103.846886
228175,1142,126,1268,1.302604,103.846744
228176,3,81,84,1.30265,103.846693
228177,2,30,32,1.302678,103.846653
228178,0,1,1,1.304019,103.84688
228179,26,0,26,1.302736,103.846585
228180,1,0,1,1.302713,103.846619
228182,1,1,2,1.309488,103.840135
228183,1,23,24,1.302839,103.846454
228184,251,23,274,1.302931,103.846192
228185,308,73,381,1.303013,103.846108
228186,54,67,121,1.303194,103.845971
228187,19,286,305,1.301956,103.848249
228188,61,21,82,1.302082,103.84759
228189,82,82,164,1.302292,103.846792
228190,30,140,170,1.302042,103.847786
228191,782,219,1001,1.301686,103.848912
228192,607,4,611,1.300117,103.848342
228193,522,83,605,1.300128,103.848333
228194,722,15,737,1.300139,103.848649
228195,59,2,61,1.300434,103.848873
228196,1368,4,1372,1.300815,103.848866
228208,12645,35972,48617,1.305662,103.831786
228209,925,1213,2138,1.305811,103.832727
228210,1434,57720,59154,1.306595,103.831788
228211,11625,96339,107964,1.306431,103.832783
228212,48,1427,1475,1.306308,103.833331
228213,10528,49527,60055,1.307249,103.833358
228218,1540,31380,32920,1.307909,103.832893
228220,5607,2476,8083,1.307079,103.832436
228221,3996,13381,17377,1.308349,103.834529
228222,63,162,225,1.310076,103.834336
228223,3801,260,4061,1.309897,103.834788
228224,527,12,539,1.310329,103.834737
228225,68,735,803,1.310434,103.834912
228226,643,344,987,1.310553,103.835137
228227,201,464,665,1.310778,103.835347
228228,31,675,706,1.310904,103.835537
228229,814,12849,13663,1.311453,103.835928
228230,2835,3830,6665,1.311777,103.836579
228231,2572,2405,4977,1.310572,103.836269
228232,498,221,719,1.311863,103.836949
228233,3609,54,3663,1.312213,103.83718
228234,1512,27375,28887,1.31249,103.837993
228235,392,7011,7403,1.306914,103.832576
228238,6114,3112,9226,1.305767,103.833083
228239,624,6421,7045,1.311909,103.836796
228240,357,263,620,1.310192,103.835117
228241,161,591,752,1.312101,103.837321
228242,7134,9098,16232,1.311308,103.836963
228243,118,19,137,1.310773,103.834931
228256,86,79,165,1.303221,103.838775
228257,11,7,18,1.303284,103.838775
228258,11,3,14,1.303347,103.838781
228259,0,11,11,1.303428,103.838786
228260,77,13,90,1.303502,103.838781
228261,2,37,39,1.303582,103.838781
228262,0,4,4,1.303662,103.838798
228263,12,6,18,1.303743,103.838809
228264,7,135,142,1.303817,103.838803
228265,1,94,95,1.303892,103.838798
228266,4,8,12,1.303954,103.838766
228267,21,31,52,1.304013,103.838776
228268,11,15,26,1.304068,103.838782
228269,82,2,84,1.304117,103.83879
228270,13,16,29,1.304174,103.838782
228271,9,9,18,1.304221,103.838781
228272,14,6,20,1.304272,103.838781
228273,61,0,61,1.304318,103.838781
228274,3,14,17,1.304375,103.838787
228275,101,6,107,1.304438,103.838787
228276,41,1,42,1.304496,103.838793
228277,12,18,30,1.304547,103.838793
228278,9,0,9,1.304604,103.838793
228279,16,11,27,1.304656,103.838798
228281,2,4,6,1.304759,103.838798
228282,4,11,15,1.304805,103.838798
228283,1,40,41,1.304851,103.838798
228305,1862,101,1963,1.307903,103.839566
228307,2475,308,2783,1.308895,103.838905
228311,61,52,113,1.309169,103.838408
228313,1175,617,1792,1.309422,103.837954
228314,2319,29,2348,1.30954,103.837778
228315,1,0,1,1.30277,103.846551
228337,41,19029,19070,1.304444,103.83459
228338,12,3671,3683,1.304528,103.834511
228364,4,161,165,1.302732,103.849382
228365,71,2182,2253,1.302663,103.849448
228366,1,18,19,1.302857,103.849419
228367,9,47,56,1.302837,103.849558
228368,3,55,58,1.302897,103.849425
228369,1,22,23,1.302906,103.849569
228370,4,41,45,1.302932,103.849431
228371,10,19,29,1.303023,103.849583
228372,16,13,29,1.302966,103.849442
228373,6,25,31,1.302939,103.84958
228374,1,13,14,1.303006,103.849442
228375,21,17,38,1.303124,103.849592
228376,6,29,35,1.303035,103.849453
228377,8,20,28,1.303193,103.849598
228378,11,13,24,1.303075,103.849453
228379,1,27,28,1.303256,103.849603
228380,0,14,14,1.303121,103.849459
228381,1,27,28,1.303148,103.849594
228382,1,9,10,1.303161,103.84947
228383,1,15,16,1.303172,103.849603
228384,2,12,14,1.303207,103.849476
228385,10,25,35,1.303224,103.849599
228386,1,7,8,1.303241,103.849488
228387,0,21,21,1.303242,103.849602
228388,5,17,22,1.303287,103.849493
228389,0,19,19,1.303305,103.849611
228390,55,14,69,1.303327,103.849499
228391,9,18,27,1.303331,103.849616
228392,0,12,12,1.303375,103.84962
228393,5,19,24,1.303373,103.849505
228394,7,51,58,1.303357,103.849617
228395,149,9,158,1.30343,103.84951
228396,28,53,81,1.303458,103.849645
228397,15,21,36,1.303487,103.849522
228398,10,25,35,1.30348,103.849644
228399,72,23,95,1.303562,103.849533
228400,91,27,118,1.303503,103.849645
228401,5,23,28,1.303613,103.849544
228402,7,66,73,1.30363,103.849648
228403,153,32,185,1.303671,103.849544
228404,3,31,34,1.303707,103.84967
228405,2,47,49,1.303675,103.849663
228407,2,28,30,1.303743,103.849667
228408,24,13,37,1.303785,103.849567
228409,1,37,38,1.303771,103.849665
228410,9,8,17,1.303843,103.849567
228411,12,50,62,1.303813,103.849671
228412,4,12,16,1.303877,103.849561
228413,10,27,37,1.303837,103.849673
228414,1,12,13,1.303923,103.849556
228415,2,32,34,1.30387,103.849678
228418,10,96,106,1.303984,103.849577
228419,2,58,60,1.3039,103.849684
228421,34,126,160,1.303984,103.849646
228422,1,85,86,1.30414,103.849636
228424,0,32,32,1.304165,103.849652
228426,0,26,26,1.304196,103.849657
228428,8,51,59,1.304223,103.849667
228450,423,296,719,1.302505,103.846176
228451,73,83,156,1.300893,103.846252
228453,2,22,24,1.301407,103.846466
228457,995,486,1481,1.301251,103.846461
228458,1,9,10,1.300936,103.846859
228459,1336,149,1485,1.301284,103.846778
228460,262,67,329,1.30065,103.846718
228461,2,8,10,1.300189,103.847089
228462,833,19,852,1.301025,103.846379
228463,952,4020,4972,1.301041,103.845815
228464,446,199,645,1.299905,103.84759
228466,0,2,2,1.302821,103.846488
228467,1,7,8,1.300127,103.847151
228468,1,14,15,1.300127,103.847191
228469,11,26,37,1.30007,103.847202
228470,0,105,105,1.299509,103.837
228471,0,12,12,1.299509,103.837
228472,1,8,9,1.299509,103.837
228473,1,11,12,1.299509,103.837
228474,0,3,3,1.314524,103.847164
228475,1,3,4,1.299509,103.837
228476,0,2,2,1.30017,103.847131
228477,0,2,2,1.299509,103.837
228478,0,2,2,1.299509,103.837
228479,0,2,2,1.299509,103.837
228481,1,5,6,1.299509,103.837
228483,35,33,68,1.30416,103.849471
228484,58,16,74,1.304259,103.849412
228485,310,929,1239,1.304198,103.849396
228486,87,90,177,1.3043,103.849361
228487,9,132,141,1.30434,103.849293
228488,6,3,9,1.305188,103.847174
228489,14,142,156,1.30419,103.849529
228490,1401,12,1413,1.30433,103.849028
228491,914,91,1005,1.304455,103.848942
228492,747,1,748,1.303558,103.848726
228493,912,1,913,1.303583,103.848756
228494,247,9,256,1.304056,103.848761
228495,922,2,924,1.303497,103.849144
228510,9232,34681,43913,1.304574,103.835553
228511,792,2655,3447,1.305888,103.83625
228512,304,97,401,1.3063,103.836232
228513,272,904,1176,1.306722,103.835936
228514,488,308,796,1.306912,103.835927
228515,20,447,467,1.306743,103.836067
228516,2618,15940,18558,1.306904,103.835004
228517,5273,5470,10743,1.307829,103.835573
228518,2373,3277,5650,1.308084,103.835577
228519,949,4903,5852,1.30805,103.835365
228541,27,135,162,1.311493,103.840573
228542,21,9,30,1.311518,103.840518
228543,8,24,32,1.311543,103.840461
228544,35,15,50,1.311567,103.840405
228545,0,76,76,1.311592,103.840353
228546,0,30,30,1.311616,103.840301
228547,4,139,143,1.31164,103.840246
228549,3,321,324,1.311652,103.840204
228550,4,488,492,1.311675,103.840136
228551,176,843,1019,1.311693,103.840061
228552,13,1254,1267,1.311703,103.839977
228553,13,5716,5729,1.311714,103.839898
228554,4,111,115,1.311428,103.841001
228575,114,203,317,1.310093,103.84021
228576,157,486,643,1.309139,103.840459
228577,56,82,138,1.309788,103.84032
228578,0,21,21,1.309787,103.840319
228579,0,36,36,1.309787,103.840319
228598,635,261,896,1.312989,103.841993
228599,633,31,664,1.312895,103.841928
228600,239,42,281,1.312503,103.841998
228601,72,11,83,1.312716,103.84199
228602,1,5,6,1.312566,103.841976
228603,9,28,37,1.312385,103.841962
228604,141,64,205,1.312198,103.841979
228626,30,39,69,1.311868,103.842461
228627,190,2,192,1.311876,103.842481
228628,279,5,284,1.311897,103.842462
228629,39,2,41,1.311912,103.842483
228630,2,9,11,1.311954,103.842464
228631,3,1,4,1.311986,103.842485
228632,1,2,3,1.299509,103.837
228633,2,3,5,1.312059,103.842488
228634,10,0,10,1.31207,103.842469
228635,74,20,94,1.312132,103.842491
228636,8,0,8,1.312127,103.842471
228637,2,2,4,1.312206,103.842494
228638,42,1,43,1.312185,103.842473
228639,24,0,24,1.312279,103.842496
228640,2,0,2,1.299509,103.837
228641,105,1,106,1.312353,103.842499
228642,1,1,2,1.312242,103.842475
228643,5,59,64,1.312426,103.842502
228644,28,32,60,1.312358,103.842479
228645,30,2,32,1.312499,103.842505
228646,22,43,65,1.312415,103.842481
228647,5,10,15,1.312473,103.842484
228649,2,6,8,1.312531,103.842486
228650,0,1,1,1.309804,103.837458
228651,2,7,9,1.312646,103.84249
228673,458,1438,1896,1.304637,103.849825
228675,115,1318,1433,1.304494,103.84992
228676,37,129,166,1.304522,103.84988
228677,214,1030,1244,1.304556,103.849819
228678,48,225,273,1.304637,103.849687
228679,23,924,947,1.304664,103.849645
228680,1,503,504,1.304697,103.849595
228681,26,0,26,1.304735,103.849547
228682,1,90,91,1.304776,103.8495
228683,0,77,77,1.304802,103.849443
228686,127,0,127,1.304716,103.849563
228687,806,349,1155,1.306053,103.847804
228688,1,46,47,1.306124,103.847668
228689,0,4,4,1.306136,103.847652
228690,0,8,8,1.30615,103.847638
228691,0,1,1,1.312588,103.842488
228692,0,3,3,1.312012,103.842466
228693,0,1,1,1.306165,103.84762
228694,0,1,1,1.306188,103.847592
228695,0,1,1,1.306202,103.847559
228696,5,10,15,1.306226,103.847534
228697,256,1,257,1.306232,103.847519
228698,1,191,192,1.306245,103.847502
228699,0,18,18,1.306261,103.84749
228700,0,22,22,1.306274,103.847479
228701,0,15,15,1.306287,103.847458
228702,1,27,28,1.3063,103.847444
228703,0,18,18,1.30631,103.847419
228704,1,26,27,1.306325,103.847396
228705,1,0,1,1.306214,103.847546
228706,14,119,133,1.306356,103.847367
228707,1,97,98,1.306372,103.847348
228708,165,829,994,1.30641,103.847294
228709,6,2,8,1.306453,103.847247
228710,151,86,237,1.3065,103.847213
228711,9,84,93,1.306556,103.847106
228712,62,264,326,1.306604,103.847034
228714,129,86,215,1.306686,103.846837
228719,602,7,609,1.306731,103.846862
228720,1,173,174,1.306817,103.846764
228721,11,0,11,1.306817,103.846764
228722,7,62,69,1.306846,103.846725
228723,49,27,76,1.306864,103.846681
228724,50,218,268,1.306886,103.846657
228725,8,95,103,1.306728,103.846784
228727,143,4,147,1.306799,103.846685
228728,3,49,52,1.306835,103.84664
228729,28,181,209,1.305135,103.848994
228750,429,3707,4136,1.301458,103.842319
228773,175,9193,9368,1.300958,103.842671
228796,1522,88795,90317,1.301793,103.840857
228818,5,78,83,1.299454,103.848221
228819,2,1,3,1.306182,103.847602
228820,0,17,17,1.299466,103.848325
228821,0,5,5,1.299466,103.848346
228822,2,6,8,1.299515,103.848542
228823,0,8,8,1.299515,103.848562
228824,0,2,2,1.3123,103.842477
228825,1,1,2,1.299596,103.848713
228826,1,0,1,1.306337,103.847381
228827,1,1,2,1.299596,103.848733
228829,1,12,13,1.299723,103.84896
228831,1,5,6,1.29972,103.849135
228832,0,28,28,1.299693,103.849253
228833,0,54,54,1.299693,103.849233
228834,0,20,20,1.299649,103.849438
228835,9,458,467,1.299639,103.849428
228859,9,2873,2882,1.312409,103.846624
228860,4,169,173,1.312604,103.846368
228861,3,151,154,1.312536,103.846103
228862,5,81,86,1.312695,103.846263
228863,1,94,95,1.312807,103.846191
228864,2,187,189,1.312825,103.846148
228865,4,151,155,1.313005,103.846013
228866,3,320,323,1.312899,103.84608
228867,1379,345,1724,1.313147,103.843547
228868,17,3,20,1.313044,103.843532
228869,106,6,112,1.31299,103.843521
228870,1,0,1,1.299638,103.848789
228871,24,8,32,1.313095,103.843504
228872,5,1,6,1.313298,103.843488
228873,5,6,11,1.313199,103.843495
228874,13,0,13,1.313458,103.843469
228875,10,52,62,1.313334,103.843473
228877,1,0,1,1.313129,103.843518
228879,1,1,2,1.299638,103.848809
228880,0,3,3,1.299454,103.848241
228881,0,15,15,1.313287,103.84198
228882,1,41,42,1.313175,103.841525
228883,0,4,4,1.313083,103.840647
228884,0,5,5,1.313066,103.840482
228892,289,257,546,1.311928,103.846623
228913,8,519,527,1.305256,103.833925
228914,6,189,195,1.30509,103.834107
228915,0,106,106,1.305256,103.833988
228916,34,29,63,1.30509,103.83417
228917,1,19,20,1.305256,103.834045
228918,0,18,18,1.30509,103.834232
228919,66,5,71,1.305262,103.834107
228920,0,20,20,1.305102,103.834295
228921,1,7,8,1.305268,103.834164
228922,3,24,27,1.305107,103.834369
228923,3,3,6,1.305291,103.834227
228924,2,21,23,1.305113,103.834437
228925,1,5,6,1.305291,103.834295
228926,15,22,37,1.305113,103.8345
228927,1,7,8,1.305302,103.834363
228928,1,14,15,1.30513,103.834568
228929,40,10,50,1.305314,103.834432
228930,91,8,99,1.305142,103.834625
228931,1,7,8,1.305314,103.8345
228932,3,9,12,1.305148,103.834688
228933,2,15,17,1.305325,103.834563
228934,2,8,10,1.305153,103.834756
228935,0,2,2,1.313287,103.84198
228936,13,17,30,1.305159,103.834819
228937,0,3,3,1.313287,103.84198
228938,4,20,24,1.305159,103.834881
228939,1,1,2,1.305325,103.834631
228940,229,11,240,1.305165,103.834944
228941,1,3,4,1.305343,103.834841
228942,8,188,196,1.305165,103.835012
228943,0,4,4,1.305337,103.83491
228944,0,8,8,1.305343,103.834978
228945,0,1,1,1.313287,103.84198
228946,76,598,674,1.305343,103.835115
228968,5,1559,1564,1.304716,103.834363
228969,0,749,749,1.304723,103.83441
228970,52,328,380,1.30473,103.834451
228971,2,191,193,1.304732,103.834498
228972,1,52,53,1.304736,103.834553
228973,4,89,93,1.304749,103.834606
228974,43,39,82,1.304759,103.83465
228976,0,74,74,1.30477,103.834743
228977,0,54,54,1.304771,103.83479
228978,1,244,245,1.304775,103.834827
228979,3,1042,1045,1.30478,103.834882
229001,719,153,872,1.305747,103.833912
229002,26,873,899,1.3056,103.833839
229003,1,301,302,1.3056,103.833902
229004,45,203,248,1.305606,103.833965
229005,36,55,91,1.305611,103.834027
229006,483,69,552,1.305771,103.83438
229007,6,26,32,1.305629,103.834095
229008,4,38,42,1.305634,103.834158
229009,2,23,25,1.305634,103.834221
229010,5,13,18,1.305634,103.834283
229011,2,11,13,1.30564,103.834346
229012,585,627,1212,1.305773,103.834702
229013,3,25,28,1.305646,103.834403
229014,1,40,41,1.305657,103.834465
229015,0,22,22,1.305657,103.834528
229016,56,59,115,1.305657,103.834591
229017,934,152,1086,1.305773,103.83493
229018,8,43,51,1.305663,103.834659
229019,3,88,91,1.305663,103.834727
229020,2,26,28,1.305669,103.834796
229021,30,28,58,1.305669,103.834858
229022,9,1,10,1.305686,103.834915
229023,60,5,65,1.305686,103.834978
229024,5,27,32,1.305692,103.835046
229046,27,3351,3378,1.30595,103.835786
229047,5,128,133,1.305966,103.835733
229048,5,92,97,1.305992,103.835667
229049,0,11,11,1.306012,103.835611
229050,2,40,42,1.306036,103.835546
229051,96,29,125,1.306059,103.835489
229052,3,11,14,1.30607,103.835432
229053,21,35,56,1.306222,103.835247
229054,1,15,16,1.306451,103.835349
229055,1,7,8,1.306255,103.835228
229056,2,5,7,1.306454,103.835431
229057,10,14,24,1.306311,103.835214
229058,4,4,8,1.30646,103.835505
229059,12,16,28,1.306405,103.835186
229060,15,10,25,1.30646,103.835585
229061,1,11,12,1.306459,103.835167
229062,1,28,29,1.30646,103.835659
229063,200,35,235,1.306494,103.835147
229064,41,51,92,1.30646,103.835733
229065,55,7,62,1.306569,103.835125
229066,6,1232,1238,1.30646,103.835801
229067,11,4,15,1.306614,103.835107
229068,4,41,45,1.306634,103.835095
229069,1,9,10,1.306516,103.835417
229070,1,8,9,1.306516,103.835468
229071,2,5,7,1.306516,103.835519
229072,2,3,5,1.306516,103.83557
229073,1,34,35,1.306522,103.835622
229074,0,39,39,1.306528,103.835673
229075,1,45,46,1.306528,103.835724
229076,14,1805,1819,1.306533,103.83577
229098,13,27,40,1.313342,103.84286
229099,1,0,1,1.305343,103.835046
229100,12,1,13,1.313321,103.842763
229101,0,32,32,1.313292,103.842765
229102,3,2,5,1.313261,103.842868
229103,1,0,1,1.313301,103.842861
229104,6,0,6,1.313266,103.84277
229106,3,0,3,1.305331,103.834699
229107,0,4,4,1.313145,103.842882
229108,14,0,14,1.31322,103.842775
229109,23,0,23,1.313191,103.842778
229110,36,0,36,1.313105,103.842889
229111,2,0,2,1.305331,103.834773
229112,16,2,18,1.31316,103.842782
229113,6,0,6,1.31313,103.842788
229114,1,0,1,1.313225,103.842868
229115,1,2,3,1.313188,103.84288
229117,1,0,1,1.313022,103.842901
229118,41,4,45,1.312962,103.842907
229119,4,0,4,1.312936,103.842909
229120,7,0,7,1.313013,103.84278
229121,7,1,8,1.31297,103.842785
229122,5,4,9,1.312908,103.842913
229123,8,0,8,1.312889,103.842914
229124,1,1,2,1.31306,103.842894
229126,8,3,11,1.312865,103.842914
229127,7,0,7,1.312834,103.842918
229128,15,1,16,1.312861,103.842805
229129,2,3,5,1.31282,103.842822
229131,3,2,5,1.312774,103.842921
229132,14,0,14,1.312763,103.842829
229133,3,10,13,1.312716,103.842831
229134,5,6,11,1.312743,103.842928
229157,921,707,1628,1.303345,103.838458
229158,1342,474,1816,1.303433,103.838246
229159,518,138,656,1.303236,103.838431
229160,126,131,257,1.302882,103.838727
229161,1507,71,1578,1.304064,103.838403
229182,56,41,97,1.311608,103.843447
229183,0,4,4,1.311631,103.843403
229184,3,6,9,1.311651,103.843379
229185,6,1,7,1.311667,103.843354
229186,6,0,6,1.311681,103.84332
229187,3,81,84,1.311428,103.843514
229188,1,0,1,1.313046,103.842778
229189,8,69,77,1.311513,103.843556
229190,1,1,2,1.312949,103.842787
229191,0,59,59,1.311591,103.843595
229192,2,0,2,1.311722,103.843246
229193,2,125,127,1.311683,103.843645
229194,1,9,10,1.311665,103.843428
229195,5,17,22,1.311769,103.84369
229196,0,4,4,1.311756,103.843632
229197,7,52,59,1.311852,103.843732
229198,0,8,8,1.311897,103.843707
229199,28,35,63,1.311934,103.843766
229200,0,7,7,1.311969,103.843746
229201,4,22,26,1.312006,103.843806
229202,4,9,13,1.312034,103.843782
229203,167,17,184,1.312082,103.843844
229204,2,14,16,1.312108,103.843817
229205,13,33,46,1.312182,103.843895
229206,36,6,42,1.31219,103.843861
229207,0,30,30,1.312247,103.843936
229208,0,21,21,1.312264,103.843892
229209,2,159,161,1.312331,103.843973
229210,0,8,8,1.312525,103.843428
229211,2,5,7,1.312342,103.843943
229212,26,4,30,1.311768,103.84324
229214,2,1,3,1.312998,103.842902
229215,0,2,2,1.311735,103.843214
229216,0,1,1,1.311706,103.843272
229217,5,2,7,1.31225,103.843294
229218,0,2,2,1.312077,103.84321
229219,26,4,30,1.312386,103.843355
229220,2,6,8,1.312461,103.84339
229221,0,14,14,1.31258,103.843527
229233,3881,24666,28547,1.299389,103.847398
229234,144,304,448,1.299496,103.846894
229235,7,5,12,1.299509,103.837
229236,400,580,980,1.299716,103.846667
229237,299,7150,7449,1.298962,103.847355
229239,1593,6130,7723,1.300401,103.845691
229257,3,194,197,1.31265,103.845265
229258,1,49,50,1.312493,103.845441
229259,1,0,1,1.312171,103.84325
229260,7,3,10,1.312336,103.845618
229261,2,1,3,1.312002,103.843168
229262,2,12,14,1.311956,103.846004
229287,20,964,984,1.301363,103.83901
229288,46,298,344,1.301825,103.839027
229289,90,19,109,1.301791,103.839033
229290,8,204,212,1.301418,103.839029
229291,71,22,93,1.301858,103.839024
229292,3,123,126,1.301454,103.839036
229293,124,78,202,1.301938,103.839032
229294,65,69,134,1.301495,103.83905
229295,14,35,49,1.301552,103.839069
229296,70,16,86,1.301602,103.839079
229297,72,103,175,1.302014,103.839031
229298,72,20,92,1.301642,103.839091
229299,7,90,97,1.302042,103.839032
229300,9,39,48,1.30169,103.83909
229301,8,43,51,1.302108,103.839043
229302,10,36,46,1.30174,103.839092
229303,4,28,32,1.302185,103.839039
229304,10,24,34,1.301801,103.839089
229305,11,84,95,1.302234,103.839045
229306,2,20,22,1.301855,103.839092
229307,1,18,19,1.301917,103.839089
229308,61,18,79,1.301982,103.839089
229309,47,14,61,1.30205,103.839093
229310,4,8,12,1.302114,103.839099
229311,0,9,9,1.302179,103.839098
229312,3,37,40,1.302241,103.839094
229313,393,8675,9068,1.302847,103.838528
229314,5,7,12,1.302296,103.839098
229315,20,31,51,1.30262,103.839046
229316,167,20,187,1.302359,103.839097
229317,46,7,53,1.302667,103.839074
229318,15,5,20,1.302418,103.839099
229319,16,12,28,1.302733,103.839097
229320,2,8,10,1.302477,103.839098
229321,75,2,77,1.30281,103.839088
229322,20,8,28,1.302535,103.839111
229323,24,3,27,1.30289,103.83913
229324,1,5,6,1.302586,103.839113
229325,32,101,133,1.302932,103.839159
229326,74,5,79,1.302629,103.83913
229327,9,61,70,1.303059,103.839156
229328,122,7,129,1.302681,103.839142
229329,92,47,139,1.303182,103.839253
229330,15,8,23,1.302735,103.839154
229331,7,2,9,1.303268,103.839292
229332,9,4,13,1.302785,103.83917
229333,111,1,112,1.303315,103.839318
229334,7,7,14,1.302834,103.839182
229335,50,0,50,1.303359,103.839335
229336,37,6,43,1.302872,103.839192
229337,9,3,12,1.303414,103.839353
229338,90,26,116,1.302915,103.839205
229339,6,0,6,1.303463,103.839365
229340,6,11,17,1.302959,103.839222
229341,1,1,2,1.312316,103.843318
229342,2,10,12,1.303018,103.83924
229343,0,5,5,1.303593,103.839376
229344,0,1,1,1.312346,103.845608
229345,7,2,9,1.303639,103.839388
229346,1,4,5,1.303091,103.839267
229347,0,9,9,1.30368,103.839392
229348,43,2,45,1.303126,103.83928
229349,33,4,37,1.303724,103.839394
229350,27,2,29,1.303165,103.839295
229351,63,8,71,1.30376,103.839396
229352,127,42,169,1.303205,103.839312
229353,1,9,10,1.303805,103.839401
229354,1,2,3,1.312151,103.845806
229355,34,3,37,1.303862,103.839405
229356,2,0,2,1.303528,103.839369
229357,2,0,2,1.30329,103.83935
229358,0,2,2,1.303908,103.839415
229359,12,5,17,1.303955,103.839423
229360,10,1,11,1.303377,103.839392
229361,1,1,2,1.303329,103.839373
229362,16,1,17,1.303432,103.839404
229363,20,0,20,1.304101,103.839441
229364,2,0,2,1.304016,103.839426
229366,10,8,18,1.303513,103.839425
229367,0,1,1,1.303053,103.839254
229368,8,3,11,1.303568,103.839431
229369,4,1,5,1.304319,103.839461
229370,10,10,20,1.303618,103.839443
229371,1,0,1,1.304255,103.839461
229372,4,23,27,1.303667,103.839443
229373,10,0,10,1.304431,103.839454
229374,67,9,76,1.303724,103.83945
229375,15,3,18,1.304474,103.839447
229376,8,2,10,1.303766,103.839458
229377,3,0,3,1.303245,103.839336
229378,3,4,7,1.303815,103.83946
229379,0,16,16,1.304586,103.839427
229380,0,4,4,1.30386,103.839462
229381,2,25,27,1.304632,103.839423
229382,26,8,34,1.303927,103.839472
229384,8,107,115,1.304687,103.839422
229385,9,33,42,1.304008,103.839483
229386,1,1,2,1.303473,103.839418
229388,0,5,5,1.304082,103.839606
229389,10,0,10,1.304093,103.839502
229390,52,7,59,1.304093,103.839502
229391,1058,100,1158,1.305099,103.839199
229392,10,5,15,1.304164,103.839513
229393,15,0,15,1.304164,103.839513
229394,2,0,2,1.304008,103.839483
229395,1,7,8,1.304258,103.839515
229396,0,1,1,1.304379,103.839454
229397,67,9,76,1.304344,103.839514
229398,0,13,13,1.304344,103.839514
229399,0,3,3,1.304538,103.83943
229401,1026,6,1032,1.305322,103.839322
229402,102,90,192,1.305397,103.83931
229403,0,15,15,1.304482,103.8395
229404,5,34,39,1.305727,103.839265
229405,10,20,30,1.304552,103.839498
229406,2,7,9,1.305797,103.839251
229407,4,10,14,1.304598,103.839493
229408,1,8,9,1.305825,103.839246
229409,267,17,284,1.304653,103.839485
229410,35,503,538,1.305905,103.83927
229411,15,10,25,1.304701,103.839483
229412,11,19,30,1.304752,103.839473
229414,303,128,431,1.30486,103.839458
229415,34,29,63,1.299509,103.837
229417,34,87,121,1.305031,103.839432
229418,15,20,35,1.305078,103.839425
229419,10,4,14,1.305274,103.839397
229420,27,13,40,1.305353,103.839387
229421,13,9,22,1.305418,103.839379
229422,16,12,28,1.305481,103.839368
229423,11,7,18,1.305543,103.839354
229424,8,54,62,1.305597,103.839347
229425,4,24,28,1.30567,103.83933
229426,26,11,37,1.305734,103.839325
229427,25,13,38,1.305796,103.839311
229428,25,198,223,1.305861,103.839297
229429,10,31,41,1.299509,103.837
229430,100,27,127,1.305204,103.839409
229431,8,3,11,1.305204,103.839409
229432,139,168,307,1.302154,103.839042
229433,27,5,32,1.305397,103.83931
229434,9,13,22,1.305397,103.83931
229435,50,53,103,1.305397,103.83931
229450,947,37345,38292,1.301787,103.840303
229451,68,5506,5574,1.30182,103.840305
229452,33,4503,4536,1.301855,103.840315
229453,25,3473,3498,1.301902,103.840319
229454,22,2601,2623,1.301931,103.840326
229455,17,2114,2131,1.301964,103.840335
229456,24,1419,1443,1.302007,103.840361
229457,16,1171,1187,1.302088,103.84039
229458,16,922,938,1.302129,103.840407
229459,10,773,783,1.302156,103.840418
229460,6,656,662,1.302202,103.840439
229461,5,360,365,1.302218,103.84044
229462,11,223,234,1.302285,103.840459
229463,34,1366,1400,1.302348,103.840469
229464,7,1110,1117,1.302401,103.840493
229465,9,286,295,1.302427,103.840488
229466,62,6152,6214,1.302459,103.840489
229468,6,59,65,1.303132,103.840272
229469,1818,5780,7598,1.302839,103.840585
229491,2238,509,2747,1.307976,103.840779
229492,189,1231,1420,1.310416,103.839896
229493,12,426,438,1.308956,103.839854
229495,2464,38040,40504,1.312041,103.839179
229516,282,439,721,1.308561,103.84007
229538,1255,8788,10043,1.307817,103.828989
229539,11,112,123,1.308046,103.829352
229540,3819,5242,9061,1.307637,103.830047
229541,15,570,585,1.308048,103.829498
229542,171,334,505,1.307977,103.829721
229543,1810,662,2472,1.307834,103.831071
229544,1879,344,2223,1.309297,103.831549
229545,956,15068,16024,1.307733,103.830233
229546,430,201,631,1.30845,103.83066
229566,11,242,253,1.306753,103.830971
229567,1,18,19,1.306753,103.830971
229568,2,3,5,1.306753,103.830971
229569,0,13,13,1.306753,103.830971
229570,19,788,807,1.306753,103.830971
229571,2558,1433,3991,1.306916,103.831469
229572,3008,3392,6400,1.307714,103.831762
229573,4325,8652,12977,1.308473,103.832239
229594,4739,46008,50747,1.307565,103.829476
229616,3700,29543,33243,1.302504,103.841106
229617,975,52809,53784,1.301216,103.841728
229618,296,937,1233,1.303583,103.841268
229619,783,450,1233,1.304133,103.841297
229620,455,24,479,1.304133,103.841297
229622,997,159,1156,1.304953,103.841305
229623,1118,1102,2220,1.305079,103.84064
229624,1475,1426,2901,1.30552,103.840513
229626,1173,1718,2891,1.306181,103.841056
229627,1417,474,1891,1.309161,103.842601
229628,1368,776,2144,1.309928,103.843172
229629,418,338,756,1.306806,103.841172
229630,756,9,765,1.304324,103.841282
229631,307,13,320,1.304324,103.841282
229632,651,85,736,1.304138,103.841129
229633,842,418,1260,1.304329,103.841114
229634,57,0,57,1.304329,103.841114
229635,2872,9233,12105,1.301178,103.842199
229650,27,6077,6104,1.303694,103.836831
229652,7,238,245,1.303173,103.837764
229653,9,51,60,1.303234,103.837995
229654,12,197,209,1.303274,103.837756
229655,33,349,382,1.303336,103.83777
229656,36,4301,4337,1.303405,103.837778
229657,830,1009,1839,1.304245,103.837712
229658,2089,533,2622,1.30493,103.837099
229659,4,192,196,1.299509,103.837
229660,1669,1966,3635,1.304789,103.837901
229661,218,780,998,1.30529,103.837645
229662,8,757,765,1.305996,103.837751
229663,17,84,101,1.30607,103.837717
229664,2000,142,2142,1.306298,103.837321
229665,36,149,185,1.30613,103.837674
229666,1772,554,2326,1.306812,103.837082
229667,67,613,680,1.306232,103.837638
229668,1152,813,1965,1.307547,103.836357
229669,1,410,411,1.30807,103.836899
229670,1,180,181,1.307805,103.83626
229671,29,387,416,1.308355,103.836627
229672,119,230,349,1.308337,103.83654
229673,18,134,152,1.308614,103.836497
229674,98,2254,2352,1.306643,103.837412
229675,1285,720,2005,1.309131,103.836245
229676,95,419,514,1.306672,103.837395
229677,4,320,324,1.306724,103.837389
229678,3,330,333,1.306769,103.837378
229679,5,27,32,1.306815,103.837372
229680,11,27,38,1.306861,103.837367
229681,97,672,769,1.309609,103.836036
229682,24,236,260,1.306901,103.837361
229683,7,690,697,1.309916,103.835823
229684,4,74,78,1.306941,103.837355
229685,26,1911,1937,1.310158,103.835627
229686,10,83,93,1.306981,103.837344
229687,3,42,45,1.307027,103.837332
229688,3,141,144,1.30716,103.837292
229689,0,20,20,1.307206,103.837258
229690,6,53,59,1.307246,103.83723
229691,14,135,149,1.307291,103.837213
229692,0,16,16,1.307337,103.83719
229693,1,8,9,1.307383,103.837167
229694,3,5,8,1.307429,103.837144
229695,5,156,161,1.307475,103.837116
229696,45,15,60,1.30752,103.837093
229697,12,107,119,1.307555,103.83707
229698,0,2,2,1.304258,103.839515
229699,20,9,29,1.307723,103.837014
229700,4,209,213,1.307763,103.837003
229701,14,1,15,1.307803,103.836991
229702,4,1,5,1.307843,103.83698
229703,21,2,23,1.307883,103.836968
229704,3,0,3,1.299509,103.837
229705,97,187,284,1.307975,103.836946
229706,47,30,77,1.308004,103.836928
229707,178,28,206,1.307989,103.837527
229708,57,194,251,1.308245,103.83687
229709,146,82,228,1.308296,103.836859
229710,15,65,80,1.308342,103.836836
229711,50,52,102,1.308377,103.836825
229712,69,60,129,1.308417,103.836819
229713,17,35,52,1.308457,103.836808
229714,2,36,38,1.308503,103.836802
229715,23,22,45,1.308548,103.836791
229716,9,168,177,1.308606,103.836785
229717,968,1065,2033,1.308758,103.836842
229719,640,660,1300,1.309847,103.836194
229720,451,316,767,1.304331,103.838028
229721,2171,32,2203,1.30815,103.836652
229722,107,621,728,1.309596,103.837787
229723,1000,1003,2003,1.303817,103.837257
229724,4940,1236,6176,1.304101,103.837061
229740,1880,410,2290,1.306712,103.839119
229741,642,390,1032,1.30695,103.839704
229742,205,147,352,1.307049,103.839444
229743,499,159,658,1.307492,103.839523
229744,575,33,608,1.308572,103.837957
229745,1007,138,1145,1.308574,103.83867
229746,691,45,736,1.308571,103.838415
229747,980,128,1108,1.308596,103.83832
229768,2903,1241,4144,1.306647,103.838619
229770,1,197,198,1.307489,103.839157
229771,3,46,49,1.30753,103.839118
229772,1,9,10,1.307615,103.839037
229773,8,7,15,1.30765,103.839002
229774,1790,10,1800,1.307758,103.839109
229775,596,44,640,1.30799,103.83866
229776,6,5,11,1.307765,103.838904
229777,5,14,19,1.307841,103.83885
229778,0,20,20,1.307877,103.838785
229779,0,7,7,1.307917,103.838726
229780,1,28,29,1.307933,103.838676
229781,2,17,19,1.307961,103.838598
229782,5,71,76,1.307989,103.838521
229783,0,15,15,1.308025,103.838445
229784,845,27,872,1.308038,103.83837
229785,105,33,138,1.30804,103.838282
229786,4,30,34,1.308044,103.838206
229787,0,12,12,1.308043,103.838118
229788,1,6,7,1.308012,103.838039
229789,71,24,95,1.308003,103.837991
229790,350,91,441,1.307664,103.837847
229791,1,61,62,1.307925,103.837824
229794,1,8,9,1.307409,103.837923
229795,0,7,7,1.307327,103.837989
229796,0,13,13,1.307229,103.83805
229797,1,19,20,1.307173,103.838122
229798,0,52,52,1.307155,103.838211
229799,1,46,47,1.307106,103.8383
229800,1,60,61,1.307059,103.83839
229801,3,194,197,1.307012,103.83846
229802,1,156,157,1.30698,103.838535
229803,1,62,63,1.306971,103.838609
229804,1,44,45,1.306943,103.838707
229805,0,82,82,1.3069,103.838789
229806,1,17,18,1.306627,103.839049
229807,2,70,72,1.307161,103.838976
229808,397,15,412,1.307253,103.838971
229809,2445,44,2489,1.307383,103.838987
229810,142,28,170,1.307732,103.838454
229811,4096,459,4555,1.305608,103.838145
229812,137,14,151,1.305288,103.838422
229813,1737,144,1881,1.305543,103.838721
229814,1079,1186,2265,1.305844,103.838857
229815,818,376,1194,1.306881,103.83813
229816,2518,667,3185,1.306856,103.837965
229832,714,2018,2732,1.30677,103.847844
229833,1273,1203,2476,1.307117,103.847797
229834,50,381,431,1.307296,103.847588
229835,2819,2272,5091,1.307661,103.847159
229837,2201,532,2733,1.310471,103.843538
229838,27,1677,1704,1.310969,103.8436
229839,2,1,3,1.307935,103.836957
229840,12,213,225,1.311009,103.843479
229841,173,866,1039,1.311009,103.842951
229842,9,95,104,1.311035,103.843419
229843,35,771,806,1.311153,103.84225
229844,33,908,941,1.311048,103.843383
229846,38,544,582,1.311312,103.84292
229847,17,132,149,1.311377,103.84268
229851,3,97,100,1.31146,103.84246
229852,11,73,84,1.311473,103.842435
229853,14,123,137,1.311486,103.842412
229854,24,308,332,1.311497,103.842381
229855,2,201,203,1.311511,103.842354
229856,35,367,402,1.311526,103.842243
229857,50,172,222,1.311539,103.842204
229858,1,134,135,1.311559,103.842163
229860,48,349,397,1.311574,103.842128
229862,71,220,291,1.311635,103.841997
229863,118,668,786,1.31165,103.84196
229864,9,120,129,1.312161,103.841021
229865,1,40,41,1.312194,103.840959
229866,2,14,16,1.312203,103.840928
229867,5,0,5,1.312213,103.840913
229868,0,21,21,1.312234,103.840871
229870,1,66,67,1.312245,103.840852
229871,0,2,2,1.307683,103.837031
229872,2,154,156,1.312292,103.840746
229873,0,2,2,1.312259,103.840813
229874,1,175,176,1.31232,103.840689
229876,1,0,1,1.299509,103.837
229877,1,101,102,1.312362,103.840605
229879,0,1,1,1.31234,103.840647
229880,1,90,91,1.31242,103.840487
229882,0,100,100,1.312473,103.840406
229884,1,51,52,1.312494,103.84034
229885,1,0,1,1.31235,103.840623
229886,2,89,91,1.31257,103.840233
229888,0,14,14,1.312579,103.840202
229889,2,186,188,1.312602,103.840107
229890,0,3,3,1.310988,103.843534
229891,0,17,17,1.312668,103.840021
229892,2,59,61,1.312696,103.839974
229893,0,1,1,1.312487,103.840369
229894,0,320,320,1.312705,103.839948
229895,0,5,5,1.312728,103.839892
229896,0,62,62,1.312751,103.839829
229897,1,42,43,1.312759,103.839806
229898,12,704,716,1.31277,103.839768
229899,7273,120612,127885,1.310644,103.847033
229900,957,4625,5582,1.306584,103.849429
229901,354,299,653,1.299509,103.837
229902,196,3539,3735,1.307634,103.84837
229920,2206,2530,4736,1.304951,103.836431
229921,9999,16260,26259,1.303278,103.836632
229922,296,61072,61368,1.304235,103.836797
229923,51,4430,4481,1.299509,103.837
229944,473,1183,1656,1.310608,103.838911
229945,43,282,325,1.299509,103.837
229946,340,15,355,1.309994,103.838054
229953,5512,2496,8008,1.310004,103.83861
229954,3564,67,3631,1.309647,103.839109
229955,1773,139,1912,1.309651,103.838467
229956,249,1417,1666,1.310965,103.838659
229957,891,1052,1943,1.311282,103.83774
229974,24,53,77,1.301935,103.847379
229975,935,54,989,1.301788,103.847488
229976,203,65,268,1.301414,103.847922
229977,131,129,260,1.301109,103.848224
229978,12,164,176,1.300681,103.848534
229979,346,296,642,1.301578,103.847707
237968,61,232,293,1.299509,103.837
237973,3655,3234,6889,1.299509,103.837
237978,1412,19170,20582,1.301049,103.835327
237983,6119,21345,27464,1.291732,103.842458
237988,3668,620,4288,1.293882,103.838679
237989,163,1494,1657,1.294428,103.838232
237990,4013,148,4161,1.294161,103.838046
237993,716,1080,1796,1.294206,103.836008
237994,13062,29133,42195,1.293984,103.832088
237995,10483,31461,41944,1.292115,103.84128
237996,2,2,4,1.293631,103.8396
237997,2,1,3,1.312623,103.840079
237998,1,2,3,1.293528,103.839627
237999,0,1,1,1.312685,103.839997
238000,0,3,3,1.293611,103.839685
238001,2,13,15,1.293452,103.839704
238002,835,12,847,1.293442,103.839836
238003,1,2,3,1.293579,103.839719
238004,254,158,412,1.29324,103.840089
238005,0,2,2,1.312277,103.840771
238006,0,3,3,1.293413,103.83976
238007,5,165,170,1.293364,103.839807
238008,823,0,823,1.2932,103.84013
238009,5,448,453,1.293315,103.839884
238010,364,621,985,1.292932,103.84046
238011,743,558,1301,1.292912,103.840681
238012,299,7,306,1.293442,103.839836
238013,2,0,2,1.29345,103.839963
238014,9,0,9,1.293442,103.839836
238015,5,0,5,1.293442,103.839836
238016,30,1,31,1.293442,103.839836
238017,147,0,147,1.293442,103.839836
238018,394,0,394,1.293442,103.839836
238019,1,1,2,1.293442,103.839836
238020,2,1,3,1.293425,103.839968
238021,21,3,24,1.293442,103.839836
238022,33,3,36,1.293442,103.839836
238023,14,3,17,1.293442,103.839836
238024,47,2,49,1.293442,103.839836
238025,12,1,13,1.293164,103.840186
238026,1333,1,1334,1.293127,103.840223
238058,15,1,16,1.293847,103.843054
238059,1,8,9,1.29378,103.842992
238060,71,8,79,1.293785,103.843009
238061,206,2378,2584,1.293886,103.84309
238065,348,488,836,1.294234,103.84323
238066,240,46,286,1.295442,103.843497
238067,18,1276,1294,1.295654,103.843692
238068,6,612,618,1.295624,103.843629
238069,252,1132,1384,1.296022,103.843462
238070,3,5,8,1.295752,103.843687
238071,0,5,5,1.295528,103.843542
238072,0,2,2,1.293442,103.839836
238073,3,0,3,1.293442,103.839836
238074,0,1,1,1.293494,103.839673
238096,294,977,1271,1.29654,103.835763
238097,20,1274,1294,1.296102,103.836392
238098,3,13,16,1.297146,103.835321
238099,0,17,17,1.297147,103.83532
238100,0,1,1,1.295752,103.843687
238101,118,40,158,1.297164,103.835524
238102,2,75,77,1.296485,103.83618
238103,54,14,68,1.297343,103.835449
238106,2,45,47,1.296793,103.836343
238107,579,125,704,1.297025,103.83606
238108,905,663,1568,1.298014,103.835524
238109,3,103,106,1.297086,103.835721
238111,58,66,124,1.297502,103.835726
238112,33,474,507,1.297793,103.835632
238113,2620,238,2858,1.297784,103.83628
238115,35,50,85,1.298637,103.836181
238117,3,1,4,1.297777,103.836394
238118,570,142,712,1.29779,103.835808
238119,0,7,7,1.29772,103.836529
238120,112,90,202,1.297777,103.835887
238121,1,364,365,1.297681,103.83665
238122,2,53,55,1.297754,103.835962
238123,0,67,67,1.297638,103.836776
238124,2,36,38,1.297729,103.836041
238125,0,65,65,1.297698,103.836121
238126,2127,117,2244,1.297368,103.836745
238128,5,16,21,1.297648,103.836296
238129,0,23,23,1.297623,103.836373
238130,4,923,927,1.297595,103.836457
238134,1,53,54,1.29757,103.836545
238136,0,10,10,1.297545,103.836622
238138,1,31,32,1.297524,103.836706
238139,77,56,133,1.297084,103.836942
238140,1442,50,1492,1.297868,103.836975
238141,2888,1368,4256,1.297911,103.835986
238142,1322,327,1649,1.296752,103.83687
238143,990,109,1099,1.298136,103.835279
238144,817,332,1149,1.298102,103.835329
238145,1116,3,1119,1.298102,103.835329
238146,13,2697,2710,1.299509,103.837
238147,3,50,53,1.299509,103.837
238162,2324,76039,78363,1.300256,103.839051
238163,4593,6001,10594,1.300711,103.837924
238164,4083,28965,33048,1.300513,103.837638
238165,52,7312,7364,1.300552,103.837484
238166,16,404,420,1.300684,103.837011
238212,1175,4962,6137,1.290923,103.838121
238213,1450,1903,3353,1.290397,103.837894
238214,575,21,596,1.290139,103.837811
238215,62,140,202,1.289984,103.837718
238216,1024,9,1033,1.289819,103.837605
238236,51,16,67,1.291062,103.840279
238237,284,7680,7964,1.290925,103.839826
238243,27,12,39,1.291079,103.837423
238245,95,349,444,1.29025,103.837156
238247,492,41,533,1.29029,103.837338
238250,1815,2122,3937,1.291003,103.837717
238251,1799,210,2009,1.291226,103.841531
238252,1650,1098,2748,1.290086,103.839168
238254,2,0,2,1.295482,103.843529
238255,5159,2582,7741,1.291715,103.836966
238256,126,32,158,1.291643,103.836604
238257,4986,809,5795,1.290937,103.836585
238258,4555,1211,5766,1.291844,103.8364
238259,8413,1376,9789,1.290662,103.837228
238260,711,970,1681,1.290952,103.837613
238274,1438,49949,51387,1.292747,103.842264
238275,2146,6454,8600,1.293131,103.841825
238276,77,1527,1604,1.293787,103.842555
238277,80,789,869,1.293771,103.842514
238278,65,2099,2164,1.293809,103.842535
238279,3,418,421,1.293791,103.842482
238280,2,49,51,1.293829,103.842507
238281,11,161,172,1.293818,103.842453
238282,17,1119,1136,1.293852,103.842482
238283,15,176,191,1.293853,103.842414
238284,26,5,31,1.293881,103.842451
238285,41,10,51,1.293888,103.842377
238286,14,2,16,1.293905,103.842431
238287,21,558,579,1.293919,103.842344
238288,12,249,261,1.293925,103.84241
238289,0,55,55,1.293953,103.84231
238290,24,9,33,1.293958,103.842385
238291,106,125,231,1.293991,103.842275
238292,20,178,198,1.293988,103.842366
238293,61,688,749,1.294032,103.842243
238294,117,104,221,1.294018,103.842336
238295,42,1842,1884,1.294073,103.842206
238296,18,14,32,1.294037,103.842311
238297,40,22,62,1.294067,103.842289
238298,137,1145,1282,1.294335,103.841969
238299,29,1204,1233,1.294105,103.842262
238300,78,12,90,1.294235,103.842298
238301,2,14,16,1.294143,103.842213
238302,169,259,428,1.294169,103.842187
238303,6,177,183,1.294526,103.841839
238304,5,492,497,1.294596,103.841799
238305,12,1271,1283,1.294672,103.841768
238306,131,824,955,1.294747,103.841734
238307,6014,1336,7350,1.294255,103.840789
238308,38,765,803,1.29442,103.841965
238309,4458,812,5270,1.294638,103.840014
238310,2,345,347,1.294465,103.841939
238312,23,360,383,1.294501,103.841914
238313,18,242,260,1.294563,103.841892
238314,4,367,371,1.29461,103.841874
238315,13,416,429,1.294653,103.841842
238316,32,12,44,1.294729,103.841807
238317,35,157,192,1.294777,103.841796
238318,106,1599,1705,1.295761,103.841102
238319,25,61,86,1.294834,103.841754
238320,128,1636,1764,1.295847,103.840064
238321,19,315,334,1.29488,103.841735
238322,16,1899,1915,1.295843,103.840012
238323,81,90,171,1.294939,103.841709
238324,81,10,91,1.295832,103.839934
238325,15,233,248,1.295005,103.8417
238326,18,4,22,1.295834,103.839884
238327,4,6,10,1.295032,103.841663
238328,76,186,262,1.295815,103.839787
238329,3,78,81,1.295108,103.841628
238330,11,263,274,1.295811,103.839732
238331,8,233,241,1.295184,103.841592
238332,6,490,496,1.295798,103.839659
238333,33,69,102,1.29526,103.841556
238334,206,293,499,1.295793,103.839613
238335,11,180,191,1.295341,103.841509
238336,28,162,190,1.295778,103.839508
238337,9,206,215,1.295422,103.841463
238338,125,2056,2181,1.295759,103.839389
238339,3,317,320,1.295503,103.841416
238340,12,26,38,1.295743,103.839298
238341,4,199,203,1.295543,103.841393
238342,60,2403,2463,1.295707,103.839137
238343,2,163,165,1.295637,103.841326
238344,69,6,75,1.295717,103.839107
238345,4,93,97,1.295721,103.841246
238346,3,0,3,1.295433,103.84346
238347,0,66,66,1.295748,103.841208
238348,2,7,9,1.295841,103.839086
238349,95,327,422,1.295801,103.841133
238350,0,301,301,1.295832,103.839009
238351,363,45,408,1.295826,103.841091
238352,286,23,309,1.29635,103.841444
238354,8,501,509,1.295805,103.838777
238355,2,995,997,1.295893,103.840956
238356,0,1,1,1.29715,103.835317
238357,326,1191,1517,1.295517,103.834987
238358,5,31,36,1.295939,103.840759
238359,1330,633,1963,1.294556,103.835162
238360,1484,0,1484,1.295941,103.8407
238361,1470,230,1700,1.29447,103.834506
238362,1,0,1,1.295911,103.840905
238363,1015,26,1041,1.294817,103.834042
238364,8,702,710,1.295956,103.840513
238365,550,271,821,1.295431,103.83422
238366,634,42,676,1.295756,103.838569
238367,105,1722,1827,1.295961,103.838048
238370,387,225,612,1.295944,103.837946
238372,5,28,33,1.29537,103.833196
238373,365,164,529,1.296813,103.834962
238374,317,3711,4028,1.296131,103.834711
238381,574,682,1256,1.296375,103.838015
238382,7,206,213,1.295026,103.83315
238383,17,36,53,1.29522,103.833492
238403,1594,421,2015,1.296488,103.834129
238405,563,1671,2234,1.296464,103.834194
238406,865,47,912,1.297289,103.834673
238427,2152,5416,7568,1.295304,103.837722
238428,1010,1257,2267,1.295182,103.837071
238429,98,3079,3177,1.294906,103.837525
238430,414,9284,9698,1.294565,103.837362
238431,399,982,1381,1.294277,103.837218
238432,723,459,1182,1.294731,103.836973
238433,409,13520,13929,1.29451,103.837199
238434,11,1986,1997,1.292998,103.836992
238435,694,291,985,1.294468,103.836483
238436,389,353,742,1.293975,103.836882
238437,1697,566,2263,1.2938,103.837025
238459,82,2085,2167,1.298048,103.844577
238461,13,274,287,1.29981,103.840902
238462,865,824,1689,1.299927,103.840513
238463,540,781,1321,1.299739,103.841206
238464,2491,819,3310,1.299566,103.842102
238465,291,353,644,1.299598,103.841923
238466,21,480,501,1.299065,103.843145
238467,3074,1609,4683,1.299269,103.84285
238468,6,637,643,1.297929,103.847235
238469,11,136,147,1.29842,103.844996
238485,3202,598,3800,1.297664,103.844549
238486,131,172,303,1.297288,103.844553
238509,342,2084,2426,1.303066,103.830051
238510,850,496,1346,1.302405,103.83085
238511,137,225,362,1.301927,103.830251
238513,1,0,1,1.295944,103.840582
238516,7,1598,1605,1.301228,103.832483
238518,924,2126,3050,1.302476,103.829564
238519,2,294,296,1.301757,103.829709
238520,2,319,321,1.302078,103.829523
238521,1,48,49,1.301622,103.829656
238522,6,4,10,1.301546,103.829603
238524,1,0,1,1.301342,103.831382
238525,1,41,42,1.301376,103.829547
238526,6,227,233,1.301249,103.829553
238527,2,16,18,1.301131,103.829645
238528,5,3,8,1.301094,103.829698
238539,1563,413,1976,1.300364,103.830308
238543,75,27,102,1.300732,103.82987
238544,5,46,51,1.300664,103.829887
238545,30,0,30,1.300532,103.829936
238546,150,0,150,1.300481,103.829953
238547,102,267,369,1.300575,103.829934
238548,45,34,79,1.300427,103.829983
238549,2932,120,3052,1.299948,103.830092
238550,2219,158,2377,1.301464,103.830806
238551,634,14,648,1.301109,103.830555
238565,75,121,196,1.301415,103.829271
238566,4,112,116,1.301293,103.829248
238567,551,203,754,1.301002,103.828757
238568,561,62,623,1.301027,103.828785
238590,708,19,727,1.295379,103.842313
238591,1204,421,1625,1.295378,103.84232
238592,299,29,328,1.295357,103.842312
238593,157,5,162,1.29538,103.842312
238594,412,15,427,1.295389,103.842347
238595,485,28,513,1.295362,103.842339
238596,340,61,401,1.295351,103.842349
238597,182,9,191,1.295354,103.842323
238598,1262,9,1271,1.295381,103.842315
238599,774,9,783,1.295385,103.842352
238619,488,417,905,1.298674,103.84149
238620,299,341,640,1.298659,103.841055
238621,433,161,594,1.298674,103.84149
238622,230,0,230,1.298659,103.841055
238623,19,1,20,1.298496,103.840916
238624,9,0,9,1.298492,103.840938
238625,43,1,44,1.298484,103.840968
238626,63,0,63,1.298471,103.841002
238627,201,14,215,1.297815,103.841013
238628,21,17,38,1.2982,103.840865
238629,2,2,4,1.297978,103.840756
238630,65,6,71,1.297755,103.840747
238631,2,20,22,1.297406,103.841058
238632,30,2,32,1.29717,103.840877
238633,53,11,64,1.29713,103.840866
238634,90,9,99,1.296995,103.840814
238635,126,55,181,1.296923,103.840821
238636,42,38,80,1.296449,103.840494
238637,4,8,12,1.296449,103.840494
238638,0,11,11,1.296775,103.840748
238639,16,0,16,1.296449,103.840494
238640,0,1,1,1.301458,103.829597
238641,1,0,1,1.296683,103.840732
238642,1,8,9,1.296601,103.840743
238643,10,0,10,1.296449,103.840494
238644,0,8,8,1.296524,103.840694
238645,18,5,23,1.296449,103.840494
238646,2,40,42,1.296511,103.840736
238647,8,6,14,1.296449,103.840494
238648,1,9,10,1.296633,103.840725
238649,14,0,14,1.296449,103.840494
238650,0,9,9,1.296605,103.840712
238651,49,809,858,1.296449,103.840494
238652,0,24,24,1.296573,103.840705
238653,45,84,129,1.296449,103.840494
238654,0,41,41,1.296495,103.840694
238655,1,13,14,1.296455,103.840701
238656,0,24,24,1.296416,103.840679
238657,0,11,11,1.296385,103.840671
238658,1,14,15,1.296277,103.840637
238659,0,8,8,1.296324,103.84065
238660,0,7,7,1.296388,103.841028
238661,1,12,13,1.296472,103.841051
238663,2,71,73,1.296303,103.840661
238664,18,4,22,1.298188,103.840892
238665,2,0,2,1.290152,103.838686
238666,2,4,6,1.29772,103.840742
238667,2,6,8,1.29768,103.840742
238668,4,12,16,1.298134,103.841329
238669,213,12,225,1.297989,103.841236
238670,5,41,46,1.297844,103.841194
238671,14,13,27,1.297586,103.841128
238672,4,2,6,1.297497,103.841095
238673,3,4,7,1.297327,103.841044
238674,6,1,7,1.299509,103.837
238675,144,34,178,1.297008,103.841021
238693,109,297,406,1.297517,103.842776
238694,0,2,2,1.298175,103.840922
238697,1421,1010,2431,1.298691,103.84236
238698,13,71,84,1.297371,103.843134
238699,9,44,53,1.297026,103.843141
238700,1,10,11,1.296979,103.843155
238701,34,170,204,1.297262,103.842897
238702,94,13,107,1.29714,103.842968
238703,44,22,66,1.297066,103.842989
238704,25,20,45,1.296972,103.843045
238705,4,49,53,1.296897,103.843076
238706,33,20,53,1.296844,103.843117
238707,61,14,75,1.296769,103.843166
238708,42,45,87,1.296722,103.843204
238709,170,755,925,1.296218,103.843625
238710,570,184,754,1.297932,103.842732
238711,499,68,567,1.297702,103.842897
238712,2121,336,2457,1.298058,103.84268
238713,690,93,783,1.298238,103.843102
238714,1210,1081,2291,1.299091,103.841614
238732,10,6,16,1.297814,103.842496
238733,27,768,795,1.29782,103.842507
238734,0,5,5,1.29782,103.842526
238735,8,627,635,1.297813,103.842522
238736,14,15,29,1.297834,103.842478
238737,3,2,5,1.29787,103.842427
238739,2,9,11,1.297874,103.842427
238740,90,2,92,1.298235,103.842142
238741,2,19,21,1.298242,103.842136
238742,5,2,7,1.298236,103.842127
238744,5,22,27,1.298225,103.842113
238747,1,2,3,1.295702,103.839045
238748,3,6,9,1.298216,103.842104
238749,6,0,6,1.298212,103.84211
238750,1,0,1,1.296449,103.840494
238751,3,115,118,1.298203,103.842126
238752,32,28,60,1.298293,103.842056
238753,4,0,4,1.298273,103.84206
238754,1,110,111,1.298257,103.842079
238755,11,0,11,1.298308,103.842034
238756,1,11,12,1.29772,103.842155
238757,2,0,2,1.297367,103.841649
238758,3,2,5,1.297711,103.842149
238759,18,14,32,1.297699,103.842144
238760,1,9,10,1.2976,103.842104
238761,0,3,3,1.29822,103.842101
238762,5,7,12,1.297584,103.842101
238763,1,0,1,1.298223,103.842113
238764,4,13,17,1.297419,103.842074
238765,3,0,3,1.297629,103.842107
238766,4,8,12,1.297432,103.842074
238767,4,3,7,1.297464,103.842079
238768,20,563,583,1.297334,103.842043
238769,28,9,37,1.297315,103.842052
238770,2,7,9,1.297346,103.842053
238772,26,32,58,1.297248,103.842048
238773,5,0,5,1.297221,103.842051
238774,3,0,3,1.297451,103.842078
238775,1,2,3,1.297159,103.842009
238776,1,2,3,1.297049,103.841872
238777,2,5,7,1.29706,103.841922
238800,6320,25843,32163,1.303257,103.833115
238801,24279,15922,40201,1.304052,103.831767
238823,43,20,63,1.307003,103.843214
238824,3689,2455,6144,1.297649,103.848116
238825,196,862,1058,1.298129,103.847651
238826,125,40,165,1.298811,103.846127
238827,5,578,583,1.299131,103.846546
238828,4,97,101,1.298813,103.846704
238829,1,66,67,1.298829,103.84667
238830,3,323,326,1.298861,103.84659
238831,2,124,126,1.298902,103.846455
238832,0,62,62,1.29892,103.8464
238833,0,149,149,1.298934,103.846355
238834,1,180,181,1.298954,103.8463
238835,2,116,118,1.298984,103.846234
238836,14,380,394,1.299011,103.846189
238837,534,1445,1979,1.299285,103.845947
238838,1092,1025,2117,1.299187,103.845897
238839,17055,103374,120429,1.301016,103.845411
238840,2716,23723,26439,1.300618,103.842224
238841,1094,22306,23400,1.301284,103.841309
238842,971,12356,13327,1.30148,103.840781
238843,5156,4822,9978,1.301949,103.839829
238845,11,4753,4764,1.301279,103.839264
238846,10,296,306,1.301292,103.839246
238847,0,477,477,1.301268,103.839288
238848,0,75,75,1.301261,103.839316
238849,0,149,149,1.30131,103.839189
238850,15,3992,4007,1.301521,103.839061
238851,239,7648,7887,1.301615,103.838784
238852,112,1746,1858,1.301679,103.838617
238853,19,486,505,1.30186,103.838486
238854,163,1185,1348,1.301895,103.838196
238855,3113,3504,6617,1.302959,103.837188
238856,27,1140,1167,1.302693,103.836805
238857,3998,7011,11009,1.302927,103.836284
238858,11617,16107,27724,1.300542,103.839192
238859,31293,33018,64311,1.30451,103.836184
238862,104,27473,27577,1.303881,103.834695
238863,8131,152262,160393,1.30436,103.833751
238864,411,784,1195,1.305029,103.833087
238865,13023,25013,38036,1.305151,103.832494
238866,44,1314,1358,1.301604,103.837772
238867,6434,108809,115243,1.30219,103.836308
238868,1297,12812,14109,1.305487,103.831573
238869,81,856,937,1.306348,103.830876
238870,227,528,755,1.306166,103.82994
238871,1272,19228,20500,1.30661,103.829563
238872,23273,4427,27700,1.30245,103.834672
238873,8342,82818,91160,1.302707,103.834289
238874,4027,8138,12165,1.302707,103.834289
238875,1558,78422,79980,1.306991,103.828903
238876,310,42183,42493,1.307196,103.828453
238877,14190,76697,90887,1.30351,103.833056
238878,647,48440,49087,1.30324,103.832318
238879,6692,13165,19857,1.307644,103.82854
238880,3520,1719,5239,1.304598,103.830326
238881,10835,12276,23111,1.305292,103.830378
238882,1508,46254,47762,1.305578,103.830139
238883,13621,20939,34560,1.30592,103.829355
238884,6822,31842,38664,1.306339,103.828639
238885,9,135,144,1.29889,103.846511
238886,3,70,73,1.298876,103.84654
238887,90,26011,26101,1.305886,103.830475
238888,12,204,216,1.299631,103.843971
238889,1974,26392,28366,1.299591,103.845234
238890,183,14862,15045,1.299591,103.845234
238891,345,1940,2285,1.299591,103.845234
238892,19,379,398,1.301824,103.837767
238895,11328,572,11900,1.301509,103.838394
238896,2267,34210,36477,1.300934,103.840008
238897,2047,4397,6444,1.302138,103.836501
238898,80,7714,7794,1.301642,103.838816
238902,12,1470,1482,1.299509,103.837
238909,240,1670,1910,1.290072,103.838529
238910,3813,12234,16047,1.291002,103.839317
238931,73,110,183,1.292305,103.837601
238932,9,164,173,1.292316,103.837717
238955,60,15,75,1.294027,103.841997
238956,322,3,325,1.293944,103.841956
238957,106,7,113,1.293911,103.841936
238958,27,12,39,1.293873,103.841921
238959,99,4,103,1.293854,103.841904
238960,104,510,614,1.293806,103.841869
238961,71,146,217,1.293754,103.841845
238962,146,361,507,1.293722,103.841814
238963,38,75,113,1.293656,103.841768
238964,11,27,38,1.293598,103.841727
238965,130,0,130,1.293572,103.841707
238966,18,0,18,1.293506,103.84166
238967,43,3,46,1.29344,103.841625
238968,204,2928,3132,1.293335,103.841547
238969,326,1,327,1.293225,103.841482
238970,3,0,3,1.297105,103.841967
238971,38,1,39,1.293156,103.841437
238972,12,3,15,1.293127,103.841408
238973,22,1187,1209,1.293068,103.841375
238974,88,115,203,1.292764,103.841134
238977,690,16160,16850,1.292359,103.840843
238993,117,2284,2401,1.291692,103.840121
238995,83,7257,7340,1.291623,103.840041
238997,324,70,394,1.291343,103.839623
238999,26,14,40,1.291305,103.839518
239001,65,0,65,1.291285,103.839442
239002,55,24,79,1.291245,103.839406
239003,110,3331,3441,1.291222,103.839355
239005,89,10031,10120,1.291202,103.839262
239006,1,2,3,1.293184,103.841459
239007,83,1737,1820,1.29142,103.840144
239010,25,0,25,1.29378,103.841853
239012,51,2,53,1.293295,103.841525
239013,2540,439,2979,1.291438,103.840551
239014,25,9,34,1.293978,103.841977
239015,56,5,61,1.291188,103.839209
239032,1002,2238,3240,1.29136,103.841946
239035,168,7070,7238,1.291378,103.841785
239058,509,9540,10049,1.291677,103.83831
239059,1357,1393,2750,1.292057,103.837929
239062,40,10254,10294,1.292395,103.837269
239063,5,225,230,1.292461,103.837218
239064,10,2434,2444,1.292539,103.837152
239065,6,1189,1195,1.292043,103.837578
239069,1,351,352,1.292506,103.837191
239070,1139,3701,4840,1.291233,103.838662
239071,50,763,813,1.292451,103.837417
239072,303,3464,3767,1.29211,103.838122
239091,1286,48,1334,1.297187,103.840424
239092,13,149,162,1.297115,103.840586
239093,102,54,156,1.296923,103.840655
239094,19,20,39,1.296961,103.840532
239095,154,9,163,1.297001,103.840479
239096,3,11,14,1.296963,103.840381
239097,15,1,16,1.297026,103.840263
239098,6,1,7,1.296973,103.840169
239099,4,11,15,1.296822,103.840377
239100,38,73,111,1.296987,103.840269
239101,15,0,15,1.297105,103.839753
239102,5,0,5,1.297105,103.839753
239103,86,368,454,1.297105,103.839753
239104,74,0,74,1.297105,103.839753
239105,5,58,63,1.297214,103.839863
239106,1050,4,1054,1.297105,103.839753
239107,74,108,182,1.297407,103.83951
239113,2,63,65,1.297969,103.839202
239114,14,180,194,1.297454,103.83911
239115,2,15,17,1.297214,103.839863
239116,1,2,3,1.291241,103.839275
239117,3,3,6,1.297214,103.839863
239118,39,12,51,1.297214,103.839863
239119,3,2,5,1.297214,103.839863
239120,15,6,21,1.297214,103.839863
239121,13,14,27,1.297214,103.839863
239122,52,13,65,1.297214,103.839863
239123,22,8,30,1.297214,103.839863
239124,10,1,11,1.297105,103.839753
239125,24,0,24,1.297105,103.839753
239126,362,20,382,1.297032,103.839527
239127,13,52,65,1.297105,103.839753
239191,1431,1736,3167,1.297333,103.833352
239192,4316,627,4943,1.297049,103.834061
239193,74,163,237,1.298136,103.834132
239194,2715,629,3344,1.298241,103.8335
239195,1577,929,2506,1.298893,103.834251
239196,26,1821,1847,1.299378,103.833005
239197,3983,1282,5265,1.299509,103.837
239198,16,101,117,1.299509,103.837
239199,31,664,695,1.299509,103.837
239219,10,689,699,1.29949,103.832269
239220,455,462,917,1.299359,103.831941
239221,4,48,52,1.299021,103.83149
239222,1029,1005,2034,1.298074,103.83148
239223,1977,597,2574,1.29872,103.831434
239224,1899,594,2493,1.298293,103.832021
239225,1719,283,2002,1.298461,103.832692
239226,215,484,699,1.298126,103.832605
239227,1021,716,1737,1.297315,103.832025
239228,2684,268,2952,1.297621,103.832718
239229,1320,1664,2984,1.296681,103.832565
239230,248,2124,2372,1.296634,103.832429
239254,0,24,24,1.300915,103.829985
239256,0,2,2,1.297687,103.842142
239260,2,2,4,1.301003,103.830067
239261,0,1,1,1.297616,103.842104
239262,1,2,3,1.297214,103.839863
239263,0,2,2,1.300942,103.830022
239264,0,1,1,1.301608,103.829917
239265,0,4,4,1.301591,103.830143
239266,0,3,3,1.301053,103.830074
239267,0,4,4,1.301575,103.830208
239268,0,1,1,1.301107,103.830088
239269,0,16,16,1.301542,103.830333
239270,0,8,8,1.301441,103.830203
239271,0,11,11,1.301565,103.830434
239272,1,7,8,1.301428,103.830287
239273,0,45,45,1.301559,103.830477
239274,0,26,26,1.301408,103.830367
239275,0,14,14,1.301537,103.830621
239276,0,22,22,1.301392,103.830438
239277,0,6,6,1.301526,103.830697
239278,0,105,105,1.301376,103.830506
239279,0,5,5,1.301533,103.830785
239280,1,26,27,1.301321,103.830618
239281,0,8,8,1.301509,103.830875
239282,1,288,289,1.301184,103.830578
239283,1,25,26,1.301319,103.830746
239284,2,4,6,1.301091,103.830545
239285,0,31,31,1.301233,103.830735
239286,0,1,1,1.301443,103.830149
239287,3,9,12,1.301136,103.830713
239288,1,1,2,1.301599,103.829994
239289,1,7,8,1.301042,103.830678
239290,0,2,2,1.300939,103.830504
239291,0,3,3,1.301157,103.830107
239292,0,6,6,1.300828,103.830407
239293,0,3,3,1.301003,103.83067
239294,4,28,32,1.300792,103.83036
239295,0,2,2,1.300875,103.830471
239296,1,11,12,1.300647,103.830386
239319,284,766,1050,1.29566,103.838819
239320,388,51,439,1.295347,103.838744
239321,27,114,141,1.295571,103.83882
239322,10,227,237,1.295505,103.83882
239323,73,5,78,1.295427,103.838823
239324,1,12,13,1.295355,103.83881
239325,4,726,730,1.294681,103.838558
239326,40,297,337,1.295233,103.838809
239328,189,323,512,1.294975,103.838826
239329,74,1,75,1.294448,103.838853
239330,4,9,13,1.294565,103.838204
239331,113,272,385,1.29423,103.838892
239332,1052,8,1060,1.293784,103.839267
239333,1350,3,1353,1.293976,103.839707
239334,18,4,22,1.293832,103.839129
239335,1,41,42,1.294565,103.838204
239336,17,1848,1865,1.293697,103.839264
239337,3,13,16,1.294565,103.838204
239338,9,24,33,1.293572,103.839389
239342,7,1609,1616,1.294565,103.838204
239343,21,1025,1046,1.293493,103.839534
239344,4,81,85,1.293429,103.839586
239345,15,52,67,1.293395,103.839634
239346,41,41,82,1.29334,103.83969
239347,1841,1255,3096,1.293698,103.839107
239348,4,55,59,1.293311,103.839729
239350,11,86,97,1.293255,103.839767
239351,3519,1499,5018,1.292233,103.838963
239352,27,78,105,1.29321,103.8398
239353,52,115,167,1.293179,103.83982
239354,8,123,131,1.293137,103.839864
239355,11,118,129,1.293073,103.83991
239356,47,36,83,1.292965,103.840014
239357,29,114,143,1.293202,103.839554
239358,31,195,226,1.293018,103.839971
239359,156,82,238,1.292865,103.839773
239360,4,134,138,1.292872,103.84014
239361,14,28,42,1.292836,103.839832
239362,0,47,47,1.292903,103.8401
239363,9,20,29,1.292802,103.839928
239364,3,109,112,1.292848,103.84016
239365,3,92,95,1.292833,103.839893
239366,2,92,94,1.2928,103.840205
239367,2,89,91,1.292777,103.840239
239368,10,114,124,1.292744,103.840263
239369,5,67,72,1.292725,103.840294
239370,16,44,60,1.292674,103.840313
239371,6,51,57,1.292657,103.840339
239372,12,39,51,1.292594,103.840391
239374,2,79,81,1.292503,103.840487
239375,193,10177,10370,1.292277,103.840464
239376,1,19,20,1.29246,103.840524
239378,14,66,80,1.292427,103.840563
239381,165,509,674,1.292867,103.839874
239403,5099,4303,9402,1.294928,103.831274
239404,7086,1359,8445,1.294688,103.831787
239426,2844,2870,5714,1.291684,103.833937
239427,2088,271,2359,1.292867,103.833334
239428,28,1134,1162,1.293088,103.833278
239429,26,1010,1036,1.293186,103.833385
239430,2,53,55,1.293183,103.833199
239431,6,144,150,1.293296,103.833202
239432,1301,140,1441,1.293244,103.833239
239433,30,460,490,1.294104,103.833056
239434,971,12841,13812,1.294408,103.832447
239435,1956,9741,11697,1.29437,103.832437
239438,3,268,271,1.293512,103.832868
239439,3,202,205,1.293512,103.832868
239440,0,15,15,1.293512,103.832868
239441,0,40,40,1.293512,103.832868
239442,1,41,42,1.293512,103.832868
239443,19,426,445,1.293512,103.832868
239444,5,50,55,1.293512,103.832868
239445,11,394,405,1.293512,103.832868
239446,0,64,64,1.293512,103.832868
239447,2,529,531,1.293512,103.832868
239448,0,88,88,1.293512,103.832868
239449,4,375,379,1.293512,103.832868
239450,2,154,156,1.293512,103.832868
239451,6,305,311,1.293512,103.832868
239452,0,232,232,1.293512,103.832868
239453,106,9594,9700,1.293512,103.832868
239471,2267,14,2281,1.295549,103.831967
239495,133,574,707,1.295698,103.831663
239496,2901,3968,6869,1.295549,103.831967
239497,1963,12422,14385,1.291076,103.834437
239498,29,13951,13980,1.299509,103.837
239518,501,15610,16111,1.300239,103.840721
239519,276,1029,1305,1.299637,103.840002
239520,44,1947,1991,1.299052,103.839639
239521,165,1078,1243,1.29899,103.839597
239522,20,1295,1315,1.298951,103.839562
239523,10,350,360,1.298924,103.83954
239524,12,629,641,1.298901,103.839518
239525,48,572,620,1.298879,103.839498
239526,21,320,341,1.29885,103.839464
239527,21,454,475,1.298821,103.839428
239528,11,179,190,1.298793,103.839396
239529,37,1267,1304,1.298767,103.839367
239530,11,1397,1408,1.29859,103.839187
239531,24,583,607,1.298557,103.839154
239532,14,503,517,1.298526,103.839141
239533,9,149,158,1.298505,103.839121
239534,25,300,325,1.298484,103.839097
239535,10,30,40,1.29846,103.839075
239536,66,670,736,1.298438,103.839057
239537,87,426,513,1.298416,103.839032
239538,17,559,576,1.298384,103.839001
239539,78,1097,1175,1.298352,103.838985
239540,4,1,5,1.298424,103.839043
239541,0,1,1,1.30102,103.830533
239542,3,3,6,1.29835,103.83918
239543,1,1,2,1.300837,103.830626
239544,77,352,429,1.298255,103.838914
239546,19,263,282,1.298196,103.838878
239547,20,279,299,1.298151,103.838842
239548,21,326,347,1.2981,103.838806
239549,191,1125,1316,1.298169,103.838705
239550,104,447,551,1.298063,103.83877
239551,145,7,152,1.298089,103.838587
239553,44,737,781,1.297999,103.838721
239554,158,2094,2252,1.297956,103.83868
239555,430,13,443,1.297956,103.838544
239556,2,51,53,1.297929,103.838512
239557,3,3,6,1.297904,103.83848
239558,49,2099,2148,1.297882,103.838463
239559,12,530,542,1.297832,103.838423
239560,9,502,511,1.297809,103.83839
239561,49,2118,2167,1.297734,103.838348
239562,212,5280,5492,1.297621,103.838247
239563,11,2630,2641,1.299509,103.837
239564,4,159,163,1.300062,103.835962
239565,1492,178,1670,1.296527,103.838684
239566,1193,19,1212,1.296849,103.837996
239568,960,4473,5433,1.296123,103.836801
239569,1158,1091,2249,1.296166,103.837543
239570,12,915,927,1.296904,103.837465
239571,2551,4925,7476,1.297592,103.838707
239572,21,514,535,1.29908,103.839647
239573,362,20,382,1.297046,103.838357
239616,919,136,1055,1.295647,103.842986
239617,1078,29,1107,1.295647,103.842986
239618,891,84,975,1.294577,103.842388
239619,1057,10,1067,1.294615,103.842391
239620,1005,10,1015,1.294582,103.84239
239621,86,251,337,1.294843,103.842587
239639,1151,1014,2165,1.295527,103.835724
239664,32,154,186,1.295092,103.839455
239665,54,69,123,1.295118,103.839622
239666,104,668,772,1.295166,103.839421
239667,4,291,295,1.295175,103.839511
239668,2,63,65,1.295116,103.839546
239669,225,41,266,1.295284,103.839929
239670,32,260,292,1.295241,103.839919
239671,134,149,283,1.295394,103.840002
239693,379,14382,14761,1.30142,103.837238
239694,48,696,744,1.299885,103.835397
239695,1086,25935,27021,1.301555,103.83666
239696,81,7,88,1.297827,103.834701
239697,18,0,18,1.297827,103.834701
239698,12,0,12,1.297827,103.834701
239699,4,162,166,1.299079,103.835468
239700,1195,2243,3438,1.29988,103.83484
239701,12,209,221,1.299509,103.837
239702,729,2050,2779,1.299463,103.834124
239703,3,233,236,1.29965,103.83195
239704,283,493,776,1.299598,103.831607
239705,3,168,171,1.299556,103.831246
239706,6,205,211,1.299505,103.830601
239708,1,16,17,1.299509,103.837
239709,5,1276,1281,1.299509,103.837
239710,0,114,114,1.299509,103.837
239711,34,917,951,1.299509,103.837
239712,63,7795,7858,1.299509,103.837
239732,4290,11632,15922,1.299364,103.838481
239733,148,23771,23919,1.299331,103.838526
239734,88,135,223,1.299151,103.838507
239756,50,21,71,1.299127,103.840536
239757,14,0,14,1.299203,103.840257
239758,23,7,30,1.299132,103.840452
239759,13,0,13,1.299132,103.840421
239760,5,16,21,1.299127,103.840391
239761,17,0,17,1.299123,103.840361
239762,5,0,5,1.299132,103.840499
239786,104,7,111,1.298673,103.839361
239788,2,35,37,1.298546,103.83966
239789,26,1,27,1.298609,103.839629
239790,1,2,3,1.300952,103.830664
239791,0,10,10,1.298638,103.839422
239792,1,0,1,1.298265,103.839141
239793,6,3,9,1.298609,103.839629
239794,1,2,3,1.298609,103.839629
239795,0,28,28,1.298614,103.839462
239796,3,3,6,1.298659,103.840027
239797,4,2,6,1.298658,103.840026
239798,3,0,3,1.298609,103.839629
239799,2,0,2,1.298288,103.839153
239800,1,3,4,1.298534,103.839958
239801,2,43,45,1.298534,103.839958
239802,39,7,46,1.298524,103.839945
239803,10,2,12,1.298573,103.839578
239804,106,26,132,1.298214,103.840273
239805,96,1,97,1.298541,103.839635
239806,14,0,14,1.298243,103.840229
239807,2,16,18,1.298509,103.839691
239808,18,0,18,1.298238,103.840246
239809,34,2,36,1.298478,103.839747
239810,3,1,4,1.298446,103.839804
239811,12,3,15,1.298414,103.83986
239812,3,23,26,1.298398,103.839892
239813,1,1,2,1.298535,103.839959
239814,0,1,1,1.298589,103.839947
239815,3,21,24,1.298316,103.840049
239816,7,20,27,1.298284,103.840112
239817,16,0,16,1.298251,103.840175
239818,4,3,7,1.298218,103.840238
239819,44,0,44,1.298186,103.840301
239820,2,2,4,1.298153,103.840364
239844,15,201,216,1.297836,103.838069
239845,1,10,11,1.297868,103.838075
239846,0,11,11,1.2979,103.838038
239847,61,337,398,1.298045,103.838006
239848,197,47,244,1.297841,103.837581
239849,280,47,327,1.298021,103.837543
239850,237,169,406,1.298279,103.837956
239851,11,192,203,1.298258,103.837831
239852,5,94,99,1.298432,103.837765
239853,1,105,106,1.298485,103.837748
239854,3,101,104,1.298585,103.83776
239855,750,1488,2238,1.298904,103.837628
239856,59,79,138,1.298852,103.837645
239864,2524,1157,3681,1.299509,103.837
239877,58,2545,2603,1.299711,103.836699
239878,54,75,129,1.299698,103.836681
239879,1,37,38,1.29968,103.836667
239880,5,38,43,1.299665,103.836654
239881,8,177,185,1.299655,103.836644
239882,34,13,47,1.299639,103.836633
239883,17,227,244,1.299628,103.836619
239884,8,44,52,1.299611,103.836607
239885,2,77,79,1.299602,103.836598
239886,40,88,128,1.299588,103.836589
239887,6,94,100,1.299575,103.836578
239888,35,104,139,1.299564,103.836572
239889,0,77,77,1.299553,103.836563
239890,1,82,83,1.299844,103.836017
239891,2,28,30,1.299857,103.835968
239892,3,785,788,1.299868,103.835956
239893,198,75,273,1.299452,103.836429
239894,618,16,634,1.299439,103.836523
239895,263,1240,1503,1.297779,103.837966
239896,3401,199,3600,1.297558,103.838017
239897,1136,274,1410,1.298324,103.836728
239899,1258,11,1269,1.298929,103.83703
239900,655,90,745,1.298982,103.837025
239917,617,4635,5252,1.292157,103.842684
239918,4351,2844,7195,1.292181,103.842695
239919,17,0,17,1.292009,103.842924
239920,2560,8470,11030,1.292809,103.842937
239922,1581,757,2338,1.297183,103.844086
239923,63,406,469,1.297724,103.844058
239924,702,2347,3049,1.298146,103.844158
239926,257,1181,1438,1.296883,103.844109
239927,49,1095,1144,1.299509,103.837
239928,14,1683,1697,1.299509,103.837
239948,1,20,21,1.29171,103.838521
239949,2110,942,3052,1.291876,103.838964
239972,7,27,34,1.302916,103.828997
239974,260,729,989,1.303352,103.829415
239975,418,151,569,1.303237,103.829414
239977,344,89,433,1.302506,103.829456
247656,67,44,111,1.299509,103.837
247661,42,93,135,1.304944,103.808419
247662,23,0,23,1.304944,103.808419
247663,7,0,7,1.304944,103.808419
247664,34,0,34,1.304944,103.808419
247665,26,0,26,1.304944,103.808419
247671,399,187,586,1.295269,103.814753
247672,397,151,548,1.295224,103.814078
247674,69,39,108,1.294736,103.815106
247675,3,16,19,1.294515,103.81496
247676,919,75,994,1.298538,103.824511
247677,55,3,58,1.299509,103.837
247678,16,10,26,1.299509,103.837
247681,19,209,228,1.309061,103.803536
247682,13,5,18,1.309437,103.80384
247683,28,1,29,1.308801,103.803829
247685,24,0,24,1.30911,103.804202
247686,11,28,39,1.309026,103.804164
247687,202,24,226,1.309953,103.804566
247688,6,11,17,1.299509,103.837
247689,29,0,29,1.299509,103.837
247692,133,55,188,1.305524,103.81169
247693,256,142,398,1.305446,103.811494
247694,548,419,967,1.304839,103.810394
247695,644,49,693,1.305222,103.811102
247696,2998,4991,7989,1.30438,103.809388
247697,1776,573,2349,1.303705,103.809825
247698,1397,5208,6605,1.303031,103.809885
247700,3931,0,3931,1.303471,103.810325
247704,10,0,10,1.309869,103.804548
247705,52,6,58,1.309911,103.804567
247706,18,484,502,1.310035,103.804409
247707,13,35,48,1.310059,103.804238
247708,0,1,1,1.298349,103.839986
247709,17,4,21,1.309928,103.803949
247710,579,4,583,1.296478,103.819261
247711,8,11,19,1.296932,103.81968
247712,29,0,29,1.297798,103.819589
247713,42,0,42,1.298235,103.819405
247714,13,2,15,1.295776,103.818993
247715,62,8,70,1.29751,103.819315
247716,21,16,37,1.29769,103.819256
247717,3,0,3,1.298658,103.840026
247718,23,1,24,1.296331,103.819216
247719,0,1,1,1.310047,103.804176
247720,0,4,4,1.296944,103.819358
247722,27,28,55,1.297908,103.819147
247725,3,0,3,1.298034,103.819143
247726,21,14,35,1.297425,103.81985
247727,67,0,67,1.297704,103.819694
247728,5,2,7,1.295504,103.818838
247729,1452,20343,21795,1.30366,103.824137
247730,93,109,202,1.294715,103.830407
247731,146,1087,1233,1.294596,103.830385
247732,10,1663,1673,1.294378,103.830714
247733,23,215,238,1.294309,103.830755
247734,4,86,90,1.294243,103.830766
247735,7,313,320,1.294168,103.83081
247736,8,174,182,1.294116,103.830821
247766,7,269,276,1.29355,103.830894
247767,15,256,271,1.293953,103.83089
247768,6,606,612,1.293769,103.830956
247769,2,1173,1175,1.293896,103.830926
247770,27,4038,4065,1.293733,103.830945
247771,13,3751,3764,1.293661,103.830992
247772,27,6585,6612,1.29359,103.831011
247773,23,2201,2224,1.293499,103.831058
247774,96,1163,1259,1.293714,103.830978
247775,11,348,359,1.293405,103.83108
247776,13,303,316,1.29335,103.831105
247777,10,575,585,1.293306,103.831102
247778,15,705,720,1.293019,103.830962
247779,50,354,404,1.293078,103.831162
247780,18,394,412,1.29286,103.830993
247781,428,1269,1697,1.292829,103.831017
247782,1,37,38,1.291723,103.831939
247783,3,39,42,1.29296,103.831223
247784,1,45,46,1.291723,103.831939
247785,694,44,738,1.292591,103.83088
247786,1,21,22,1.291723,103.831939
247787,3,23,26,1.292591,103.83088
247788,0,14,14,1.291723,103.831939
247789,1,29,30,1.292591,103.83088
247790,0,53,53,1.291723,103.831939
247791,1,30,31,1.292591,103.83088
247792,135,1257,1392,1.292393,103.830962
247811,376,62,438,1.293032,103.830817
247813,786,248,1034,1.293045,103.830436
247854,1131,1024,2155,1.302652,103.826027
247855,877,409,1286,1.303028,103.827073
247856,1216,253,1469,1.302391,103.826298
247857,471,1854,2325,1.304313,103.825662
247876,21,13,34,1.302101,103.816876
247877,7,1,8,1.302126,103.81686
247878,163,3,166,1.302175,103.816888
247879,107,0,107,1.302261,103.816931
247880,47,1,48,1.302332,103.816971
247881,7,2,9,1.302412,103.817016
247882,13,0,13,1.302475,103.817051
247883,18,0,18,1.302555,103.817099
247884,18,1,19,1.302621,103.817142
247904,11,22,33,1.299509,103.837
247905,2791,13621,16412,1.306884,103.827365
247908,60,3155,3215,1.30651,103.826244
247909,3195,21836,25031,1.306364,103.827018
247910,22,2326,2348,1.306352,103.826383
247911,4428,606,5034,1.305978,103.825884
247912,2925,20856,23781,1.304998,103.825894
247913,3732,1643,5375,1.305591,103.826598
247914,16,4280,4296,1.306061,103.825955
247915,36,19602,19638,1.305863,103.825652
247917,12,3393,3405,1.305652,103.825347
247918,119,11369,11488,1.305285,103.824945
247919,546,3806,4352,1.304315,103.821339
247920,4,18,22,1.305306,103.82464
247921,7,1074,1081,1.305309,103.82467
247923,6,224,230,1.305294,103.824604
247924,6,0,6,1.305288,103.82459
247925,7,189,196,1.305284,103.824576
247926,1,2,3,1.298044,103.819153
247927,4,348,352,1.305274,103.824549
247928,2,2,4,1.30527,103.824535
247929,8,106,114,1.305266,103.824522
247930,4,2,6,1.305261,103.824509
247931,208,53179,53387,1.305257,103.824495
247933,6073,238,6311,1.304713,103.823345
247936,16,61,77,1.30376,103.821897
247937,5,125,130,1.303718,103.821881
247938,5,226,231,1.303011,103.821162
247939,35,249,284,1.302918,103.820949
247940,1,0,1,1.296731,103.819351
247942,0,4,4,1.302778,103.820626
247944,3,0,3,1.305279,103.824562
247946,25,83,108,1.302699,103.820445
247947,54,224,278,1.302583,103.820192
247948,1,7,8,1.302426,103.819917
247949,1,0,1,1.302866,103.820817
247950,3,88,91,1.301276,103.81845
247951,5,781,786,1.300521,103.818811
247952,2,1,3,1.302698,103.820444
247953,13,517,530,1.300051,103.817483
247954,10,304,314,1.299208,103.817261
247955,101,10,111,1.297186,103.818022
247956,4,30,34,1.297065,103.816793
247957,1,0,1,1.301791,103.819348
247958,1,0,1,1.298146,103.818298
247959,41,2083,2124,1.294815,103.816354
247960,218,2569,2787,1.294246,103.816321
247961,793,47,840,1.293338,103.817566
247964,983,1128,2111,1.305459,103.822829
247965,1141,1045,2186,1.292103,103.815829
247966,875,891,1766,1.29199,103.816553
247967,40,0,40,1.29228,103.815807
247968,5,2668,2673,1.303339,103.821698
247969,174,351,525,1.303144,103.820684
247970,128,1054,1182,1.29786,103.816792
247971,342,67,409,1.297456,103.815983
247972,526,103,629,1.297329,103.814943
247973,1155,283,1438,1.297234,103.81443
247974,208,70,278,1.297722,103.814598
247975,425,6,431,1.298561,103.814719
247976,238,216,454,1.297916,103.815007
247977,426,191,617,1.297526,103.815309
247978,87,134,221,1.298837,103.81603
247979,771,92,863,1.297893,103.81569
247980,230,112,342,1.298467,103.816559
247982,38,196,234,1.298291,103.814998
247983,34,56,90,1.301676,103.817465
247984,58,83,141,1.30164,103.817675
247985,113,1,114,1.301777,103.817603
247986,11,4,15,1.301706,103.817712
247987,28,26,54,1.301851,103.817635
247988,47,0,47,1.301772,103.817749
247989,164,3,167,1.301908,103.817686
247990,86,4,90,1.301837,103.817792
247991,12,19,31,1.301977,103.817726
247992,21,5,26,1.301897,103.817829
247993,44,0,44,1.302045,103.817769
247994,61,6,67,1.301972,103.817866
247995,81,8,89,1.302029,103.817906
247996,20,8,28,1.302117,103.817809
247997,53,7,60,1.302097,103.817934
247998,9,3,12,1.302185,103.81782
248018,575,55,630,1.30127,103.817666
248019,7,52,59,1.301519,103.817213
248020,1,1,2,1.298381,103.839923
248021,0,1,1,1.296077,103.818198
248022,15,0,15,1.301672,103.816864
248023,10,0,10,1.301672,103.816864
248024,2,5,7,1.301858,103.816275
248025,62,0,62,1.301597,103.816179
248026,4,0,4,1.301295,103.816073
248027,2,0,2,1.301519,103.817213
248028,23,3,26,1.301496,103.815985
248029,3,0,3,1.300692,103.817853
248030,21,0,21,1.301337,103.817839
248031,52,5,57,1.30228,103.816376
248032,2,8,10,1.302323,103.816569
248033,47,1,48,1.302634,103.816696
248034,2,4,6,1.302722,103.816593
248035,11,3,14,1.302685,103.816493
248036,0,2,2,1.30128,103.815947
248037,33,0,33,1.302894,103.815667
248038,45,22,67,1.303211,103.815711
248039,5,1,6,1.303199,103.815612
248040,28,4,32,1.302883,103.815583
248041,3,2,5,1.302578,103.815535
248042,1,1,2,1.302666,103.815649
248047,7,2,9,1.302333,103.815563
248048,15,0,15,1.301734,103.815455
248049,8,4,12,1.30211,103.815432
248050,13,27,40,1.301709,103.814941
248051,7,2,9,1.301519,103.81461
248052,4,23,27,1.300947,103.814978
248053,0,1,1,1.301519,103.817213
248054,223,3,226,1.301485,103.814531
248055,0,3,3,1.301799,103.816102
248057,2,3,5,1.303285,103.815107
248058,1,7,8,1.303243,103.814766
248059,0,9,9,1.303138,103.814495
248060,2,3,5,1.302976,103.814294
248061,1,0,1,1.301518,103.814609
248072,2,1,3,1.30235,103.815443
248073,4,0,4,1.306446,103.805991
248074,199,0,199,1.30634,103.805963
248075,22,10,32,1.306101,103.805244
248076,9,0,9,1.305784,103.806381
248077,14,13,27,1.30604,103.805808
248078,4,0,4,1.305884,103.805763
248079,12,0,12,1.305297,103.806356
248080,3,10,13,1.305768,103.805207
248081,14,0,14,1.305814,103.804855
248083,2,4,6,1.304977,103.80575
248084,4,1,5,1.30486,103.806153
248085,39,2,41,1.305389,103.805069
248086,5,11,16,1.305255,103.805436
248087,15,4,19,1.30515,103.805408
248088,5,0,5,1.305033,103.805375
248089,19,13,32,1.30509,103.80553
248090,98,2,100,1.304983,103.805597
248091,46,19,65,1.304483,103.805212
248092,62,0,62,1.304346,103.805407
248093,6,1,7,1.303896,103.805664
248094,5,1,6,1.30437,103.804626
248096,2,2,4,1.303636,103.805326
248097,64,0,64,1.303635,103.805325
248098,13,17,30,1.303626,103.805316
248099,7,10,17,1.303378,103.805425
248100,1,0,1,1.302795,103.814532
248101,11,0,11,1.303535,103.805054
248102,5,4,9,1.302789,103.806234
248103,3,1,4,1.302798,103.806624
248105,262,27,289,1.302181,103.806888
248106,9,7,16,1.303378,103.805405
248107,24,0,24,1.302708,103.805861
248108,3,1,4,1.30296,103.805678
248109,98,7,105,1.302455,103.806
248110,15,1,16,1.303378,103.805405
248111,6,0,6,1.302249,103.805567
248112,3,9,12,1.301861,103.805919
248113,13,2,15,1.300489,103.80578
248114,50,9,59,1.299884,103.806939
248115,40,6,46,1.301196,103.806054
248116,82,6,88,1.300178,103.806088
248117,56,16,72,1.306201,103.805902
248118,10,26,36,1.303557,103.8048
248119,4,0,4,1.303726,103.804482
248121,17,0,17,1.303444,103.804773
248122,61,0,61,1.302801,103.805245
248125,7,2,9,1.30227,103.805781
248126,27,50,77,1.301215,103.806053
248128,400,43,443,1.301205,103.806063
248129,145,2,147,1.301568,103.806991
248130,60,0,60,1.301122,103.807187
248131,274,0,274,1.30122,103.806863
248132,4,0,4,1.303355,103.805553
248133,17,0,17,1.299509,103.837
248134,11,1,12,1.300278,103.807027
248135,21,0,21,1.30057,103.806963
248136,9,0,9,1.300684,103.806826
248138,2,0,2,1.302576,103.814026
248139,10,12,22,1.300694,103.806836
248140,10,3,13,1.299984,103.806984
248157,5,0,5,1.303412,103.8198
248158,2,0,2,1.299884,103.806939
248159,0,3,3,1.306821,103.806074
248160,4,2,6,1.304238,103.819569
248162,5,2,7,1.303236,103.819925
248163,6551,22,6573,1.304644,103.818323
248180,646,144,790,1.294811,103.827709
248184,755,343,1098,1.295176,103.827696
248185,122,98,220,1.295067,103.827447
248191,197,35,232,1.295668,103.827174
248196,450,44,494,1.295607,103.827424
248201,1501,104,1605,1.296147,103.827029
248204,2,40,42,1.296273,103.827299
248205,0,30,30,1.295797,103.827016
248207,2,57,59,1.295972,103.826915
248209,855,45,900,1.2948,103.827872
248228,4,120,124,1.302115,103.822968
248229,15,84,99,1.30237,103.823032
248230,4,16,20,1.302886,103.822735
248231,58,5,63,1.303146,103.82242
248232,40,51,91,1.301938,103.82275
248233,25,0,25,1.301645,103.822489
248234,1,0,1,1.302978,103.806083
248235,9,27,36,1.302006,103.822636
248237,51,39,90,1.302524,103.821796
248238,1,1,2,1.303622,103.819644
248239,61,2,63,1.301808,103.822172
248240,3,20,23,1.301997,103.821958
248241,9,0,9,1.30265,103.82188
248242,11,21,32,1.301704,103.822136
248243,17,1,18,1.301867,103.821923
248244,54,27,81,1.302026,103.82154
248245,345,38,383,1.30233,103.821469
248246,10,10,20,1.301394,103.822138
248247,33,0,33,1.301277,103.821665
248248,23,0,23,1.300855,103.821429
248249,133,5,138,1.301437,103.821242
248250,14,0,14,1.301406,103.821246
248251,27,11,38,1.301531,103.821026
248252,2,0,2,1.301455,103.82222
248253,3,1,4,1.302104,103.821077
248255,5,0,5,1.302133,103.820721
248256,9,2,11,1.301804,103.820169
248257,123,11,134,1.302061,103.820467
248258,63,0,63,1.301891,103.819955
248259,11,86,97,1.30194,103.819786
248260,11,4,15,1.302915,103.822188
248261,26,1,27,1.302611,103.822353
248262,0,7,7,1.302137,103.822756
248263,43,4,47,1.301238,103.822022
248264,60,1,61,1.301212,103.821972
248265,35,0,35,1.300951,103.822491
248266,15,503,518,1.302124,103.820079
248279,43,452,495,1.295936,103.830685
248280,18,428,446,1.295912,103.830543
248281,13,80,93,1.295918,103.830467
248282,13,483,496,1.295864,103.830412
248289,852,23,875,1.295587,103.829337
248290,113,4169,4282,1.295566,103.829463
248291,59,3280,3339,1.299509,103.837
248292,30,1287,1317,1.295542,103.830252
248293,4,149,153,1.299509,103.837
248294,3,50,53,1.299509,103.837
248295,63,775,838,1.295521,103.830204
248296,48,46,94,1.295248,103.829089
248297,3,3927,3930,1.295247,103.829088
248298,3,0,3,1.303592,103.819753
248299,2,4,6,1.295491,103.830146
248300,1,394,395,1.295219,103.829046
248301,25,1085,1110,1.295485,103.830119
248302,0,439,439,1.295163,103.82896
248303,17,785,802,1.295464,103.830053
248304,3,655,658,1.295106,103.828873
248305,44,2654,2698,1.295425,103.829959
248306,643,62,705,1.29505,103.828787
248307,104,120,224,1.295418,103.829914
248308,3,57,60,1.294993,103.828701
248309,120,2943,3063,1.2954,103.829868
248310,0,6,6,1.294937,103.828615
248311,4,783,787,1.295385,103.829805
248312,1,305,306,1.29488,103.828528
248313,0,58,58,1.294827,103.828401
248314,330,937,1267,1.295342,103.829664
248315,1,810,811,1.294824,103.828442
248316,37,979,1016,1.295335,103.829635
248317,0,85,85,1.294767,103.828356
248318,25,779,804,1.295308,103.82958
248319,7,748,755,1.294711,103.82827
248320,13,691,704,1.295293,103.829518
248321,0,12,12,1.294654,103.828183
248322,4,103,107,1.295272,103.829476
248323,12,2975,2987,1.294598,103.828097
248324,98,217,315,1.295251,103.829418
248326,76,2919,2995,1.295226,103.829371
248327,147,3927,4074,1.294531,103.828001
248328,58,664,722,1.295197,103.829315
248329,8,1060,1068,1.295129,103.829141
248330,0,6,6,1.294092,103.827292
248331,6,1128,1134,1.295109,103.829111
248332,5,327,332,1.295068,103.829051
248333,6,865,871,1.295028,103.828991
248334,2,144,146,1.294987,103.828931
248335,4,347,351,1.294947,103.828872
248336,0,96,96,1.294907,103.828812
248337,4,293,297,1.294866,103.828752
248338,3,63,66,1.294826,103.828692
248339,4,219,223,1.294786,103.828632
248340,4,311,315,1.294745,103.828572
248341,3,79,82,1.294705,103.828512
248342,90,3400,3490,1.294048,103.827094
248343,8,48,56,1.294664,103.828452
248344,28,1814,1842,1.294624,103.828392
248345,26,3333,3359,1.29383,103.826981
248346,331,254,585,1.294584,103.828333
248347,44,151,195,1.293769,103.82687
248348,251,0,251,1.294543,103.828273
248349,15,3341,3356,1.293722,103.826821
248350,480,0,480,1.294503,103.828213
248351,3,293,296,1.293681,103.826777
248352,365,131,496,1.294462,103.828153
248353,74,4427,4501,1.293651,103.826708
248354,318,1,319,1.294422,103.828093
248355,3,377,380,1.293612,103.82667
248356,156,0,156,1.29448,103.828188
248357,81,1553,1634,1.293571,103.826628
248358,2211,2612,4823,1.293385,103.82792
248359,5,243,248,1.293525,103.826587
248360,3201,408,3609,1.293932,103.828699
248361,26,851,877,1.293496,103.826507
248362,2868,638,3506,1.293777,103.829308
248363,0,78,78,1.293452,103.826424
248364,3224,733,3957,1.293033,103.829505
248365,18,1344,1362,1.293397,103.826353
248366,74,483,557,1.293115,103.829121
248367,3,17,20,1.293309,103.826248
248368,4654,382,5036,1.293167,103.828573
248369,61,1695,1756,1.293353,103.826273
248370,23,2866,2889,1.293279,103.82622
248371,4640,5586,10226,1.293043,103.826933
248372,10733,460,11193,1.293071,103.827092
248373,717,0,717,1.293086,103.827064
248390,1,0,1,1.301469,103.82232
248391,11,0,11,1.304522,103.820521
248411,37,31,68,1.306694,103.806972
248412,9,4,13,1.306733,103.806758
248413,17,2,19,1.306116,103.806694
248416,47,18,65,1.306414,103.805483
248417,35,5,40,1.306062,103.804941
248418,30,5,35,1.306596,103.804677
248419,8,0,8,1.306157,103.804646
248421,37,21,58,1.306347,103.804286
248422,57,6,63,1.306063,103.80333
248423,1,5,6,1.3064,103.803963
248424,0,7,7,1.306362,103.803286
248425,18,4,22,1.306362,103.803286
248426,24,0,24,1.305731,103.803824
248427,63,404,467,1.305479,103.802584
248428,4,0,4,1.304414,103.804319
248429,113,10,123,1.306236,103.802691
248430,32,19,51,1.306787,103.802848
248431,46,5,51,1.303769,103.804056
248432,22,3,25,1.305327,103.803219
248433,6,1,7,1.305125,103.802755
248434,18,15,33,1.304894,103.803235
248435,41,6,47,1.304777,103.802714
248436,30,1,31,1.303442,103.803272
248437,37,2,39,1.303472,103.802669
248438,22,4,26,1.302922,103.803867
248439,2,0,2,1.301595,103.820687
248440,62,15,77,1.302619,103.803214
248441,15,1,16,1.302423,103.803854
248442,646,7,653,1.302771,103.802825
248443,45,5,50,1.302866,103.804482
248444,157,6,163,1.3016,103.804279
248445,51,2,53,1.300853,103.805046
248446,31,2,33,1.302979,103.80487
248447,28,3,31,1.302647,103.804833
248448,2,0,2,1.302922,103.803867
248449,29,0,29,1.300456,103.805434
248450,12,10,22,1.302422,103.803853
248451,1,8,9,1.299509,103.837
248452,5,37,42,1.299509,103.837
248466,388,895,1283,1.300219,103.816147
248467,1137,611,1748,1.300414,103.817111
248468,633,1052,1685,1.300414,103.817111
248469,635,393,1028,1.299617,103.81698
248470,6,352,358,1.300841,103.817006
248471,1005,131,1136,1.299103,103.816825
248472,44,13,57,1.299199,103.815614
248473,1724,63,1787,1.299293,103.816085
248474,1577,253,1830,1.299431,103.816543
248475,8,247,255,1.30058,103.815793
248476,2190,113,2303,1.299809,103.816555
248477,1231,21,1252,1.300428,103.81618
248478,1212,193,1405,1.299703,103.815533
248479,594,55,649,1.299708,103.81527
248480,265,248,513,1.300233,103.81552
248481,45,12,57,1.299597,103.814722
248482,90,24,114,1.299231,103.813914
248483,57,8,65,1.298644,103.814499
248484,99,9,108,1.298655,103.813846
248485,39,1,40,1.297451,103.814046
248486,1,2,3,1.295247,103.829088
248487,95,6,101,1.29832,103.813018
248488,103,33,136,1.300433,103.814665
248489,0,1,1,1.304559,103.820455
248490,142,6,148,1.300007,103.813889
248491,81,8,89,1.299703,103.813223
248492,30,29,59,1.300904,103.814093
248493,137,47,184,1.300994,103.813573
248494,59,38,97,1.300822,103.815145
248495,2,0,2,1.302378,103.804911
248496,4,36,40,1.301136,103.814181
248497,20,1,21,1.301356,103.814165
248498,68,0,68,1.301428,103.814069
248500,53,19,72,1.300705,103.812997
248501,80,7,87,1.300262,103.812637
248502,21,3,24,1.300262,103.812637
248503,22,26,48,1.299611,103.812321
248504,175,12,187,1.299274,103.812658
248505,52,4,56,1.298797,103.811998
248506,20,0,20,1.298443,103.812455
248507,2,100,102,1.300546,103.816361
248527,27,3,30,1.305696,103.806945
248528,3,0,3,1.298556,103.813022
248529,12,0,12,1.30544,103.80744
248530,140,67,207,1.304893,103.807008
248531,10,16,26,1.304323,103.807104
248532,12,10,22,1.304045,103.807092
248533,124,5,129,1.303949,103.807105
248534,43,8,51,1.303319,103.807411
248536,26,0,26,1.302425,103.807261
248537,22,20,42,1.302066,103.808195
248538,13,2,15,1.301973,103.808272
248539,29,20,49,1.301823,103.807597
248540,115,15,130,1.30176,103.807463
248541,3,14,17,1.301602,103.807439
248542,60,9,69,1.301732,103.807683
248543,84,15,99,1.301802,103.807924
248551,2,0,2,1.301302,103.815165
248552,5,1,6,1.300702,103.808515
248554,192,3,195,1.307222,103.80841
248558,195,10,205,1.304401,103.80655
248559,101,17,118,1.304391,103.806975
248560,33,18,51,1.303674,103.806759
248561,25,1,26,1.304427,103.80679
248562,24,2,26,1.303503,103.806477
248563,7,7,14,1.304452,103.806583
248564,79,9,88,1.303027,103.806793
248565,8,1,9,1.304466,103.806406
248566,33,0,33,1.304378,103.806246
248567,57,0,57,1.304113,103.806163
248568,16,0,16,1.303272,103.806357
248569,6,0,6,1.303052,103.806485
248570,3,1,4,1.302687,103.80695
248571,4,0,4,1.302795,103.807288
248591,0,25,25,1.306841,103.807346
248592,3,0,3,1.305191,103.807272
248593,5,0,5,1.30703,103.806881
248614,116,1,117,1.301606,103.804714
248615,8,11,19,1.301466,103.805361
248616,3,0,3,1.306981,103.807127
248617,15,0,15,1.301802,103.805057
248618,96,6,102,1.301206,103.806044
248619,17,0,17,1.300731,103.805367
248620,21,4,25,1.302082,103.805051
248621,53,3,56,1.301502,103.805043
248623,11,1,12,1.30159,103.804269
248624,14,0,14,1.301353,103.805796
248643,16,397,413,1.302315,103.824189
248644,4,2449,2453,1.30384,103.82467
248645,829,1877,2706,1.303543,103.82578
248646,10999,11256,22255,1.305002,103.828286
248648,2223,371,2594,1.302456,103.824808
248649,4844,20186,25030,1.303152,103.823715
248650,7,352,359,1.30473,103.827669
248651,4,564,568,1.305323,103.827691
248652,749,14099,14848,1.304018,103.832007
248653,30,1496,1526,1.303017,103.824675
248668,573,2,575,1.300526,103.824702
248669,2034,553,2587,1.300632,103.824798
248670,241,130,371,1.30037,103.824926
248671,5,37,42,1.301181,103.825233
248672,372,16,388,1.300292,103.825067
248673,35,7,42,1.301269,103.825286
248674,8,36,44,1.30054,103.825026
248675,44,37,81,1.301367,103.825542
248676,38,9,47,1.300364,103.825681
248677,97,35,132,1.301122,103.825513
248678,111,21,132,1.301453,103.82608
248679,2,15,17,1.301486,103.826216
248680,3,0,3,1.301512,103.805053
248681,6,0,6,1.301367,103.826077
248682,0,17,17,1.301551,103.825844
248683,7,0,7,1.30143,103.826474
248684,22,1,23,1.301362,103.826596
248686,2,1,3,1.301634,103.826091
248687,2,0,2,1.301211,103.807976
248688,7,1,8,1.301284,103.827195
248689,3,25,28,1.301497,103.826876
248690,1,3,4,1.30136,103.827258
248691,5,3,8,1.301529,103.826987
248692,29,2,31,1.301578,103.827174
248693,3,1,4,1.301611,103.827046
248694,3,1,4,1.301657,103.8273
248695,1,3,4,1.301713,103.82712
248696,0,4,4,1.301745,103.82738
248697,0,5,5,1.301803,103.827199
248699,1,0,1,1.300028,103.814381
248700,1,0,1,1.30207,103.827385
248701,26,9,35,1.302145,103.827457
248702,0,3,3,1.301359,103.826843
248703,11,51,62,1.302265,103.827525
248704,50,2,52,1.302093,103.827639
248705,28,4,32,1.302245,103.827713
248706,352,185,537,1.300602,103.825044
248707,30,6,36,1.301341,103.825502
248708,127,19,146,1.301425,103.825596
248709,94,18,112,1.301531,103.825702
248710,2,23,25,1.299509,103.837
248711,1,6,7,1.299509,103.837
248713,6,3,9,1.299509,103.837
248726,1039,563,1602,1.296721,103.825603
248727,1003,156,1159,1.296977,103.824626
248728,815,92,907,1.297909,103.825383
248729,0,5,5,1.29679,103.824429
248730,3737,747,4484,1.297253,103.825944
248732,4295,643,4938,1.296938,103.826392
248733,109,72,181,1.296946,103.826908
248734,17,1,18,1.296383,103.825093
248735,4,0,4,1.296244,103.82513
248736,3,0,3,1.301868,103.827481
248737,1390,211,1601,1.296089,103.826016
248738,1,0,1,1.301963,103.827765
248739,6,0,6,1.295746,103.826077
248740,2,290,292,1.29573,103.826127
248741,721,177,898,1.295777,103.826486
248742,623,565,1188,1.295507,103.826284
248743,1324,145,1469,1.295085,103.826903
248744,304,1078,1382,1.294592,103.827287
248745,558,840,1398,1.294566,103.827286
248747,463,740,1203,1.294895,103.826496
248749,487,59,546,1.294265,103.827409
248750,2,6,8,1.299509,103.837
248751,17,165,182,1.299509,103.837
248752,74,0,74,1.299509,103.837
248765,2,9,11,1.295362,103.81928
248766,2,27,29,1.295352,103.81958
248767,2,3,5,1.295615,103.81949
248768,0,20,20,1.295194,103.819801
248769,18,1,19,1.295753,103.819572
248770,91,10,101,1.294911,103.819998
248771,2,10,12,1.296028,103.819737
248772,4,9,13,1.294909,103.8203
248773,6,4,10,1.296304,103.819901
248774,10,2,12,1.294923,103.820551
248775,14,1,15,1.296417,103.819945
248776,4,32,36,1.294927,103.820816
248777,2,0,2,1.301364,103.826946
248778,0,8,8,1.295315,103.821
248779,1,0,1,1.296042,103.82611
248780,6,1,7,1.295286,103.821338
248781,1,0,1,1.296725,103.820249
248782,8,0,8,1.295721,103.821156
248783,88,11,99,1.29598,103.82115
248784,186,0,186,1.296222,103.821062
248785,382,3,385,1.296447,103.820963
248786,10,0,10,1.296684,103.820822
248787,20,8,28,1.296878,103.820559
248788,2,25,27,1.296223,103.820096
248789,11,12,23,1.296111,103.820245
248790,13,9,22,1.296,103.820307
248791,85,35,120,1.295733,103.820654
248792,1,1,2,1.296715,103.820239
248793,17,0,17,1.295734,103.820311
248794,0,4,4,1.295464,103.819842
248795,26,0,26,1.295776,103.820305
248796,38,98,136,1.295982,103.82025
248816,807,681,1488,1.305159,103.815739
248817,2861,1158,4019,1.305449,103.815515
248818,476,69,545,1.304811,103.815153
248819,3525,1568,5093,1.305807,103.815495
248820,98,1570,1668,1.299509,103.837
248837,10,31,41,1.30273,103.812423
248839,147,1155,1302,1.303507,103.811898
248840,1,0,1,1.297093,103.820477
248842,1,0,1,1.300953,103.811998
248843,361,0,361,1.301413,103.812288
248844,262,0,262,1.30128,103.812046
248845,1035,415,1450,1.301982,103.812393
248846,737,128,865,1.30156,103.810834
248847,975,135,1110,1.302142,103.81166
248848,1264,247,1511,1.301519,103.811834
248849,3,12,15,1.299509,103.837
248850,154,151,305,1.302901,103.811612
248851,66,131,197,1.302322,103.812124
248852,280,114,394,1.301921,103.811574
248853,228,37,265,1.301921,103.811574
248854,9,58,67,1.299509,103.837
248858,2,51,53,1.301057,103.825096
248859,23,3,26,1.301085,103.825035
248860,1,0,1,1.301198,103.812016
248861,1,2,3,1.29574,103.82603
248862,7,2,9,1.301328,103.824804
248863,0,18,18,1.301376,103.824767
248864,0,2,2,1.295521,103.820463
248865,2,2,4,1.301598,103.824876
248866,20,15,35,1.30146,103.824966
248867,5,0,5,1.301652,103.824929
248868,33,36,69,1.301517,103.825063
248869,0,9,9,1.301708,103.824954
248870,161,7,168,1.299509,103.837
248871,5,4,9,1.301697,103.825044
248872,9,0,9,1.301672,103.82526
248873,263,18,281,1.301752,103.825129
248874,3,1,4,1.301747,103.825339
248875,9,6,15,1.301824,103.825206
248876,0,11,11,1.301792,103.825411
248877,1,2,3,1.301221,103.824899
248878,0,17,17,1.301963,103.82542
248879,11,9,20,1.302143,103.825509
248881,14,0,14,1.302143,103.825509
248882,6,14,20,1.302143,103.825509
248883,18,6,24,1.302143,103.825509
248884,43,190,233,1.302143,103.825509
248885,8,44,52,1.302143,103.825509
248886,31,24,55,1.302143,103.825509
248887,0,1,1,1.301155,103.82495
248899,227,105,332,1.294825,103.829403
248901,5,73,78,1.294533,103.829496
248902,324,31,355,1.294948,103.830057
248903,1328,879,2207,1.293841,103.829844
248904,962,1176,2138,1.293347,103.830412
248922,1775,1135,2910,1.296523,103.81581
248923,63,29,92,1.296474,103.815064
248924,7,32,39,1.296946,103.813665
248925,27,28,55,1.297486,103.812911
248926,30,7,37,1.297665,103.81239
248927,62,5,67,1.297529,103.812296
248928,3,3,6,1.297844,103.811496
248929,12,31,43,1.298523,103.811725
248930,185,14,199,1.29886,103.81096
248931,22,15,37,1.298067,103.810749
248932,92,7,99,1.298816,103.810054
248933,4,7,11,1.298217,103.810383
248935,165,48,213,1.298568,103.809941
248936,56,54,110,1.299517,103.810692
248937,0,2,2,1.301447,103.824764
248963,49,187,236,1.296499,103.829344
248969,311,84,395,1.296417,103.829534
248973,580,245,825,1.295846,103.829798
248992,74,2105,2179,1.292787,103.825719
248993,1,40,41,1.292875,103.825602
248994,100,1992,2092,1.293097,103.825994
249001,389,1303,1692,1.293351,103.823993
249002,1144,430,1574,1.293256,103.823988
249003,297,83,380,1.292639,103.823938
249004,329,728,1057,1.293896,103.824154
249005,106,31,137,1.293575,103.823724
249006,11,35,46,1.293462,103.823884
249007,577,13,590,1.293272,103.823901
249008,6,42,48,1.293435,103.823636
249009,11,1,12,1.29314,103.823487
249010,14,130,144,1.293349,103.823566
249012,371,9,380,1.293058,103.823254
249013,492,8,500,1.293058,103.823254
249014,19,19,38,1.293058,103.823254
249015,689,13,702,1.293538,103.823348
249016,255,696,951,1.293853,103.823554
249018,1038,58,1096,1.293853,103.823554
249020,29,58,87,1.294432,103.822955
249021,6,413,419,1.294799,103.822355
249022,0,6,6,1.294795,103.822399
249023,3,2,5,1.294802,103.822434
249024,3,14,17,1.294775,103.822469
249025,1,13,14,1.294757,103.8225
249026,5,12,17,1.294722,103.822523
249027,1,16,17,1.294693,103.822537
249028,42,12,54,1.294641,103.822542
249029,1,17,18,1.294571,103.822527
249030,8,5,13,1.294551,103.822512
249032,73,0,73,1.294522,103.822458
249033,9,78,87,1.294505,103.822421
249034,536,27,563,1.293853,103.823554
249035,3,14,17,1.293765,103.822869
249036,3,58,61,1.293541,103.822892
249037,16,5,21,1.293464,103.822588
249038,0,2,2,1.299689,103.810198
249039,0,2,2,1.293419,103.822616
249040,2,0,2,1.293374,103.822641
249041,0,1,1,1.302143,103.825509
249042,3,7,10,1.293254,103.822723
249045,396,36,432,1.294821,103.821964
249046,1020,23,1043,1.294717,103.821122
249047,1738,233,1971,1.294354,103.821038
249048,1,326,327,1.29422,103.820985
249049,12,15,27,1.293686,103.821771
249050,2,20,22,1.294446,103.820881
249051,98,78,176,1.294386,103.820863
249052,2,1,3,1.301921,103.825326
249053,0,2,2,1.293341,103.822661
249054,0,3,3,1.294326,103.820857
249055,269,105,374,1.294874,103.819033
249056,820,104,924,1.295232,103.818495
249057,350,166,516,1.2952,103.818331
249058,327,146,473,1.295161,103.81781
249061,5,4,9,1.294297,103.817766
249062,6,33,39,1.29482,103.817109
249063,177,109,286,1.295038,103.816747
249069,2,0,2,1.294262,103.820855
249071,37,2,39,1.295016,103.822842
249072,0,21,21,1.294964,103.823334
249073,1,0,1,1.293305,103.822687
249074,5,53,58,1.294594,103.823625
249075,22,103,125,1.294517,103.8239
249076,16,5071,5087,1.294577,103.824181
249077,476,953,1429,1.29528,103.825743
249078,9,29,38,1.294099,103.822762
249079,36,37,73,1.293686,103.823795
249080,228,83,311,1.292881,103.823339
249081,950,11,961,1.29448,103.822185
249082,7,0,7,1.295364,103.817722
249083,6,298,304,1.296529,103.816766
249084,9,3,12,1.29621,103.816795
249085,2,0,2,1.295494,103.823027
249086,10,18,28,1.295191,103.816856
249087,1,0,1,1.295251,103.823611
249088,48,0,48,1.295441,103.818122
249089,4,39,43,1.29522,103.817273
249090,0,22,22,1.29531,103.817639
249091,15,46,61,1.295531,103.816777
249092,72,2,74,1.299509,103.837
249093,345,42,387,1.295055,103.822325
249094,489,3,492,1.293527,103.822273
249095,177,190,367,1.299509,103.837
249096,94,1,95,1.299509,103.837
249099,730,16,746,1.292986,103.824909
249101,473,131,604,1.29295,103.824891
249103,956,8,964,1.292333,103.824607
249105,698,1,699,1.292466,103.824545
249107,956,3,959,1.292417,103.82449
249110,126,18,144,1.292773,103.824757
249114,465,148,613,1.29248,103.825251
249115,1826,2582,4408,1.292979,103.824881
249116,736,978,1714,1.292786,103.8246
249133,16,45,61,1.301912,103.829177
249134,2,45,47,1.301857,103.829267
249135,0,3,3,1.294175,103.820856
249136,82,11,93,1.302195,103.829006
249137,4,57,61,1.302246,103.828913
249138,5,19,24,1.302316,103.828833
249139,22,19,41,1.302322,103.828549
249140,29,1,30,1.302398,103.8284
249141,14,47,61,1.302527,103.828529
249142,0,3,3,1.30214,103.829078
249143,1,296,297,1.302662,103.828333
249144,0,6,6,1.302542,103.828108
249145,5,57,62,1.302715,103.828075
249146,29,23,52,1.302544,103.827883
249147,4,111,115,1.302707,103.827932
249148,52,511,563,1.302703,103.827761
249149,57,118,175,1.302654,103.827685
249150,1,37,38,1.302627,103.827549
249152,31,5,36,1.302505,103.827277
249153,14,6,20,1.302315,103.827137
249154,194,81,275,1.302477,103.827146
249155,8,1,9,1.302246,103.827046
249156,4,4,8,1.302324,103.826965
249157,10,2,12,1.30213,103.826949
249158,11,5,16,1.30195,103.826663
249159,259,4,263,1.302038,103.826887
249160,17,5,22,1.301793,103.826522
249161,8,5,13,1.301905,103.826783
249162,5,7,12,1.301817,103.826693
249163,2,5,7,1.301677,103.826591
249166,72,24,96,1.302569,103.827399
249167,30,8,38,1.302572,103.827327
249168,9,28,37,1.302266,103.826911
249169,1,0,1,1.29543,103.817914
249170,0,2,2,1.295794,103.816752
249183,608,187,795,1.295912,103.829131
249185,3,242,245,1.295754,103.828843
249188,1305,72,1377,1.296135,103.828893
249191,528,24,552,1.295599,103.828523
249192,6,536,542,1.296422,103.828715
249193,11,1,12,1.296537,103.828656
249195,2,9,11,1.296585,103.828547
249196,18,52,70,1.295544,103.82816
249197,2,6,8,1.296633,103.828499
249198,1,28,29,1.29558,103.828155
249199,2,1,3,1.302468,103.82831
249200,11,0,11,1.296661,103.82841
249201,116,3,119,1.296673,103.828337
249202,0,11,11,1.296684,103.828247
249203,28,4,32,1.2967,103.828183
249204,0,2,2,1.299509,103.837
249205,0,15,15,1.2967,103.828128
249206,756,112,868,1.295965,103.828749
249207,32,5,37,1.296693,103.828083
249208,1114,55,1169,1.296548,103.828226
249209,4,2,6,1.296689,103.827987
249210,982,12,994,1.296591,103.827752
249211,45,20,65,1.296694,103.827932
249212,3,7,10,1.296497,103.828452
249213,2,1,3,1.296647,103.828461
249214,5,348,353,1.296568,103.828124
249215,2,1,3,1.296691,103.827855
249216,0,123,123,1.296571,103.828079
249217,15,3,18,1.296691,103.827709
249218,0,11,11,1.296398,103.828137
249219,1,2,3,1.296692,103.827787
249220,0,194,194,1.296415,103.828097
249221,2,2,4,1.296722,103.82752
249222,3,1,4,1.296765,103.827395
249223,8,2,10,1.296751,103.827333
249224,1,109,110,1.296453,103.827731
249225,42,12,54,1.296681,103.82726
249226,9,12,21,1.296645,103.827313
249246,1,0,1,1.299509,103.837
249247,0,5,5,1.301992,103.828044
249248,15,0,15,1.301983,103.828387
249249,5,4,9,1.301764,103.82787
249250,0,2,2,1.296372,103.828554
249251,13,4,17,1.301496,103.827647
249252,11,3,14,1.301664,103.828044
249253,8,0,8,1.301308,103.827497
249254,0,1,1,1.30204,103.82829
249255,5,1,6,1.301048,103.827249
249256,3,0,3,1.296695,103.827622
249257,0,9,9,1.30087,103.826947
249258,3,4,7,1.301429,103.827854
249259,207,3,210,1.300882,103.826659
249260,42,4,46,1.301373,103.827798
249261,62,5,67,1.300892,103.826555
249262,26,30,56,1.301291,103.827753
249263,72,0,72,1.300909,103.826369
249264,6,0,6,1.301247,103.827682
249265,0,1,1,1.30159,103.827982
249266,24,6,30,1.301211,103.827639
249268,6,0,6,1.301147,103.827636
249269,1,0,1,1.300947,103.826264
249270,32,6,38,1.301123,103.827612
249271,5,0,5,1.301086,103.827586
249272,27,4,31,1.301074,103.827516
249273,7,0,7,1.301011,103.827453
249274,14,2,16,1.300956,103.827383
249275,1,0,1,1.300934,103.82605
249276,2,0,2,1.301763,103.828113
249277,40,21,61,1.300754,103.827082
249278,15,1,16,1.300729,103.826967
249279,38,16,54,1.30072,103.826874
249281,198,9,207,1.300719,103.826684
249282,15,23,38,1.300706,103.82658
249283,400,0,400,1.300713,103.82647
249284,10,7,17,1.300719,103.826374
249285,1,2,3,1.301506,103.827923
249286,3,2,5,1.300771,103.826203
249287,9,4,13,1.300779,103.826123
249307,13,25,38,1.301953,103.828914
249308,80,27,107,1.302068,103.828783
249309,1,2,3,1.300743,103.826299
249310,0,5,5,1.302002,103.828761
249311,15,0,15,1.301779,103.828821
249312,0,2,2,1.300808,103.827193
249313,129,7,136,1.301702,103.828782
249314,79,5,84,1.301881,103.828692
249315,4,1,5,1.301633,103.828711
249316,7,2,9,1.301665,103.82853
249317,0,4,4,1.301562,103.828699
249318,9,6,15,1.301584,103.828482
249319,11,21,32,1.30151,103.828657
249320,219,5,224,1.301512,103.8284
249321,7,9,16,1.300729,103.826967
249322,84,56,140,1.301444,103.828356
249323,3,0,3,1.301895,103.828868
249324,70,0,70,1.301357,103.828268
249325,26,46,72,1.301258,103.82847
249326,6,20,26,1.301321,103.828262
249327,5,7,12,1.301159,103.828386
249329,0,1,1,1.300882,103.827299
249330,2,3,5,1.301173,103.828157
249331,3,4,7,1.300978,103.828228
249332,1,1,2,1.30194,103.828735
249333,1,3,4,1.300879,103.828158
249334,5,2,7,1.301021,103.828058
249335,12,1,13,1.300782,103.828077
249336,11,26,37,1.300724,103.82775
249337,116,0,116,1.300725,103.828012
249338,5,0,5,1.300826,103.827877
249339,44,14,58,1.300616,103.827928
249340,48,19,67,1.30073,103.827804
249341,1,3,4,1.300508,103.827829
249342,95,8,103,1.300617,103.827734
249343,7,5,12,1.300423,103.827776
249344,335,10,345,1.300599,103.827687
249345,21,5,26,1.300322,103.827712
249346,4,5,9,1.300387,103.827391
249349,3,172,175,1.300183,103.826519
249350,49,20,69,1.300273,103.82714
249351,0,4,4,1.300254,103.826942
249355,68,7,75,1.300274,103.826678
249356,0,116,116,1.300282,103.82616
249357,1,6,7,1.300294,103.826547
249359,17,37,54,1.300317,103.826449
249360,0,38,38,1.300406,103.825888
249361,10,0,10,1.300355,103.826306
249363,78,21,99,1.300385,103.826244
249364,0,5,5,1.300578,103.825621
249365,3,0,3,1.301373,103.828552
249367,3,1,4,1.300559,103.825945
249368,0,38,38,1.300737,103.825453
249370,0,142,142,1.300869,103.825286
249371,20,16,36,1.300484,103.826054
249372,4,5,9,1.299509,103.837
249390,10,0,10,1.296059,103.830283
249392,28,206,234,1.296121,103.830271
249393,10,50,60,1.296157,103.830273
249394,1,22,23,1.296195,103.830272
249395,44,22,66,1.296242,103.830271
249396,2,26,28,1.296297,103.830275
249397,13,14,27,1.296351,103.830279
249398,13,12,25,1.296407,103.830274
249399,12,591,603,1.29621,103.830011
249400,16,1,17,1.296473,103.830274
249401,2,29,31,1.296255,103.830012
249402,8,15,23,1.296531,103.83028
249403,1,53,54,1.296295,103.830018
249404,8,95,103,1.2966,103.830262
249405,52,824,876,1.296459,103.830084
249406,4,7,11,1.296669,103.830254
249407,8,16,24,1.296539,103.830074
249408,18,24,42,1.296496,103.829987
249409,19,18,37,1.296751,103.830159
249410,117,154,271,1.296713,103.830182
249411,3,88,91,1.296813,103.830155
249413,43,117,160,1.296871,103.830151
249415,3,250,253,1.296944,103.830143
249416,6,1,7,1.296944,103.830192
249417,1,132,133,1.297039,103.830145
249419,18,63,81,1.297185,103.830133
249420,0,120,120,1.297084,103.83014
249421,40,523,563,1.297281,103.830129
249422,13,951,964,1.299509,103.837
249441,2230,116,2346,1.294586,103.826687
249442,3,1,4,1.294648,103.826174
249443,3,119,122,1.299509,103.837
249444,1571,986,2557,1.294187,103.826138
249445,1574,24,1598,1.293963,103.825612
249446,1365,1528,2893,1.293662,103.825295
249469,7,0,7,1.309296,103.805287
249470,2,3,5,1.309296,103.805287
249472,0,1,1,1.301082,103.828309
249473,434,69,503,1.309455,103.803455
249476,702,125,827,1.309963,103.804576
249477,29,1,30,1.309014,103.804353
249478,2,0,2,1.301103,103.828102
249479,19,8,27,1.308654,103.804189
249480,1,2,3,1.300438,103.826142
249481,114,5,119,1.30833,103.804196
249482,4,3,7,1.309125,103.805497
249483,7,6,13,1.309027,103.806257
249484,7,3,10,1.308614,103.806136
249486,2,15,17,1.308868,103.805362
249487,167,0,167,1.308805,103.805316
249488,83,18,101,1.308274,103.805794
249489,11,0,11,1.307952,103.805882
249490,25,1,26,1.307779,103.806026
249491,63,1,64,1.307823,103.805556
249492,9,2,11,1.308931,103.805409
249493,12,1,13,1.308489,103.805082
249494,2,0,2,1.308833,103.804529
249495,12,1,13,1.30868,103.804838
249496,14,3,17,1.308499,103.805072
249498,16,25,41,1.309636,103.803636
249499,1,0,1,1.308922,103.80417
249500,3,138,141,1.309876,103.803876
249501,3,59,62,1.299509,103.837
249502,1,40,41,1.308619,103.803332
249503,34,37,71,1.308782,103.80298
249504,6,35,41,1.308247,103.803177
249505,33,53,86,1.308629,103.803342
249506,34,9,43,1.308208,103.803156
249507,2,6,8,1.308619,103.803352
249508,1,12,13,1.308178,103.803144
249510,434,119,553,1.308119,103.803121
249511,1,0,1,1.309756,103.803756
249512,0,44,44,1.30806,103.803098
249513,0,7,7,1.308011,103.803085
249514,3,6,9,1.308237,103.803187
249515,53,0,53,1.308227,103.803177
249516,7,0,7,1.308119,103.803141
249517,3,0,3,1.308551,103.804377
249537,744,669,1413,1.304816,103.814189
249540,1,0,1,1.308437,103.803505
249541,221,9,230,1.304867,103.813428
249542,1148,1358,2506,1.299509,103.837
249543,68,2109,2177,1.305899,103.818063
249544,7,1070,1077,1.306101,103.814563
249545,1,0,1,1.305307,103.813799
249546,1,0,1,1.305307,103.813799
249548,1171,697,1868,1.305733,103.813881
249549,3399,2174,5573,1.304339,103.811012
249563,3,18,21,1.299235,103.835652
249564,1211,1572,2783,1.29737,103.828157
249565,4647,1189,5836,1.298708,103.827767
249566,2788,1148,3936,1.298164,103.827153
249567,2868,191,3059,1.297565,103.826992
249568,44,4,48,1.297186,103.827186
249569,751,831,1582,1.298865,103.826628
249570,3577,1772,5349,1.298432,103.825579
249572,45,1317,1362,1.299708,103.82469
249574,811,1620,2431,1.299211,103.829213
249575,2,287,289,1.299865,103.823849
249576,707,186,893,1.299216,103.829105
249577,4,96,100,1.299948,103.823401
249578,480,46,526,1.299199,103.828981
249579,8,34,42,1.299993,103.823213
249580,1103,401,1504,1.29973,103.82859
249581,5,23,28,1.300642,103.823249
249582,3,7,10,1.300964,103.823001
249584,76,28,104,1.301452,103.823128
249585,336,3606,3942,1.299245,103.828474
249586,16,317,333,1.302931,103.823302
249587,3993,2787,6780,1.299265,103.82744
249589,6,604,610,1.29959,103.827106
249591,1322,613,1935,1.299337,103.826682
249592,724,60,784,1.299429,103.826335
249593,90,442,532,1.299419,103.826383
249594,751,204,955,1.299443,103.826062
249595,1062,94,1156,1.29956,103.825762
249596,13,1,14,1.299599,103.825668
249597,1,0,1,1.305307,103.813799
249598,0,96,96,1.299599,103.825668
249599,1,0,1,1.299489,103.825953
249600,355,413,768,1.299755,103.825407
249601,9,203,212,1.299899,103.82515
249602,31,390,421,1.299923,103.825077
249603,2,5,7,1.29997,103.824944
249604,69,960,1029,1.300017,103.824875
249605,71,206,277,1.300306,103.824451
249606,22,41,63,1.300223,103.82446
249607,2,181,183,1.300591,103.823938
249608,2,149,151,1.300723,103.823767
249609,1,212,213,1.300867,103.823625
249612,60,0,60,1.300607,103.822717
249613,1594,1232,2826,1.303691,103.823069
249614,2383,653,3036,1.304026,103.823134
249616,2351,2848,5199,1.304164,103.822976
249617,1288,117,1405,1.300642,103.823887
249631,979,627,1606,1.30122,103.823762
249632,11,64,75,1.299509,103.837
249633,1545,129,1674,1.301227,103.824115
249634,0,3,3,1.308001,103.803095
249636,10,75,85,1.301207,103.824115
249668,30,23,53,1.306978,103.809721
249669,163,360,523,1.305484,103.809552
249670,6391,3364,9755,1.305811,103.81175
249671,1436,1137,2573,1.304682,103.808906
249672,1469,189,1658,1.30349,103.809365
249673,6300,2702,9002,1.304363,103.809968
249674,367,527,894,1.304632,103.810304
249675,268,387,655,1.3051,103.810392
249676,1583,124,1707,1.305834,103.810209
249677,153,2560,2713,1.305838,103.810827
249678,5,9,14,1.306995,103.810168
249679,4248,8225,12473,1.306912,103.810132
249680,23,0,23,1.306912,103.810132
249681,2,0,2,1.308203,103.804528
249682,51,0,51,1.306497,103.812109
249683,116,229,345,1.30489,103.808531
249684,240,39,279,1.304932,103.808214
249685,221,1004,1225,1.305294,103.8111
249686,1121,1021,2142,1.30587,103.811339
249687,98,465,563,1.305944,103.809713
249688,608,492,1100,1.305663,103.809628
249689,122,0,122,1.305824,103.809509
249690,104,3640,3744,1.30403,103.829105
249691,951,3905,4856,1.304212,103.828545
249692,2727,80,2807,1.303645,103.828919
249693,3001,163,3164,1.30319,103.82769
249694,2334,637,2971,1.303979,103.827889
249695,45,12,57,1.303688,103.82886
249696,564,407,971,1.303795,103.828981
249697,484,83,567,1.303604,103.828789
249715,8201,568,8769,1.304999,103.824973
249716,6003,8459,14462,1.304215,103.823973
249718,22,168,190,1.305166,103.826301
249719,77,834,911,1.305764,103.827012
249720,642,32365,33007,1.306497,103.827812
249722,2021,676,2697,1.304517,103.826421
249723,1805,442,2247,1.304904,103.826854
249724,744,8582,9326,1.305871,103.828054
249725,3,341,344,1.305085,103.828219
249726,504,874,1378,1.304552,103.826165
249727,56,242,298,1.305484,103.826856
249745,1510,52,1562,1.299212,103.824859
249746,11,87,98,1.299341,103.823893
249747,2,1,3,1.30103,103.823231
249748,9,2,11,1.298695,103.822826
249749,1,0,1,1.299546,103.825817
249750,0,2,2,1.306771,103.811412
249751,3,0,3,1.299301,103.823756
249752,13,0,13,1.298694,103.822825
249755,1,0,1,1.298694,103.822825
249756,0,1,1,1.298694,103.822825
249758,0,2,2,1.298694,103.822825
249760,1,13,14,1.300061,103.823251
249761,1689,1980,3669,1.299322,103.822752
249762,9,332,341,1.300046,103.822797
249763,61,16,77,1.298648,103.821996
249764,14,14398,14412,1.300086,103.822588
249765,27,17,44,1.298986,103.821657
249766,10,13,23,1.29947,103.821828
249767,168,1,169,1.299833,103.821912
249768,12,8,20,1.30068,103.821062
249769,4,1,5,1.300006,103.821426
249770,2,0,2,1.298694,103.822825
249771,2,0,2,1.29956,103.821225
249772,5,103,108,1.299897,103.820752
249773,12,47,59,1.300028,103.821218
249774,85,4,89,1.29963,103.820696
249775,30,23,53,1.300128,103.819784
249776,54,17,71,1.300278,103.819626
249777,7,3,10,1.300462,103.819315
249778,35,1,36,1.300258,103.819214
249779,19,21,40,1.29921,103.819463
249780,289,0,289,1.299647,103.819453
249781,5,33,38,1.299524,103.819353
249782,4,26,30,1.299319,103.819232
249783,45,19,64,1.29924,103.818801
249784,19,5,24,1.299554,103.818611
249786,10,638,648,1.299275,103.817532
249787,186,42,228,1.299702,103.818255
249788,99,4,103,1.298676,103.821679
249789,266,809,1075,1.300277,103.822073
249790,1,0,1,1.298694,103.822825
249791,1,251,252,1.300299,103.821596
249792,5,4,9,1.300215,103.822275
249793,3,40,43,1.300343,103.821295
249794,3,50,53,1.300086,103.819881
249795,104,45,149,1.299877,103.823414
249807,16,41,57,1.299396,103.819839
249808,5,16,21,1.298523,103.819695
249809,4,1,5,1.299273,103.819981
249810,16,2,18,1.299318,103.820591
249811,0,4,4,1.299151,103.820104
249812,21,0,21,1.298926,103.820458
249813,7,7,14,1.298784,103.820532
249814,1,0,1,1.300321,103.821809
249815,5,0,5,1.297559,103.820916
249816,1,0,1,1.299179,103.821127
249817,221,0,221,1.297826,103.820931
249818,3,1,4,1.298867,103.82129
249819,0,1,1,1.299266,103.821349
249820,4,1,5,1.297898,103.82099
249821,20,12,32,1.298262,103.820777
249837,2,196,198,1.301412,103.819107
249838,29,18,47,1.301217,103.819444
249839,1,0,1,1.298663,103.821177
249840,15,0,15,1.301363,103.819745
249841,3,52,55,1.301141,103.819538
249842,1,19,20,1.30091,103.819835
249843,1,0,1,1.301323,103.819575
249844,28,2,30,1.301049,103.820183
249845,87,4,91,1.300875,103.820024
249846,59,10,69,1.300988,103.81931
249847,13,0,13,1.300512,103.820414
249848,1,258,259,1.301595,103.819264
249887,7,1915,1922,1.296016,103.825558
249888,8,0,8,1.29572,103.8248
249889,46,2,48,1.29592,103.823792
249890,3,26,29,1.296021,103.823874
249891,16,7,23,1.296358,103.823366
249892,1,1,2,1.29976,103.821016
249893,4,74,78,1.296155,103.823223
249894,6,3,9,1.29597,103.823367
249895,6,0,6,1.295767,103.823618
249896,37,2,39,1.295348,103.823836
249897,19,1,20,1.295253,103.824085
249898,7,6,13,1.295116,103.824344
249899,5,656,661,1.294909,103.824314
249900,3,35,38,1.295772,103.824096
249901,9,1,10,1.295831,103.824155
249903,26,19,45,1.295966,103.825413
249904,29,1,30,1.29586,103.823989
249905,2,1,3,1.298694,103.822825
249906,1,0,1,1.301088,103.81998
249907,14,0,14,1.297066,103.823458
249908,144,2,146,1.295948,103.822939
249919,2,14,16,1.298402,103.82393
249920,0,4,4,1.298392,103.823965
249921,0,4,4,1.298389,103.823982
249922,0,2,2,1.296254,103.823436
249925,1,0,1,1.296136,103.823649
249926,1,0,1,1.29835,103.824129
249932,0,4,4,1.298289,103.824315
249933,4,64,68,1.298273,103.824359
249934,1,7,8,1.298422,103.824284
249935,0,4,4,1.298414,103.82431
249936,0,1,1,1.298329,103.824189
249937,0,1,1,1.298266,103.824381
249939,0,3,3,1.295977,103.824096
249940,0,1,1,1.298397,103.82432
249941,0,4,4,1.298431,103.824287
249942,0,1,1,1.298441,103.824308
249943,0,39,39,1.298461,103.824331
249963,20,10,30,1.297761,103.823688
249964,4,23,27,1.298603,103.823785
249965,26,15,41,1.298897,103.8239
249966,5,0,5,1.298725,103.823748
249967,2,6,8,1.298486,103.823642
249968,71,13,84,1.298383,103.823462
249969,21,0,21,1.297461,103.823137
249970,21,1,22,1.297576,103.822529
249971,88,0,88,1.297381,103.822929
249972,10,15,25,1.296846,103.82247
249973,128,0,128,1.29679,103.822982
249974,5,2,7,1.296373,103.822701
249975,1,1,2,1.298386,103.82401
249976,0,5,5,1.296539,103.822434
249977,21,15,36,1.295917,103.822212
249978,13,2,15,1.295765,103.821822
249979,5,100,105,1.295578,103.822525
249980,1,44,45,1.295561,103.821828
249981,207,147,354,1.295215,103.821991
249982,29,10,39,1.296385,103.82175
249983,5,22,27,1.296962,103.821985
249984,8,0,8,1.296129,103.821809
249985,57,2,59,1.296821,103.821706
249986,248,0,248,1.296888,103.821756
249987,4,25,29,1.297274,103.822845
249988,271,72,343,1.296608,103.822355
249989,14,2,16,1.296584,103.821714
249991,25,0,25,1.297675,103.821221
249992,11,1,12,1.297747,103.822141
249993,1,0,1,1.298412,103.824283
249994,8,5,13,1.298153,103.823059
249995,30,3,33,1.297432,103.821725
249996,1,0,1,1.29809,103.822962
249997,6,1,7,1.29786,103.821401
249998,2,1,3,1.298225,103.824493
250000,3,0,3,1.298307,103.823261
257488,314,168,482,1.318973,103.815592
257489,0,2,2,1.296525,103.822564
257490,0,20,20,1.299509,103.837
257494,1147,952,2099,1.322215,103.814591
257496,260,2,262,1.32215,103.814144
257497,24,32,56,1.299509,103.837
257499,14,26,40,1.316418,103.811144
257500,20,104,124,1.318682,103.815149
257501,58,129,187,1.319204,103.814883
257503,11,534,545,1.318363,103.809693
257504,0,7,7,1.318606,103.809944
257505,14,257,271,1.318737,103.81011
257506,63,210,273,1.318932,103.81035
257507,97,0,97,1.318946,103.810482
257508,46,5,51,1.318771,103.81033
257509,0,6,6,1.318597,103.810105
257510,52,2,54,1.318373,103.80987
257511,80,4,84,1.317439,103.809184
257512,9,44,53,1.318013,103.809415
257513,248,8,256,1.317229,103.809026
257514,48,1281,1329,1.318062,103.809371
257515,28,12,40,1.316878,103.808843
257516,68,96,164,1.316262,103.808782
257517,89,327,416,1.318159,103.809282
257518,26,19,45,1.315782,103.808649
257519,139,10,149,1.318256,103.809194
257520,7,57,64,1.315477,103.808963
257521,6,16,22,1.318354,103.809106
257522,2,13,15,1.317282,103.808957
257523,1,308,309,1.317325,103.808878
257524,2,29,31,1.31741,103.80872
257525,31,47,78,1.317496,103.808562
257526,1123,61,1184,1.316904,103.808837
257530,976,100,1076,1.316148,103.808125
257534,492,107,599,1.315369,103.808419
257535,309,47,356,1.314949,103.808836
257536,1109,0,1109,1.314847,103.808561
257537,671,8,679,1.315168,103.808134
257551,416,7,423,1.317964,103.809459
257552,52,42,94,1.317954,103.809449
257553,7,4,11,1.317388,103.810056
257554,2,1,3,1.317671,103.809742
257555,6,0,6,1.317378,103.810066
257556,9,0,9,1.317378,103.810046
257557,8,5,13,1.317256,103.810205
257558,104,1,105,1.317276,103.809968
257559,6,0,6,1.317175,103.80989
257560,67,4,71,1.316971,103.809733
257561,2,3,5,1.316768,103.809577
257562,29,6,35,1.316614,103.80949
257563,3,1,4,1.316333,103.809383
257564,11,10,21,1.316097,103.8093
257565,95,5,100,1.315871,103.809227
257583,26,170,196,1.317533,103.825379
257584,2,6,8,1.317541,103.825127
257585,21,9,30,1.317504,103.825135
257586,396,30,426,1.299509,103.837
257587,1,0,1,1.297709,103.822348
257603,3,0,3,1.317671,103.809742
257605,264,2,266,1.316142,103.822771
257606,1,4,5,1.316972,103.82338
257607,2,3,5,1.317264,103.823208
257608,3,6,9,1.317583,103.822937
257609,1,8,9,1.317555,103.822788
257610,86,2,88,1.317389,103.822574
257611,23,0,23,1.317155,103.822444
257612,13,0,13,1.316821,103.822183
257613,14,5,19,1.316651,103.822137
257614,196,0,196,1.316939,103.822185
257615,0,5,5,1.317143,103.822547
257616,42,0,42,1.317354,103.822658
257617,2,2,4,1.316664,103.823331
257618,53,28,81,1.316545,103.823143
257619,15,4,19,1.31636,103.822885
257620,1,2,3,1.316568,103.823285
257621,37,3,40,1.316045,103.822435
257623,0,55,55,1.315809,103.822075
257624,95,0,95,1.315655,103.821855
257625,0,8,8,1.315531,103.821733
257626,22,5,27,1.31539,103.821679
257627,11,0,11,1.315254,103.821661
257628,9,3,12,1.315006,103.821672
257629,59,3,62,1.314785,103.82171
257630,16,1,17,1.315551,103.822514
257631,1,0,1,1.299509,103.837
257632,3,0,3,1.316348,103.822662
257633,2,3,5,1.315474,103.822061
257634,76,2,78,1.315126,103.821856
257635,5,5,10,1.314825,103.822037
257647,9,29,38,1.313154,103.827727
257650,391,24,415,1.313028,103.826988
257652,562,894,1456,1.313222,103.827512
257654,1138,864,2002,1.312512,103.827381
257662,204,69,273,1.312948,103.827417
257663,28,26,54,1.312973,103.827092
257679,104,0,104,1.314795,103.813437
257680,78,69,147,1.315845,103.814878
257681,17,66,83,1.315125,103.814212
257682,24,8,32,1.315759,103.814501
257683,82,33,115,1.312782,103.812485
257684,23,0,23,1.312781,103.812484
257685,56,24,80,1.313491,103.812503
257686,7,0,7,1.314045,103.812488
257687,35,21,56,1.313694,103.812854
257688,105,2,107,1.314084,103.812688
257689,81,8,89,1.314218,103.812981
257690,173,47,220,1.313953,103.813201
257698,11,1,12,1.310311,103.809534
257699,2,224,226,1.311061,103.8095
257700,2787,703,3490,1.30986,103.809764
257717,390,455,845,1.308229,103.818936
257718,629,441,1070,1.308097,103.819048
257719,37,10179,10216,1.308097,103.819048
257720,843,237,1080,1.308387,103.81927
257721,382,64,446,1.308336,103.819482
257722,598,105,703,1.308363,103.819954
257723,666,155,821,1.308471,103.819511
257724,643,142,785,1.308469,103.819832
257742,751,1004,1755,1.310126,103.807419
257743,71,104,175,1.310495,103.80779
257744,1928,31,1959,1.310487,103.806892
257745,30,6,36,1.310187,103.807691
257746,2,1,3,1.315241,103.82216
257747,56,31,87,1.310187,103.807691
257748,114,0,114,1.310187,103.807691
257749,434,1,435,1.310187,103.807691
257750,65,47,112,1.310715,103.807281
257751,215,1,216,1.31076,103.807205
257752,151,10,161,1.310751,103.807136
257753,8,4,12,1.310787,103.807089
257754,212,17,229,1.311062,103.8072
257755,17,0,17,1.31114,103.807215
257756,21,3,24,1.311193,103.807248
257757,78,8,86,1.311233,103.807282
257758,45,0,45,1.311295,103.807319
257759,42,0,42,1.3114,103.807324
257760,560,19,579,1.31146,103.807319
257761,148,28,176,1.311504,103.807331
257762,58,7,65,1.311547,103.807627
257763,62,19,81,1.311609,103.807662
257764,14,12,26,1.311678,103.807663
257765,56,0,56,1.311715,103.807701
257766,64,19,83,1.311779,103.807734
257767,93,31,124,1.311876,103.807746
257768,41,12,53,1.311916,103.807744
257769,197,0,197,1.311998,103.807758
257770,254,33,287,1.31212,103.807863
257771,35,3,38,1.312182,103.807892
257772,138,4,142,1.312228,103.807948
257773,161,92,253,1.312301,103.807996
257774,119,85,204,1.312338,103.80802
257775,129,6,135,1.312406,103.808087
257776,246,8,254,1.312294,103.807583
257777,138,34,172,1.312367,103.807601
257778,236,55,291,1.312421,103.807626
257779,138,13,151,1.31249,103.807632
257780,52,24,76,1.312756,103.807775
257781,320,1,321,1.312702,103.807834
257782,48,1,49,1.312716,103.807936
257783,44,2,46,1.312667,103.807957
257784,97,3,100,1.312695,103.80807
257785,245,1,246,1.312686,103.808124
257786,127,20,147,1.312676,103.808199
257787,78,7,85,1.312634,103.80826
257788,134,3,137,1.312999,103.808419
257789,99,12,111,1.312994,103.808383
257790,46,4,50,1.313025,103.808281
257791,29,0,29,1.313019,103.808222
257792,79,10,89,1.313046,103.808167
257793,161,6,167,1.313041,103.808082
257794,378,25,403,1.313053,103.808041
257795,219,14,233,1.313069,103.807956
257796,218,304,522,1.310187,103.807691
257814,5589,8269,13858,1.309439,103.832625
257815,9,96,105,1.31182,103.833169
257816,6,604,610,1.310767,103.832904
257817,2,111,113,1.31093,103.832853
257818,1,29,30,1.311119,103.832823
257819,74,58,132,1.312297,103.832694
257820,167,78,245,1.31129,103.832805
257821,6,7,13,1.311456,103.832771
257822,2,0,2,1.299509,103.837
257823,13,6,19,1.311749,103.832579
257824,3,10,13,1.31188,103.832467
257825,1,16,17,1.311978,103.832351
257826,2,19,21,1.312053,103.832172
257827,4,181,185,1.312723,103.83128
257828,39,14,53,1.31352,103.831788
257829,2,0,2,1.311606,103.832693
257830,39,352,391,1.314012,103.831528
257831,26,218,244,1.313603,103.831017
257832,25,36,61,1.313491,103.830891
257833,10,1332,1342,1.312875,103.830528
257840,48,96,144,1.313439,103.828417
257841,8,391,399,1.313347,103.827882
257844,14,41,55,1.299509,103.837
257845,280,897,1177,1.31407,103.827176
257846,2,321,323,1.299509,103.837
257847,0,3,3,1.310187,103.807691
257848,414,216,630,1.314973,103.826378
257849,62,35,97,1.315752,103.826672
257850,0,51,51,1.315755,103.826699
257851,11,52,63,1.316105,103.826701
257852,1,39,40,1.316622,103.825906
257853,3,7,10,1.317165,103.825806
257854,2329,1513,3842,1.316545,103.826449
257855,29,2,31,1.317936,103.825192
257856,125,0,125,1.317719,103.8259
257857,6,141,147,1.3182,103.825374
257862,1,141,142,1.31782,103.82589
257863,2,6,8,1.318002,103.825865
257864,293,106,399,1.318462,103.825816
257865,24,739,763,1.31952,103.825662
257867,2,49,51,1.319419,103.825096
257868,19,2,21,1.319433,103.824857
257869,16,12,28,1.319454,103.824864
257870,2,54,56,1.319443,103.825189
257871,139,148,287,1.316166,103.826941
257872,1558,621,2179,1.320009,103.82505
257873,92,140,232,1.317918,103.825875
257877,641,1300,1941,1.299509,103.837
257878,3,115,118,1.299509,103.837
257888,5,301,306,1.317403,103.826318
257889,10,157,167,1.317314,103.826333
257890,7,435,442,1.317195,103.826283
257892,4,550,554,1.31741,103.825951
257893,7,3,10,1.31748,103.826102
257894,0,8,8,1.317403,103.82635
257895,4,0,4,1.317275,103.826359
257896,61,0,61,1.317116,103.826374
257898,67,0,67,1.317466,103.826331
257899,3,13,16,1.317536,103.82635
257900,5,12,17,1.317489,103.826942
257901,13,2,15,1.317416,103.826713
257902,535,90,625,1.317466,103.826331
257903,11,34,45,1.317072,103.826972
257905,137,0,137,1.317488,103.826636
257906,9,0,9,1.317549,103.827024
257907,3,7,10,1.317465,103.827053
257908,9,6,15,1.317465,103.827053
257909,1,2,3,1.314169,103.827042
257910,1,4,5,1.317564,103.826986
257911,58,35,93,1.31724,103.827582
257912,4,1,5,1.316962,103.827857
257913,477,86,563,1.31697,103.827675
257914,382,3,385,1.316717,103.827208
257919,547,49,596,1.317239,103.827497
257922,95,1,96,1.316906,103.826746
257939,38,0,38,1.315212,103.825834
257940,535,32,567,1.315342,103.825986
257941,4,0,4,1.315117,103.825602
257942,1,289,290,1.31515,103.825687
257943,0,1,1,1.315224,103.822578
257944,3,317,320,1.315249,103.825754
257945,0,5,5,1.315062,103.825432
257946,0,3,3,1.317561,103.826959
257947,6,17,23,1.314987,103.825228
257948,1,2,3,1.315261,103.825651
257949,51,3,54,1.314931,103.82512
257950,20,0,20,1.315137,103.825384
257951,5,0,5,1.314875,103.824967
257952,2,0,2,1.313634,103.831953
257953,3,2,5,1.315055,103.825205
257954,95,0,95,1.314826,103.824826
257955,11,0,11,1.31501,103.825104
257956,157,3,160,1.314761,103.824665
257957,0,5,5,1.314749,103.824637
257958,1,1,2,1.315097,103.825324
257959,12,14,26,1.314675,103.824472
257960,7,8,15,1.314646,103.824403
257961,63,1,64,1.314577,103.823625
257962,21,0,21,1.314583,103.824256
257963,317,66,383,1.314386,103.823679
257964,602,5,607,1.314274,103.823311
257965,8,4,12,1.314508,103.824079
257966,12,1,13,1.314468,103.823982
257967,6,5,11,1.314425,103.823841
257969,8,13,21,1.314313,103.823601
257970,9,51,60,1.314221,103.823441
257971,1,17,18,1.299509,103.837
257988,61,404,465,1.305849,103.824644
257989,589,27,616,1.306001,103.824419
257990,179,212,391,1.305784,103.8243
257991,53,7,60,1.306085,103.824347
257992,194,1,195,1.30674,103.823999
257996,306,5849,6155,1.305728,103.824124
257997,2,369,371,1.299509,103.837
257998,18,986,1004,1.305717,103.823944
258000,0,110,110,1.305799,103.823765
258002,2,63,65,1.305876,103.823653
258004,645,287,932,1.306354,103.823422
258005,736,33,769,1.306237,103.824238
258006,16,1,17,1.30627,103.823816
258007,25,12,37,1.306277,103.824128
258008,9,0,9,1.306237,103.824155
258009,25,9,34,1.30619,103.824183
258010,31,0,31,1.306158,103.824205
258011,10,10,20,1.306125,103.824225
258012,3,36,39,1.306071,103.82425
258013,1,4,5,1.306095,103.824242
258014,1,4,5,1.306048,103.82426
258015,19,38,57,1.306045,103.824283
258022,172,143,315,1.311114,103.805736
258023,75,3,78,1.311027,103.805716
258024,73,10,83,1.311004,103.80578
258025,42,8,50,1.310988,103.805854
258026,20,5,25,1.310962,103.805912
258027,35,8,43,1.310945,103.805973
258028,4,3,7,1.310918,103.806042
258029,1,4,5,1.310895,103.806099
258030,21,11,32,1.310874,103.806159
258031,10,7,17,1.310849,103.806235
258032,2,47,49,1.310824,103.8063
258033,9,34,43,1.311203,103.806808
258034,1,6,7,1.311222,103.806768
258035,0,8,8,1.311258,103.806687
258036,6,13,19,1.311295,103.806606
258037,49,9,58,1.311332,103.806525
258038,9,0,9,1.311369,103.806444
258039,41,4,45,1.311406,103.806362
258040,131,11,142,1.311442,103.806281
258041,164,22,186,1.311479,103.8062
258042,14,4,18,1.311516,103.806119
258043,66,3,69,1.311552,103.806038
258044,0,7,7,1.311589,103.805957
258045,176,4,180,1.311616,103.805886
258046,246,24,270,1.311609,103.805933
258047,131,2,133,1.311592,103.805971
258048,9,5,14,1.311558,103.806046
258049,16,3,19,1.311524,103.806121
258050,9,10,19,1.31149,103.806195
258051,26,0,26,1.311456,103.80627
258052,139,5,144,1.311422,103.806345
258053,27,0,27,1.311389,103.80642
258054,53,25,78,1.311355,103.806495
258055,24,10,34,1.311321,103.80657
258056,47,14,61,1.311287,103.806644
258057,114,2,116,1.311253,103.806719
258058,14,2,16,1.311219,103.806794
258059,296,49,345,1.311195,103.806859
258095,1,444,445,1.306349,103.825466
258096,0,4,4,1.306831,103.825028
258097,0,4,4,1.307177,103.824692
258098,17,4,21,1.306596,103.824793
258099,3,24,27,1.306229,103.825153
258117,226,80,306,1.314518,103.836958
258118,8,6,14,1.314194,103.836854
258119,4,0,4,1.314236,103.836881
258120,0,3,3,1.315194,103.825558
258121,3,8,11,1.314161,103.836716
258122,14,0,14,1.314224,103.836769
258123,2,16,18,1.314276,103.836836
258124,31,97,128,1.314202,103.836565
258125,454,91,545,1.314032,103.836508
258126,380,114,494,1.314028,103.836346
258127,545,13,558,1.313829,103.836284
258128,627,17,644,1.313685,103.836121
258129,393,167,560,1.313759,103.83611
258130,1250,902,2152,1.314333,103.836985
258147,10,1,11,1.319707,103.826429
258148,12,4,16,1.319554,103.826344
258149,24,0,24,1.319469,103.8263
258150,16,7,23,1.319787,103.826359
258151,7,1,8,1.319596,103.826144
258152,1,18,19,1.319152,103.826186
258153,74,5,79,1.319209,103.826153
258154,1,17,18,1.319276,103.826161
258155,9,16,25,1.318835,103.826073
258157,0,33,33,1.319097,103.826067
258159,321,52,373,1.319219,103.826105
258176,407,590,997,1.318867,103.828501
258177,6,303,309,1.319315,103.828533
258178,3,12,15,1.318658,103.828516
258179,42,7,49,1.318541,103.82851
258180,0,2,2,1.314732,103.824603
258181,0,1,1,1.31518,103.825794
258182,5,1,6,1.318546,103.828665
258183,0,1,1,1.318524,103.828792
258184,138,19,157,1.318497,103.828714
258185,7,0,7,1.318496,103.828713
258186,0,2,2,1.319146,103.828489
258187,1,1,2,1.318658,103.828516
258188,15,3,18,1.318488,103.828636
258189,0,2,2,1.318489,103.828637
258190,1,0,1,1.318808,103.828403
258191,0,10,10,1.318474,103.82848
258192,1,10,11,1.318192,103.828259
258193,11,14,25,1.318358,103.828432
258194,3,15,18,1.318393,103.828443
258195,19,15,34,1.318096,103.828258
258196,764,14,778,1.318088,103.828418
258197,2,66,68,1.318009,103.828268
258198,1,162,163,1.317993,103.828404
258199,18,19,37,1.317942,103.828282
258200,51,35,86,1.317792,103.828316
258201,119,0,119,1.317624,103.828348
258202,2,28,30,1.31753,103.82836
258203,1454,267,1721,1.317649,103.828489
258204,734,234,968,1.317408,103.828569
258205,21,3,24,1.317076,103.828117
258206,6,108,114,1.317047,103.828112
258207,7,34,41,1.317047,103.827791
258208,1055,46,1101,1.316651,103.828842
258210,424,88,512,1.31679,103.828136
258216,27,11,38,1.317232,103.828284
258217,14,0,14,1.317104,103.82815
258233,9,0,9,1.319778,103.826996
258234,5,11,16,1.31947,103.826815
258235,12,0,12,1.319399,103.826801
258236,19,24,43,1.319384,103.826801
258237,11,9,20,1.318824,103.827258
258238,9,2,11,1.319217,103.826736
258239,1,6,7,1.319282,103.826819
258240,4,0,4,1.319159,103.82675
258242,0,11,11,1.318911,103.826651
258243,64,1,65,1.318752,103.826542
258261,435,315,750,1.319629,103.827712
258262,0,141,141,1.319628,103.827711
258263,252,200,452,1.318984,103.828056
258264,12,24,36,1.319047,103.827608
258265,11,3,14,1.318844,103.827645
258266,48,15,63,1.318688,103.827645
258267,9,0,9,1.299509,103.837
258268,111,0,111,1.299509,103.837
258269,56,47,103,1.299509,103.837
258284,1,24,25,1.318825,103.826063
258285,3,1,4,1.318747,103.826196
258287,12,5,17,1.31872,103.82632
258288,29,1,30,1.31851,103.82646
258289,1,0,1,1.318475,103.828481
258290,6,2,8,1.31826,103.826427
258291,3,13,16,1.31826,103.826427
258292,0,3,3,1.314114,103.836664
258293,21,5,26,1.318251,103.826438
258294,15,9,24,1.318545,103.826573
258295,3,2,5,1.318544,103.826572
258296,44,5,49,1.318545,103.826573
258297,111,9,120,1.318627,103.826678
258299,18,12,30,1.317894,103.826995
258300,1,1,2,1.31847,103.828316
258301,13,2,15,1.317884,103.827005
258302,14,2,16,1.318458,103.82719
258303,3,1,4,1.318322,103.827179
258304,48,0,48,1.318414,103.827301
258305,10,2,12,1.317998,103.827648
258306,7,21,28,1.31838,103.827403
258307,2,3,5,1.318312,103.827605
258308,5,1,6,1.31773,103.827605
258309,0,14,14,1.318254,103.827798
258310,83,3,86,1.317803,103.827634
258311,2,2,4,1.31795,103.827692
258312,2,2,4,1.318097,103.82775
258313,4,3,7,1.318234,103.827798
258314,1,1,2,1.31852,103.826991
258315,0,3,3,1.31826,103.826427
258316,4,15,19,1.318321,103.827178
258317,1,3,4,1.318336,103.827115
258318,0,6,6,1.318336,103.827115
258320,4,4,8,1.31825,103.826437
258321,0,5,5,1.318336,103.827115
258322,1,8,9,1.318336,103.827115
258323,22,40,62,1.318337,103.827116
258324,21,9,30,1.317883,103.827004
258325,1,3,4,1.317883,103.827004
258326,0,6,6,1.317883,103.827004
258331,273,1706,1979,1.308331,103.828096
258332,132,27993,28125,1.30817,103.827936
258333,1558,1436,2994,1.308505,103.827455
258342,633,813,1446,1.308925,103.826906
258343,802,249,1051,1.309193,103.827734
258344,10,121,131,1.309366,103.826023
258346,71,109,180,1.3097,103.82584
258347,31,1639,1670,1.310221,103.82583
258350,29515,20522,50037,1.311266,103.826781
258351,718,3040,3758,1.312469,103.825139
258352,5362,1511,6873,1.312934,103.826019
258353,2005,1331,3336,1.309982,103.826387
258354,614,770,1384,1.313397,103.825775
258355,9868,3743,13611,1.307861,103.826836
258356,295,67,362,1.313137,103.825364
258357,430,7,437,1.313361,103.825296
258358,265,0,265,1.313586,103.825228
258359,341,0,341,1.313346,103.824818
258360,395,10,405,1.313949,103.824821
258361,311,136,447,1.313779,103.825033
258362,201,608,809,1.313379,103.825156
258363,28,17,45,1.313247,103.826532
258364,2578,57,2635,1.313679,103.826557
258370,75,13266,13341,1.307417,103.827373
258371,1277,109,1386,1.307124,103.826185
258372,39,106,145,1.307385,103.826948
258373,9,239,248,1.307634,103.825841
258374,74,257,331,1.307241,103.825421
258375,25,6,31,1.308361,103.825806
258376,251,480,731,1.307701,103.825356
258377,6,203,209,1.308872,103.825034
258378,618,428,1046,1.307616,103.82483
258379,683,0,683,1.30779,103.824126
258380,850,676,1526,1.308563,103.824731
258383,1,1,2,1.318321,103.827178
258384,25,2,27,1.309053,103.824133
258385,23,986,1009,1.308676,103.823861
258386,1227,33,1260,1.308358,103.823667
258387,217,3842,4059,1.308295,103.823866
258388,99,3438,3537,1.308331,103.823739
258389,32,3,35,1.30836,103.823601
258390,872,196,1068,1.309281,103.823386
258391,488,19,507,1.307896,103.823012
258392,14,5,19,1.308481,103.823267
258393,14,1,15,1.308531,103.823139
258394,61,0,61,1.30856,103.823002
258395,844,9291,10135,1.309141,103.82303
258396,181,0,181,1.309028,103.822955
258397,49,0,49,1.309169,103.82322
258398,30,45,75,1.309863,103.823338
258399,28,17,45,1.30863,103.821812
258400,3,1,4,1.309981,103.822459
258401,102,3,105,1.308808,103.821803
258402,92,5,97,1.309278,103.821089
258403,662,1,663,1.310398,103.82174
258404,8,1,9,1.310902,103.821894
258405,7,0,7,1.311443,103.822239
258406,25,0,25,1.311888,103.822312
258407,4,0,4,1.312264,103.822603
258408,55,196,251,1.31007,103.820631
258409,6,40,46,1.311053,103.82107
258410,20,3,23,1.311987,103.821271
258411,94,4,98,1.312258,103.821533
258412,23,2,25,1.313028,103.82149
258413,13,7,20,1.312115,103.822005
258414,3,0,3,1.318321,103.827178
258415,2,0,2,1.307898,103.824531
258416,21,15,36,1.312517,103.822274
258417,215,0,215,1.312887,103.822151
258418,9,12,21,1.310685,103.820284
258419,82,6,88,1.311826,103.821496
258420,30,8,38,1.311354,103.821178
258421,4,0,4,1.311653,103.82109
258422,17,23,40,1.311508,103.821542
258423,1897,264,2161,1.311899,103.819622
258424,61,1,62,1.311648,103.820647
258425,4,22,26,1.312358,103.819527
258426,82,4,86,1.312247,103.820835
258427,16,1,17,1.312469,103.821283
258428,25,3,28,1.312271,103.821077
258429,17,200,217,1.312228,103.819684
258430,1,1,2,1.312594,103.821977
258431,16,20,36,1.313034,103.819706
258432,10,0,10,1.313389,103.820031
258434,67,4,71,1.313242,103.819376
258435,3,35,38,1.313539,103.818935
258437,39,0,39,1.314546,103.82014
258438,5,23,28,1.314575,103.819754
258439,151,0,151,1.313798,103.818669
258440,23,0,23,1.314615,103.819493
258441,35,43,78,1.313695,103.819084
258442,34,1,35,1.314228,103.819507
258443,188,0,188,1.314481,103.819218
258444,1,30,31,1.314138,103.818999
258445,3,0,3,1.312375,103.821983
258446,3,0,3,1.313777,103.818764
258447,0,41,41,1.313776,103.818763
258448,60,13,73,1.315067,103.8188
258449,62,1,63,1.312344,103.820609
258450,119,4,123,1.313805,103.819924
258451,28,1,29,1.31432,103.820542
258452,24,83,107,1.30931,103.822237
258453,2,0,2,1.31296,103.82082
258454,30,209,239,1.309668,103.822133
258455,65,3,68,1.312537,103.819664
258456,5,1,6,1.312564,103.820204
258457,67,1,68,1.310899,103.821492
258458,412,10065,10477,1.306921,103.826601
258459,99,32,131,1.31011,103.820903
258460,1,1,2,1.309614,103.822748
258461,508,0,508,1.307345,103.8238
258462,305,0,305,1.308688,103.822786
258463,798,153,951,1.299509,103.837
258464,65,123,188,1.299509,103.837
258465,137,312,449,1.299509,103.837
258466,182,4,186,1.308206,103.821412
258467,1,3,4,1.307663,103.820798
258468,1831,300,2131,1.306959,103.822434
258469,1,15,16,1.307493,103.82285
258470,159,55,214,1.30706,103.82148
258471,36,3,39,1.307347,103.820989
258472,1432,209,1641,1.309514,103.819528
258473,2,1,3,1.313776,103.818763
258474,905,109,1014,1.310069,103.819213
258475,1,1,2,1.308128,103.824301
258477,6,5,11,1.308882,103.820303
258478,86,30,116,1.308828,103.820347
258479,17,7,24,1.308793,103.820372
258480,186,90,276,1.308751,103.820408
258482,862,882,1744,1.30671,103.821326
258484,348,5,353,1.305573,103.823716
258485,84,11,95,1.306411,103.82255
258486,26,96,122,1.299509,103.837
258498,66,339,405,1.307334,103.819589
258499,3823,42620,46443,1.307048,103.819726
258500,4648,23150,27798,1.307063,103.819973
258502,1082,155,1237,1.306573,103.820254
258503,98,6233,6331,1.306443,103.819839
258504,5,307,312,1.306495,103.820444
258506,29,403,432,1.306013,103.822268
258507,1731,1718,3449,1.305331,103.819227
258508,2636,123,2759,1.305145,103.820529
258509,2625,2110,4735,1.30523,103.821358
258510,65,444,509,1.30592,103.822316
258527,21,37,58,1.318647,103.825134
258528,2,0,2,1.309574,103.819306
258529,1,65,66,1.318677,103.825247
258530,8,1,9,1.317876,103.82479
258531,6,0,6,1.318697,103.825061
258532,0,1,1,1.318261,103.826428
258533,0,11,11,1.318717,103.824802
258534,2,4,6,1.318131,103.82451
258535,2,1,3,1.309363,103.819745
258536,70,7,77,1.318374,103.824467
258538,12,2,14,1.319389,103.824227
258539,6,1,7,1.318608,103.824478
258540,2,0,2,1.318725,103.824907
258541,171,29,200,1.319773,103.824232
258542,351,330,681,1.320509,103.824345
258543,21,4,25,1.318566,103.823771
258544,1,9,10,1.319575,103.824195
258545,2,0,2,1.319564,103.824247
258546,0,3,3,1.318161,103.824451
258547,30,2,32,1.318228,103.8237
258548,10,1,11,1.319111,103.824147
258549,1,0,1,1.318337,103.824518
258550,19,8,27,1.318906,103.824132
258552,16,6,22,1.318986,103.823582
258553,28,0,28,1.31833,103.823086
258554,15,0,15,1.319146,103.8236
258556,13,0,13,1.319434,103.823626
258557,38,1,39,1.318203,103.822974
258558,0,1,1,1.318553,103.823721
258559,2,4,6,1.318402,103.822998
258560,6,6,12,1.319629,103.823603
258561,88,1,89,1.319834,103.823369
258562,16,0,16,1.319827,103.823534
258563,18,11,29,1.31981,103.823715
258564,1,1,2,1.318184,103.823776
258565,90,1,91,1.319335,103.823282
258566,20,1,21,1.31935,103.823185
258567,13,1,14,1.319316,103.823161
258568,13,2,15,1.319297,103.823312
258569,54,0,54,1.318826,103.823476
258570,167,18,185,1.318831,103.823332
258571,11,13,24,1.318851,103.823149
258572,1,4,5,1.318879,103.822902
258573,4,1,5,1.318765,103.824364
258590,152,43,195,1.320707,103.822801
258591,162,18,180,1.320489,103.82269
258592,3,107,110,1.320829,103.822962
258593,17,2,19,1.320379,103.822713
258594,2,14,16,1.320649,103.822869
258595,14,3,17,1.319844,103.822518
258599,5,0,5,1.319576,103.822421
258600,4,7,11,1.320491,103.822788
258601,10,0,10,1.31945,103.822373
258602,42,0,42,1.320149,103.822665
258603,60,7,67,1.319276,103.822308
258605,27,0,27,1.319078,103.822237
258606,2,46,48,1.320027,103.822704
258607,91,2,93,1.319478,103.822538
258608,2,7,9,1.319407,103.822749
258609,2,0,2,1.319327,103.823477
258610,12,67,79,1.319436,103.822527
258611,30,0,30,1.319393,103.822653
258612,18,0,18,1.319408,103.822395
258613,84,0,84,1.319271,103.822342
258614,22,0,22,1.319175,103.82231
258616,6,1,7,1.319904,103.822577
258617,458,0,458,1.32113,103.823025
258633,18,54,72,1.311346,103.817862
258634,373,14,387,1.311435,103.818148
258635,154,68,222,1.311346,103.817862
258636,37,0,37,1.310784,103.818539
258637,9,0,9,1.310966,103.818747
258638,41,6,47,1.311677,103.818322
258639,0,1,1,1.319627,103.823641
258640,16,2,18,1.311818,103.818595
258641,8,2,10,1.311534,103.818646
258642,1,6,7,1.311905,103.81881
258643,14,1,15,1.311392,103.818671
258648,0,1,1,1.310415,103.819008
258650,1,0,1,1.312269,103.818961
258651,56,0,56,1.3126,103.818816
258652,3,12,15,1.312756,103.818754
258670,1311,11,1322,1.31042,103.825058
258671,29,190,219,1.311222,103.824441
258672,240,48,288,1.310011,103.823916
258673,11,91,102,1.310564,103.824206
258674,1,0,1,1.312435,103.818888
258675,5,1,6,1.310705,103.823842
258676,0,6,6,1.310365,103.822955
258677,9,1,10,1.310447,103.823771
258678,5,5,10,1.310584,103.822588
258679,14,2,16,1.320649,103.822869
258680,4,7,11,1.310389,103.823265
258681,7,0,7,1.311,103.823474
258682,13,1,14,1.311207,103.823116
258683,92,9,101,1.310797,103.822813
258684,6,0,6,1.310826,103.822942
258685,2022,1654,3676,1.310721,103.825475
258686,1,1,2,1.319415,103.822816
258687,9,2,11,1.310642,103.822478
258702,19,378,397,1.318522,103.83065
258703,19,3,22,1.318195,103.830499
258704,4,30,34,1.318413,103.830622
258705,71,48,119,1.31832,103.830582
258706,11,32,43,1.318214,103.830548
258707,208,241,449,1.31794,103.830371
258708,27,322,349,1.317937,103.8305
258709,2370,0,2370,1.318146,103.830456
258710,2753,211,2964,1.317258,103.829975
258711,900,296,1196,1.316873,103.830541
258712,7,3,10,1.317692,103.830349
258714,0,222,222,1.317589,103.830328
258716,0,1088,1088,1.317493,103.830293
258718,1,77,78,1.317379,103.830259
258720,4,4,8,1.317255,103.830218
258743,39,468,507,1.321973,103.814223
258745,0,1,1,1.31074,103.824065
258746,0,9,9,1.322055,103.813802
258747,2,28,30,1.322067,103.813674
258748,1581,671,2252,1.322372,103.81374
258749,20,1503,1523,1.322095,103.813526
258767,2,15,17,1.32132,103.813594
258768,1,2,3,1.319392,103.824179
258769,1,0,1,1.322028,103.813945
258770,40,6,46,1.321382,103.813633
258771,3,0,3,1.32103,103.814293
258772,14,0,14,1.321509,103.813669
258773,3,2,5,1.32158,103.813684
258774,5,2,7,1.321655,103.813701
258775,1,0,1,1.321351,103.813622
258776,26,2,28,1.321298,103.813556
258777,8,332,340,1.321544,103.813227
258778,3,0,3,1.321444,103.813656
258794,7,0,7,1.321053,103.813651
258795,1,24,25,1.321114,103.813688
258796,3,12,15,1.320951,103.813555
258797,134,19,153,1.321071,103.813648
258798,2,0,2,1.31097,103.822207
258799,2,0,2,1.320745,103.813364
258800,66,0,66,1.32054,103.813172
258802,71,1,72,1.320335,103.81298
258803,5,1,6,1.320818,103.813411
258804,5,0,5,1.32013,103.812788
258805,2,25,27,1.320733,103.813332
258806,27,0,27,1.320649,103.813253
258807,58,1,59,1.320077,103.812979
258808,19,2,21,1.320564,103.813174
258809,2,0,2,1.320987,103.813569
258810,19,8,27,1.32048,103.813095
258811,58,4,62,1.31986,103.812697
258812,64,4,68,1.320395,103.813017
258813,5,4,9,1.319714,103.812609
258815,5,7,12,1.320226,103.812859
258816,5,0,5,1.320142,103.81278
258817,2,4,6,1.320057,103.812701
258819,3,2,5,1.319888,103.812543
258820,8,0,8,1.319804,103.812464
258821,3,2,5,1.319719,103.812385
258823,0,1,1,1.321683,103.813699
258824,5,0,5,1.319481,103.812233
258825,0,7,7,1.319396,103.812158
258827,5,1,6,1.31935,103.811996
258828,2,2,4,1.319252,103.811858
258849,24,594,618,1.307927,103.809316
258850,15,2003,2018,1.308709,103.808757
258851,59,387,446,1.308709,103.808757
258852,102,16,118,1.30812,103.807787
258853,743,989,1732,1.309859,103.808127
258854,17,6,23,1.307969,103.806955
258855,63,5,68,1.308435,103.807339
258856,3,10,13,1.308435,103.807339
258857,48,0,48,1.307676,103.807508
258858,6,160,166,1.30998,103.806794
258859,438,218,656,1.309072,103.808163
258860,21,18,39,1.308727,103.807255
258861,5,7,12,1.308727,103.807255
258862,4,2,6,1.308725,103.806551
258863,23,1,24,1.308045,103.806565
258864,1,2,3,1.321146,103.813737
258865,9,9,18,1.309291,103.806603
258866,3,246,249,1.309714,103.807462
258867,70,3,73,1.309352,103.806229
258868,287,617,904,1.30956,103.80626
258869,144,211,355,1.309713,103.805839
258870,399,424,823,1.310939,103.804663
258871,11,1270,1281,1.310857,103.804619
258873,501,146,647,1.311092,103.804308
258875,275,248,523,1.311328,103.804254
258878,3,25,28,1.308709,103.808757
258879,4,3,7,1.308727,103.807255
258881,40,266,306,1.30901,103.807182
258882,13,20,33,1.309357,103.807569
258883,8,9,17,1.309093,103.806911
258884,25,10,35,1.309136,103.806839
258885,62,5,67,1.309198,103.806577
258886,10,2,12,1.309263,103.806484
258887,1605,181,1786,1.309356,103.806978
258895,6,15,21,1.299509,103.837
258896,55,2,57,1.311493,103.834751
258897,31,10,41,1.312884,103.834157
258898,5,7,12,1.311548,103.835456
258899,34,5,39,1.31234,103.835415
258900,34,0,34,1.312347,103.834244
258901,10,9,19,1.31262,103.83528
258902,68,36,104,1.313115,103.835406
258903,43,90,133,1.313115,103.835406
258904,80,3,83,1.312608,103.835912
258905,106,21,127,1.313175,103.835232
258906,80,46,126,1.313609,103.835011
258907,5,3,8,1.313941,103.83491
258908,54,3,57,1.314153,103.834294
258909,33,16,49,1.313474,103.833308
258910,28,6,34,1.314006,103.833446
258911,4,3,7,1.313769,103.834405
258912,16,3,19,1.313188,103.832871
258913,0,127,127,1.312801,103.832162
258930,8,0,8,1.31587,103.81029
258931,99,44,143,1.31587,103.81029
258932,9,0,9,1.316027,103.810035
258933,3,6,9,1.316196,103.80997
258934,35,11,46,1.31648,103.810154
258935,0,5,5,1.316786,103.809842
258936,10,0,10,1.31649,103.810164
258937,2,0,2,1.319966,103.812885
258938,11,0,11,1.316402,103.810314
258939,2,3,5,1.316324,103.810453
258940,21,40,61,1.316256,103.810583
258960,2,1,3,1.309901,103.80704
258961,333,35,368,1.313985,103.811861
258965,101,21,122,1.314167,103.809978
258966,63,3,66,1.314022,103.811691
258967,69,0,69,1.314321,103.811803
258968,0,1,1,1.319561,103.812268
258969,28,1,29,1.314886,103.811959
258970,26,2,28,1.314886,103.811959
258971,11,0,11,1.314886,103.811959
258973,49,2,51,1.315507,103.811991
258974,10,4,14,1.313773,103.811476
258975,12,4,16,1.314206,103.811186
258976,13,12,25,1.314452,103.810994
258977,9,0,9,1.314693,103.810847
258978,0,5,5,1.316006,103.810617
258980,0,2,2,1.316441,103.810244
258983,94,0,94,1.314725,103.81217
258984,19,4,23,1.314578,103.812586
258985,68,2,70,1.314782,103.812323
258986,32,11,43,1.314678,103.812983
258987,33,0,33,1.314894,103.81263
258988,111,7,118,1.315241,103.81272
258989,31,7,38,1.315007,103.812936
258990,1,15,16,1.314206,103.811186
258991,68,0,68,1.317256,103.810205
258992,2,13,15,1.318093,103.810711
258993,15,0,15,1.317914,103.810184
258994,1,0,1,1.314886,103.811959
258995,12,1,13,1.317975,103.810914
258996,11,19,30,1.31809,103.811681
258998,22,8,30,1.3181,103.811671
258999,4,9,13,1.317804,103.811147
259000,3,9,12,1.318946,103.811647
259001,2,2,4,1.31809,103.811661
259002,2,2,4,1.318927,103.811635
259003,9,14,23,1.319122,103.811505
259004,9,0,9,1.319095,103.811427
259005,2,0,2,1.317087,103.81084
259006,0,424,424,1.319,103.811125
259007,3,6,9,1.319158,103.811573
259008,0,65,65,1.319855,103.811407
259009,197,6,203,1.31534,103.812105
259010,1194,29,1223,1.314127,103.811899
259011,353,4,357,1.3143,103.811956
259012,22,0,22,1.315588,103.811405
259013,2,0,2,1.319043,103.811271
259026,1,3,4,1.318909,103.811719
259027,2,0,2,1.299509,103.837
259028,3,1,4,1.318813,103.811901
259029,0,1,1,1.317586,103.811804
259030,16,1,17,1.317956,103.81247
259031,5,0,5,1.317663,103.81236
259049,976,473,1449,1.314571,103.825867
259050,11,12,23,1.314636,103.825904
259051,2,0,2,1.318875,103.811795
259052,5,17,22,1.31478,103.826141
259053,0,6,6,1.31474,103.826071
259054,1,132,133,1.314555,103.825729
259055,14,20,34,1.314708,103.825997
259056,54,0,54,1.31469,103.825959
259057,3,92,95,1.314508,103.825638
259058,399,9,408,1.31464,103.825842
259059,5,27,32,1.314623,103.825804
259060,12,2,14,1.314603,103.825754
259062,3,22,25,1.314474,103.825546
259063,15,1,16,1.314565,103.825672
259064,8,1,9,1.314549,103.825632
259065,21,1,22,1.314533,103.8256
259066,6,1,7,1.314518,103.825557
259067,2,18,20,1.314435,103.82545
259068,26,2,28,1.314425,103.825279
259069,4,138,142,1.314401,103.82537
259070,9,3,12,1.314323,103.825032
259071,0,52,52,1.314452,103.825526
259072,2,4,6,1.314261,103.824873
259073,32,41,73,1.314408,103.825429
259074,4,0,4,1.314266,103.8249
259075,9,13,22,1.314309,103.825197
259076,0,35,35,1.314274,103.825122
259077,78,15,93,1.314246,103.825067
259078,103,13,116,1.314222,103.825005
259079,54,35,89,1.314202,103.824928
259080,2,0,2,1.314589,103.825813
259091,21,1,22,1.313975,103.824362
259092,17,1,18,1.31395,103.824297
259093,6,11,17,1.314334,103.824654
259094,57,0,57,1.314004,103.824442
259095,0,19,19,1.314324,103.824566
259096,1,0,1,1.318283,103.812547
259098,18,50,68,1.314274,103.824421
259099,15,4,19,1.31386,103.824077
259101,83,95,178,1.314165,103.824243
259102,4,15,19,1.314096,103.824186
259103,6,0,6,1.313945,103.824282
259104,17,3,20,1.314055,103.824058
259105,145,25,170,1.313941,103.824262
259106,2,0,2,1.314251,103.824836
259108,2,12,14,1.313998,103.823954
259109,1,0,1,1.313989,103.824403
259110,17,5,22,1.313946,103.823885
259112,0,63,63,1.313892,103.824151
259113,0,18,18,1.313907,103.823782
259116,6,65,71,1.313877,103.82368
259117,1012,0,1012,1.313663,103.823622
259118,4,4,8,1.31319,103.823524
259119,3,2,5,1.312287,103.823736
259120,0,7,7,1.312197,103.823963
259121,18,0,18,1.313227,103.823489
259123,45,4,49,1.312923,103.823175
259125,12,0,12,1.313008,103.822788
259126,13,1,14,1.312877,103.823093
259127,236,2,238,1.31287,103.823147
259128,0,1,1,1.313904,103.82418
259129,1,6,7,1.312814,103.823285
259131,6,8,14,1.31181,103.823641
259132,34,0,34,1.311655,103.823546
259133,16,0,16,1.314565,103.825672
259134,16,0,16,1.311685,103.823642
259135,0,1,1,1.312829,103.82326
259136,2,11,13,1.31178,103.82418
259137,1062,181,1243,1.311728,103.824495
259138,57,422,479,1.311298,103.824514
259139,5,24,29,1.314662,103.825896
259140,16,11,27,1.312876,103.823275
259141,9,24,33,1.313344,103.823528
259142,13,0,13,1.313363,103.82354
259143,14,0,14,1.313321,103.823529
259144,11,0,11,1.31328,103.823506
259145,126,82,208,1.313089,103.823413
259146,3,0,3,1.313724,103.810551
259147,3,0,3,1.313153,103.823448
259148,4,0,4,1.313042,103.823398
259149,4,0,4,1.313054,103.823402
259150,51,0,51,1.312995,103.823391
259151,16,0,16,1.311685,103.823642
259152,33,0,33,1.312916,103.823367
259153,15,0,15,1.312938,103.823361
259154,1,24,25,1.314337,103.825249
259156,40,5,45,1.313511,103.82393
259157,7,21,28,1.313503,103.823784
259158,23,1,24,1.313401,103.82414
259159,1,0,1,1.311857,103.823717
259161,42,2,44,1.31336,103.824074
259162,15,8,23,1.313263,103.824295
259163,0,7,7,1.313286,103.824211
259164,74,1,75,1.313178,103.824321
259165,85,17,102,1.312587,103.824212
259166,15,1,16,1.313084,103.824349
259167,106,0,106,1.312618,103.82412
259168,32,24,56,1.312645,103.824035
259169,2,4,6,1.312997,103.824378
259170,465,7,472,1.312658,103.824005
259171,21,10,31,1.312854,103.824418
259172,1,0,1,1.313406,103.823966
259173,23,19,42,1.312763,103.824434
259174,7,1,8,1.312695,103.82387
259175,44,25,69,1.312574,103.824328
259176,29,2,31,1.312771,103.823613
259177,34,25,59,1.312533,103.82432
259178,0,1,1,1.312671,103.823966
259179,53,6,59,1.312497,103.824296
259180,0,1,1,1.312712,103.823666
259181,0,8,8,1.312269,103.824195
259182,32,4,36,1.312607,103.824023
259183,4,7,11,1.312106,103.824073
259184,10,0,10,1.312592,103.824097
259185,3,20,23,1.312557,103.824194
259186,2,8,10,1.299509,103.837
259187,25,0,25,1.299509,103.837
259203,22,2,24,1.312568,103.822767
259204,4,0,4,1.312449,103.822995
259205,1,2,3,1.313102,103.82343
259207,16,1,17,1.312239,103.82324
259208,5,1,6,1.31236,103.823183
259209,4,0,4,1.312321,103.823252
259210,5,1,6,1.312289,103.82332
259211,161,1,162,1.312408,103.823084
259225,85,121,206,1.319813,103.811606
259226,56,5,61,1.319869,103.811659
259227,7,67,74,1.319868,103.811658
259228,14,43,57,1.31998,103.811763
259229,4,0,4,1.319979,103.811762
259230,1,8,9,1.320092,103.811868
259231,4,12,16,1.313084,103.824349
259232,4,0,4,1.320204,103.811972
259233,4,52,56,1.320203,103.811971
259234,0,64,64,1.320315,103.812077
259235,0,3,3,1.312457,103.822846
259236,0,66,66,1.320427,103.812181
259237,0,8,8,1.320426,103.81218
259239,5,105,110,1.320538,103.812285
259240,510,107,617,1.319577,103.809597
259242,1,0,1,1.312634,103.823958
259243,5,454,459,1.320762,103.812495
259245,15,885,900,1.320722,103.811664
259246,2,0,2,1.313926,103.824237
259247,5,18,23,1.320873,103.812599
259248,8,95,103,1.320986,103.812704
259249,2,0,2,1.320874,103.8126
259250,1,15,16,1.321097,103.812809
259251,10,11,21,1.321096,103.812808
259252,1,3,4,1.321209,103.812913
259253,1,40,41,1.321208,103.812912
259255,0,59,59,1.32132,103.813017
259256,1,7,8,1.321432,103.813122
259258,4,64,68,1.321534,103.813217
259275,815,996,1811,1.315886,103.80661
259276,343,159,502,1.315106,103.806727
259277,99,38,137,1.315106,103.806727
259278,451,18,469,1.315106,103.806727
259279,1198,32,1230,1.313866,103.806496
259280,1280,99,1379,1.311483,103.805479
259281,1697,123,1820,1.311971,103.805706
259282,1653,165,1818,1.312504,103.805984
259283,1534,271,1805,1.31338,103.806052
259284,23,4,27,1.313015,103.806629
259285,21,31,52,1.313015,103.806625
259286,478,17,495,1.313324,103.806977
259287,187,13,200,1.313815,103.807043
259288,537,69,606,1.31412,103.807817
259289,782,68,850,1.313484,103.808304
259290,569,27,596,1.313454,103.807863
259291,571,88,659,1.312729,103.807296
259292,731,33,764,1.312112,103.80704
259293,836,90,926,1.312275,103.806517
259294,497,41,538,1.312071,103.806337
259295,540,32,572,1.311878,103.806792
259296,77,42,119,1.314139,103.806388
259297,15,24,39,1.299509,103.837
259298,14,9,23,1.299509,103.837
259313,213,62,275,1.316511,103.832534
259316,15,22,37,1.316022,103.831783
259323,5,43,48,1.316518,103.830906
259324,986,30,1016,1.316536,103.831778
259325,448,225,673,1.316317,103.830894
259326,637,181,818,1.316597,103.831607
259327,556,86,642,1.316063,103.830752
259328,315,241,556,1.316727,103.831077
259329,354,49,403,1.316208,103.830536
259330,214,80,294,1.316267,103.830419
259332,821,150,971,1.316645,103.83039
259333,151,86,237,1.317187,103.829341
259335,724,22,746,1.316664,103.82989
259336,1,33,34,1.316937,103.829912
259338,10,96,106,1.316656,103.829796
259340,1,2,3,1.320314,103.812076
259342,771,33,804,1.31765,103.829158
259343,429,71,500,1.317156,103.829168
259344,587,43,630,1.31719,103.831119
259345,290,170,460,1.316869,103.829315
259346,52,20,72,1.299509,103.837
259361,98,46,144,1.316504,103.819086
259362,170,28,198,1.315959,103.81904
259363,3,127,130,1.317606,103.819558
259364,95,89,184,1.317924,103.819704
259365,69,116,185,1.318142,103.819772
259366,1055,1429,2484,1.318499,103.819515
259367,521,0,521,1.318608,103.819974
259368,25,234,259,1.317535,103.819242
259369,40,45,85,1.318308,103.819859
259370,12,11,23,1.318436,103.819926
259372,83,61,144,1.321366,103.821101
259373,7,437,444,1.321651,103.82041
259385,170,44,214,1.310111,103.830757
259386,20,373,393,1.310337,103.831637
259387,239,46,285,1.310716,103.831877
259388,16,146,162,1.310965,103.831474
259389,4,6,10,1.31102,103.831393
259390,5,3,8,1.310959,103.831313
259391,22,28,50,1.310993,103.831255
259392,7,36,43,1.31113,103.831106
259393,86,10,96,1.311193,103.831163
259394,21,33,54,1.311155,103.830898
259395,13,197,210,1.310991,103.830953
259396,1662,502,2164,1.311727,103.831282
259397,31,257,288,1.312011,103.831388
259398,192,0,192,1.31201,103.831388
259399,58,50,108,1.311989,103.831521
259400,5,4,9,1.311993,103.831523
259401,200,5,205,1.311825,103.831685
259402,80,12,92,1.311797,103.831694
259403,708,310,1018,1.310621,103.831812
259404,1854,24,1878,1.310506,103.832262
259405,1082,27,1109,1.311427,103.832064
259420,827,361,1188,1.309174,103.830876
259421,361,186,547,1.309001,103.83043
259422,1,119,120,1.308213,103.830188
259423,2,621,623,1.30833,103.830091
259424,7,4616,4623,1.308811,103.830248
259426,524,422,946,1.31019,103.83105
259428,409,266,675,1.309625,103.830611
259446,7,0,7,1.315283,103.820673
259448,21,9,30,1.315611,103.819241
259449,51,1,52,1.315514,103.819398
259450,16,5,21,1.315449,103.819584
259451,2,0,2,1.320985,103.812703
259452,2,2,4,1.31498,103.81972
259454,13,6,19,1.314446,103.82153
259455,10,2,12,1.314325,103.821826
259456,52,0,52,1.314119,103.821834
259457,4,0,4,1.313953,103.821947
259458,9,36,45,1.313746,103.822113
259459,14,8,22,1.314887,103.82094
259460,109,0,109,1.313815,103.822186
259461,7,11,18,1.31424,103.821923
259462,13,11,24,1.314586,103.822105
259463,10,4,14,1.314612,103.822271
259464,9,2,11,1.315077,103.823792
259465,11,1,12,1.315158,103.824067
259466,13,2,15,1.315231,103.824289
259467,0,4,4,1.31532,103.824556
259468,2,2,4,1.315397,103.824722
259469,313,57,370,1.315655,103.824997
259476,3,4,7,1.315178,103.82369
259485,8,239,247,1.315979,103.825578
259487,1,0,1,1.32065,103.81239
259489,57,70,127,1.315957,103.825539
259490,1,0,1,1.315951,103.825483
259495,8,0,8,1.315399,103.824174
259498,60,46,106,1.315902,103.825127
259499,74,3,77,1.315955,103.825244
259500,40,504,544,1.316102,103.825538
259501,219,224,443,1.316165,103.825632
259502,13,13,26,1.315745,103.820005
259503,206,0,206,1.31554,103.819871
259504,0,2,2,1.315291,103.820345
259505,23,0,23,1.314753,103.822445
259506,0,1,1,1.315399,103.824174
259507,17,0,17,1.314794,103.822776
259508,2,0,2,1.314721,103.82225
259509,17,7,24,1.314984,103.823238
259510,1,5,6,1.314806,103.823072
259511,11,2,13,1.299509,103.837
259512,184,82,266,1.299509,103.837
259519,44,15,59,1.316195,103.820445
259520,80,5,85,1.315933,103.820622
259521,4,17,21,1.315933,103.820622
259522,17,0,17,1.317196,103.820158
259523,0,40,40,1.316849,103.81956
259524,3,3,6,1.317489,103.820441
259525,157,13,170,1.317489,103.820441
259526,58,0,58,1.317489,103.820441
259527,95,14,109,1.316529,103.821092
259528,44,2,46,1.316486,103.82129
259529,53,0,53,1.316582,103.821434
259530,98,0,98,1.316929,103.821594
259531,119,2,121,1.317244,103.821616
259532,10,5,15,1.317551,103.821839
259533,32,2,34,1.317643,103.821871
259534,51,1,52,1.317639,103.821778
259535,19,3,22,1.317575,103.821573
259536,0,5,5,1.317319,103.821493
259537,58,22,80,1.316881,103.821199
259538,103,4,107,1.318221,103.821285
259539,14,2,16,1.321097,103.812809
259540,39,54,93,1.319865,103.821247
259541,6,3,9,1.319817,103.821418
259542,47,32,79,1.320217,103.821386
259543,123,10,133,1.320143,103.82152
259544,6,12,18,1.320564,103.821504
259545,40,1,41,1.320303,103.821605
259546,10,0,10,1.320511,103.821648
259547,96,1,97,1.320596,103.821757
259548,219,216,435,1.321052,103.821893
259549,4,6,10,1.320944,103.821808
259551,0,272,272,1.321258,103.82192
259552,57,0,57,1.315952,103.820299
259553,16,0,16,1.316448,103.820954
259554,9,0,9,1.315933,103.820622
259555,1179,247,1426,1.320911,103.821642
259556,1,0,1,1.314847,103.822882
259557,14,11,25,1.31947,103.821295
259558,41,10,51,1.317192,103.820169
259559,6,2,8,1.299509,103.837
259560,16,4,20,1.299509,103.837
259569,8906,14327,23233,1.311125,103.814733
259570,235,120,355,1.309428,103.818401
259571,3,1,4,1.309953,103.818513
259572,9,66,75,1.309637,103.817961
259573,12,0,12,1.310041,103.818184
259574,7,42,49,1.310299,103.818137
259575,164,0,164,1.311533,103.817332
259576,12,15,27,1.311713,103.817212
259577,71,30,101,1.312321,103.817063
259578,10,0,10,1.312129,103.817857
259579,11,0,11,1.312211,103.81825
259580,8,0,8,1.312433,103.817478
259581,189,0,189,1.312443,103.818045
259582,6,29,35,1.313006,103.817066
259583,29,23,52,1.313841,103.817383
259584,15,14,29,1.314327,103.81741
259585,62,0,62,1.318819,103.81398
259586,108,2,110,1.319772,103.813774
259587,61,12,73,1.321229,103.814101
259588,10,145,155,1.321295,103.814111
259589,5,0,5,1.321411,103.814088
259590,7,10,17,1.320867,103.814245
259591,8,1,9,1.320982,103.81427
259592,31,126,157,1.32104,103.814283
259593,42,51,93,1.31087,103.817805
259594,661,4,665,1.322144,103.814171
259595,610,945,1555,1.322153,103.814107
259596,8,18,26,1.312442,103.818044
259597,812,0,812,1.316764,103.818017
259598,21,2,23,1.316489,103.817211
259599,250,41,291,1.317786,103.816998
259600,1226,137,1363,1.318074,103.816506
259601,34,19,53,1.318459,103.816228
259602,234,76,310,1.318833,103.816122
259603,135,125,260,1.319346,103.816629
259604,239,425,664,1.320671,103.818448
259605,2,0,2,1.315527,103.823191
259606,3,33,36,1.299509,103.837
259607,49,363,412,1.299509,103.837
259610,11,12,23,1.317939,103.815267
259611,11,49,60,1.318066,103.814655
259612,71,523,594,1.318383,103.814004
259613,20,0,20,1.31742,103.814753
259614,21,6,27,1.31716,103.814544
259615,82,0,82,1.317256,103.814316
259616,41,9,50,1.318065,103.814654
259617,8,11,19,1.318065,103.814654
259618,14,0,14,1.316865,103.813948
259619,64,137,201,1.318263,103.813333
259621,3,0,3,1.316574,103.829748
259622,87,18,105,1.319216,103.813589
259623,2,0,2,1.299509,103.837
259624,4,4,8,1.319049,103.813347
259625,144,24,168,1.319221,103.813269
259626,42,1,43,1.319136,103.812852
259627,7,19,26,1.318263,103.813333
259628,12,4,16,1.316448,103.820954
259629,27,10,37,1.318253,103.813323
259630,2,42,44,1.319049,103.813327
259631,26,0,26,1.319089,103.812723
259633,26,0,26,1.318261,103.812976
259634,19,3,22,1.318249,103.812847
259649,14,15,29,1.316522,103.815091
259650,18,20,38,1.316535,103.81507
259651,0,2,2,1.319432,103.813419
259652,52,0,52,1.31656,103.814968
259653,3,2,5,1.316831,103.814283
259654,112,1,113,1.316016,103.814124
259655,14,0,14,1.316548,103.813992
259656,27,0,27,1.315612,103.813246
259657,32,0,32,1.315745,103.812885
259658,9,1,10,1.318192,103.813603
259659,4,0,4,1.316766,103.81275
259660,71,0,71,1.316819,103.812344
259661,3,2,5,1.31725,103.813194
259662,8,2,10,1.31728,103.812336
259666,42,0,42,1.31754,103.81275
259667,0,40,40,1.316909,103.812916
259670,38,0,38,1.317706,103.813179
259671,1,3,4,1.317449,103.813098
259672,2,2,4,1.31577,103.812535
259673,102,1,103,1.316098,103.812502
259675,7,0,7,1.315885,103.813884
259676,1,0,1,1.320605,103.821918
259677,1,11,12,1.316979,103.812798
259681,120,0,120,1.317291,103.812959
259682,74,33,107,1.316529,103.813485
259683,23,16,39,1.316258,103.812949
259684,14,16,30,1.31672,103.813176
259685,17,1,18,1.299509,103.837
259686,30,0,30,1.299509,103.837
259687,12,0,12,1.299509,103.837
259689,11,609,620,1.313478,103.838034
259690,95,295,390,1.314864,103.836704
259691,19,193,212,1.315295,103.836902
259692,14,100,114,1.315394,103.836822
259693,5,7,12,1.315344,103.836867
259694,0,1,1,1.315714,103.81355
259695,1,2,3,1.318402,103.813333
259696,15,190,205,1.314915,103.836144
259697,1,63,64,1.315615,103.836644
259698,1,603,604,1.315661,103.836603
259699,5,23,28,1.315716,103.836554
259700,0,7,7,1.315101,103.836298
259701,0,15,15,1.31504,103.83623
259702,0,24,24,1.314995,103.836164
259703,1242,65,1307,1.314094,103.836001
259704,2022,543,2565,1.315115,103.835517
259705,1144,22,1166,1.314262,103.835362
259708,2509,14400,16909,1.316498,103.835472
259709,678,566,1244,1.317356,103.833578
259710,206,46,252,1.317561,103.833244
259711,778,13,791,1.317697,103.832876
259712,34,689,723,1.317568,103.832902
259713,0,142,142,1.317564,103.832866
259714,196,60,256,1.317131,103.833071
259715,221,390,611,1.317812,103.832508
259716,8,29,37,1.317593,103.832205
259717,82,811,893,1.318068,103.831972
259718,1998,726,2724,1.317997,103.831561
259719,1612,527,2139,1.317921,103.830987
259720,0,57,57,1.318791,103.830595
259721,6,427,433,1.318822,103.830503
259722,3,1,4,1.318856,103.830413
259723,14,1,15,1.318862,103.830364
259724,1788,909,2697,1.318184,103.829818
259725,2208,981,3189,1.318301,103.829375
259726,44,206,250,1.318924,103.828914
259727,922,348,1270,1.31975,103.82731
259728,21,292,313,1.319852,103.826987
259729,2,0,2,1.316534,103.815069
259731,2,3,5,1.319934,103.826788
259732,2,368,370,1.319956,103.826712
259734,2,0,2,1.319883,103.826917
259735,4,281,285,1.320015,103.826573
259736,18,378,396,1.299509,103.837
259738,401,33,434,1.320325,103.823711
259739,12,419,431,1.32078,103.823642
259740,6,2,8,1.320557,103.82362
259741,173,1,174,1.320362,103.82361
259742,221,43,264,1.320285,103.8237
259743,1,179,180,1.320778,103.823467
259745,10,332,342,1.321049,103.823128
259750,253,329,582,1.321064,103.822658
259751,6,3,9,1.320747,103.81996
259756,89,182,271,1.319298,103.816877
259760,2544,9854,12398,1.322784,103.814529
259765,65,1054,1119,1.322851,103.81397
259768,20,4,24,1.299509,103.837
259769,1228,214,1442,1.321086,103.818099
259770,618,116,734,1.319325,103.817322
259771,55,224,279,1.319584,103.817437
259772,2070,346,2416,1.319743,103.817486
259773,68,63,131,1.318741,103.818082
259774,16,594,610,1.318978,103.817652
259775,10,8,18,1.318396,103.81743
259776,1382,169,1551,1.318318,103.816878
259777,1874,10969,12843,1.322485,103.818276
259778,13,16,29,1.319861,103.826532
259779,5,60,65,1.312872,103.837682
259784,137,1179,1316,1.313333,103.830196
259785,109,329,438,1.313748,103.830639
259786,820,107,927,1.314457,103.830499
259787,628,202,830,1.314233,103.831809
259788,1039,75,1114,1.314689,103.830594
259790,5,12,17,1.315098,103.830837
259791,5,4,9,1.315169,103.830863
259792,762,2255,3017,1.314694,103.832202
259796,155,290,445,1.314279,103.831172
259797,145,40,185,1.314644,103.831135
259798,691,184,875,1.314632,103.831673
259799,44,86,130,1.315469,103.831991
259800,3,13,16,1.315029,103.832935
259801,1421,906,2327,1.314956,103.831841
259802,24,479,503,1.315408,103.833316
259803,249,443,692,1.315794,103.832209
259804,11,22,33,1.315773,103.832931
259805,388,166,554,1.315949,103.832948
259806,700,905,1605,1.316502,103.833126
259807,7,111,118,1.316487,103.833206
259808,764,14,778,1.316445,103.833765
259809,4,164,168,1.316677,103.833658
259810,90,54,144,1.317089,103.833881
259811,406,167,573,1.316899,103.834478
259816,791,52,843,1.315288,103.83168
259817,387,32,419,1.315385,103.831144
259818,475,78,553,1.315651,103.831419
259819,527,279,806,1.316093,103.831623
259820,2289,661,2950,1.314913,103.832927
259821,20,109,129,1.313333,103.830196
259822,206,31,237,1.314223,103.830443
259824,0,2,2,1.319998,103.826617
259826,1,2,3,1.314881,103.836373
259827,1,18,19,1.299509,103.837
259828,1,0,1,1.315466,103.836764
259829,430,14,444,1.315065,103.827273
259830,1102,234,1336,1.315236,103.82722
259831,10,91,101,1.314556,103.827474
259833,4,32,36,1.314556,103.827474
259835,6,1,7,1.314556,103.827474
259836,0,4,4,1.314556,103.827474
259837,1,1,2,1.31514,103.832625
259839,5,16,21,1.314556,103.827474
259840,0,10,10,1.314556,103.827474
259841,19,37,56,1.31552,103.827327
259842,55,3,58,1.315604,103.827436
259843,9,3,12,1.315561,103.827426
259844,1281,117,1398,1.316097,103.827934
259845,855,194,1049,1.316323,103.828145
259846,336,51,387,1.31551,103.82791
259847,1830,336,2166,1.314441,103.828035
259848,610,85,695,1.314913,103.828603
259849,136,114,250,1.315539,103.828357
259850,2191,90,2281,1.315938,103.829071
259851,12,163,175,1.315524,103.829195
259852,744,313,1057,1.315864,103.829713
259853,3,63,66,1.315421,103.829513
259854,895,164,1059,1.315524,103.830203
259855,1091,149,1240,1.315229,103.8299
259856,1799,34,1833,1.315251,103.829201
259858,953,152,1105,1.314714,103.829375
259859,41,197,238,1.31466,103.829236
259860,262,64,326,1.314766,103.829264
259861,55,25,80,1.314722,103.829238
259862,98,31,129,1.31466,103.829236
259864,31,69,100,1.314522,103.829193
259865,206,9,215,1.315806,103.827556
259866,402,121,523,1.314778,103.826844
259882,345,67,412,1.315794,103.83408
259884,221,253,474,1.315686,103.833557
259885,79,4,83,1.315532,103.833665
259886,80,5,85,1.315511,103.833942
259887,20,121,141,1.315311,103.834099
259888,613,64,677,1.315444,103.834297
259889,559,132,691,1.314672,103.834088
259895,1800,288,2088,1.315754,103.834547
259896,218,93,311,1.314742,103.834613
259900,1,92,93,1.315911,103.834932
259902,4,6,10,1.31592,103.835088
259904,7,3,10,1.299509,103.837
259905,702,123,825,1.31555,103.834824
259906,4,67,71,1.299509,103.837
259909,34,11,45,1.299509,103.837
259910,847,847,1694,1.316153,103.835046
259912,3,13,16,1.315029,103.832935
259913,9,4,13,1.316153,103.835046
259914,94,1,95,1.316153,103.835046
259915,2,7,9,1.316153,103.835046
259916,341,0,341,1.316297,103.834527
259917,481,1126,1607,1.316508,103.834893
259918,256,32,288,1.316047,103.834207
259920,210,0,210,1.316271,103.834325
259921,6,202,208,1.316306,103.834371
259922,2,38,40,1.31634,103.834422
259923,0,17,17,1.31638,103.834479
259924,2,54,56,1.316381,103.834756
259925,2,74,76,1.316335,103.834796
259926,1,52,53,1.316278,103.834824
259927,9,1206,1215,1.316227,103.834876
259928,570,5,575,1.315059,103.83473
259929,56,11,67,1.316153,103.835046
259945,165,1247,1412,1.310248,103.827866
259947,2205,423,2628,1.309352,103.82821
259948,17,373,390,1.309674,103.828061
259949,8,164,172,1.309898,103.827565
259950,331,1374,1705,1.308378,103.828571
259951,9,492,501,1.308733,103.829668
259953,547,565,1112,1.309164,103.830319
259954,1488,461,1949,1.309894,103.828674
259955,3574,17,3591,1.309401,103.829723
259956,110,206,316,1.309401,103.829723
259957,3339,181,3520,1.309401,103.829723
259959,2742,797,3539,1.310549,103.829488
259960,909,204,1113,1.308689,103.829069
259961,43,12,55,1.309999,103.829219
259962,2029,1613,3642,1.309796,103.827559
259963,63,1351,1414,1.308871,103.830064
259977,110,2968,3078,1.310866,103.828352
259978,1196,344,1540,1.31172,103.828974
259983,7174,961,8135,1.309444,103.826661
259984,1532,264,1796,1.312418,103.828298
259985,836,117,953,1.312927,103.828235
259986,908,828,1736,1.3126,103.829048
259987,9,131,140,1.31151,103.827765
260001,344,6396,6740,1.31755,103.806668
260002,70,8827,8897,1.31755,103.806668
260003,614,593,1207,1.318329,103.807862
260004,1206,146,1352,1.318187,103.807265
260005,337,595,932,1.316842,103.80729
260006,364,198,562,1.316842,103.80729
260007,385,9406,9791,1.316358,103.80569
260008,958,4,962,1.317179,103.806296
261006,61,887,948,1.316787,103.807338
261008,157,751,908,1.316827,103.806351
266084,0,19,19,1.299509,103.837
266085,0,5,5,1.299509,103.837
266098,1,1,2,1.314556,103.827474
266100,1,10,11,1.299509,103.837
266102,0,1,1,1.299509,103.837
266106,0,1,1,1.299509,103.837
266110,0,1,1,1.299509,103.837
266112,2,0,2,1.299509,103.837
266114,0,1,1,1.299509,103.837
266116,0,2,2,1.299509,103.837
266118,0,3,3,1.299509,103.837
266120,0,5,5,1.299509,103.837
266122,0,3,3,1.299509,103.837
266124,0,1,1,1.299509,103.837
266136,1,0,1,1.299509,103.837
266137,14,0,14,1.299509,103.837
266138,0,1,1,1.299509,103.837
266140,0,1,1,1.299509,103.837
266142,0,2,2,1.299509,103.837
266148,0,1,1,1.299509,103.837
266164,0,3,3,1.299509,103.837
266204,17,64,81,1.299509,103.837
266205,52,40,92,1.299509,103.837
266206,9,16,25,1.299509,103.837
266213,5,7,12,1.299509,103.837
266214,354,27,381,1.299509,103.837
266215,466,2,468,1.299509,103.837
266216,653,43,696,1.314062,103.802611
266217,467,148,615,1.314062,103.802611
266218,10,17,27,1.299509,103.837
266219,365,493,858,1.314251,103.802347
266220,395,760,1155,1.381935,103.745595
266224,3849,296,4145,1.314655,103.801596
266225,2858,805,3663,1.314578,103.803154
266226,95,288,383,1.299509,103.837
266227,93,51,144,1.313829,103.803964
266228,508,13,521,1.299509,103.837
266229,4,10,14,1.321557,103.792417
266230,2,5,7,1.321557,103.792417
266231,1,16,17,1.321557,103.792417
266232,48,3,51,1.321557,103.792417
266233,19,0,19,1.321557,103.792417
266234,4,0,4,1.321557,103.792417
266235,18,0,18,1.321557,103.792417
266236,1,0,1,1.299509,103.837
266237,1,2,3,1.299509,103.837
266238,22,0,22,1.321557,103.792417
266239,41,0,41,1.321557,103.792417
266240,40,0,40,1.321557,103.792417
266241,3,2,5,1.321557,103.792417
266242,20,0,20,1.321557,103.792417
266243,24,0,24,1.321557,103.792417
266244,13,0,13,1.321557,103.792417
266245,5,0,5,1.321557,103.792417
266246,6,0,6,1.321557,103.792417
266247,4,0,4,1.321557,103.792417
266248,12,2,14,1.321557,103.792417
266249,9,0,9,1.321557,103.792417
266250,11,0,11,1.321322,103.792992
266251,7,0,7,1.321343,103.793039
266252,3,0,3,1.321557,103.792417
266254,39,0,39,1.32099,103.792727
266255,22,1,23,1.320986,103.792808
266256,14,0,14,1.321033,103.792814
266257,3,0,3,1.320907,103.792604
266258,244,0,244,1.321052,103.792908
266259,22,0,22,1.32108,103.792973
266261,12,0,12,1.321146,103.793073
266262,42,0,42,1.321164,103.793104
266263,1,0,1,1.321557,103.792417
266264,11,1,12,1.322183,103.79459
266265,25,0,25,1.322183,103.79459
266266,4,1,5,1.322183,103.79459
266268,596,2276,2872,1.325363,103.807799
266269,12,1,13,1.321606,103.791875
266270,5,8,13,1.321606,103.791875
266271,4,1,5,1.32156,103.791212
266273,1,0,1,1.322183,103.79459
266274,176,0,176,1.321049,103.791765
266275,16,1,17,1.321082,103.791799
266276,40,0,40,1.321074,103.791849
266277,11,0,11,1.321071,103.791932
266278,9,0,9,1.321067,103.791982
266279,16,0,16,1.321037,103.79205
266280,31,1,32,1.320883,103.792077
266281,306,0,306,1.32088,103.792017
266282,28,1,29,1.320888,103.791936
266283,3,0,3,1.321068,103.792902
266284,0,1,1,1.321051,103.791686
266285,2,0,2,1.299509,103.837
266286,181,0,181,1.320899,103.791718
266287,3,1,4,1.320927,103.791695
266288,7,0,7,1.320927,103.791615
266289,5,0,5,1.32094,103.79156
266290,3,1,4,1.320931,103.791535
266291,7,2,9,1.320918,103.791443
266292,2,0,2,1.320899,103.791769
266293,3,0,3,1.320886,103.791917
266294,28,2,30,1.321557,103.792417
266295,20,2,22,1.321557,103.792417
266296,64,8,72,1.321557,103.792417
266297,7,32,39,1.321557,103.792417
266298,7,43,50,1.321557,103.792417
266299,7,1,8,1.321914,103.797296
266300,88,20,108,1.322272,103.797943
266301,14,2,16,1.321037,103.79205
266302,0,15,15,1.317213,103.805087
266303,2,0,2,1.320943,103.791389
266304,38,4,42,1.322752,103.810778
266305,58,1,59,1.322752,103.810778
266306,25,5,30,1.322752,103.810778
266307,163,2,165,1.322752,103.810778
266308,4,1,5,1.322752,103.810778
266309,4,16,20,1.322752,103.810778
266310,889,2,891,1.324546,103.80151
266311,1210,1,1211,1.324372,103.800929
266312,991,12,1003,1.323796,103.800982
266313,884,8,892,1.323896,103.801614
266314,364,6,370,1.324282,103.801596
266315,3,4,7,1.321052,103.796768
266316,3,9,12,1.322028,103.797594
266317,7,15,22,1.322029,103.797595
266318,2,4,6,1.323281,103.807025
266319,132,3,135,1.322714,103.799382
266320,19,2,21,1.318335,103.792908
266321,24,11,35,1.316688,103.791789
266322,45,0,45,1.322485,103.798785
266324,1,3,4,1.32347,103.799636
266325,1,0,1,1.320918,103.791829
266326,40,0,40,1.323449,103.799545
266327,22,0,22,1.323438,103.799499
266328,3,0,3,1.32094,103.791337
266329,5,0,5,1.323418,103.799407
266330,14,0,14,1.323463,103.799519
266331,29,0,29,1.323463,103.799519
266332,81,0,81,1.323463,103.799519
266333,2,1,3,1.323428,103.799453
266334,6,0,6,1.324041,103.799347
266335,35,0,35,1.324114,103.799344
266336,64,0,64,1.324212,103.799402
266337,4,0,4,1.324299,103.799408
266338,246,20,266,1.324353,103.799694
266339,8,0,8,1.323558,103.800387
266340,40,17,57,1.323589,103.800501
266341,398,1,399,1.32357,103.800416
266342,44,1,45,1.32355,103.80033
266343,7,0,7,1.323531,103.800244
266344,304,3,307,1.323511,103.800159
266345,72,5,77,1.323487,103.800126
266347,6,0,6,1.323453,103.80001
266348,44,10,54,1.323434,103.799924
266349,39,0,39,1.323414,103.799838
266350,46,1,47,1.323394,103.799753
266351,1,1,2,1.322752,103.810778
266352,9,0,9,1.323355,103.799581
266353,178,8,186,1.323336,103.799496
266354,77,4,81,1.323316,103.79941
266356,25,16,41,1.322128,103.800661
266357,9,5,14,1.31872,103.806787
266358,409,410,819,1.317672,103.80585
266359,1,20,21,1.319689,103.807819
266360,175,4,179,1.322694,103.800486
266361,85,36,121,1.322869,103.799827
266362,47,5,52,1.322831,103.800027
266363,36,8,44,1.322818,103.800177
266364,3,1,4,1.322809,103.800332
266365,6,3,9,1.322783,103.80044
266366,4,39,43,1.32134,103.796724
266368,17,3,20,1.318972,103.806492
266369,107,14,121,1.319104,103.806423
266370,38,30,68,1.318949,103.806469
266371,7,7,14,1.319121,103.806439
266372,95,14,109,1.318903,103.806424
266373,0,5,5,1.319154,103.806471
266374,0,2,2,1.323375,103.799667
266375,15,10,25,1.319188,103.806503
266377,2,2,4,1.319222,103.806534
266378,72,2,74,1.318764,103.80629
266379,15,5,20,1.319255,103.806566
266380,3,7,10,1.318718,103.806245
266381,1,2,3,1.323463,103.799519
266382,92,0,92,1.318321,103.805593
266383,41,4,45,1.319323,103.80663
266384,1,1,2,1.318857,103.806379
266385,11,6,17,1.319357,103.806662
266386,27,2,29,1.31858,103.80611
266387,3,8,11,1.31939,103.806694
266388,9,5,14,1.318534,103.806065
266389,4,4,8,1.319424,103.806725
266390,1,0,1,1.32346,103.799591
266391,8,4,12,1.319458,103.806757
266392,6,0,6,1.318442,103.805976
266393,11,4,15,1.319491,103.806789
266394,45,1,46,1.318395,103.805931
266395,3,3,6,1.319525,103.806821
266396,56,1,57,1.318349,103.805886
266397,0,2,2,1.318626,103.806155
266398,129,6,135,1.318303,103.805841
266399,2,0,2,1.319559,103.806853
266400,33,6,39,1.318842,103.8061
266401,4,0,4,1.319626,103.806917
266403,6,9,15,1.31966,103.806948
266405,1,0,1,1.318488,103.80602
266407,66,1,67,1.319727,103.807012
266409,7,1,8,1.319749,103.807036
266411,66,4,70,1.319779,103.807072
266413,234,6,240,1.31981,103.807109
266415,3,0,3,1.319289,103.806598
266417,1,2,3,1.31984,103.807145
266419,34,3,37,1.31962,103.806588
266420,220,0,220,1.319318,103.80583
266421,67,4,71,1.319531,103.806571
266422,41,0,41,1.319348,103.80586
266423,9,0,9,1.319461,103.806488
266424,47,2,49,1.319409,103.805918
266425,10,0,10,1.319412,103.806452
266426,40,6,46,1.31947,103.805977
266427,4,2,6,1.319356,103.806348
266428,4,3,7,1.319501,103.806007
266429,0,14,14,1.319284,103.80631
266430,116,3,119,1.319533,103.806036
266431,57,37,94,1.319504,103.806029
266433,2,10,12,1.319537,103.806061
266434,0,1,1,1.319693,103.80698
266435,34,4,38,1.319605,103.806124
266436,1,0,1,1.319658,103.806155
266437,15,16,31,1.319672,103.806188
266438,25,3,28,1.319784,103.806274
266439,0,1,1,1.319721,103.806215
266440,5,1,6,1.319847,103.806333
266441,1,1,2,1.319906,103.807444
266442,53,0,53,1.31991,103.806393
266443,8,2,10,1.319874,103.806379
266444,4,2,6,1.319972,103.806452
266445,0,1,1,1.319739,103.806252
266446,0,15,15,1.320035,103.806512
266447,1,9,10,1.320008,103.806506
266448,17,2,19,1.320098,103.806571
266449,2,4,6,1.320076,103.80657
266450,6,3,9,1.320161,103.80663
266451,9,1,10,1.320143,103.806633
266452,6,2,8,1.320224,103.80669
266453,15,13,28,1.32021,103.806697
266454,2,11,13,1.320286,103.806749
266455,102,0,102,1.320277,103.806761
266456,111,34,145,1.320349,103.806809
266457,29,17,46,1.320345,103.806824
266458,10,2,12,1.320412,103.806868
266459,2,0,2,1.319806,103.806315
266460,40,4,44,1.319246,103.807284
266461,22,5,27,1.319168,103.807203
266462,9,2,11,1.319088,103.807122
266463,2,2,4,1.319038,103.807074
266464,0,4,4,1.318959,103.806997
266465,1,58,59,1.318879,103.80692
266466,2,9,11,1.3188,103.806844
266467,1,4,5,1.31872,103.806767
266468,6,4,10,1.318678,103.80673
266469,51,13,64,1.318595,103.806657
266470,1,4,5,1.318511,103.806584
266471,8,22,30,1.318428,103.80651
266472,0,5,5,1.318344,103.806437
266473,1,49,50,1.31826,103.806364
266474,18,0,18,1.324186,103.80305
266475,61,0,61,1.324179,103.803019
266476,19,2,21,1.324173,103.802989
266477,20,0,20,1.324167,103.802958
266478,6,20,26,1.317237,103.804422
266479,1,0,1,1.319941,103.806442
266480,5,7,12,1.317236,103.804421
266481,45,2,47,1.317236,103.804421
266483,2,6,8,1.317338,103.804496
266484,30,1,31,1.317495,103.804278
266485,0,3,3,1.31987,103.807181
266487,17,0,17,1.317534,103.804245
266488,16,0,16,1.317495,103.804298
266489,0,1,1,1.317236,103.804421
266491,4,0,4,1.318263,103.804283
266492,442,49,491,1.318409,103.804922
266493,1,5,6,1.318263,103.804283
266494,6,9,15,1.318679,103.804011
266495,3,0,3,1.317534,103.804245
266496,44,2,46,1.319456,103.80408
266497,0,1,1,1.317607,103.804347
266498,1,0,1,1.320503,103.804468
266499,63,0,63,1.320703,103.804376
266500,13,5,18,1.320827,103.803842
266501,80,1,81,1.321221,103.804423
266502,4,0,4,1.320946,103.803306
266505,3,0,3,1.319073,103.80404
266506,9,11,20,1.32029,103.802564
266507,15,0,15,1.320894,103.803788
266508,3,4,7,1.320893,103.803787
266509,2,9,11,1.319917,103.803433
266510,9,0,9,1.320962,103.803384
266511,118,0,118,1.3203,103.803035
266514,106,9,115,1.320835,103.802564
266515,66,4,70,1.320834,103.802563
266516,47,0,47,1.320036,103.802312
266517,15,2,17,1.32091,103.80226
266518,27,0,27,1.320152,103.802349
266520,15,1,16,1.317495,103.804298
266521,15,11,26,1.320825,103.802554
266523,9,0,9,1.321306,103.801697
266524,6,3,9,1.321306,103.801697
266525,142,11,153,1.321684,103.801587
266527,148,11,159,1.32188,103.801621
266528,113,34,147,1.322528,103.80168
266530,1,12,13,1.317753,103.804155
266531,0,4,4,1.317773,103.804279
266532,2,12,14,1.317773,103.804279
266533,2,19,21,1.320309,103.804418
266534,27,0,27,1.299509,103.837
266547,1,8,9,1.31866,103.803688
266548,11,54,65,1.318659,103.803687
266549,0,16,16,1.318954,103.802948
266550,272,7,279,1.318659,103.803707
266551,1,3,4,1.318826,103.802643
266552,24,2,26,1.319088,103.802115
266553,1,2,3,1.321264,103.803945
266554,3,0,3,1.31958,103.801772
266555,35,13,48,1.319105,103.803325
266556,14,0,14,1.319314,103.802937
266557,10,1,11,1.31884,103.802434
266573,1,3,4,1.329916,103.798689
266574,16,1,17,1.329459,103.798692
266576,3,8,11,1.329561,103.798378
266577,11,0,11,1.329772,103.798058
266578,64,0,64,1.329156,103.798811
266579,17,0,17,1.329392,103.798191
266580,17,0,17,1.328889,103.798723
266581,10,3,13,1.329081,103.798171
266582,17,1,18,1.328635,103.798566
266583,106,30,136,1.328855,103.798114
266584,76,2,78,1.328354,103.798481
266585,12,2,14,1.328578,103.797979
266586,6,0,6,1.328359,103.797821
266588,52,6,58,1.328039,103.797836
266589,16,0,16,1.318954,103.802948
266592,20,1,21,1.327518,103.798435
266593,10,30,40,1.327501,103.797656
266594,3,0,3,1.319119,103.802469
266595,7,3,10,1.327679,103.797888
266596,17,1,18,1.327439,103.797806
266597,70,50,120,1.327153,103.797144
266598,15,1,16,1.327199,103.797723
266599,0,2,2,1.320402,103.806878
266600,79,15,94,1.327682,103.796904
266601,18,0,18,1.328185,103.797
266618,4,51,55,1.322197,103.812538
266619,7,1,8,1.322197,103.812538
266620,2,3,5,1.322061,103.812407
266621,276,398,674,1.321928,103.812348
266622,2,0,2,1.327521,103.796916
266624,0,2,2,1.321924,103.812275
266625,138,163,301,1.321523,103.811959
266626,1,2,3,1.327919,103.797971
266628,20,11,31,1.321515,103.811882
266630,230,89,319,1.320833,103.811245
266632,2,18,20,1.321106,103.811488
266633,60,13,73,1.320969,103.811356
266634,17,36,53,1.320913,103.811261
266635,1,30,31,1.322005,103.812288
266637,129,42,171,1.321016,103.811445
266652,7,20,27,1.32959,103.799691
266653,25,13,38,1.329073,103.79987
266654,2,0,2,1.321788,103.812144
266655,18,11,29,1.328748,103.799735
266656,10,1,11,1.32931,103.799628
266657,3,9,12,1.328518,103.799647
266658,10,0,10,1.329001,103.799516
266660,2,2,4,1.328692,103.799403
266661,153,0,153,1.328227,103.799313
266662,26,10,36,1.328022,103.799221
266663,2,2,4,1.327781,103.799439
266664,51,2,53,1.328383,103.799291
266665,10,12,22,1.328075,103.799178
266666,33,1,34,1.327663,103.799048
266667,38,1,39,1.327766,103.799066
266668,15,1,16,1.327199,103.797723
266669,10,0,10,1.327457,103.798953
266670,13,3,16,1.327091,103.798893
266671,72,10,82,1.327341,103.798885
266672,0,9,9,1.326761,103.798754
266673,3,8,11,1.327151,103.798799
266674,46,8,54,1.326926,103.798713
266675,50,0,50,1.299509,103.837
266692,18,7,25,1.320993,103.800805
266693,9,10,19,1.32077,103.801452
266694,1,0,1,1.320224,103.804158
266695,4,0,4,1.320664,103.801416
266696,1,0,1,1.321728,103.800833
266697,49,2,51,1.320451,103.801342
266698,22,0,22,1.321507,103.800825
266699,23,0,23,1.320237,103.801269
266700,22,1,23,1.32125,103.800805
266701,4,0,4,1.320024,103.801196
266703,13,3,16,1.320034,103.801186
266704,19,21,40,1.320451,103.801322
266705,13,6,19,1.320877,103.801469
266706,0,4,4,1.320982,103.800845
266707,0,5,5,1.320972,103.800904
266708,55,1,56,1.320202,103.800837
266709,6,24,30,1.320846,103.799806
266710,2,0,2,1.329496,103.799662
266711,5,10,15,1.320782,103.800144
266712,6,5,11,1.32013,103.800196
266713,90,2,92,1.320171,103.799927
266714,103,9,112,1.320372,103.799818
266715,4,3,7,1.32096,103.801852
266733,5,6,11,1.322762,103.811193
266734,39,276,315,1.322901,103.811631
266735,1,13,14,1.322866,103.811418
266736,36,7,43,1.322726,103.811297
266737,8,0,8,1.322694,103.811253
266738,21,0,21,1.322645,103.811159
266739,67,2,69,1.322644,103.811158
266740,4,7,11,1.322191,103.810725
266741,9,0,9,1.32245,103.810982
266742,14,3,17,1.32245,103.81098
266743,154,5,159,1.322077,103.810573
266744,16,3,19,1.322147,103.810788
266745,8,4,12,1.321971,103.810834
266746,119,21,140,1.321158,103.809768
266747,69,5,74,1.32107,103.809672
266748,25,12,37,1.320906,103.809575
266749,6,2,8,1.320847,103.809524
266750,1,2,3,1.321651,103.812013
266751,16,4,20,1.320609,103.80932
266752,18,0,18,1.32049,103.809217
266753,1,2,3,1.320728,103.809422
266754,3,0,3,1.320371,103.809115
266755,5,3,8,1.320132,103.808911
266756,2,2,4,1.320013,103.808809
266759,1,0,1,1.321607,103.80083
266760,5,23,28,1.319666,103.808477
266761,1,42,43,1.319587,103.808393
266762,4,7,11,1.319347,103.808235
266763,7,7,14,1.319277,103.808171
266764,34,49,83,1.319136,103.808044
266765,1,16,17,1.318994,103.807918
266766,1,18,19,1.318853,103.807791
266767,3,13,16,1.318712,103.807664
266768,2,43,45,1.318571,103.807537
266769,6,28,34,1.318429,103.807411
266770,5,17,22,1.318428,103.80741
266771,8,12,20,1.318288,103.807284
266772,17,21,38,1.318157,103.807167
266773,30,4,34,1.318147,103.807157
266774,4,16,20,1.31785,103.806895
266775,12,13,25,1.317564,103.806643
266776,1,36,37,1.317563,103.806642
266777,6,7,13,1.322006,103.810452
266778,16,36,52,1.322353,103.810841
266779,31,22,53,1.322288,103.810767
266780,12,3,15,1.321406,103.809966
266781,2,2,4,1.321288,103.809862
266782,12,37,49,1.32292,103.811496
266783,72,4,76,1.322804,103.811382
266795,26,1,27,1.316548,103.790124
266796,1,4,5,1.316737,103.789814
266797,5,0,5,1.316937,103.789533
266799,32,3,35,1.317477,103.788911
266800,7,5,12,1.317153,103.789753
266802,16,4,20,1.31767,103.788677
266803,84,17,101,1.317924,103.788476
266804,6,3,9,1.317461,103.78999
266805,18,0,18,1.31772,103.790176
266806,22,2,24,1.318272,103.790522
266807,5,0,5,1.318708,103.790676
266808,2,5,7,1.319126,103.790775
266809,33,0,33,1.319453,103.790715
266810,50,2,52,1.319645,103.790937
266811,2,1,3,1.320252,103.809013
266812,5,1,6,1.319721,103.79027
266813,1,0,1,1.319709,103.808529
266814,25,0,25,1.319878,103.78995
266815,0,23,23,1.319941,103.789898
266816,4,0,4,1.320039,103.789945
266817,149,19,168,1.32001,103.790015
266818,11,0,11,1.319932,103.790204
266819,10,2,12,1.319783,103.79038
266820,45,3,48,1.320443,103.790932
266821,131,0,131,1.320837,103.791023
266822,1,0,1,1.319845,103.790091
266823,41,0,41,1.31938,103.790979
266824,26,8,34,1.319007,103.790906
266825,6,10,16,1.3187,103.79087
266826,1,6,7,1.317876,103.790438
266827,7,1,8,1.317617,103.790216
266828,5,2,7,1.317245,103.789958
266829,4,2,6,1.316767,103.790514
266830,49,1,50,1.31704,103.790775
266831,58,5,63,1.318006,103.791542
266832,16,1,17,1.318679,103.791787
266833,121,2,123,1.318847,103.791862
266834,6,0,6,1.319032,103.791949
266835,39,14,53,1.318765,103.791961
266836,29,17,46,1.318296,103.791785
266837,16,0,16,1.317813,103.791631
266838,80,1,81,1.317424,103.791374
266839,37,39,76,1.316919,103.790813
266840,33,0,33,1.318411,103.79079
266841,6,0,6,1.31896,103.792048
266844,56,12,68,1.317381,103.791153
266845,55,36,91,1.317217,103.791169
266846,28,1,29,1.317999,103.790312
266847,1,0,1,1.319591,103.79102
266848,16,1,17,1.318523,103.790879
266849,93,15,108,1.299509,103.837
266857,7,10,17,1.317842,103.788844
266858,13,3,16,1.317813,103.791631
266859,13,0,13,1.317967,103.788932
266860,2,3,5,1.31805,103.78901
266861,12,26,38,1.318216,103.789106
266863,6,34,40,1.318215,103.789105
266864,6,0,6,1.318215,103.789105
266865,26,5,31,1.318273,103.789188
266866,72,0,72,1.318337,103.789277
266867,22,0,22,1.318336,103.789276
266868,2,0,2,1.320141,103.800565
266869,9,0,9,1.318336,103.789276
266870,1,1,2,1.318336,103.789276
266871,8,11,19,1.318447,103.789552
266872,11,0,11,1.318446,103.789551
266873,9,0,9,1.318446,103.789551
266875,1,2,3,1.319559,103.790426
266877,13,0,13,1.318668,103.789724
266880,24,11,35,1.319187,103.789767
266881,20,0,20,1.318961,103.789777
266882,5,1,6,1.319177,103.789757
266900,46,0,46,1.324437,103.808923
266901,9,8,17,1.324576,103.808882
266902,5,4,9,1.324337,103.80884
266903,9,34,43,1.324603,103.808918
266904,11,1,12,1.324248,103.808773
266905,4,6,10,1.324075,103.808647
266906,7,1,8,1.323942,103.808555
266907,1,0,1,1.299509,103.837
266908,0,1,1,1.324324,103.808727
266909,9,1,10,1.323741,103.808424
266910,9,0,9,1.32374,103.808423
266911,16,0,16,1.324146,103.808624
266912,8,37,45,1.324146,103.808624
266913,3,1,4,1.323972,103.808505
266914,10,23,33,1.323972,103.808505
266915,7,3,10,1.323406,103.808214
266917,88,0,88,1.323779,103.808384
266918,3,1,4,1.323274,103.808116
266919,37,26,63,1.323579,103.808249
266920,23,2,25,1.323579,103.808249
266921,7,0,7,1.323208,103.80807
266923,2,5,7,1.323426,103.808159
266924,105,20,125,1.323077,103.807977
266925,73,0,73,1.322946,103.807885
266926,3,3,6,1.322815,103.807792
266927,0,3,3,1.318762,103.789776
266928,3,6,9,1.323287,103.808055
266929,1,10,11,1.322553,103.807608
266931,31,5,36,1.322422,103.807515
266932,2,0,2,1.318427,103.789552
266933,81,8,89,1.322291,103.807423
266934,2,6,8,1.322981,103.807853
266935,28,0,28,1.32216,103.80733
266937,0,2,2,1.323072,103.80792
266938,0,1,1,1.324324,103.808727
266939,3,0,3,1.322684,103.8077
266940,54,1,55,1.322712,103.807651
266941,40,23,63,1.322017,103.807282
266942,11,0,11,1.322627,103.807587
266943,2,0,2,1.322125,103.807328
266944,22,0,22,1.322479,103.807473
266945,3,1,4,1.322388,103.807419
266946,0,2,2,1.322553,103.80752
266947,26,3,29,1.322213,103.807277
266948,40,2,42,1.322126,103.807213
266949,0,5,5,1.322025,103.807146
266950,2,1,3,1.322082,103.807306
266951,10,1,11,1.32354,103.808293
266952,1,1,2,1.322308,103.807345
266953,22,0,22,1.324197,103.808743
266967,3,4,7,1.323967,103.80927
266969,4,3,7,1.323784,103.809192
266970,50,3,53,1.323667,103.809116
266971,2,2,4,1.32355,103.809041
266972,24,1,25,1.323433,103.808966
266974,0,1,1,1.322806,103.807705
266975,3,0,3,1.32374,103.808423
266976,9,3,12,1.322976,103.808674
266977,2,2,4,1.322929,103.808636
266978,8,0,8,1.322892,103.808608
266979,0,1,1,1.3232,103.808815
266982,8,2,10,1.322744,103.808497
266983,2,0,2,1.324352,103.808881
266984,3,3,6,1.32267,103.808442
266986,83,1,84,1.322596,103.808386
266987,1,0,1,1.322914,103.808645
266988,1,0,1,1.322552,103.808373
266989,6,0,6,1.322448,103.808295
266990,48,2,50,1.322441,103.808044
266991,18,0,18,1.324076,103.80938
266992,1,15,16,1.324146,103.808624
267008,28,224,252,1.314526,103.791345
267009,40,115,155,1.314646,103.791247
267010,1,0,1,1.322522,103.808331
267011,19,3,22,1.314986,103.791189
267012,0,1,1,1.314827,103.791179
267013,1,0,1,1.315171,103.791222
267014,2,2,4,1.315431,103.791345
267015,1,0,1,1.315272,103.791277
267016,93,5,98,1.315637,103.791606
267017,45,16,61,1.315682,103.791792
267018,166,1,167,1.315781,103.792137
267019,14,3,17,1.316155,103.792668
267021,4,5,9,1.31582,103.792405
267022,0,37,37,1.315879,103.792722
267023,2,0,2,1.322759,103.808528
267024,16,0,16,1.315031,103.792855
267025,1,5,6,1.31503,103.793052
267026,170,15,185,1.314892,103.793293
267027,2,0,2,1.315889,103.792712
267028,3,1,4,1.314768,103.793655
267029,15,0,15,1.31474,103.793575
267030,31,6,37,1.314802,103.793267
267031,12,0,12,1.314755,103.793274
267032,34,1,35,1.314712,103.793241
267033,7,0,7,1.314614,103.793234
267034,75,69,144,1.313805,103.793091
267035,16,21,37,1.31443,103.793188
267036,94,11,105,1.314173,103.792301
267037,1,55,56,1.314462,103.791437
267038,0,35,35,1.314367,103.791687
267039,2,1,3,1.323083,103.808739
267040,9,0,9,1.314603,103.792226
267041,16,1,17,1.315021,103.792845
267042,1,0,1,1.315516,103.791466
267043,2,69,71,1.314467,103.792862
267044,2,25,27,1.314892,103.793273
267045,7,4,11,1.314881,103.793145
267046,48,1,49,1.315116,103.792673
267047,23,0,23,1.315427,103.792595
267048,28,3,31,1.315712,103.792524
267049,9,0,9,1.315645,103.792185
267050,7,6,13,1.315579,103.791885
267052,6,1,7,1.315267,103.791358
267053,15,3,18,1.314889,103.79127
267054,1,5,6,1.314657,103.791348
267055,2,0,2,1.31486,103.793477
267057,2,0,2,1.314664,103.791767
267058,83,1,84,1.31486,103.792157
267059,5,0,5,1.315685,103.792072
267060,26,3,29,1.314957,103.7924
267078,2,0,2,1.315676,103.792029
267080,83,6,89,1.325552,103.797978
267081,2,15,17,1.325705,103.797824
267082,5,0,5,1.325445,103.797983
267085,14,0,14,1.325307,103.797967
267086,121,4,125,1.324887,103.798028
267087,92,13,105,1.325032,103.797976
267088,8,9,17,1.324757,103.797985
267089,11,3,14,1.324692,103.798166
267090,0,3,3,1.314736,103.792136
267091,56,0,56,1.324655,103.798206
267092,2,14,16,1.324204,103.798201
267093,50,0,50,1.325817,103.797592
267094,6,0,6,1.325825,103.797751
267095,27,0,27,1.325791,103.797785
267096,2,1,3,1.324498,103.79816
267109,8,2,10,1.326255,103.793844
267110,5,12,17,1.32639,103.794015
267111,4,13,17,1.326338,103.793882
267113,4,0,4,1.326418,103.793954
267114,1,0,1,1.314245,103.792662
267115,4,1,5,1.326393,103.794029
267116,119,2,121,1.326252,103.794317
267117,1,0,1,1.326307,103.794196
267118,13,1,14,1.326197,103.794438
267119,3,0,3,1.299509,103.837
267120,7,2,9,1.326141,103.79456
267121,25,0,25,1.326086,103.794681
267122,4,0,4,1.326219,103.79441
267123,0,1,1,1.326368,103.794083
267124,16,3,19,1.326169,103.794519
267125,15,2,17,1.325975,103.794923
267126,6,2,8,1.326119,103.794628
267127,9,2,11,1.32592,103.795044
267130,3,2,5,1.32597,103.794955
267131,63,25,88,1.32593,103.795054
267149,2,2,4,1.323483,103.798965
267150,13,6,19,1.323484,103.798955
267151,7,1,8,1.323477,103.798907
267152,57,11,68,1.323455,103.79879
267153,7,2,9,1.323461,103.79881
267154,0,1,1,1.326031,103.794802
267155,0,2,2,1.325872,103.797712
267156,4,1,5,1.32343,103.798617
267157,33,0,33,1.323399,103.798439
267158,21,0,21,1.323398,103.798438
267159,4,0,4,1.323415,103.798521
267160,25,2,27,1.32338,103.798323
267161,11,14,25,1.3234,103.798424
267162,17,0,17,1.323362,103.798206
267163,5,0,5,1.323384,103.798328
267164,3,7,10,1.323343,103.798089
267165,3,10,13,1.323369,103.798232
267166,18,0,18,1.323324,103.797972
267167,17,4,21,1.323353,103.798135
267168,32,0,32,1.323306,103.797856
267169,8,0,8,1.323338,103.798039
267170,8,0,8,1.323287,103.797739
267171,6,15,21,1.323323,103.797942
267172,84,0,84,1.323268,103.797622
267173,24,12,36,1.323307,103.797846
267174,22,0,22,1.32325,103.797505
267176,4,7,11,1.323277,103.797653
267177,52,0,52,1.323261,103.797556
267178,141,0,141,1.323246,103.79746
267179,2,1,3,1.326318,103.794192
267180,7,0,7,1.32323,103.797364
267181,14,3,17,1.323157,103.796922
267182,28,40,68,1.323215,103.797267
267183,56,0,56,1.323138,103.796805
267184,11,0,11,1.323137,103.796804
267185,6,0,6,1.323137,103.796804
267186,5,1,6,1.323137,103.796804
267187,11,1,12,1.323137,103.796804
267189,40,11,51,1.323257,103.796754
267190,13,0,13,1.323184,103.797074
267191,132,1,133,1.323377,103.796723
267192,1,12,13,1.323169,103.796978
267193,22,0,22,1.323496,103.796692
267194,2,13,15,1.323153,103.796881
267195,5,1,6,1.323615,103.796661
267196,6,0,6,1.323138,103.796785
267197,31,0,31,1.322954,103.796535
267198,25,1,26,1.323239,103.796779
267199,3,0,3,1.323175,103.797038
267200,26,0,26,1.32334,103.796753
267202,2,0,2,1.323417,103.798556
267203,2,0,2,1.323542,103.7967
267204,5,0,5,1.323744,103.796648
267205,5,64,69,1.323831,103.796608
267206,19,18,37,1.323794,103.796635
267207,29,1,30,1.323869,103.7966
267208,95,1,96,1.323861,103.796716
267209,108,25,133,1.32386,103.796715
267210,2,4,6,1.323944,103.796586
267211,21,0,21,1.323904,103.796707
267212,0,14,14,1.323903,103.796706
267214,18,0,18,1.323989,103.79669
267215,1,3,4,1.323988,103.796689
267216,5,20,25,1.324093,103.796557
267217,1,0,1,1.323446,103.798714
267218,3,0,3,1.322863,103.796548
267219,4,0,4,1.324168,103.796542
267220,40,3,43,1.32416,103.796655
267222,5,0,5,1.324242,103.796528
267223,242,0,242,1.324246,103.796637
267224,14,0,14,1.324245,103.796636
267225,6,2,8,1.324317,103.796514
267226,135,47,182,1.324331,103.79662
267227,38,0,38,1.32433,103.796619
267228,23,6,29,1.324382,103.796509
267229,38,1,39,1.324417,103.796602
267230,1,1,2,1.323643,103.796674
267231,5,4,9,1.324441,103.796491
267232,2,27,29,1.324441,103.796511
267233,1,0,1,1.324075,103.796672
267234,85,2,87,1.324489,103.796502
267235,27,10,37,1.324586,103.796465
267236,5,2,7,1.324586,103.796485
267237,1,0,1,1.324489,103.796482
267238,10,1,11,1.324684,103.796468
267239,36,1,37,1.324781,103.796432
267240,9,0,9,1.324781,103.796452
267241,5,1,6,1.324878,103.796415
267242,6,2,8,1.324878,103.796435
267243,0,7,7,1.324965,103.796408
267244,14,3,17,1.324935,103.796444
267245,0,1,1,1.324684,103.796448
267246,20,8,28,1.325296,103.796393
267253,24,0,24,1.323072,103.796811
267254,56,2,58,1.323072,103.796811
267255,50,0,50,1.323072,103.796811
267256,3,2,5,1.323072,103.796811
267257,11,1,12,1.323072,103.796811
267258,3,17,20,1.323072,103.796811
267259,2,0,2,1.324416,103.796601
267260,23,5,28,1.299509,103.837
267265,7,30,37,1.326354,103.799065
267266,13,1,14,1.326323,103.799044
267267,2,3,5,1.326263,103.799061
267268,32,0,32,1.326203,103.799038
267269,19,11,30,1.326082,103.799052
267270,20,0,20,1.325961,103.799027
267271,29,6,35,1.325901,103.799044
267272,2,0,2,1.299509,103.837
267273,1,0,1,1.325334,103.796315
267274,6,0,6,1.325479,103.799005
267275,9,2,11,1.325539,103.799028
267276,1,5,6,1.325237,103.798994
267277,188,0,188,1.325006,103.798993
267278,15,1,16,1.325177,103.799011
267279,5,5,10,1.324996,103.799003
267297,35,3,38,1.325837,103.796694
267298,2,4,6,1.325901,103.796462
267299,1,2,3,1.324074,103.796671
267300,8,1,9,1.325885,103.796175
267301,6,1,7,1.325963,103.796612
267302,6,7,13,1.325744,103.795826
267303,5,0,5,1.325975,103.79653
267304,1,0,1,1.32572,103.799036
267305,13,2,15,1.325977,103.796264
267306,2,0,2,1.32572,103.799016
267307,0,1,1,1.325569,103.795686
267308,39,0,39,1.325863,103.795999
267309,11,0,11,1.325704,103.795747
267310,13,0,13,1.325535,103.795615
267311,5,4,9,1.325511,103.795556
267312,6,0,6,1.325427,103.795507
267313,15,0,15,1.325982,103.796413
267314,34,2,36,1.299509,103.837
267330,15,1,16,1.325177,103.799011
267331,47,0,47,1.324743,103.797895
267332,1,0,1,1.325934,103.796185
267333,3,6,9,1.324706,103.797604
267334,101,5,106,1.32465,103.797594
267335,86,0,86,1.324677,103.797539
267336,30,0,30,1.324601,103.797394
267337,19,0,19,1.324621,103.797394
267338,6,1,7,1.324553,103.797193
267339,7,1,8,1.324573,103.797193
267340,29,0,29,1.324504,103.796993
267341,5,1,6,1.324524,103.796993
267342,15,25,40,1.324476,103.796792
267343,15,1,16,1.324407,103.796592
267344,13,0,13,1.324427,103.796592
267345,1,0,1,1.324698,103.797795
267346,34,2,36,1.324385,103.796432
267347,6,3,9,1.324379,103.796386
267348,21,1,22,1.324379,103.796366
267349,2,0,2,1.325408,103.795606
267350,15,1,16,1.324407,103.796592
267352,15,3,18,1.324353,103.796099
267353,2,0,2,1.324366,103.796252
267354,37,2,39,1.32434,103.795966
267356,1,3,4,1.324333,103.795919
267357,4,0,4,1.324363,103.795703
267358,0,1,1,1.324385,103.796452
267359,5,5,10,1.324421,103.795581
267360,1,0,1,1.324363,103.795723
267361,10,0,10,1.324478,103.79546
267362,3,0,3,1.325866,103.796816
267363,6,2,8,1.324536,103.795338
267364,2,1,3,1.324446,103.795549
267365,19,0,19,1.299509,103.837
267366,3,2,5,1.324556,103.795317
267368,4,1,5,1.324611,103.795201
267369,7,70,77,1.324709,103.794974
267370,6,1,7,1.324666,103.795085
267371,53,0,53,1.324767,103.794852
267372,18,6,24,1.324721,103.794969
267373,0,1,1,1.324391,103.795665
267374,1,0,1,1.324825,103.794731
267375,13,3,16,1.324882,103.794609
267376,1,9,10,1.324831,103.794737
267377,3,8,11,1.32494,103.794488
267378,56,15,71,1.324886,103.794621
267379,6,4,10,1.324959,103.794437
267380,1,0,1,1.324776,103.794853
267381,2,10,12,1.32501,103.794326
267382,17,0,17,1.324969,103.794447
267383,4,0,4,1.325051,103.794226
267384,4,0,4,1.325002,103.794367
267385,40,0,40,1.325132,103.794025
267386,3,5,8,1.325034,103.794286
267387,12,2,14,1.325219,103.793773
267388,0,3,3,1.324501,103.795433
267391,4,3,7,1.325263,103.793647
267392,0,5,5,1.32523,103.793762
267393,1,3,4,1.325336,103.79321
267394,7,7,14,1.32523,103.793762
267395,13,1,14,1.325374,103.792969
267396,6,3,9,1.325298,103.79347
267397,47,135,182,1.325383,103.792859
267398,21,26,47,1.325312,103.793384
267399,1,0,1,1.324941,103.794505
267400,7,18,25,1.325366,103.793041
267401,9,461,470,1.325403,103.792859
267402,18,4,22,1.325009,103.794326
267403,2,0,2,1.32434,103.795986
267404,40,26,66,1.325009,103.794326
267405,14,0,14,1.32505,103.794225
267406,4,5,9,1.32505,103.794225
267407,1,1,2,1.325009,103.794326
267408,92,1,93,1.324755,103.797696
267419,2,0,2,1.32505,103.794225
267420,3,0,3,1.325099,103.794125
267421,5,0,5,1.324427,103.798898
267422,22,0,22,1.32432,103.798673
267423,0,4,4,1.324303,103.798656
267424,18,0,18,1.324391,103.798619
267425,2,0,2,1.324417,103.798908
267426,3,0,3,1.32439,103.798852
267427,19,0,19,1.324198,103.798024
267428,2,0,2,1.324211,103.79839
267429,2,0,2,1.324177,103.798247
267430,6,8,14,1.324087,103.797792
267431,1,0,1,1.325339,103.793212
267432,15,1,16,1.324882,103.794609
267433,23,1,24,1.324085,103.797864
267434,0,5,5,1.323984,103.797361
267435,12,1,13,1.324062,103.797768
267436,22,0,22,1.323932,103.797146
267437,3,0,3,1.3242,103.798342
267438,3,10,13,1.32388,103.79693
267439,3,2,5,1.324015,103.797576
267440,30,0,30,1.323828,103.796715
267442,198,15,213,1.323804,103.796625
267443,3,0,3,1.324039,103.797672
267444,116,9,125,1.323722,103.796088
267445,1,2,3,1.323969,103.797385
267446,22,2,24,1.323722,103.796088
267447,2,0,2,1.324131,103.798055
267448,5,3,8,1.323705,103.795891
267450,63,2,65,1.323795,103.795595
267451,6,1,7,1.323877,103.797002
267452,6,8,14,1.323833,103.795516
267453,12,1,13,1.323854,103.796906
267454,0,2,2,1.323923,103.797194
267455,1,0,1,1.324108,103.797959
267456,1,1,2,1.323871,103.795438
267457,69,1,70,1.323808,103.796715
267458,30,2,32,1.324024,103.795124
267459,5,1,6,1.324101,103.794966
267461,6,1,7,1.324253,103.794652
267462,12,0,12,1.32433,103.794495
267463,0,1,1,1.323831,103.796811
267464,3,3,6,1.32449,103.794289
267465,25,8,33,1.32377,103.796536
267466,0,1,1,1.324406,103.794338
267467,5,0,5,1.323757,103.796446
267468,60,0,60,1.324874,103.794408
267469,44,0,44,1.323729,103.796267
267470,17,6,23,1.324959,103.794437
267471,17,3,20,1.323702,103.796088
267472,39,13,52,1.323601,103.796108
267473,19,13,32,1.32349,103.796119
267474,1,1,2,1.323948,103.795281
267475,1,0,1,1.324684,103.794328
267476,16,0,16,1.324036,103.797576
267477,10,0,10,1.323188,103.79616
267478,6,0,6,1.323269,103.796139
267479,18,5,23,1.323057,103.79615
267480,136,2,138,1.323696,103.79599
267481,132,4,136,1.323705,103.795871
267482,2,0,2,1.323188,103.79616
267483,0,7,7,1.323785,103.795585
267484,41,2,43,1.323785,103.795585
267485,2,1,3,1.323946,103.797289
267486,10,0,10,1.323395,103.795382
267487,65,0,65,1.323465,103.795428
267488,5,0,5,1.323532,103.795453
267489,55,0,55,1.323602,103.795494
267490,2,29,31,1.323836,103.795491
267491,8,2,10,1.323876,103.795407
267492,20,4,24,1.323958,103.79524
267493,14,3,17,1.324039,103.795072
267494,6,0,6,1.324121,103.794905
267495,0,1,1,1.323188,103.79616
267496,1,2,3,1.323309,103.795389
267497,3,3,6,1.324365,103.794402
267498,2,2,4,1.32449,103.794269
267499,23,7,30,1.324684,103.794308
267500,38,15,53,1.324874,103.794388
267501,4,0,4,1.324969,103.794427
267502,40,0,40,1.324683,103.794308
267503,35,4,39,1.299509,103.837
267504,26,2,28,1.299509,103.837
267505,31,5,36,1.299509,103.837
267506,15,5,20,1.299509,103.837
267520,10,1,11,1.326349,103.797071
267521,2,0,2,1.323731,103.795774
267522,2,5,7,1.326432,103.796926
267523,17,0,17,1.326452,103.797029
267524,11,1,12,1.326484,103.796853
267525,17,4,21,1.326544,103.796869
267526,10,8,18,1.326638,103.79659
267527,35,0,35,1.326595,103.796767
267528,1,0,1,1.324202,103.794737
267529,106,12,118,1.326637,103.796666
267530,78,1,79,1.326691,103.796516
267531,19,2,21,1.326686,103.796059
267532,5,0,5,1.326625,103.795883
267533,15,8,23,1.326731,103.7964
267534,0,2,2,1.326484,103.796974
267535,70,4,74,1.326736,103.796123
267536,4,0,4,1.326479,103.795352
267537,7,3,10,1.326734,103.796033
267538,1,4,5,1.326486,103.795481
267539,124,3,127,1.326724,103.79596
267540,10,0,10,1.326208,103.795196
267541,14,7,21,1.326684,103.795805
267542,40,12,52,1.32592,103.795064
267543,0,6,6,1.326569,103.795516
267544,2,2,4,1.32591,103.795054
267545,10,11,21,1.326523,103.795308
267546,63,0,63,1.325696,103.795005
267547,10,5,15,1.326542,103.795069
267548,42,2,44,1.32647,103.79513
267550,2,1,3,1.324284,103.794569
267551,28,3,31,1.326962,103.794411
267552,1,0,1,1.326682,103.796408
267553,1,2,3,1.326486,103.79508
267554,0,1,1,1.326549,103.794923
267555,49,0,49,1.327172,103.794448
267556,7,0,7,1.326658,103.794728
267558,1,0,1,1.32659,103.794873
267559,38,7,45,1.326911,103.794184
267560,21,1,22,1.326795,103.794439
267561,2,1,3,1.32713,103.794465
267562,5,1,6,1.326854,103.794305
267563,40,0,40,1.327053,103.793792
267564,0,11,11,1.326892,103.794217
267565,13,29,42,1.32711,103.79372
267566,11,1,12,1.326921,103.794138
267567,7,2,9,1.326978,103.793981
267568,53,1,54,1.327034,103.793825
267569,7,14,21,1.327055,103.793724
267570,7,204,211,1.327082,103.793635
267571,7,8,15,1.326681,103.795863
267572,3,2,5,1.326368,103.797208
267573,2,0,2,1.326568,103.795747
267574,5,9,14,1.326547,103.796752
267575,1,10,11,1.299509,103.837
267589,0,2,2,1.326555,103.795704
267590,8,0,8,1.325747,103.798317
267591,74,0,74,1.32569,103.798322
267609,26,337,363,1.329147,103.802043
267610,22,7,29,1.328604,103.801247
267611,7,79,86,1.328147,103.801358
267612,1,2,3,1.326959,103.794054
267613,8,3,11,1.327699,103.80103
267614,4,26,30,1.327617,103.800735
267615,4,33,37,1.327275,103.800595
267616,692,120,812,1.325921,103.79995
267617,0,4,4,1.3266,103.79844
267618,11,1,12,1.326412,103.79863
267619,6,9,15,1.326615,103.798321
267620,0,6,6,1.326528,103.798274
267621,5,7,12,1.326622,103.79816
267622,3,2,5,1.326529,103.798151
267623,1,7,8,1.326604,103.798099
267624,1,0,1,1.326709,103.794605
267625,2,0,2,1.325928,103.798267
267626,66,13,79,1.326382,103.79772
267627,39,0,39,1.326445,103.797621
267628,17,2,19,1.326304,103.797594
267629,66,25,91,1.326519,103.797751
267630,18,4,22,1.326149,103.797485
267631,58,36,94,1.325934,103.797342
267632,13,8,21,1.326024,103.797296
267633,5,5,10,1.325872,103.7973
267634,8,1,9,1.325939,103.797231
267635,10,2,12,1.325747,103.797217
267636,3,3,6,1.325855,103.797184
267637,0,1,1,1.326459,103.797843
267638,4,0,4,1.325737,103.797122
267639,6,0,6,1.32554,103.797073
267640,1,2,3,1.327934,103.801215
267641,1,0,1,1.325622,103.797133
267642,46,2,48,1.325499,103.797023
267644,14,2,16,1.325252,103.796843
267646,3,0,3,1.325537,103.797027
267647,16,2,18,1.32514,103.796828
267648,1,0,1,1.325458,103.797013
267649,13,0,13,1.325072,103.796775
267650,8,9,17,1.32499,103.796326
267651,7,1,8,1.324967,103.796263
267652,0,1,1,1.325072,103.796575
267653,4,8,12,1.324917,103.796084
267654,7,4,11,1.324891,103.79605
267655,11,0,11,1.324941,103.796039
267656,1,1,2,1.326568,103.797975
267657,5,1,6,1.324956,103.795815
267658,61,0,61,1.324902,103.795847
267659,9,0,9,1.324985,103.795672
267660,7,7,14,1.324924,103.795767
267661,140,4,144,1.325058,103.795513
267662,5,0,5,1.324985,103.795652
267663,21,4,25,1.325086,103.795499
267664,18,3,21,1.325058,103.795493
267665,48,7,55,1.325174,103.795332
267666,4,2,6,1.325085,103.795423
267667,18,3,21,1.325226,103.795234
267668,1,2,3,1.325066,103.796697
267669,1,1,2,1.324884,103.795929
267670,0,3,3,1.325125,103.795352
267671,2,5,7,1.325372,103.794967
267672,47,4,51,1.325213,103.795167
267673,8,8,16,1.325455,103.794757
267674,1,9,10,1.325273,103.795045
267676,78,8,86,1.325332,103.794922
267677,14,0,14,1.325554,103.794566
267678,0,1,1,1.324891,103.796084
267679,2,1,3,1.325154,103.79529
267680,0,3,3,1.325595,103.794457
267682,19,0,19,1.325449,103.794679
267683,3,2,5,1.325688,103.794244
267684,22,3,25,1.325508,103.79456
267685,2,5,7,1.325741,103.794102
267686,1,1,2,1.325326,103.795042
267687,5,2,7,1.325799,103.793982
267688,0,5,5,1.325624,103.794321
267689,4,0,4,1.325858,103.793863
267690,10,1,11,1.325683,103.794201
267691,7,6,13,1.325882,103.793832
267692,2,3,5,1.325741,103.794082
267693,4,9,13,1.325947,103.793645
267694,1,1,2,1.325566,103.79444
267695,3,3,6,1.325991,103.793577
267696,3,2,5,1.325839,103.793859
267697,4,4,8,1.32604,103.793446
267698,0,1,1,1.325381,103.794809
267699,52,135,187,1.326098,103.793341
267700,5,0,5,1.3259,103.793683
267701,3,0,3,1.32542,103.794739
267702,4,8,12,1.325954,103.793536
267703,7,0,7,1.325987,103.793451
267704,3,10,13,1.326016,103.793347
267705,13,659,672,1.32604,103.793296
267706,23,0,23,1.326476,103.797648
267707,10,5,15,1.325807,103.79716
267708,2,1,3,1.325912,103.793633
267709,3,1,4,1.326379,103.797569
267723,4,3,7,1.318684,103.798851
267724,161,12,173,1.318694,103.798861
267725,179,4,183,1.318911,103.798423
267726,35,4,39,1.318921,103.798433
267744,14,20,34,1.321524,103.81007
267745,4,0,4,1.321233,103.810697
267746,13,15,28,1.321861,103.810352
267747,20,93,113,1.321266,103.810909
267748,29,11,40,1.321298,103.810954
267749,3,0,3,1.326299,103.797506
267750,40,11,51,1.321168,103.811125
267751,2,3,5,1.321826,103.810085
267752,0,13,13,1.322105,103.810081
267753,2,16,18,1.321809,103.809824
267770,4,0,4,1.322244,103.792644
267771,0,7,7,1.322503,103.792408
267772,0,1,1,1.325883,103.79376
267773,81,0,81,1.322201,103.79223
267774,6,0,6,1.322529,103.792376
267775,97,0,97,1.322528,103.792375
267776,17,0,17,1.322467,103.79245
267777,1,3,4,1.322581,103.792311
267778,0,3,3,1.32132,103.810963
267779,1,0,1,1.322502,103.792407
267780,22,1,23,1.322633,103.792247
267781,1,1,2,1.325799,103.793962
267782,10,1,11,1.322566,103.792534
267783,0,7,7,1.322685,103.792182
267784,1,0,1,1.322521,103.792497
267785,6,1,7,1.322655,103.792607
267786,1,0,1,1.322684,103.792181
267787,5,9,14,1.322726,103.792127
267788,5,3,8,1.322743,103.792681
267789,6,37,43,1.3232,103.792481
267790,1,3,4,1.322832,103.792754
267791,64,5,69,1.323179,103.792507
267792,20,0,20,1.322911,103.792818
267793,13,0,13,1.323136,103.792561
267794,15,1,16,1.322921,103.792828
267795,8,0,8,1.323093,103.792614
267796,15,1,16,1.323302,103.793158
267797,7,12,19,1.32305,103.792668
267800,8,17,25,1.322931,103.792818
267801,26,11,37,1.323512,103.793285
267802,20,5,25,1.323526,103.793267
267803,4,0,4,1.323555,103.793232
267804,0,1,1,1.322727,103.792128
267805,1,0,1,1.323584,103.793196
267806,8,0,8,1.32364,103.793125
267807,6,0,6,1.323669,103.793089
267808,0,1,1,1.323612,103.793161
267809,1,8,9,1.323726,103.793018
267810,31,12,43,1.323754,103.792983
267811,1,0,1,1.323698,103.793054
267828,212,121,333,1.312536,103.796509
267829,943,553,1496,1.312818,103.796595
267830,2,71,73,1.313318,103.796582
267831,2,48,50,1.312699,103.796513
267832,46,15,61,1.312797,103.796529
267833,531,144,675,1.313727,103.797053
267834,31,20,51,1.312893,103.796555
267835,16,2,18,1.313087,103.796635
267836,43,2,45,1.313262,103.796058
267837,1,0,1,1.323773,103.792957
267838,8,0,8,1.315977,103.798418
267839,97,1,98,1.31339,103.796764
267840,3,0,3,1.32258,103.79231
267841,11,46,57,1.31344,103.796786
267843,0,2,2,1.322632,103.792246
267844,50,12,62,1.314098,103.797432
267845,10,0,10,1.314543,103.797663
267846,17,38,55,1.314899,103.797686
267847,31,4,35,1.314889,103.797696
267848,6,0,6,1.315326,103.797811
267849,1,24,25,1.315326,103.797811
267850,34,3,37,1.315732,103.798115
267851,31,21,52,1.315967,103.798614
267852,12,11,23,1.315987,103.798614
267853,28,1,29,1.31563,103.79928
267854,5,22,27,1.315471,103.799186
267855,6,3,9,1.315143,103.80007
267856,79,6,85,1.31526,103.800864
267857,3,5,8,1.31401,103.800743
267858,9,0,9,1.314871,103.801161
267859,10,12,22,1.314385,103.800945
267860,10,34,44,1.314523,103.801303
267861,64,6,70,1.315143,103.80005
267862,1,13,14,1.314078,103.797432
267863,52,1,53,1.313641,103.797816
267864,19,0,19,1.316052,103.797534
267865,1,3,4,1.315883,103.797842
267866,40,0,40,1.31595,103.799532
267878,3,10,13,1.314899,103.797686
267879,4,13,17,1.315657,103.797088
267880,6,0,6,1.31513,103.796921
267881,0,1,1,1.313667,103.796076
267882,10,1,11,1.315161,103.796388
267883,25,15,40,1.315766,103.796027
267884,92,0,92,1.315686,103.79577
267885,173,10,183,1.316385,103.79706
267886,65,0,65,1.315686,103.79577
267887,600,0,600,1.316232,103.796073
267888,26,3,29,1.31573,103.795333
267889,9,0,9,1.317151,103.796721
267890,27,0,27,1.316837,103.797176
267891,6,0,6,1.315837,103.794857
267892,16,6,22,1.316886,103.797865
267893,3,17,20,1.315992,103.794668
267894,0,1,1,1.31513,103.796941
267895,24,0,24,1.315992,103.794668
267896,2,1,3,1.314217,103.797519
267897,19,7,26,1.316718,103.798097
267898,153,15,168,1.315941,103.796024
267899,1,15,16,1.316503,103.798713
267900,7,7,14,1.316116,103.796042
267901,89,0,89,1.316592,103.795136
267902,16,104,120,1.316815,103.79611
267903,26,351,377,1.317165,103.796145
267904,2,2,4,1.317165,103.796145
267905,1,0,1,1.315992,103.794668
267906,14,22,36,1.317275,103.795911
267907,115,12,127,1.317377,103.795689
267908,34,15,49,1.317596,103.796388
267909,0,24,24,1.317645,103.796343
267910,2,6,8,1.317742,103.796251
267911,16,12,28,1.31783,103.79617
267912,11,11,22,1.317557,103.796444
267913,2,1,3,1.315992,103.794668
267914,5,4,9,1.317611,103.797147
267916,30,21,51,1.317229,103.797636
267917,10,3,13,1.317549,103.797941
267918,127,1,128,1.317718,103.798158
267919,35,16,51,1.316718,103.798117
267920,34,0,34,1.316513,103.798723
267921,3,41,44,1.316896,103.797875
267922,34,33,67,1.316513,103.798723
267923,4,9,13,1.31589,103.796073
267924,1,0,1,1.317276,103.795912
267925,0,14,14,1.299509,103.837
267927,13,1,14,1.299509,103.837
267928,54,3,57,1.299509,103.837
267935,1063,401,1464,1.314312,103.801578
267936,1191,208,1399,1.312713,103.800866
267937,239,382,621,1.312749,103.801481
267938,92,57,149,1.313474,103.802226
267939,167,6,173,1.314301,103.802999
267940,3,2,5,1.299509,103.837
267941,0,2,2,1.31558,103.797633
267942,2,1,3,1.317621,103.797137
267944,8,0,8,1.299509,103.837
267945,0,1,1,1.299509,103.837
267946,1,0,1,1.299509,103.837
267947,1,0,1,1.299509,103.837
267948,30,0,30,1.299509,103.837
267949,1,1,2,1.299509,103.837
267950,6,1,7,1.299509,103.837
267951,4033,423,4456,1.314993,103.803334
267952,5176,1843,7019,1.314818,103.802398
267953,2892,3102,5994,1.299509,103.837
267954,4304,744,5048,1.314647,103.80352
267955,4551,3,4554,1.299509,103.837
267956,77,17,94,1.318699,103.804011
267957,1,8,9,1.318753,103.804114
267958,6,1,7,1.319054,103.804402
267959,19,16,35,1.318941,103.804495
267960,2,8,10,1.319064,103.804412
267961,187,35,222,1.318805,103.804656
267962,7,0,7,1.318808,103.804749
267963,0,3,3,1.299509,103.837
267964,4,9,13,1.319588,103.804777
267965,15,8,23,1.31952,103.804839
267966,16,0,16,1.31996,103.805052
267967,5,5,10,1.319345,103.805055
267968,0,8,8,1.320195,103.805174
267969,6,5,11,1.319229,103.805199
267970,10,0,10,1.320221,103.805139
267971,14,127,141,1.31992,103.805103
267972,22,3,25,1.320274,103.805071
267973,35,0,35,1.319879,103.805154
267974,91,6,97,1.320316,103.805012
267975,4,0,4,1.319798,103.805255
267976,22,8,30,1.320691,103.805558
267977,3,1,4,1.319717,103.805356
267978,5,0,5,1.320726,103.80551
267979,17,20,37,1.319636,103.805458
267980,0,4,4,1.320796,103.805414
267981,15,11,26,1.320095,103.805281
267982,1,1,2,1.299509,103.837
267983,3,2,5,1.320384,103.805465
267984,41,1,42,1.32087,103.80579
267985,7,0,7,1.320343,103.805518
267986,8,0,8,1.321187,103.805992
267987,63,2,65,1.320262,103.805625
267988,8,24,32,1.321356,103.805976
267989,14,2,16,1.32018,103.805732
267990,23,3,26,1.320098,103.805838
267991,15,2,17,1.320822,103.805828
267992,11,10,21,1.320785,103.805876
267993,7,1,8,1.320704,103.805976
267994,11,0,11,1.320662,103.806028
267995,2,0,2,1.320856,103.805328
267996,11,1,12,1.320482,103.806228
267997,16,11,27,1.321009,103.805952
267998,67,1,68,1.319462,103.804911
268015,1,0,1,1.299509,103.837
268016,20,14,34,1.317638,103.803138
268018,0,1,1,1.317687,103.803216
268019,8,0,8,1.317567,103.803058
268020,1,0,1,1.317607,103.8031
268021,4,0,4,1.317562,103.802958
268022,4,1,5,1.3176,103.802798
268023,0,2,2,1.320572,103.806128
268024,8,0,8,1.317617,103.802637
268025,5,5,10,1.317585,103.802744
268026,13,9,22,1.317634,103.802477
268027,7,3,10,1.317652,103.802316
268028,7,0,7,1.317609,103.80253
268029,1,0,1,1.317582,103.802958
268030,1,0,1,1.31762,103.802423
268048,43,21,64,1.32298,103.810911
268049,20,10,30,1.322864,103.810838
268050,6,11,17,1.322752,103.810778
268051,56,7,63,1.32301,103.810569
268052,0,13,13,1.322986,103.810532
268053,1,2,3,1.318959,103.804584
268054,56,2,58,1.32287,103.810419
268055,4,5,9,1.322557,103.810448
268056,0,1,1,1.317632,103.802316
268057,0,3,3,1.322924,103.810446
268058,0,12,12,1.322422,103.810397
268059,1,2,3,1.32272,103.810347
268061,13,3,16,1.322668,103.810243
268062,4,1,5,1.322185,103.810144
268063,1,1,2,1.317574,103.802851
268064,0,4,4,1.32251,103.810341
268065,11,0,11,1.322456,103.810298
268066,7,8,15,1.322392,103.810283
268067,1,9,10,1.322185,103.810101
268068,6,0,6,1.322129,103.81002
268069,8,25,33,1.32207,103.809991
268070,1,1,2,1.322546,103.810382
268071,3,0,3,1.322328,103.810356
268072,5,0,5,1.321845,103.80973
268073,2,1,3,1.321892,103.809777
268074,3,0,3,1.321644,103.809676
268075,0,1,1,1.32279,103.810343
268076,15,1,16,1.321569,103.809597
268077,38,0,38,1.321677,103.809589
268078,6,2,8,1.321653,103.809567
268079,13,4,17,1.321458,103.809483
268080,2,0,2,1.321934,103.80982
268081,0,2,2,1.321609,103.809532
268082,161,4,165,1.321361,103.809382
268083,22,0,22,1.321536,103.809456
268084,22,0,22,1.321504,103.809429
268085,26,5,31,1.321149,103.8092
268086,8,0,8,1.321465,103.809397
268087,21,3,24,1.321128,103.809163
268088,12,5,17,1.320961,103.809037
268089,1,6,7,1.320937,103.808968
268090,4,11,15,1.320817,103.80886
268091,0,7,7,1.320697,103.808751
268092,10,201,211,1.320578,103.808642
268093,5,0,5,1.320458,103.808533
268094,28,72,100,1.320338,103.808424
268095,18,13,31,1.320218,103.808316
268096,9,6,15,1.320098,103.808207
268097,1524,18,1542,1.320943,103.808147
268098,40,17,57,1.320041,103.808029
268099,2,4,6,1.319978,103.808098
268100,3,0,3,1.32179,103.809678
268101,2,2,4,1.320157,103.807827
268102,1,1,2,1.321585,103.809501
268103,41,0,41,1.320297,103.807639
268104,3,0,3,1.320106,103.807879
268105,3,1,4,1.320455,103.807467
268106,3,3,6,1.32055,103.807364
268107,2,0,2,1.320254,103.807704
268108,5,11,16,1.320762,103.807127
268109,1,8,9,1.319858,103.807989
268110,2,4,6,1.319921,103.807859
268111,9,5,14,1.319972,103.8078
268112,2,0,2,1.320609,103.807306
268113,3,5,8,1.320112,103.807612
268114,15,2,17,1.320228,103.807501
268115,18,4,22,1.32027,103.80744
268116,52,1,53,1.320365,103.807337
268117,3,11,14,1.320424,103.807279
268119,2,9,11,1.320579,103.807124
268120,20,0,20,1.320674,103.807034
268121,0,3,3,1.320413,103.807528
268122,2,0,2,1.320069,103.807677
268123,6,0,6,1.319767,103.807908
268124,2,1,3,1.320727,103.806965
268125,1,1,2,1.320792,103.80687
268126,2,0,2,1.319752,103.807868
268127,11,0,11,1.319534,103.80764
268128,66,1,67,1.319379,103.807458
268129,5,3,8,1.319379,103.807458
268130,43,0,43,1.319302,103.807365
268131,2,3,5,1.319302,103.807365
268132,0,1,1,1.321743,103.809632
268133,5,1,6,1.319188,103.807243
268134,8,25,33,1.318863,103.806925
268136,0,7,7,1.31872,103.806787
268137,4,0,4,1.318532,103.806622
268138,1,15,16,1.318344,103.806457
268139,1,5,6,1.318344,103.806457
268141,3,23,26,1.317968,103.806127
268142,4,6,10,1.31873,103.806777
268143,29,290,319,1.317306,103.805348
268144,3,10,13,1.31729,103.805358
268145,0,3,3,1.319689,103.807819
268146,0,2,2,1.319534,103.80764
268147,0,13,13,1.317189,103.805418
268148,1,198,199,1.317156,103.805438
268150,3,4,7,1.317089,103.805477
268151,1,0,1,1.319188,103.807243
268153,1,1,2,1.317223,103.805398
268154,57,33,90,1.316965,103.805547
268155,70,1,71,1.317682,103.80584
268156,380,109,489,1.316368,103.803693
268157,424,195,619,1.316435,103.802572
268158,912,2,914,1.316204,103.804014
268166,26,13,39,1.317276,103.805203
268167,0,18,18,1.317218,103.805077
268168,2,21,23,1.317104,103.804826
268169,5,31,36,1.316989,103.804575
268170,7,0,7,1.322185,103.810101
268171,4,2,6,1.321444,103.809364
268172,963,66,1029,1.317517,103.805549
268173,3,1,4,1.322557,103.810448
268174,4,6,10,1.319858,103.807989
268175,25,8,33,1.319858,103.807989
268176,103,5,108,1.319718,103.807829
268177,8,0,8,1.319649,103.807749
268178,3,0,3,1.317256,103.805378
268179,13,1,14,1.319511,103.807591
268180,48,1,49,1.319476,103.807551
268181,1,1,2,1.316988,103.805537
268182,20,0,20,1.319322,103.807365
268183,80,33,113,1.316738,103.80413
268184,142,22,164,1.316752,103.804136
268185,9,5,14,1.316779,103.80409
268186,78,2,80,1.316807,103.804083
268187,11,2,13,1.316918,103.803976
268188,2,2,4,1.31703,103.803869
268189,119,0,119,1.317141,103.803762
268190,28,1,29,1.317252,103.803654
268191,8,0,8,1.317363,103.803547
268192,6,1,7,1.31728,103.803608
268193,50,3,53,1.317475,103.80344
268195,17,2,19,1.317586,103.803333
268196,6,1,7,1.317447,103.803447
268198,29,0,29,1.31753,103.803367
268199,1,4,5,1.317614,103.803286
268200,0,1,1,1.317055,103.805497
268201,3,31,34,1.318281,103.802749
268202,72,1,73,1.317707,103.803216
268203,3,2,5,1.318279,103.802718
268204,1,0,1,1.317687,103.803216
268205,7,0,7,1.318277,103.802655
268206,69,6,75,1.318282,103.802781
268207,3,6,9,1.318274,103.802592
268208,111,0,111,1.318271,103.802528
268209,2,0,2,1.319399,103.807458
268210,116,19,135,1.318282,103.802781
268212,8,6,14,1.318279,103.80321
268213,22,0,22,1.318263,103.802339
268214,18,0,18,1.318276,103.803638
268215,65,1,66,1.318301,103.802924
268216,0,6,6,1.3183,103.803067
268217,106,14,120,1.318298,103.803352
268218,3,24,27,1.318296,103.803638
268236,3,1,4,1.322288,103.796259
268237,21,1,22,1.322184,103.796782
268238,1,0,1,1.317984,103.802941
268239,6,1,7,1.322318,103.79637
268240,10,1,11,1.322236,103.796842
268241,22,0,22,1.322363,103.796512
268242,2,15,17,1.322375,103.796559
268243,14,0,14,1.322362,103.796747
268244,9,12,21,1.322434,103.79671
268245,5,0,5,1.32244,103.796748
268246,5,0,5,1.322392,103.796815
268247,7,1,8,1.322452,103.796852
268248,2,2,4,1.322451,103.796851
268249,30,0,30,1.32243,103.796908
268250,5,4,9,1.322536,103.79707
268251,6,1,7,1.322535,103.797069
268252,36,1,37,1.322464,103.796934
268253,4,2,6,1.322621,103.797289
268254,2,0,2,1.318268,103.802465
268255,1,0,1,1.322258,103.796498
268256,6,1,7,1.322611,103.797316
268257,40,0,40,1.322685,103.797507
268258,5,4,9,1.322262,103.796194
268259,3,5,8,1.322302,103.796321
268275,2,0,2,1.322538,103.797125
268276,14,0,14,1.315727,103.793695
268278,11,1,12,1.31564,103.793926
268279,8,2,10,1.315325,103.79393
268280,2,0,2,1.315812,103.793496
268282,2,14,16,1.315823,103.794252
268283,207,0,207,1.315991,103.794182
268284,46,9,55,1.317982,103.793739
268285,3,5,8,1.315748,103.793989
268286,43,2,45,1.317895,103.793932
268287,0,3,3,1.31958,103.80767
268288,14,0,14,1.317797,103.794135
268289,9,3,12,1.315878,103.793603
268290,0,8,8,1.317677,103.794372
268291,32,7,39,1.315964,103.793386
268292,141,39,180,1.317587,103.794583
268293,9,38,47,1.317511,103.794785
268294,6,1,7,1.317482,103.794897
268295,19,0,19,1.317389,103.794944
268296,14,0,14,1.31739,103.794835
268297,54,0,54,1.317418,103.794714
268298,23,0,23,1.317503,103.794522
268299,10,4,14,1.317604,103.79429
268300,22,5,27,1.317723,103.794014
268301,9,24,33,1.317832,103.793768
268302,6,0,6,1.316401,103.792888
268303,59,0,59,1.31781,103.79353
268319,1,5,6,1.316698,103.793191
268320,2,0,2,1.315374,103.794082
268321,5,5,10,1.316686,103.793199
268322,2,3,5,1.316592,103.793444
268323,14,0,14,1.316639,103.793312
268324,27,2,29,1.316522,103.793613
268325,51,8,59,1.316546,103.793536
268326,71,5,76,1.316462,103.793771
268345,35,30,65,1.3214,103.795977
268347,3,0,3,1.3158,103.793816
268348,11,5,16,1.321378,103.796026
268349,4,0,4,1.321842,103.795401
268350,7,0,7,1.321446,103.795938
268351,2,9,11,1.321581,103.795762
268352,203,1,204,1.321716,103.795587
268353,123,4,127,1.321852,103.795411
268354,26,0,26,1.321946,103.795266
268355,7,3,10,1.32204,103.795142
268356,107,31,138,1.322039,103.795141
268357,6,7,13,1.322039,103.795141
268358,7,0,7,1.322147,103.794862
268359,27,0,27,1.322146,103.794862
268360,23,0,23,1.322233,103.794576
268361,57,1,58,1.322273,103.793962
268362,128,0,128,1.322235,103.793853
268363,12,12,24,1.322234,103.793852
268364,91,0,91,1.322196,103.793745
268365,27,0,27,1.322195,103.793744
268366,30,0,30,1.322195,103.793744
268367,36,0,36,1.322195,103.793744
268369,26,1,27,1.322036,103.79336
268371,2,5,7,1.321998,103.793302
268373,11,5,16,1.321971,103.793254
268374,20,2,22,1.321916,103.793159
268375,111,15,126,1.321861,103.793064
268376,1,22,23,1.321806,103.792968
268378,6,12,18,1.321776,103.792887
268380,4,0,4,1.321416,103.793042
268382,9,6,15,1.321416,103.793042
268383,4,3,7,1.321416,103.793042
268384,15,1,16,1.321416,103.793042
268385,1,0,1,1.322695,103.797497
268386,7,3,10,1.321391,103.792426
268387,5,11,16,1.322236,103.793799
268389,149,0,149,1.322178,103.793636
268390,74,0,74,1.322112,103.793482
268391,18,11,29,1.322111,103.793481
268392,2,0,2,1.316663,103.793276
268393,9,11,20,1.322045,103.793349
268394,13,0,13,1.321614,103.792315
268395,6,0,6,1.322538,103.793257
268396,2,1,3,1.321671,103.795625
268397,72,13,85,1.32141,103.792346
268398,5,0,5,1.322409,103.793156
268400,111,4,115,1.321197,103.792387
268401,19,0,19,1.32229,103.793066
268402,17,0,17,1.322289,103.793065
268403,107,18,125,1.321607,103.791876
268404,21,0,21,1.322036,103.79334
268405,5,7,12,1.322035,103.793339
268406,7,2,9,1.321561,103.791213
268407,15,4,19,1.32156,103.791212
268408,117,5,122,1.321899,103.793095
268409,4,11,15,1.32152,103.791201
268410,41,24,65,1.321786,103.792877
268411,0,1,1,1.322264,103.79388
268412,85,1,86,1.321776,103.792867
268413,18,0,18,1.321368,103.791134
268414,4,0,4,1.321685,103.792595
268415,3,1,4,1.321267,103.79109
268416,4,30,34,1.321634,103.792315
268417,0,1,1,1.32147,103.791179
268418,5,2,7,1.321634,103.792315
268419,0,5,5,1.321233,103.791071
268420,47,17,64,1.32162,103.792086
268421,0,1,1,1.32125,103.791081
268422,27,6,33,1.321627,103.791876
268423,10,0,10,1.321165,103.791034
268424,1,17,18,1.321131,103.791015
268425,9,1,10,1.32159,103.79163
268426,1,3,4,1.321097,103.790996
268427,2,13,15,1.321571,103.791223
268428,1,0,1,1.321199,103.791052
268429,79,4,83,1.321837,103.791279
268430,13,8,21,1.321289,103.79104
268431,48,6,54,1.321882,103.791293
268432,29,3,32,1.32131,103.791009
268433,4,8,12,1.321916,103.791296
268434,30,24,54,1.321332,103.790979
268435,1,8,9,1.321985,103.791303
268436,26,7,33,1.321353,103.790948
268437,0,4,4,1.322054,103.79131
268438,1,3,4,1.321375,103.790918
268439,2,1,3,1.322537,103.793256
268440,13,3,16,1.321396,103.790887
268441,7,0,7,1.322193,103.791317
268442,24,14,38,1.321418,103.790857
268443,3,0,3,1.322123,103.791313
268444,18,0,18,1.321439,103.790826
268445,6,6,12,1.322287,103.791312
268446,4,3,7,1.321461,103.790796
268447,1,1,2,1.322046,103.79335
268448,41,19,60,1.321494,103.790745
268449,6,4,10,1.321857,103.791253
268450,9,0,9,1.321867,103.791236
268451,7,3,10,1.321887,103.791203
268452,16,0,16,1.321908,103.79117
268453,1,3,4,1.321928,103.791137
268454,27,0,27,1.321948,103.791105
268455,6,62,68,1.321968,103.791072
268456,15,429,444,1.321989,103.791039
268457,7,1,8,1.322009,103.791006
268458,76,12,88,1.322019,103.790983
268459,2,7,9,1.322158,103.793636
268460,12,47,59,1.322264,103.794278
268461,9,8,17,1.321589,103.792315
268462,34,0,34,1.321569,103.792319
268463,9,0,9,1.321613,103.792314
268464,21,1,22,1.321606,103.791875
268465,16,38,54,1.321606,103.791875
268466,6,0,6,1.321606,103.791875
268467,4,5,9,1.321606,103.791875
268468,22,0,22,1.321606,103.791875
268469,0,1,1,1.321278,103.791055
268470,6,0,6,1.321606,103.791875
268471,55,1,56,1.321606,103.791875
268472,40,0,40,1.321606,103.791875
268474,6,0,6,1.321606,103.791875
268475,59,0,59,1.321606,103.791875
268476,8,6,14,1.317334,103.793468
268477,14,7,21,1.317325,103.793509
268478,60,2,62,1.31728,103.793618
268479,147,6,153,1.317225,103.793727
268481,4,7,11,1.317151,103.793901
268482,2,0,2,1.321482,103.790765
268483,41,13,54,1.317078,103.794074
268484,4,0,4,1.317015,103.794257
268485,70,18,88,1.317005,103.794247
268504,4,0,4,1.323986,103.793379
268505,3,2,5,1.322173,103.795909
268506,14,3,17,1.322095,103.795979
268507,30,37,67,1.32224,103.795829
268508,9,2,11,1.322269,103.795797
268509,27,30,57,1.322257,103.795789
268510,17,2,19,1.322308,103.795748
268511,21,3,24,1.322338,103.795715
268512,54,3,57,1.322409,103.795608
268513,21,3,24,1.322375,103.795668
268514,2,0,2,1.317096,103.79405
268515,0,4,4,1.322713,103.795247
268516,3,0,3,1.322262,103.79132
268517,39,0,39,1.322442,103.795587
268518,8,1,9,1.322307,103.795429
268519,8,2,10,1.32251,103.795508
268520,4,0,4,1.322509,103.795507
268521,4,32,36,1.322363,103.795389
268522,1,3,4,1.322578,103.795428
268523,35,2,37,1.322576,103.795427
268524,21,2,23,1.322645,103.795348
268525,34,64,98,1.322644,103.795347
268526,5,7,12,1.322915,103.795027
268527,1,7,8,1.322914,103.795026
268528,36,6,42,1.322914,103.795026
268529,2,13,15,1.322983,103.794947
268530,22,1,23,1.322982,103.794946
268532,14,1,15,1.32305,103.794867
268533,0,27,27,1.323118,103.794786
268534,24,54,78,1.323185,103.794706
268535,1439,7,1446,1.322915,103.794921
268536,17,12,29,1.323253,103.794626
268537,29,15,44,1.32332,103.794546
268538,2,0,2,1.322374,103.795667
268539,7,2,9,1.323498,103.794338
268540,5,1,6,1.323497,103.794337
268542,17,0,17,1.323557,103.794269
268543,2,0,2,1.32335,103.794511
268544,0,10,10,1.323616,103.794199
268545,1,3,4,1.323615,103.794198
268546,7,0,7,1.323675,103.79413
268547,4,35,39,1.323734,103.794061
268549,13,20,33,1.323853,103.793922
268550,3,3,6,1.323912,103.793853
268551,0,11,11,1.323971,103.793784
268552,29,1,30,1.32403,103.793714
268553,14,6,20,1.324089,103.793645
268554,16,19,35,1.324149,103.793576
268555,9,5,14,1.324208,103.793506
268556,1,0,1,1.321606,103.791875
268557,3,32,35,1.324293,103.793457
268558,3,8,11,1.324318,103.793478
268559,1,4,5,1.32437,103.793518
268560,25,10,35,1.324421,103.793559
268561,64,4,68,1.324472,103.7936
268562,10,13,23,1.324524,103.79364
268563,51,1,52,1.324565,103.793671
268564,12,2,14,1.324324,103.793368
268566,2,3,5,1.324494,103.79316
268567,5,10,15,1.324608,103.793022
268568,17,0,17,1.324721,103.792884
268569,8,0,8,1.323388,103.794447
268570,81,3,84,1.324835,103.792745
268571,80,0,80,1.323455,103.794368
268572,145,182,327,1.324948,103.792607
268573,28,25,53,1.323591,103.794209
268574,8,0,8,1.323726,103.794051
268575,2,5,7,1.323996,103.793734
268576,0,7,7,1.324132,103.793575
268577,0,10,10,1.324257,103.793427
268578,13,14,27,1.324267,103.793417
268579,2,22,24,1.324159,103.793169
268580,43,23,66,1.323861,103.793892
268581,8,46,54,1.3217,103.796435
268582,9,0,9,1.32176,103.796346
268583,7,8,15,1.321805,103.796282
268584,3,23,26,1.299509,103.837
268588,0,2,2,1.323556,103.794268
268591,14,73,87,1.299509,103.837
268597,3,15,18,1.321596,103.795054
268598,71,0,71,1.321546,103.794993
268599,45,1,46,1.321491,103.794924
268600,21,24,45,1.321736,103.795315
268601,4,7,11,1.321417,103.794836
268602,51,1,52,1.32167,103.795251
268603,127,29,156,1.321357,103.794772
268604,3,0,3,1.322443,103.795588
268605,3,46,49,1.321252,103.794647
268606,8,5,13,1.321212,103.794604
268607,140,2,142,1.32154,103.795086
268608,22,0,22,1.321164,103.794553
268609,160,36,196,1.321121,103.794516
268610,166,0,166,1.321417,103.794952
268611,16,2,18,1.321082,103.794472
268612,12,1,13,1.321681,103.794293
268613,1,0,1,1.324267,103.793437
268614,47,0,47,1.321007,103.794383
268615,4,6,10,1.321267,103.79478
268616,6,0,6,1.320968,103.794338
268617,5,1,6,1.321176,103.794675
268618,63,4,67,1.320923,103.794286
268619,28,0,28,1.321132,103.794633
268620,80,0,80,1.320887,103.794243
268621,5,0,5,1.321064,103.79457
268622,12,0,12,1.320853,103.794201
268623,19,5,24,1.321019,103.794515
268624,10,2,12,1.320807,103.794147
268625,6,0,6,1.320927,103.794415
268626,1,2,3,1.321594,103.79515
268627,7,5,12,1.320903,103.794376
268628,104,1,105,1.320738,103.793925
268630,159,15,174,1.320829,103.793837
268631,47,6,53,1.320777,103.794228
268632,5,10,15,1.320921,103.79375
268633,5,0,5,1.320729,103.794169
268634,33,0,33,1.321012,103.793662
268635,7,0,7,1.320676,103.794095
268636,9,8,17,1.321104,103.793575
268637,52,4,56,1.320615,103.794022
268638,20,0,20,1.320268,103.793951
268639,4,0,4,1.320077,103.794123
268640,91,20,111,1.319886,103.794295
268641,22,209,231,1.319803,103.794336
268642,29,1,30,1.32092,103.793749
268643,11,5,16,1.321011,103.793661
268644,60,0,60,1.319885,103.794294
268645,5,0,5,1.321103,103.793574
268646,4,4,8,1.320498,103.793919
268647,17,5,22,1.320497,103.793918
268648,106,22,128,1.321789,103.795275
268649,49,3,52,1.321719,103.795203
268650,89,17,106,1.321662,103.795123
268659,2,30,32,1.329855,103.797329
268660,2,0,2,1.330163,103.797466
268661,3,7,10,1.328473,103.796844
268662,0,17,17,1.328546,103.796922
268663,101,9,110,1.328023,103.796276
268664,13,8,21,1.327632,103.796516
268665,1,2,3,1.320705,103.793964
268666,2,1,3,1.327164,103.79641
268667,148,20,168,1.327154,103.79642
268669,394,121,515,1.328344,103.796605
268670,6,7,13,1.327209,103.796225
268671,3,1,4,1.329857,103.796595
268685,1402,410,1812,1.313498,103.793691
268686,465,1728,2193,1.312987,103.794041
268690,3,98,101,1.313798,103.794318
268691,82,5,87,1.31385,103.794328
268692,73,16,89,1.313266,103.794713
268693,21,3,24,1.313562,103.794961
268694,23,15,38,1.313976,103.794388
268695,75,0,75,1.313415,103.795454
268696,5,0,5,1.314059,103.794428
268697,19,0,19,1.313358,103.795449
268698,49,6,55,1.313357,103.795448
268699,155,2,157,1.314143,103.794467
268700,2,32,34,1.313291,103.795454
268701,31,3,34,1.31329,103.795453
268702,12,0,12,1.313157,103.795465
268703,4,1,5,1.313156,103.795464
268704,0,37,37,1.313023,103.795475
268705,46,22,68,1.315056,103.794606
268706,67,8,75,1.313702,103.795606
268707,83,0,83,1.314985,103.795194
268708,1,2,3,1.327354,103.796493
268709,3,1,4,1.314562,103.794666
268710,10,25,35,1.31452,103.796606
268711,14,10,24,1.314646,103.794706
268712,8,15,23,1.314088,103.797422
268713,42,0,42,1.314729,103.794746
268714,16,3,19,1.313955,103.794699
268715,12,0,12,1.313759,103.795131
268717,38,5,43,1.314437,103.795959
268719,11,0,11,1.313435,103.795454
268720,0,11,11,1.313701,103.795585
268721,19,0,19,1.314188,103.795817
268722,9,4,13,1.314539,103.796605
268723,17,4,21,1.313159,103.794944
268724,37,0,37,1.313937,103.79353
268725,11,0,11,1.313877,103.793612
268726,31,1,32,1.313449,103.794048
268727,62,1,63,1.313449,103.794048
268728,31,0,31,1.313449,103.794048
268729,4,3,7,1.313796,103.794261
268730,18,0,18,1.313796,103.794261
268731,96,0,96,1.313796,103.794261
268732,5,22,27,1.313796,103.794261
268733,130,2,132,1.313808,103.794308
268736,11,83,94,1.329399,103.800837
268737,3,3,6,1.329093,103.80084
268738,16,2,18,1.329118,103.800741
268739,2,0,2,1.330163,103.797466
268740,90,1,91,1.328881,103.800667
268741,9,0,9,1.328681,103.800699
268742,88,20,108,1.328582,103.800561
268743,2,0,2,1.328945,103.800781
268744,12,1,13,1.328377,103.800593
268745,4,1,5,1.328306,103.800475
268746,10,0,10,1.328393,103.800472
268747,29,0,29,1.328069,103.800487
268748,0,2,2,1.328689,103.800598
268749,1,0,1,1.321319,103.79483
268750,19,2,21,1.327746,103.800356
268751,18,0,18,1.327658,103.800276
268752,35,15,50,1.327474,103.800297
268753,16,2,18,1.327373,103.800176
268755,0,2,2,1.328057,103.800359
268756,106,15,121,1.327278,103.800163
268757,28,8,36,1.326814,103.799988
268758,65,14,79,1.327133,103.800147
268759,38,81,119,1.326974,103.800102
268760,1,0,1,1.327942,103.800375
268761,3,3,6,1.329229,103.800785
268762,5,51,56,1.3293,103.800914
268777,19,4,23,1.329805,103.796117
268778,4,3,7,1.329185,103.796173
268779,4,2,6,1.328947,103.796072
268780,18,1,19,1.329151,103.795349
268781,45,1,46,1.328627,103.796011
268782,80,17,97,1.32847,103.795893
268783,7,2,9,1.328863,103.795591
268784,6,0,6,1.328139,103.796006
268785,6,14,20,1.328666,103.795474
268786,64,3,67,1.327916,103.795726
268787,24,0,24,1.328502,103.795402
268788,59,17,76,1.328501,103.795376
268789,9,83,92,1.327553,103.796045
268790,0,5,5,1.328217,103.795376
268791,0,39,39,1.328684,103.79568
268792,22,11,33,1.328084,103.795419
268793,11,0,11,1.327882,103.79536
268794,2,3,5,1.327245,103.795574
268795,0,3,3,1.314168,103.795817
268796,0,4,4,1.327605,103.795244
268797,16,0,16,1.326962,103.795449
268799,6,23,29,1.327185,103.795123
268800,1403,664,2067,1.330196,103.795899
268802,3294,3205,6499,1.330685,103.795675
268803,6,8,14,1.329099,103.795639
268817,1140,1230,2370,1.312936,103.803533
268818,935,376,1311,1.311599,103.803069
268819,734,173,907,1.312274,103.803027
268820,1298,154,1452,1.312554,103.804461
268821,514,102,616,1.313046,103.802642
268822,1473,88,1561,1.312265,103.805143
268823,350,131,481,1.313578,103.802813
268824,1210,38,1248,1.311646,103.804892
268825,225,59,284,1.311908,103.804535
268826,48,426,474,1.312536,103.804838
268828,246,1790,2036,1.312749,103.804388
268829,22,24,46,1.312833,103.805025
268830,274,104,378,1.31273,103.804997
268831,777,44,821,1.313379,103.805483
268836,2326,351,2677,1.313937,103.804749
268844,494,581,1075,1.314075,103.805178
268845,1343,266,1609,1.313983,103.805679
268846,530,177,707,1.314428,103.805978
268847,486,145,631,1.314893,103.806143
268848,1288,2588,3876,1.315304,103.806185
268849,562,3601,4163,1.315055,103.80575
268850,589,330,919,1.316148,103.807256
268851,997,20,1017,1.315229,103.80764
268852,274,1,275,1.314816,103.807954
268853,595,0,595,1.314589,103.808236
268854,663,0,663,1.314323,103.808521
268855,550,1,551,1.314014,103.808135
268856,1239,10,1249,1.314416,103.807567
268857,959,3486,4445,1.317371,103.807805
268867,5,220,225,1.317439,103.806063
268868,7,159,166,1.317662,103.80584
268869,14,754,768,1.317207,103.806296
268886,95,219,314,1.322797,103.812088
268887,1,1,2,1.327089,103.800077
268888,75,646,721,1.322846,103.812122
268890,15,10,25,1.322672,103.811973
268891,8,15,23,1.32263,103.811935
268892,2,3,5,1.32258,103.811881
268893,1,6,7,1.322565,103.811989
268894,20,0,20,1.322481,103.811831
268895,18,3,21,1.322518,103.81185
268896,2,1,3,1.327216,103.795577
268897,2,0,2,1.322691,103.81211
268898,15,0,15,1.322421,103.811872
268899,18,3,21,1.322333,103.811722
268900,50,15,65,1.322332,103.811721
268901,1,2,3,1.32252,103.811931
268902,0,5,5,1.322174,103.811609
268903,41,37,78,1.322016,103.811456
268904,14,23,37,1.322016,103.811476
268905,18,1,19,1.321857,103.811343
268906,443,35,478,1.321698,103.81121
268907,1,12,13,1.321798,103.811158
268908,674,15,689,1.321726,103.811304
268910,8,2,10,1.321485,103.81095
268912,283,35,318,1.32144,103.810865
268914,46,396,442,1.322797,103.812249
268915,5,22,27,1.321856,103.811342
268916,18,10,28,1.322372,103.811808
268932,8,0,8,1.323906,103.800669
268934,4,0,4,1.324029,103.800667
268944,0,5,5,1.324467,103.800821
268946,2,26,28,1.324499,103.800934
268948,0,70,70,1.324531,103.801047
268950,4,46,50,1.324562,103.80116
268977,8,725,733,1.324968,103.808398
268978,3,185,188,1.325001,103.808414
268979,0,57,57,1.324856,103.808335
268980,1,21,22,1.324719,103.808239
268981,1,10,11,1.324615,103.808182
268982,19,16,35,1.324542,103.808115
268983,0,24,24,1.324448,103.808042
268985,0,10,10,1.324373,103.807985
268986,12,130,142,1.324091,103.80765
268987,58,5,63,1.324327,103.807946
268988,91,6,97,1.324536,103.807042
268989,3,19,22,1.324221,103.807876
268992,52,0,52,1.324116,103.807806
268994,0,14,14,1.324438,103.806747
268995,8,12,20,1.324011,103.807737
268996,1,0,1,1.329346,103.800816
268997,1,3,4,1.323905,103.807666
268998,16,31,47,1.323905,103.807666
268999,13,118,131,1.323664,103.807506
269000,13,0,13,1.323603,103.807465
269001,3,48,51,1.323481,103.807384
269002,1,0,1,1.323906,103.807667
269003,97,9,106,1.323237,103.80722
269004,8,1,9,1.323166,103.807169
269005,5,4,9,1.323095,103.807118
269006,4,0,4,1.322954,103.807016
269007,1,0,1,1.323359,103.807302
269009,5,14,19,1.32267,103.806811
269010,0,4,4,1.32262,103.806775
269011,2,0,2,1.322405,103.811747
269012,27,3,30,1.322418,103.806633
269013,6,20,26,1.322576,103.806725
269014,1,0,1,1.322812,103.806913
269015,24,0,24,1.322216,103.806491
269016,15,0,15,1.322295,103.806527
269017,1,0,1,1.322317,103.806562
269018,1,2,3,1.322174,103.811589
269019,0,3,3,1.322108,103.806395
269020,2,0,2,1.322519,103.806704
269022,4,2,6,1.32182,103.806193
269023,57,15,72,1.321889,103.806276
269024,7,8,15,1.321715,103.806102
269029,449,46,495,1.324132,103.807146
269030,628,94,722,1.324159,103.807083
269031,382,28,410,1.324413,103.807189
269032,62,10,72,1.324282,103.807326
269033,322,24,346,1.324144,103.807499
269034,22,27,49,1.321814,103.806238
269035,36,70,106,1.32177,103.806193
269042,16,68,84,1.324036,103.802264
269043,3,29,32,1.324036,103.802284
269044,72,29,101,1.324115,103.802248
269045,5,18,23,1.324115,103.802268
269046,49,43,92,1.324272,103.802216
269047,2,13,15,1.324272,103.802236
269048,7,30,37,1.324429,103.802184
269049,50,4,54,1.324429,103.802204
269050,25,82,107,1.324586,103.802151
269051,0,7,7,1.324586,103.802171
269052,0,16,16,1.324743,103.802119
269053,19,10,29,1.324743,103.802139
269054,2,2,4,1.3249,103.802087
269055,3,3,6,1.3249,103.802107
269056,50,6,56,1.325047,103.802065
269057,12,6,18,1.325057,103.802075
269075,5,87,92,1.323282,103.807026
269076,1,7,8,1.323307,103.806958
269077,5,12,17,1.323358,103.806821
269079,42,7,49,1.323408,103.806685
269081,0,12,12,1.323459,103.806549
269083,12,3,15,1.323489,103.806518
269086,2,1,3,1.322014,103.806349
269088,15,0,15,1.323641,103.806109
269092,10,6,16,1.323699,103.805895
269094,4,5,9,1.323718,103.805829
269096,4,0,4,1.323725,103.805751
269099,3,8,11,1.324053,103.806602
269100,8,16,24,1.323768,103.806443
269101,5,6,11,1.323822,103.805522
269102,3,38,41,1.323935,103.806338
269103,0,4,4,1.324161,103.806427
269104,162,36,198,1.323888,103.805391
269105,190,3,193,1.324189,103.80618
269106,1,5,6,1.323949,103.806055
269107,36,35,71,1.324035,103.8059
269108,0,2,2,1.322014,103.806329
269109,1,5,6,1.324383,103.805796
269110,17,3,20,1.323925,103.805565
269111,38,2,40,1.323786,103.805167
269112,89,39,128,1.323846,103.80504
269113,137,27,164,1.323915,103.804864
269114,10,17,27,1.323971,103.804754
269115,96,12,108,1.324035,103.804561
269116,34,13,47,1.324223,103.804449
269117,3,23,26,1.324245,103.804324
269118,11,14,25,1.324298,103.804254
269119,144,29,173,1.324277,103.803991
269120,6,4,10,1.324221,103.803917
269121,12,16,28,1.324238,103.803799
269122,13,175,188,1.324197,103.803635
269123,16,8,24,1.323869,103.803608
269124,91,0,91,1.323918,103.803587
269125,20,1,21,1.323859,103.803595
269126,17,1,18,1.323976,103.803576
269127,51,1,52,1.324094,103.803555
269128,4,57,61,1.324201,103.803543
269129,98,21,119,1.324236,103.803296
269130,45,14,59,1.324002,103.802827
269131,9,1,10,1.323944,103.802838
269132,3,2,5,1.323828,103.802861
269133,6,5,11,1.323712,103.802884
269134,1,1,2,1.324302,103.805996
269135,12,1,13,1.32349,103.80292
269137,8,2,10,1.323596,103.802887
269138,2,0,2,1.323596,103.802907
269139,16,0,16,1.323828,103.802841
269140,14,1,15,1.323944,103.802818
269141,25,29,54,1.32405,103.802805
269142,1,11,12,1.323877,103.802184
269143,1,0,1,1.322115,103.80642
269144,23,0,23,1.323705,103.802224
269145,117,0,117,1.32359,103.802252
269146,4,0,4,1.323476,103.802279
269147,10,0,10,1.323371,103.802296
269148,9,0,9,1.323418,103.802272
269149,1,10,11,1.323476,103.802259
269150,22,2,24,1.32359,103.802232
269151,8,0,8,1.323705,103.802204
269152,62,1,63,1.323819,103.802177
269153,11,74,85,1.323924,103.80216
269154,15,12,27,1.323735,103.801533
269155,96,5,101,1.323676,103.801544
269156,1,1,2,1.323712,103.802864
269157,53,0,53,1.323439,103.801587
269158,1,1,2,1.323558,103.801566
269159,1,0,1,1.323819,103.802197
269160,8,0,8,1.323262,103.8016
269161,0,1,1,1.323213,103.801621
269162,2,0,2,1.323321,103.801609
269163,46,0,46,1.323558,103.801546
269164,36,5,41,1.323676,103.801524
269165,26,19,45,1.323784,103.801512
269166,35,7,42,1.323583,103.800936
269167,0,2,2,1.323439,103.801567
269168,11,4,15,1.323284,103.800988
269169,4,0,4,1.323229,103.801171
269170,5,0,5,1.32311,103.800896
269171,33,8,41,1.324254,103.800451
269172,4,1,5,1.323199,103.80089
269173,16,20,36,1.324225,103.800289
269174,2,1,3,1.32359,103.806245
269175,48,12,60,1.324198,103.800224
269176,1,16,17,1.323516,103.800855
269177,12,14,26,1.32416,103.800072
269178,2,6,8,1.324159,103.800148
269179,12,2,14,1.324178,103.800224
269180,10,1,11,1.324215,103.800375
269181,5,4,9,1.324227,103.800437
269182,3,5,8,1.323612,103.800256
269183,10,0,10,1.323607,103.800233
269184,1,3,4,1.323596,103.800187
269185,15,4,19,1.323586,103.800141
269186,132,90,222,1.324135,103.79958
269187,718,12,730,1.323875,103.799738
269188,6,10,16,1.323554,103.800004
269189,3,1,4,1.323544,103.799958
269190,26,1,27,1.323533,103.799912
269191,30,0,30,1.323522,103.799866
269192,4,2,6,1.323512,103.79982
269193,2,2,4,1.323502,103.799774
269194,6,2,8,1.323491,103.799728
269195,31,1,32,1.323868,103.803607
269196,993,130,1123,1.324512,103.803826
269197,515,37,552,1.324253,103.804527
269198,434,45,479,1.324134,103.805293
269199,367,30,397,1.32466,103.80491
269200,821,64,885,1.324832,103.804202
269201,569,37,606,1.32503,103.803482
269202,13,126,139,1.325012,103.803482
269203,237,19,256,1.325163,103.802895
269204,1100,103,1203,1.324682,103.803008
269205,5,0,5,1.32423,103.803265
269206,23,0,23,1.324223,103.803234
269207,5,4,9,1.324217,103.803204
269208,455,0,455,1.324211,103.803173
269209,40,0,40,1.324204,103.803142
269210,24,10,34,1.324198,103.803112
269211,20,0,20,1.324192,103.803081
269212,5,0,5,1.323891,103.809595
269213,32,8,40,1.323789,103.809519
269214,1,3,4,1.323672,103.809445
269215,1,7,8,1.32345,103.809306
269216,4,11,15,1.323291,103.809178
269217,6,4,10,1.323191,103.809075
269218,0,1,1,1.323321,103.801589
269219,3,0,3,1.323417,103.800884
269237,132,403,535,1.314947,103.790206
269238,12,17,29,1.315485,103.79044
269239,10,32,42,1.316351,103.790478
269240,10,10,20,1.316381,103.790611
269241,2,80,82,1.316396,103.790665
269242,35,1,36,1.316442,103.790853
269243,0,28,28,1.316532,103.791227
269244,5,0,5,1.316668,103.791789
269245,13,9,22,1.316867,103.79217
269246,23,27,50,1.316978,103.792321
269247,18,3,21,1.317298,103.792577
269248,16,29,45,1.317644,103.792714
269249,17,6,23,1.318681,103.792966
269250,46,68,114,1.318862,103.793089
269252,69,2,71,1.318549,103.793404
269253,16,17,33,1.318804,103.793374
269254,25,1,26,1.318605,103.793478
269255,2,1,3,1.322845,103.808842
269256,26,22,48,1.316954,103.791822
269257,818,100,918,1.319664,103.794632
269258,411,47,458,1.319014,103.794108
269259,1282,381,1663,1.318139,103.794894
269260,646,33,679,1.318488,103.794316
269261,371,28,399,1.318353,103.792489
269262,1562,152,1714,1.318867,103.794726
269263,1201,136,1337,1.318837,103.795468
269264,844,30,874,1.318069,103.795546
269265,746,50,796,1.319119,103.795843
269266,351,90,441,1.31946,103.795634
269267,55,89,144,1.319884,103.794658
269268,2,1,3,1.318455,103.793547
269269,863,106,969,1.319943,103.794793
269270,19,3,22,1.319884,103.794658
269271,12,0,12,1.319971,103.794696
269272,37,0,37,1.320064,103.794839
269273,6,43,49,1.320064,103.794839
269274,1,0,1,1.323018,103.808958
269275,9,0,9,1.320243,103.795019
269276,4,1,5,1.320602,103.795381
269277,2,0,2,1.323427,103.80096
269278,3,7,10,1.320782,103.795562
269279,3,4,7,1.320602,103.795381
269280,2,11,13,1.320961,103.795742
269281,6,0,6,1.320782,103.795562
269282,73,1,74,1.320987,103.795344
269283,3,0,3,1.319795,103.794567
269284,4,15,19,1.320961,103.795742
269285,24,3,27,1.321141,103.795923
269286,26,13,39,1.32131,103.796094
269287,114,15,129,1.32132,103.796104
269288,0,9,9,1.321641,103.796543
269290,2,7,9,1.321764,103.796628
269291,56,7,63,1.320855,103.795931
269293,27,1,28,1.321818,103.796811
269294,4,4,8,1.320896,103.795971
269295,33,0,33,1.320522,103.796124
269296,63,0,63,1.321861,103.796903
269297,0,4,4,1.320993,103.796078
269298,4,3,7,1.320624,103.796258
269299,12,0,12,1.320459,103.796194
269300,17,8,25,1.32189,103.797
269301,1,1,2,1.320423,103.7952
269302,5,0,5,1.320711,103.796378
269303,1,1,2,1.320896,103.795697
269304,1,3,4,1.321924,103.797092
269305,18,0,18,1.3213,103.796104
269306,0,1,1,1.320206,103.794953
269307,8,0,8,1.320652,103.796462
269308,6,13,19,1.321953,103.797188
269309,2,1,3,1.320961,103.795742
269310,208,1,209,1.320904,103.796582
269311,2,0,2,1.320557,103.796335
269312,0,1,1,1.320806,103.796483
269313,48,0,48,1.321523,103.796381
269314,6,11,17,1.32101,103.796705
269315,51,0,51,1.320845,103.796683
269316,6,0,6,1.32203,103.797367
269317,16,9,25,1.321627,103.796541
269318,25,11,36,1.321108,103.796825
269319,94,4,98,1.320943,103.79681
269320,106,46,152,1.322059,103.79744
269321,6,53,59,1.321716,103.796775
269322,3,0,3,1.32131,103.796114
269323,4,4,8,1.321163,103.79706
269324,6,0,6,1.322116,103.797571
269325,2,7,9,1.322136,103.797633
269326,8,3,11,1.321744,103.79685
269327,0,3,3,1.321241,103.797043
269328,8,0,8,1.321201,103.797237
269329,79,2,81,1.322185,103.797735
269330,82,25,107,1.321801,103.796999
269331,31,3,34,1.321335,103.79735
269332,215,1,216,1.321236,103.797378
269333,7,2,9,1.32225,103.797863
269334,28,8,36,1.321858,103.797148
269336,7,0,7,1.321915,103.797297
269337,65,4,69,1.321972,103.797446
269338,87,1,88,1.321971,103.797445
269340,108,1,109,1.322087,103.797743
269341,3,2,5,1.322144,103.797892
269342,3,15,18,1.322201,103.798041
269343,2,0,2,1.320743,103.796553
269344,0,1,1,1.321987,103.797275
269345,57,0,57,1.32243,103.798291
269346,0,7,7,1.322315,103.798339
269347,2,6,8,1.322314,103.798338
269348,38,0,38,1.322478,103.798393
269349,16,0,16,1.322372,103.798488
269350,24,0,24,1.322371,103.798487
269351,3,3,6,1.322493,103.798475
269352,7,2,9,1.322429,103.798637
269353,10,4,14,1.322486,103.798786
269354,1,0,1,1.322258,103.79819
269355,2,2,4,1.322543,103.798935
269356,81,4,85,1.3226,103.799084
269357,19,0,19,1.322771,103.799531
269360,2,4,6,1.32279,103.79979
269361,36,5,41,1.322769,103.799959
269362,7,20,27,1.322748,103.800129
269363,19,32,51,1.322667,103.800118
269364,7,0,7,1.322666,103.800118
269365,38,0,38,1.322576,103.800118
269366,7,6,13,1.322575,103.800117
269367,9,5,14,1.322575,103.800117
269368,43,3,46,1.322575,103.800117
269369,3,0,3,1.321296,103.797192
269370,2,0,2,1.322379,103.798207
269371,121,5,126,1.322394,103.800117
269372,3,16,19,1.322392,103.800116
269374,103,0,103,1.32221,103.800115
269375,63,18,81,1.322039,103.800125
269376,13,0,13,1.322224,103.800437
269379,4,5,9,1.322627,103.800904
269380,12,5,17,1.32259,103.800899
269381,7,0,7,1.322515,103.80089
269382,9,2,11,1.322441,103.800881
269383,3,0,3,1.321945,103.800078
269384,55,0,55,1.322292,103.800862
269385,0,1,1,1.322485,103.798785
269386,12,0,12,1.322143,103.800844
269387,69,10,79,1.322118,103.800811
269388,27,1,28,1.322123,103.800736
269389,23,23,46,1.316623,103.791602
269391,7,70,77,1.315281,103.790244
269392,24,14,38,1.322307,103.798038
269393,10,23,33,1.322355,103.798149
269394,20,15,35,1.322534,103.798545
269395,46,0,46,1.322561,103.79862
269396,23,5,28,1.32258,103.798746
269397,2,1,3,1.322366,103.800872
269398,49,3,52,1.32264,103.798854
269399,4,0,4,1.322674,103.798922
269400,72,3,75,1.322718,103.799072
269401,3,0,3,1.322607,103.798787
269402,48,11,59,1.322772,103.799227
269403,3,2,5,1.322794,103.7993
269404,33,11,44,1.322809,103.799364
269405,33,12,45,1.322838,103.799415
269406,968,1280,2248,1.323357,103.810508
269407,115,1,116,1.323174,103.810369
269408,10,15,25,1.323192,103.81029
269409,2,6,8,1.323015,103.810281
269410,4,1,5,1.32299,103.810275
269411,3,2,5,1.323317,103.810055
269412,28,0,28,1.323504,103.809888
269413,1,14,15,1.322986,103.810153
269414,11,0,11,1.323127,103.810056
269415,0,27,27,1.322903,103.810066
269416,6,3,9,1.322912,103.809918
269418,9,0,9,1.322827,103.809792
269419,0,7,7,1.322781,103.809909
269420,2,3,5,1.322734,103.80991
269422,7,0,7,1.322727,103.809651
269423,4,4,8,1.322594,103.809683
269424,1,0,1,1.322218,103.800853
269425,1,5,6,1.32252,103.809606
269426,6,2,8,1.322498,103.809578
269427,1,4,5,1.32252,103.809455
269428,7,12,19,1.322266,103.809316
269430,8,2,10,1.322238,103.809342
269431,1,0,1,1.322577,103.809539
269432,1,3,4,1.322266,103.809316
269433,7,0,7,1.322359,103.8093
269434,3,4,7,1.322292,103.809205
269436,0,7,7,1.322085,103.80915
269437,10,0,10,1.322045,103.809124
269438,6,9,15,1.321954,103.809063
269439,3,0,3,1.32275,103.79914
269440,20,4,24,1.321886,103.808883
269441,7,1,8,1.321813,103.808822
269442,1,12,13,1.321992,103.808404
269443,88,11,99,1.321869,103.808773
269444,37,85,122,1.321944,103.808409
269445,78,2,80,1.321992,103.808404
269446,2,2,4,1.321992,103.808404
269447,6,0,6,1.321992,103.808404
269448,2,0,2,1.321869,103.800089
269449,6,0,6,1.321923,103.808179
269450,5,2,7,1.3216,103.807451
269451,31,40,71,1.32187,103.808159
269452,1,2,3,1.322019,103.809092
269453,38,10,48,1.321932,103.807972
269454,4,0,4,1.321616,103.807232
269455,29,5,34,1.32183,103.807844
269456,9,6,15,1.321611,103.807171
269457,28,0,28,1.322075,103.807825
269458,85,4,89,1.32163,103.806968
269459,11,15,26,1.32163,103.806968
269460,268,0,268,1.321079,103.806642
269461,4,18,22,1.321913,103.807075
269462,1,25,26,1.320496,103.80479
269464,98,4,102,1.321516,103.805531
269465,157,3,160,1.321063,103.805189
269466,10,9,19,1.320751,103.804795
269467,88,5,93,1.321214,103.804965
269468,0,1,1,1.322266,103.809316
269469,15,0,15,1.321627,103.805368
269470,9,0,9,1.321913,103.805225
269471,2,2,4,1.321998,103.805127
269472,71,1,72,1.322216,103.805153
269473,20,0,20,1.322076,103.805095
269474,0,1,1,1.321495,103.805302
269475,1,3,4,1.322114,103.80484
269476,23,0,23,1.322395,103.804942
269477,2,3,5,1.322062,103.804779
269478,38,0,38,1.322452,103.80489
269479,40,6,46,1.321984,103.804677
269480,39,0,39,1.322546,103.804805
269481,4,0,4,1.322061,103.804728
269482,8,35,43,1.322679,103.804695
269483,73,0,73,1.321622,103.804725
269484,12,0,12,1.322718,103.80464
269485,0,3,3,1.3216,103.807376
269486,25,9,34,1.322749,103.804576
269487,65,1,66,1.321816,103.804583
269488,29,20,49,1.322776,103.804471
269489,5,0,5,1.321867,103.804342
269490,5,0,5,1.322758,103.804543
269491,7,2,9,1.321998,103.804346
269492,2,3,5,1.323044,103.804076
269493,1,0,1,1.32234,103.805
269494,1,19,20,1.322925,103.80417
269495,5,7,12,1.322991,103.804068
269496,14,2,16,1.322193,103.804523
269497,35,1,36,1.323024,103.80408
269498,1,2,3,1.32167,103.804695
269499,3,4,7,1.322349,103.804848
269500,27,1,28,1.323106,103.804083
269501,0,1,1,1.322129,103.804468
269502,9,2,11,1.322463,103.80477
269503,8,2,10,1.323256,103.804099
269504,124,1,125,1.323293,103.804104
269505,5,0,5,1.322558,103.804689
269506,0,8,8,1.323373,103.804125
269507,50,0,50,1.323313,103.804034
269508,9,1,10,1.322438,103.80455
269509,21,0,21,1.32327,103.804049
269511,37,1,38,1.323191,103.804029
269512,72,0,72,1.323143,103.804018
269513,5,1,6,1.323083,103.804
269514,3,8,11,1.323002,103.803997
269515,48,0,48,1.322954,103.803733
269516,2,0,2,1.322026,103.808257
269517,39,0,39,1.322948,103.803531
269518,108,31,139,1.322933,103.803431
269519,0,1,1,1.323163,103.804086
269520,1,1,2,1.32296,103.803626
269521,3,13,16,1.322837,103.8031
269522,2,0,2,1.322887,103.803256
269523,29,2,31,1.322794,103.802931
269524,1,1,2,1.322831,103.803021
269525,297,2,299,1.322697,103.802555
269526,174,6,180,1.322601,103.802207
269527,25,13,38,1.322605,103.801914
269528,39,0,39,1.32264,103.801775
269529,3,3,6,1.322644,103.8016
269530,6,1,7,1.322658,103.80145
269531,0,3,3,1.323069,103.804082
269532,61,0,61,1.32267,103.801312
269533,2,12,14,1.32268,103.801104
269534,108,5,113,1.322766,103.801008
269535,83,16,99,1.322737,103.800894
269536,1,1,2,1.322788,103.802845
269539,8,0,8,1.32321,103.809711
269540,37,13,50,1.323438,103.810108
269541,2,0,2,1.322756,103.800651
269542,29,0,29,1.32301,103.809626
269543,30,0,30,1.32262,103.809566
269544,10,1,11,1.299509,103.837
269556,5,24,29,1.321914,103.805355
269557,1,12,13,1.321901,103.805364
269558,6,1,7,1.321958,103.805411
269559,14,0,14,1.321953,103.80543
269560,4,2,6,1.322047,103.805525
269561,110,2,112,1.322057,103.805563
269562,2,0,2,1.323173,103.809594
269564,53,5,58,1.322287,103.805732
269565,1,2,3,1.322497,103.801333
269566,21,4,25,1.32233,103.805803
269567,13,1,14,1.322286,103.805817
269568,6,1,7,1.322368,103.805851
269569,7,0,7,1.322554,103.805871
269570,3,1,4,1.322446,103.805889
269571,1,20,21,1.322684,103.805905
269572,21,1,22,1.322539,103.805915
269573,5,0,5,1.322814,103.805939
269574,5,0,5,1.322687,103.805954
269575,33,3,36,1.322945,103.805973
269576,37,6,43,1.322794,103.80608
269577,4,0,4,1.322978,103.805882
269578,13,1,14,1.322767,103.806161
269579,26,0,26,1.32301,103.805791
269580,15,8,23,1.322731,103.806286
269581,28,0,28,1.323075,103.80561
269582,5,10,15,1.322705,103.806375
269583,2,0,2,1.322136,103.805638
269584,15,3,18,1.322732,103.806675
269585,34,0,34,1.323205,103.805246
269587,2,0,2,1.32314,103.805428
269588,17,4,21,1.322844,103.806394
269589,22,0,22,1.323336,103.804883
269590,12,8,20,1.322848,103.806331
269592,6,7,13,1.322896,103.806162
269593,0,1,1,1.322916,103.80338
269594,22,5,27,1.322945,103.805993
269595,3,2,5,1.323531,103.804338
269596,2,0,2,1.32327,103.805064
269597,78,1,79,1.323586,103.804166
269598,71,0,71,1.322981,103.805892
269599,16,6,22,1.323017,103.805791
269600,16,0,16,1.323054,103.80569
269601,32,11,43,1.32309,103.805589
269602,394,2,396,1.323126,103.805488
269603,55,0,55,1.323198,103.805286
269604,4,11,15,1.323234,103.805185
269605,1,1,2,1.322963,103.805943
269606,3,0,3,1.322243,103.805773
269607,42,0,42,1.323343,103.804883
269608,4,7,11,1.323379,103.804782
269609,1,3,4,1.323415,103.804681
269611,2,0,2,1.32327,103.805084
269612,19,1,20,1.323524,103.804378
269613,0,1,1,1.323466,103.804519
269614,2,0,2,1.323488,103.804479
269615,111,3,114,1.323162,103.805387
269616,18,11,29,1.323075,103.80561
269632,1088,101,1189,1.312158,103.800379
269633,35,160,195,1.3125,103.799851
269634,154,2,156,1.313438,103.800129
269635,5,360,365,1.312791,103.800175
269636,2,0,2,1.323596,103.804176
269637,68,8,76,1.312816,103.799914
269638,3,0,3,1.323307,103.804984
269639,12,4,16,1.313386,103.80021
269640,131,7,138,1.313549,103.799796
269641,32,18,50,1.313577,103.800248
269642,11,5,16,1.313801,103.800223
269643,51,0,51,1.314264,103.799686
269644,55,19,74,1.314248,103.800172
269645,16,48,64,1.315143,103.80007
269646,22,2,24,1.31568,103.799757
269647,0,5,5,1.315153,103.80006
269648,3,0,3,1.313536,103.799946
269650,5,2,7,1.316465,103.800341
269651,6,0,6,1.316423,103.799747
269652,32,1,33,1.316464,103.80034
269653,59,11,70,1.315837,103.801135
269654,9,18,27,1.316626,103.800507
269655,250,5,255,1.315554,103.801669
269656,17,107,124,1.316725,103.800678
269657,5,1,6,1.315912,103.801901
269658,10,0,10,1.316768,103.801242
269659,0,1,1,1.32356,103.804277
269660,12,3,15,1.316279,103.8012
269661,4,1,5,1.317099,103.801915
269662,116,0,116,1.317557,103.801736
269663,20,1,21,1.316461,103.801849
269664,27,13,40,1.317557,103.801736
269665,2,0,2,1.313479,103.800058
269666,5,0,5,1.31844,103.801181
269667,49,2,51,1.317661,103.801779
269668,69,2,71,1.317754,103.801796
269669,2,1,3,1.315823,103.800037
269670,3,8,11,1.318323,103.80162
269671,4,0,4,1.318538,103.801518
269672,6,0,6,1.318784,103.801398
269673,28,0,28,1.31903,103.801276
269674,90,0,90,1.319153,103.801216
269675,61,2,63,1.313019,103.799931
269676,135,3,138,1.316767,103.801241
269677,6,6,12,1.31676,103.801775
269678,1105,38,1143,1.312346,103.800859
269682,6,0,6,1.315913,103.800481
269683,4,12,16,1.316139,103.800572
269684,1,0,1,1.31678,103.801775
269686,5,15,20,1.316433,103.800924
269687,107,0,107,1.316724,103.800677
269688,23,0,23,1.316724,103.800677
269692,38,951,989,1.323128,103.812029
269693,5,0,5,1.323148,103.8119
269694,1156,835,1991,1.323016,103.811217
269695,218,575,793,1.323162,103.810749
269707,3869,13924,17793,1.323784,103.810236
269708,85,1007,1092,1.324377,103.809478
269709,1,8,9,1.324373,103.809483
269710,165,0,165,1.324383,103.809468
269711,50,244,294,1.324377,103.809478
269712,26,0,26,1.32439,103.809457
269713,0,147,147,1.324383,103.809468
269714,63,0,63,1.324396,103.809447
269715,4,143,147,1.32439,103.809457
269716,47,0,47,1.324403,103.809437
269717,0,173,173,1.324396,103.809447
269718,35,0,35,1.324577,103.809191
269719,4,109,113,1.324403,103.809437
269720,141,60,201,1.324488,103.809309
269721,0,24,24,1.32457,103.809324
269722,5,0,5,1.324488,103.809309
269723,4,78,82,1.324488,103.809309
269724,7,33,40,1.324528,103.809256
269726,2,0,2,1.318133,103.801274
269728,53,1,54,1.324488,103.809309
269729,25,561,586,1.324488,103.809309
269730,5,0,5,1.324488,103.809309
269731,33,261,294,1.324577,103.809191
269732,0,2,2,1.324488,103.809309
269733,4,151,155,1.324832,103.808619
269734,564,179,743,1.324644,103.8059
269735,4052,1039,5091,1.327567,103.801402
269741,4,8,12,1.328833,103.801633
269742,36,1,37,1.328813,103.801303
269743,24,0,24,1.329035,103.801167
269744,10,60,70,1.329253,103.801096
269745,9,7,16,1.329718,103.800689
269747,49,108,157,1.329373,103.799959
269748,443,711,1154,1.32982,103.799538
269757,15,214,229,1.32996,103.798963
269758,85,0,85,1.330877,103.797535
269759,4,1412,1416,1.330919,103.797416
269760,6,1,7,1.331002,103.797178
269761,20,0,20,1.331086,103.79694
269762,126,0,126,1.331169,103.796702
269763,56,0,56,1.331253,103.796463
269764,88,237,325,1.331336,103.796225
269765,15,2,17,1.33142,103.795987
269766,52,808,860,1.331503,103.795749
269767,19,692,711,1.331577,103.795521
269768,2,0,2,1.324577,103.809191
269770,16,0,16,1.329034,103.801169
269772,1,0,1,1.315793,103.800838
269773,3,0,3,1.318088,103.801705
269774,4,0,4,1.328828,103.801634
269777,0,33,33,1.328807,103.801602
269778,3,0,3,1.329068,103.801173
269779,12,2,14,1.328991,103.801379
269780,16,408,424,1.329124,103.801388
269781,2,46,48,1.329273,103.801038
269782,94,3930,4024,1.328337,103.802301
269783,1894,171,2065,1.326019,103.801167
269784,1106,16367,17473,1.299509,103.837
269785,71,6,77,1.317611,103.797147
269786,47,0,47,1.317967,103.797818
269787,0,7,7,1.31878,103.797118
269788,39,13,52,1.318836,103.79702
269789,67,34,101,1.31908,103.796963
269790,15,0,15,1.318773,103.796861
269791,15,13,28,1.319322,103.796934
269792,10,0,10,1.319902,103.796987
269793,7,1,8,1.318656,103.796552
269794,8,6,14,1.320362,103.797406
269795,79,7,86,1.320661,103.797742
269796,16,4,20,1.319322,103.796914
269798,1,5,6,1.319617,103.796896
269799,64,1,65,1.321133,103.798505
269800,14,1,15,1.320137,103.797182
269801,32,16,48,1.320891,103.798642
269802,63,19,82,1.320372,103.797396
269803,11,0,11,1.321498,103.799402
269804,85,2,87,1.320681,103.797742
269805,2,0,2,1.329045,103.801169
269806,19,15,34,1.32087,103.797955
269807,0,1,1,1.329043,103.801172
269808,32,1,33,1.32058,103.799632
269809,6,14,20,1.321095,103.79779
269810,47,8,55,1.321225,103.798683
269811,25,6,31,1.320543,103.798868
269812,26,20,46,1.32135,103.79845
269813,25,6,31,1.320188,103.799085
269814,19,8,27,1.321508,103.799392
269815,16,0,16,1.319928,103.79855
269816,8,4,12,1.321572,103.799366
269817,5,0,5,1.319859,103.798459
269818,17,2,19,1.321636,103.79934
269819,30,0,30,1.319358,103.797971
269821,0,5,5,1.318932,103.797573
269822,11,2,13,1.321881,103.799246
269823,18,6,24,1.31879,103.797108
269824,19,6,25,1.321373,103.799524
269825,229,32,261,1.321296,103.799587
269826,215,23,238,1.321123,103.799687
269827,43,0,43,1.320856,103.799796
269828,13,3,16,1.32058,103.799652
269829,77,15,92,1.32035,103.799441
269830,3,0,3,1.328801,103.801624
269831,13,0,13,1.319859,103.798479
269832,9,1,10,1.319358,103.797991
269833,54,5,59,1.318912,103.797573
269834,27,2,29,1.31878,103.797118
269835,7,0,7,1.3216,103.800262
269837,134,9,143,1.299509,103.837
269852,166,154,320,1.312816,103.798893
269853,2,7,9,1.312815,103.798892
269854,531,76,607,1.312806,103.798914
269855,5,12,17,1.313186,103.79888
269857,218,23,241,1.314045,103.798751
269858,19,7,26,1.315004,103.798532
269859,11,0,11,1.313947,103.79881
269861,1,1,2,1.321498,103.799402
269862,3,2,5,1.314659,103.798566
269863,14,2,16,1.314772,103.798561
269864,94,0,94,1.314962,103.798717
269866,15,2,17,1.315216,103.798694
269867,8,0,8,1.315702,103.798629
269868,16,0,16,1.315345,103.798407
269869,138,8,146,1.315723,103.798647
269870,3,12,15,1.315977,103.798624
269871,15,18,33,1.316624,103.798813
269872,84,1,85,1.316745,103.798873
269873,101,0,101,1.316745,103.798893
269874,12,6,18,1.317546,103.799423
269875,18,2,20,1.316928,103.799758
269876,25,4,29,1.31725,103.799914
269877,42,0,42,1.31746,103.799659
269878,8,9,17,1.317424,103.800154
269880,2,1,3,1.320111,103.798893
269881,3,0,3,1.318023,103.800294
269882,49,12,61,1.318588,103.8004
269883,40,0,40,1.317796,103.80086
269884,79,34,113,1.318248,103.800625
269885,203,2,205,1.318518,103.799667
269886,59,39,98,1.318501,103.800726
269887,74,2,76,1.318778,103.800984
269888,294,3,297,1.318863,103.800571
269889,18,6,24,1.318179,103.799124
269890,33,0,33,1.319035,103.800861
269891,35,4,39,1.317801,103.799055
269892,170,7,177,1.317852,103.799289
269893,5,27,32,1.318588,103.80042
269894,64,10,74,1.318942,103.799251
269895,54,9,63,1.319493,103.800616
269896,3,12,15,1.318674,103.798861
269897,17,1,18,1.3197,103.800286
269898,25,10,35,1.318532,103.798769
269899,11,4,15,1.319185,103.800123
269900,2,0,2,1.31439,103.798588
269902,105,1,106,1.319607,103.799155
269903,5,2,7,1.319026,103.799255
269904,20,1,21,1.318694,103.798861
269905,23,0,23,1.318517,103.79823
269906,131,3,134,1.318237,103.798554
269907,103,67,170,1.312933,103.798903
269908,38,19,57,1.313694,103.798833
269909,10,8,18,1.317921,103.800517
269910,52,4,56,1.313743,103.798528
269911,0,1,1,1.320846,103.799786
269912,0,21,21,1.314051,103.798477
269913,81,2,83,1.316949,103.798882
269914,1,0,1,1.31369,103.798108
269915,13,7,20,1.299509,103.837
269924,7,16,23,1.319208,103.792893
269925,13,3,16,1.319656,103.79246
269926,15,1,16,1.319783,103.792106
269927,61,1,62,1.319965,103.791689
269929,15,0,15,1.320513,103.791408
269931,11,0,11,1.320393,103.791928
269932,21,1,22,1.320468,103.793048
269933,3,3,6,1.320594,103.792364
269934,9,0,9,1.320906,103.793212
269935,54,2,56,1.320483,103.793549
269936,2,7,9,1.319786,103.793308
269937,135,14,149,1.319429,103.793909
269938,41,27,68,1.319776,103.793298
269939,7,10,17,1.319355,103.793182
269940,3,3,6,1.320232,103.79276
269941,12,8,20,1.319488,103.792993
269942,25,9,34,1.319364,103.792841
269943,2,7,9,1.32003,103.792418
269944,23,12,35,1.320226,103.791289
269961,4,48,52,1.323207,103.794458
269962,9,44,53,1.323207,103.794438
269963,0,9,9,1.323095,103.79437
269964,51,2,53,1.323095,103.79435
269965,17,1,18,1.322869,103.794174
269966,48,8,56,1.322654,103.794008
269967,26,11,37,1.322666,103.79399
269968,9,0,9,1.322689,103.793961
269969,0,1,1,1.317453,103.798807
269970,2,0,2,1.319242,103.799952
269971,21,8,29,1.322822,103.793791
269972,2,0,2,1.322778,103.793848
269973,0,1,1,1.322733,103.793905
269974,3,0,3,1.317514,103.80043
269975,8,0,8,1.323,103.793565
269976,1,0,1,1.322911,103.793678
269977,100,5,105,1.323089,103.793451
269978,21,5,26,1.323134,103.793395
269979,5,4,9,1.323178,103.793338
269980,12,0,12,1.323223,103.793281
269981,4,2,6,1.322737,103.793661
269982,2,0,2,1.322867,103.793735
269983,7,3,10,1.322869,103.794194
269984,40,3,43,1.322644,103.794018
269985,11,0,11,1.322634,103.794008
269986,24,6,30,1.322283,103.793972
270001,1713,68,1781,1.312969,103.786885
270002,358,140,498,1.312437,103.787146
270003,466,3638,4104,1.312165,103.7874
270004,462,110,572,1.313201,103.787951
270005,202,380,582,1.312641,103.787954
270006,713,11512,12225,1.312305,103.788024
270007,412,1696,2108,1.311269,103.787215
270008,182,57,239,1.310688,103.787588
270009,9,13165,13174,1.311042,103.789469
270010,4,463,467,1.310459,103.789891
270012,1,0,1,1.323045,103.793508
270013,417,4940,5357,1.309771,103.789038
270014,948,3522,4470,1.308948,103.789115
270015,391,1146,1537,1.309118,103.788369
270016,535,508,1043,1.309488,103.788083
270017,480,57,537,1.309907,103.787271
270018,751,295,1046,1.31022,103.787029
270019,669,604,1273,1.311556,103.788406
270020,267,128,395,1.311118,103.788465
270021,1026,744,1770,1.310653,103.789243
270023,29,7,36,1.311368,103.793281
270024,24,138,162,1.308896,103.785623
270025,100,2772,2872,1.308145,103.786252
270026,858,2942,3800,1.308224,103.78567
270027,1188,2012,3200,1.308407,103.785111
270028,1554,284,1838,1.308855,103.784951
270029,6,150,156,1.299509,103.837
270030,522,355,877,1.30768,103.796619
270031,687,824,1511,1.307083,103.796985
270032,892,1027,1919,1.306585,103.796394
270033,5,74,79,1.299509,103.837
270036,191,2402,2593,1.30946,103.792805
270040,70,1269,1339,1.307283,103.793459
270041,132,2625,2757,1.307571,103.793427
270042,97,786,883,1.30787,103.792867
270043,585,5197,5782,1.307439,103.792904
270044,49,397,446,1.308133,103.792731
270045,177,6383,6560,1.308583,103.792897
270046,162,364,526,1.308768,103.79258
270047,89,742,831,1.308526,103.792384
271001,221,29,250,1.30922,103.796609
271002,447,5653,6100,1.309072,103.795855
271003,603,214,817,1.308172,103.796632
271004,1122,2305,3427,1.30786,103.795639
271005,71,171,242,1.308791,103.796019
271006,2548,621,3169,1.307145,103.795477
271007,72,528,600,1.311475,103.787563
271008,203,4956,5159,1.306555,103.794112
271009,1,6,7,1.311101,103.79018
271010,209,14111,14320,1.308714,103.793103
271011,257,21,278,1.308714,103.793103
271013,845,4312,5157,1.308714,103.793103
271014,6,136,142,1.310675,103.794171
271015,19,38,57,1.31116,103.793857
271016,9,137,146,1.312326,103.793044
271017,9,157,166,1.31238,103.792664
271018,41,1605,1646,1.311545,103.791957
271019,97,261,358,1.310502,103.791453
271020,1019,637,1656,1.310558,103.792194
271021,348,5674,6022,1.311058,103.792276
271022,2219,944,3163,1.309153,103.78562
271023,1679,405,2084,1.308686,103.78623
271029,9,942,951,1.299509,103.837
271030,953,107,1060,1.307488,103.797109
271031,0,19,19,1.307046,103.79649
271032,6,31,37,1.299509,103.837
271033,1,103,104,1.299509,103.837
272002,46,125,171,1.312358,103.787522
272003,497,226,723,1.308661,103.796886
272004,102,1156,1258,1.312924,103.787558
272005,522,2233,2755,1.30762,103.796199
272008,63,179,242,1.311103,103.787338
272009,597,130,727,1.307555,103.794362
272010,301,32,333,1.308358,103.793579
272012,325,6298,6623,1.309746,103.7945
272013,26,294,320,1.309885,103.788606
272014,20,3780,3800,1.309925,103.788785
272016,47,270,317,1.309649,103.78763
272018,593,305,898,1.311274,103.792553
272019,59,5511,5570,1.311612,103.787785
272023,8,114,122,1.308445,103.786484
272030,7,600,607,1.299509,103.837
272031,1,81,82,1.299509,103.837
272033,0,37,37,1.299509,103.837
273005,31,164,195,1.312482,103.788066
273008,16,2431,2447,1.307117,103.79403
273018,944,94,1038,1.311274,103.792553
273019,32,9878,9910,1.311704,103.788118
273031,3,38,41,1.299509,103.837
274005,10,88,98,1.30797,103.796287
274018,766,67,833,1.311274,103.792553
275018,867,3432,4299,1.309866,103.7925
275757,20,658,678,1.299509,103.837
275758,3,89,92,1.299509,103.837
275759,15,0,15,1.313031,103.783179
275761,6,15,21,1.299509,103.837
275762,1,9,10,1.299509,103.837
275763,0,42,42,1.299509,103.837
275764,2929,288,3217,1.32857,103.789274
275766,13,0,13,1.311751,103.783798
275767,121,816,937,1.317845,103.78637
275768,53,22,75,1.317831,103.786472
275769,2,7,9,1.322635,103.783562
275770,39,13,52,1.324309,103.792326
275771,10,0,10,1.323842,103.792757
275773,117,0,117,1.324309,103.792326
275774,2,0,2,1.322624,103.793834
275775,2,0,2,1.324309,103.792326
275777,3,1,4,1.324309,103.792326
275778,0,4,4,1.324309,103.792326
275779,7,48,55,1.324309,103.792326
275780,280,9,289,1.324309,103.792326
275781,0,1,1,1.309327,103.789911
275782,2,0,2,1.324309,103.792326
275783,7,1,8,1.324309,103.792326
275784,15,3,18,1.324309,103.792326
275786,1,1,2,1.324309,103.792326
275787,127,7,134,1.315983,103.785837
275788,10,0,10,1.315983,103.785837
275789,12,0,12,1.315983,103.785837
275790,15,0,15,1.315983,103.785837
275791,73,3,76,1.315983,103.785837
275792,219,11,230,1.322983,103.785391
275793,73,38,111,1.324032,103.785714
275794,7,7,14,1.323988,103.785709
275796,13,37,50,1.299509,103.837
275797,12,1,13,1.299509,103.837
275798,32,15,47,1.299509,103.837
275799,20,0,20,1.299509,103.837
275800,4,0,4,1.299509,103.837
275801,40,4,44,1.299509,103.837
275806,20,3,23,1.299509,103.837
275807,11,0,11,1.299509,103.837
275810,3,21,24,1.299509,103.837
275812,1,0,1,1.324309,103.792326
275813,3,1,4,1.299509,103.837
275814,0,1,1,1.299509,103.837
275816,1,2,3,1.322956,103.793621
275817,1,1,2,1.324309,103.792326
275819,0,2,2,1.299509,103.837
275822,1,1,2,1.299509,103.837
275823,3,0,3,1.299509,103.837
275824,0,18,18,1.299509,103.837
275825,21,18,39,1.327813,103.792025
275826,14,5,19,1.327862,103.791779
275827,6,2,8,1.317711,103.786869
275828,1,6,7,1.317785,103.786736
275829,5,4,9,1.319034,103.780881
275830,59,4,63,1.330913,103.788777
275831,49,16,65,1.324844,103.785157
275833,187,7,194,1.326483,103.790283
275834,23,0,23,1.326478,103.790291
275835,41,0,41,1.326467,103.790307
275836,20,0,20,1.326457,103.790322
275837,28,1,29,1.326446,103.790338
275838,31,0,31,1.326436,103.790354
275839,24,18,42,1.326426,103.79037
275840,9,0,9,1.326415,103.790385
275841,1,0,1,1.299509,103.837
275842,36,0,36,1.326394,103.790417
275843,18,7,25,1.327018,103.789805
275844,418,0,418,1.327052,103.789779
275845,32,0,32,1.327047,103.789789
275846,6,0,6,1.32702,103.789806
275848,1,2,3,1.299509,103.837
275849,134,0,134,1.327018,103.789803
275850,21,12,33,1.327178,103.789925
275851,345,0,345,1.327148,103.789952
275852,48,0,48,1.32718,103.789951
275853,4,2,6,1.327149,103.789944
275854,28,0,28,1.327151,103.789926
275855,59,9,68,1.326899,103.790328
275856,26,0,26,1.326922,103.790323
275857,2,0,2,1.299509,103.837
275858,15,0,15,1.326893,103.790353
275859,4,0,4,1.326929,103.790349
275860,23,0,23,1.326898,103.790329
275861,33,2,35,1.326921,103.790353
275862,20,0,20,1.326895,103.790329
275863,38,0,38,1.326898,103.79035
275864,451,0,451,1.326929,103.790325
275866,187,0,187,1.327093,103.790493
275867,97,37,134,1.327246,103.790594
275868,38,0,38,1.327253,103.790591
275869,1,0,1,1.326405,103.790401
275870,30,0,30,1.327228,103.790623
275871,8,0,8,1.327223,103.790591
275872,3,0,3,1.327017,103.789781
275873,1,2,3,1.327222,103.790616
275874,8,0,8,1.32723,103.790615
275875,1,1,2,1.326901,103.79036
275876,18,4,22,1.327195,103.790321
275877,22,1,23,1.327214,103.790285
275878,2,1,3,1.32723,103.79062
275879,1,0,1,1.327229,103.790593
275880,9,0,9,1.327211,103.790289
275881,0,1,1,1.327194,103.790313
275882,5,0,5,1.327514,103.790437
275883,3,0,3,1.327222,103.790287
275884,2,0,2,1.327246,103.790624
275886,5,0,5,1.327514,103.790464
275887,3,0,3,1.327524,103.790464
275888,10,0,10,1.327523,103.790445
275889,1,0,1,1.327541,103.790436
275890,28,0,28,1.327551,103.790466
275891,9,0,9,1.327542,103.790475
275893,3,0,3,1.327545,103.790445
275894,19,0,19,1.327545,103.790441
275895,21,0,21,1.327523,103.790469
275896,24,0,24,1.327551,103.790446
275897,13,0,13,1.327551,103.790465
275898,3,0,3,1.327516,103.790444
275899,26,0,26,1.327551,103.790465
275900,82,0,82,1.327009,103.790884
275901,15,14,29,1.327011,103.790906
275902,6,0,6,1.327002,103.79089
275903,5,0,5,1.327029,103.79089
275904,165,0,165,1.327005,103.790909
275905,29,0,29,1.327035,103.790886
275907,146,1,147,1.32704,103.790911
275908,245,9,254,1.326992,103.791238
275909,50,0,50,1.326963,103.791234
275910,10,0,10,1.326963,103.791205
275911,5,0,5,1.326993,103.791212
275912,21,0,21,1.32696,103.791238
275913,21,0,21,1.326997,103.791234
275914,6,0,6,1.326963,103.791205
275915,32,0,32,1.326994,103.791228
275916,19,0,19,1.326963,103.791211
275917,33,0,33,1.326968,103.791209
275918,1,0,1,1.32752,103.790472
275919,23,0,23,1.326986,103.791236
275920,16,0,16,1.32696,103.791205
275921,14,23,37,1.326989,103.791204
275922,146,0,146,1.326969,103.791205
275923,25,6,31,1.326465,103.791048
275924,7,0,7,1.326491,103.791053
275925,15,8,23,1.326493,103.791058
275926,68,0,68,1.326501,103.791026
275927,206,0,206,1.326499,103.791055
275928,11,0,11,1.326473,103.79106
275929,114,0,114,1.326477,103.791024
275930,31,0,31,1.326467,103.791021
275931,8,0,8,1.326465,103.791024
275932,2,0,2,1.327524,103.79044
275933,14,0,14,1.326467,103.791055
275934,1,0,1,1.326964,103.791207
275935,93,16,109,1.325427,103.791882
275936,15,0,15,1.325416,103.791898
275937,10,0,10,1.325997,103.791698
275939,39,0,39,1.325987,103.791737
275940,25,0,25,1.325996,103.791706
275941,1,0,1,1.326468,103.791053
275942,13,0,13,1.32602,103.79173
275944,11,10,21,1.326012,103.791524
275945,0,2,2,1.326465,103.791026
275947,84,0,84,1.326007,103.791561
275948,10,0,10,1.326036,103.791532
275949,0,21,21,1.326036,103.791532
275950,123,18,141,1.326198,103.791141
275951,37,0,37,1.326189,103.791141
275952,3,0,3,1.327516,103.790442
275953,269,0,269,1.326188,103.791118
275954,49,0,49,1.326217,103.791118
275955,16,0,16,1.326189,103.791142
275956,9,0,9,1.326215,103.791113
275958,3,0,3,1.326225,103.79111
275959,23,2,25,1.326217,103.791135
275960,11,0,11,1.32619,103.79112
275961,1,0,1,1.325988,103.791705
275962,38,0,38,1.326198,103.79111
275963,0,14,14,1.326199,103.791145
275964,2,0,2,1.32601,103.791555
275965,53,0,53,1.326466,103.791052
275966,52,0,52,1.326498,103.791025
275967,236,0,236,1.32647,103.791047
275968,10,0,10,1.326503,103.791056
275969,142,0,142,1.326491,103.791058
275970,1,0,1,1.326216,103.791145
275971,2,0,2,1.326502,103.791049
275972,4,0,4,1.326469,103.791056
275973,3,0,3,1.326224,103.791108
275974,22,0,22,1.326469,103.791057
275975,3,6,9,1.326474,103.79105
275976,56,0,56,1.3265,103.791048
275977,72,0,72,1.326497,103.791027
275978,176,4,180,1.326511,103.790702
275979,33,0,33,1.326516,103.790674
275980,4,372,376,1.326544,103.790702
275981,5,2,7,1.326511,103.790707
275982,60,12,72,1.330643,103.787823
275983,1180,1086,2266,1.309322,103.79165
275984,2,4,6,1.327729,103.792236
276124,11,2,13,1.325858,103.784897
276125,28,8,36,1.325919,103.784951
276126,41,2,43,1.325822,103.78487
276127,43,3,46,1.325953,103.784989
276128,1,5,6,1.325749,103.784818
276129,127,2,129,1.32602,103.785064
276130,46,8,54,1.325676,103.784765
276131,38,11,49,1.326088,103.78514
276132,14,1,15,1.325602,103.784713
276133,10,7,17,1.326156,103.785216
276134,12,0,12,1.325529,103.78466
276135,48,6,54,1.325939,103.784866
276136,14,6,20,1.325456,103.784608
276137,23,2,25,1.325982,103.78481
276138,7,2,9,1.325383,103.784555
276139,1,4,5,1.32607,103.784696
276140,8,7,15,1.325982,103.784789
276141,21,9,30,1.326148,103.78454
276142,10,0,10,1.32607,103.784676
276143,12,0,12,1.326217,103.784388
276144,89,2,91,1.326182,103.784444
276145,2,11,13,1.326251,103.784313
276146,2,0,2,1.326477,103.791029
276147,4,1,5,1.326277,103.784249
276148,57,1,58,1.32619,103.784274
276149,15,13,28,1.326303,103.784186
276150,15,0,15,1.32613,103.784234
276151,17,12,29,1.326354,103.784059
276152,9,1,10,1.326008,103.784155
276153,4,0,4,1.326406,103.783931
276154,87,0,87,1.325887,103.784076
276155,1,0,1,1.3265,103.791052
276156,8,4,12,1.325766,103.783997
276157,5,0,5,1.326509,103.783677
276158,273,19,292,1.326251,103.784293
276159,12,1,13,1.326541,103.783602
276160,82,0,82,1.326499,103.783667
276161,32,2,34,1.326573,103.783527
276162,7,5,12,1.326464,103.783645
276163,117,12,129,1.326637,103.783376
276164,48,0,48,1.326418,103.783613
276165,66,0,66,1.326701,103.783226
276166,118,0,118,1.326327,103.783549
276167,13,30,43,1.326765,103.783076
276168,118,0,118,1.326236,103.783485
276169,23,0,23,1.326145,103.783421
276170,5,18,23,1.32653,103.783607
276171,15,1,16,1.326552,103.783557
276172,61,0,61,1.326594,103.783457
276173,2,0,2,1.326241,103.784303
276174,4,0,4,1.32668,103.783256
276175,50,0,50,1.326722,103.783156
276176,33,2,35,1.326755,103.783066
276177,76,3,79,1.312035,103.783994
276178,26,2,28,1.311805,103.783356
276179,2,1,3,1.326497,103.791051
276180,9,16,25,1.311918,103.783226
276181,12,12,24,1.311805,103.783687
276182,0,3,3,1.311874,103.783893
276183,75,0,75,1.311956,103.783472
276184,25,0,25,1.312027,103.783353
276185,8,2,10,1.312092,103.783224
276186,6,0,6,1.312158,103.783095
276187,53,4,57,1.312207,103.783008
276188,40,0,40,1.312252,103.78294
276189,35,0,35,1.312298,103.782871
276190,20,7,27,1.312373,103.782771
276191,16,0,16,1.312452,103.782672
276192,2,9,11,1.312535,103.782575
276193,2,4,6,1.312618,103.782478
276194,2,0,2,1.326637,103.783356
276195,26,0,26,1.312783,103.782284
276196,13,2,15,1.312856,103.782197
276197,3,26,29,1.31289,103.782216
276198,17,0,17,1.312684,103.782401
276199,0,3,3,1.311881,103.783579
276200,13,1,14,1.312502,103.782614
276201,205,2,207,1.31296,103.782245
276202,46,1,47,1.312411,103.782721
276203,18,5,23,1.313007,103.782263
276204,4,3,7,1.312354,103.782117
276205,154,11,165,1.313054,103.782282
276206,21,87,108,1.312302,103.782107
276207,16,4,20,1.313101,103.782301
276208,27,0,27,1.312454,103.781813
276209,0,1,1,1.326457,103.783804
276210,1,2,3,1.312913,103.782226
276211,1,10,11,1.313195,103.782338
276212,2,1,3,1.312491,103.781839
276213,25,0,25,1.313242,103.782357
276214,1,0,1,1.313148,103.78232
276215,40,5,45,1.313279,103.782366
276216,5,16,21,1.312944,103.782064
276217,70,0,70,1.312905,103.782146
276218,4,5,9,1.313023,103.781942
276219,20,1,21,1.312944,103.782084
276220,8,1,9,1.313081,103.781754
276221,59,0,59,1.313023,103.781962
276222,20,5,25,1.3131,103.781575
276223,129,2,131,1.31306,103.781871
276224,13,51,64,1.313084,103.781579
276225,6,0,6,1.313096,103.78168
276226,30,8,38,1.313058,103.781573
276227,4,6,10,1.31312,103.781575
276228,14,2,16,1.313005,103.781562
276230,17,2,19,1.312953,103.78155
276231,15,5,20,1.313111,103.781505
276232,154,8,162,1.3129,103.781539
276233,19,1,20,1.313113,103.781425
276234,1,4,5,1.312848,103.781527
276235,2,5,7,1.313114,103.781344
276236,1,8,9,1.312795,103.781516
276237,11,12,23,1.313115,103.781264
276238,39,17,56,1.312743,103.781504
276239,30,15,45,1.313117,103.781184
276240,24,6,30,1.31269,103.781493
276241,13,4,17,1.313118,103.781104
276242,7,9,16,1.312638,103.781481
276243,3,3,6,1.31312,103.781023
276244,2,23,25,1.312585,103.78147
276245,6,5,11,1.313131,103.780933
276246,171,23,194,1.312533,103.781458
276247,40,0,40,1.313127,103.78083
276248,129,3,132,1.31309,103.780939
276249,89,0,89,1.313127,103.78083
276250,2,4,6,1.313059,103.780934
276251,67,0,67,1.313099,103.780643
276252,87,3,90,1.312998,103.780926
276253,1,0,1,1.312652,103.781839
276254,29,1,30,1.312936,103.780917
276255,24,0,24,1.313043,103.780268
276256,4,0,4,1.312875,103.780908
276257,98,6,104,1.313066,103.780279
276258,16,15,31,1.312813,103.780899
276259,23,0,23,1.313099,103.780279
276260,2,14,16,1.312752,103.780891
276261,6,0,6,1.313165,103.780281
276262,28,15,43,1.31269,103.780882
276264,40,0,40,1.313111,103.780933
276265,11,0,11,1.313296,103.780284
276266,36,0,36,1.313107,103.78083
276267,4,0,4,1.313352,103.780275
276268,18,1,19,1.313086,103.78069
276269,77,13,90,1.313039,103.780213
276270,31,0,31,1.313065,103.780549
276271,3,14,17,1.313035,103.780158
276272,53,50,103,1.313044,103.780409
276273,19,7,26,1.313026,103.780048
276274,20,0,20,1.313023,103.780268
276275,6,4,10,1.313018,103.779937
276276,13,33,46,1.312981,103.779717
276277,15,0,15,1.313009,103.779827
276278,8,26,34,1.313001,103.779717
276279,5,8,13,1.313025,103.779727
276280,7,0,7,1.313058,103.779727
276281,23,1,24,1.313125,103.779728
276282,12,8,20,1.313193,103.779728
276283,97,1,98,1.31326,103.779729
276284,3,27,30,1.313317,103.779719
276285,28,0,28,1.313014,103.779514
276286,2,1,3,1.312597,103.781834
276287,31,1,32,1.313205,103.778917
276288,24,36,60,1.313317,103.779241
276289,394,1,395,1.313395,103.779014
276290,38,2,40,1.330375,103.787685
276291,94,3,97,1.330885,103.787992
276292,95,0,95,1.330884,103.787991
276293,7,37,44,1.330884,103.787991
276294,7,3,10,1.331426,103.78832
276295,10,35,45,1.331426,103.788318
276296,142,6,148,1.331419,103.788988
276297,13,1,14,1.331262,103.789245
276298,1,0,1,1.313071,103.780455
276299,43,4,47,1.331267,103.789782
276300,2513,410,2923,1.332238,103.788503
276301,303,83,386,1.332112,103.787553
276302,67,18,85,1.332045,103.787344
276303,557,4,561,1.332428,103.787675
276304,279,11,290,1.332258,103.788284
276305,2279,336,2615,1.333033,103.789281
276306,2250,422,2672,1.332916,103.789792
276307,187,120,307,1.332506,103.789883
276308,2144,57,2201,1.332227,103.79027
276309,856,119,975,1.331518,103.789568
276310,630,191,821,1.332235,103.789122
276311,38,25,63,1.315897,103.788753
276312,3,19,22,1.315996,103.78882
276313,1,2,3,1.31308,103.779213
276314,4,0,4,1.315872,103.788711
276315,1,0,1,1.331346,103.78949
276316,1,3,4,1.315626,103.788493
276317,146,2,148,1.315502,103.788404
276319,3,1,4,1.31525,103.788241
276320,271,9,280,1.315093,103.788158
276321,2,7,9,1.315093,103.788178
276322,22,2,24,1.314819,103.788076
276323,24,0,24,1.314555,103.788004
276324,10,5,15,1.314545,103.788014
276325,6,46,52,1.315995,103.788819
276326,137,2,139,1.315249,103.78824
276337,1142,11,1153,1.311658,103.799472
276338,27,20,47,1.311465,103.799308
276340,367,3,370,1.311339,103.799331
276341,11,21,32,1.311425,103.799289
276342,348,10,358,1.310869,103.799098
276344,6,5,11,1.299509,103.837
276345,6,2,8,1.311268,103.799212
276346,5,8,13,1.311432,103.799312
276347,4,3,7,1.31119,103.799174
276348,0,10,10,1.31136,103.799277
276349,5,11,16,1.311111,103.799135
276350,0,8,8,1.311072,103.799116
276351,2,12,14,1.311072,103.799136
276352,1,15,16,1.310989,103.79907
276353,6,8,14,1.310947,103.799067
276354,2,1,3,1.315798,103.788666
276355,1,28,29,1.310791,103.79898
276356,0,8,8,1.31083,103.798982
276357,0,129,129,1.310708,103.798922
276358,37,9,46,1.310756,103.798935
276359,14,9,23,1.310543,103.798807
276360,54,18,72,1.310685,103.798886
276361,52,6,58,1.3105,103.798733
276362,0,5,5,1.310614,103.798836
276363,11,1,12,1.310467,103.798669
276364,3,9,12,1.310553,103.798797
276365,12,3,15,1.3104,103.798541
276366,56,6,62,1.310535,103.798761
276367,6,1,7,1.310334,103.798412
276368,108,12,120,1.310516,103.798726
276370,2,23,25,1.310479,103.798655
276371,2,0,2,1.312701,103.782381
276372,1,5,6,1.310442,103.798583
276373,11,8,19,1.310405,103.798512
276374,0,1,1,1.315601,103.788491
276375,2,2,4,1.310332,103.79837
276376,0,1,1,1.310369,103.798441
276377,0,3,3,1.310908,103.799025
276378,27,8,35,1.310221,103.798156
276379,4,2,6,1.31021,103.79812
276380,1,3,4,1.310198,103.798084
276381,3,0,3,1.310258,103.798227
276382,0,1,1,1.310295,103.798298
276383,1,1,2,1.310211,103.798166
276384,0,2,2,1.31013,103.797868
276385,65,0,65,1.310084,103.797724
276386,1,4,5,1.310062,103.797652
276388,165,13,178,1.310039,103.79758
276390,2,41,43,1.310036,103.797538
276391,0,1,1,1.310153,103.79794
276392,0,2,2,1.310107,103.797796
276393,0,4,4,1.310018,103.797328
276394,0,4,4,1.310012,103.797243
276395,0,1,1,1.310032,103.797496
276396,20,0,20,1.309998,103.797075
276397,60,11,71,1.309991,103.796991
276398,2,8,10,1.309994,103.796958
276399,0,3,3,1.310176,103.798012
276400,0,12,12,1.310032,103.79683
276401,0,2,2,1.310025,103.797412
276402,36,9,45,1.310083,103.796658
276403,12,8,20,1.310108,103.796573
276404,7,91,98,1.310134,103.796487
276405,11,31,42,1.310305,103.796036
276418,6,222,228,1.325416,103.792637
276419,5,242,247,1.325468,103.792584
276420,0,1,1,1.310005,103.797159
276421,1,2,3,1.310006,103.796915
276422,0,7,7,1.325472,103.792557
276423,19,6,25,1.326136,103.792436
276424,2,0,2,1.310058,103.796744
276425,3,18,21,1.326111,103.792506
276426,21,0,21,1.325548,103.79245
276427,3,0,3,1.325538,103.792484
276428,1,17,18,1.325586,103.792397
276429,4,7,11,1.326064,103.792637
276430,3,0,3,1.326087,103.792566
276431,25,0,25,1.32604,103.792706
276432,20,1,21,1.325661,103.79229
276433,1,4,5,1.326012,103.792797
276434,30,8,38,1.32568,103.792263
276435,17,0,17,1.32598,103.792884
276436,29,9,38,1.325746,103.79221
276437,62,206,268,1.325919,103.793077
276438,2,9,11,1.325808,103.792212
276439,0,1,1,1.325435,103.792611
276441,1,1,2,1.32551,103.792504
276442,5,0,5,1.326054,103.792266
276443,94,0,94,1.326116,103.792279
276444,2,2,4,1.326157,103.792304
276445,6,2,8,1.326178,103.792375
276446,2,1,3,1.325623,103.792343
276447,15,0,15,1.326136,103.792494
276448,2,7,9,1.326116,103.792553
276449,9,0,9,1.326095,103.792612
276450,2,14,16,1.326074,103.792672
276451,1,0,1,1.325869,103.792225
276452,1,2,3,1.326157,103.792434
276453,2,0,2,1.325993,103.792252
276454,0,1,1,1.326054,103.792731
276455,40,0,40,1.325971,103.792968
276456,13,3,16,1.32595,103.793028
276457,7,57,64,1.325929,103.793087
276470,277,1163,1440,1.331169,103.795254
276471,23,187,210,1.33112,103.795238
276472,14,206,220,1.33104,103.795206
276473,67,1121,1188,1.330994,103.795183
276474,39,8,47,1.330953,103.795178
276475,75,648,723,1.330879,103.795154
276476,386,255,641,1.330833,103.795138
276477,33,179,212,1.330741,103.795104
276478,2,48,50,1.330649,103.795071
276479,8,90,98,1.330557,103.795038
276480,21,35,56,1.330465,103.795011
276481,32,820,852,1.330383,103.794981
276484,778,2,780,1.329502,103.79486
276485,5,141,146,1.329365,103.794781
276486,24,3,27,1.329319,103.794763
276487,9,25,34,1.328905,103.794877
276488,0,2,2,1.326012,103.79285
276490,1,1,2,1.328843,103.795037
276491,18,0,18,1.328651,103.795076
276492,6,2,8,1.328414,103.795123
276493,17,125,142,1.32857,103.7944
276494,2,0,2,1.328478,103.795141
276495,1,0,1,1.325991,103.792909
276496,1,1,2,1.3284,103.794424
276497,30,1,31,1.327868,103.794375
276498,12,167,179,1.328276,103.794128
276499,1,64,65,1.328066,103.794007
276500,122,14,136,1.327694,103.793997
276501,2,4,6,1.327912,103.793224
276504,26,2,28,1.327701,103.793149
276505,10,1,11,1.327632,103.793124
276506,16,5,21,1.32757,103.793098
276507,10,11,21,1.327836,103.79314
276508,4,0,4,1.327771,103.793117
276509,3,1,4,1.327709,103.793093
276510,1,1,2,1.327926,103.794399
276511,28,0,28,1.327597,103.793051
276513,2,0,2,1.32765,103.793069
276514,16,0,16,1.327875,103.792672
276515,1,1,2,1.327872,103.79274
276516,5,2,7,1.327889,103.792532
276517,12,0,12,1.3279,103.792463
276519,15,69,84,1.327656,103.793851
276521,21,0,21,1.327666,103.793901
276522,58,0,58,1.327656,103.794014
276523,2,0,2,1.327884,103.792594
276524,43,1,44,1.327661,103.7942
276531,8,3,11,1.326691,103.793262
276534,1,1,2,1.327673,103.79407
276535,21,5,26,1.326691,103.793262
276536,4,80,84,1.326764,103.793392
276537,1089,468,1557,1.32669,103.793264
276538,6,57,63,1.326518,103.793308
276539,302,1,303,1.326691,103.793262
276540,19,22,41,1.326415,103.793293
276541,349,0,349,1.326573,103.792664
276542,167,0,167,1.326607,103.792393
276543,1887,4,1891,1.326691,103.793262
276544,478,261,739,1.326691,103.793262
276545,1544,1,1545,1.327337,103.792769
276553,2,1,3,1.326033,103.79279
276554,1,0,1,1.328145,103.794407
276556,140,1,141,1.323995,103.792515
276557,7,1,8,1.324029,103.792459
276558,4,2,6,1.324707,103.792451
276559,54,325,379,1.323796,103.792385
276560,49,1,50,1.323788,103.792379
276561,8,0,8,1.323812,103.792388
276562,539,273,812,1.323322,103.792063
276563,3,0,3,1.323859,103.792673
276564,61,0,61,1.323345,103.792063
276565,19,5,24,1.323352,103.792059
276566,14,3,17,1.32307,103.792503
276567,14,0,14,1.323043,103.792474
276568,17,0,17,1.323063,103.792501
276569,2,0,2,1.326888,103.793435
276570,31,42,73,1.322909,103.791901
276571,7,0,7,1.322909,103.79188
276572,10,0,10,1.322906,103.791904
276575,2,7,9,1.322369,103.792042
276576,20,9,29,1.3222,103.791927
276577,1,0,1,1.323932,103.792646
276578,5,4,9,1.322737,103.791576
276579,0,2,2,1.323067,103.792502
276580,12,0,12,1.322642,103.791694
276581,2,173,175,1.322535,103.791715
276582,6,2,8,1.321187,103.790178
276583,28,6,34,1.32118,103.790233
276584,2,8,10,1.320903,103.789597
276585,1,16,17,1.321165,103.790343
276587,28,14,42,1.321151,103.790453
276588,1,0,1,1.322076,103.791707
276589,0,6,6,1.321146,103.790553
276590,2,14,16,1.320715,103.78977
276591,8,51,59,1.321126,103.790553
276593,0,29,29,1.320693,103.789818
276595,0,1,1,1.320709,103.789766
276598,1,17,18,1.320762,103.789801
276599,4,1,5,1.320644,103.789997
276601,6,2,8,1.320625,103.790069
276602,3,55,58,1.320326,103.78931
276603,9,0,9,1.320605,103.79014
276605,0,1,1,1.320683,103.789854
276606,2,2,4,1.320257,103.789219
276607,1,0,1,1.320586,103.790212
276608,1,0,1,1.320566,103.790284
276610,1,5,6,1.320122,103.78916
276612,7,5,12,1.320077,103.789126
276614,7,13,20,1.320019,103.789091
276615,9,1,10,1.320488,103.79057
276616,0,12,12,1.319945,103.789002
276617,1,19,20,1.320522,103.789963
276618,1,1,2,1.322679,103.791661
276619,1,12,13,1.320696,103.789789
276620,5,11,16,1.319809,103.788983
276621,1,9,10,1.319796,103.788902
276622,25,0,25,1.319736,103.78889
276623,1,0,1,1.320211,103.789205
276624,2,13,15,1.319638,103.788825
276625,16,19,35,1.319568,103.788806
276626,2,1,3,1.323316,103.79206
276627,0,20,20,1.31946,103.78891
276628,1,12,13,1.319598,103.789004
276629,54,7,61,1.319182,103.788458
276630,62,23,85,1.319956,103.789508
276631,4,55,59,1.319113,103.78844
276632,3,14,17,1.31977,103.789398
276633,1,0,1,1.319691,103.788875
276634,4,4,8,1.319654,103.78939
276635,0,8,8,1.318927,103.788325
276636,2,1,3,1.319391,103.788862
276638,2,6,8,1.31949,103.78927
276639,0,112,112,1.318765,103.788205
276640,3,8,11,1.319432,103.789191
276641,2,5,7,1.318606,103.7881
276642,2,0,2,1.319869,103.788996
276643,11,38,49,1.318576,103.78808
276644,0,12,12,1.31938,103.788874
276645,2,9,11,1.318437,103.788169
276647,2,19,21,1.318564,103.788262
276648,28,20,48,1.319552,103.788993
276649,74,8,82,1.318252,103.787855
276650,0,1,1,1.318998,103.78835
276651,24,34,58,1.318225,103.787803
276652,5,16,21,1.318904,103.788899
276653,14,6,20,1.318147,103.787739
276654,0,1,1,1.319001,103.788997
276655,0,30,30,1.317813,103.787765
276656,1,1,2,1.319356,103.789171
276657,1,0,1,1.318865,103.788897
276658,13,19,32,1.318578,103.788717
276659,3,0,3,1.319523,103.789336
276660,0,5,5,1.318475,103.788582
276661,2,0,2,1.318761,103.788826
276662,0,53,53,1.318264,103.788492
276663,1,3,4,1.318311,103.788097
276664,1,38,39,1.317944,103.788257
276665,3,24,27,1.317793,103.788097
276666,1,16,17,1.317803,103.787775
276667,13,206,219,1.328551,103.79422
276668,12,68,80,1.327523,103.793619
276669,13,133,146,1.324309,103.792326
276670,7,37,44,1.324309,103.792326
276671,19,13,32,1.324309,103.792326
276672,187,7,194,1.324309,103.792326
276673,15,4,19,1.324309,103.792326
276674,7,4,11,1.324309,103.792326
276675,2,7,9,1.324317,103.792988
276676,0,4,4,1.324296,103.793041
276677,20,19,39,1.324254,103.793057
276678,1,0,1,1.31869,103.788778
276692,2165,332,2497,1.317753,103.778578
276693,2036,103,2139,1.31704,103.778496
276694,1193,109,1302,1.317167,103.779025
276695,48,960,1008,1.317533,103.777528
276696,193,9,202,1.316644,103.778973
276697,2432,176,2608,1.316272,103.778082
276698,3420,903,4323,1.317386,103.777708
276711,17,2,19,1.331422,103.792351
276712,0,3,3,1.318523,103.788688
276713,3,0,3,1.331414,103.792397
276714,3,0,3,1.331455,103.792259
276715,5,0,5,1.33152,103.792074
276716,29,1,30,1.331484,103.792195
276717,28,0,28,1.331584,103.791889
276718,3,7,10,1.331531,103.79206
276719,5,7,12,1.331649,103.791704
276720,3,0,3,1.331437,103.792329
276721,4,0,4,1.331714,103.791518
276722,1,0,1,1.324093,103.79294
276723,1,1,2,1.318371,103.788598
276724,4,6,10,1.331673,103.791656
276725,28,2,30,1.331843,103.791148
276726,4,3,7,1.33172,103.791522
276727,4,0,4,1.331898,103.790973
276728,7,2,9,1.331767,103.791387
276729,2,1,3,1.331578,103.791925
276730,1,1,2,1.331625,103.791791
276731,1,0,1,1.331714,103.791518
276732,30,0,30,1.331861,103.791118
276733,1,18,19,1.332064,103.790497
276734,1,12,13,1.331908,103.790983
276748,60,4,64,1.308091,103.802384
276750,2336,1034,3370,1.308434,103.801925
276751,182,3,185,1.307449,103.80204
276762,1,0,1,1.331991,103.790725
276763,1,1,2,1.331814,103.791252
276764,10,3,13,1.330418,103.791563
276765,8,1,9,1.330381,103.791685
276766,9,1,10,1.330437,103.791532
276767,46,1,47,1.330492,103.79138
276768,8,2,10,1.330548,103.791227
276769,7,0,7,1.330604,103.791074
276770,0,1,1,1.330372,103.791691
276771,3,3,6,1.330594,103.791064
276772,30,0,30,1.299509,103.837
276782,4,0,4,1.317181,103.780214
276783,153,49,202,1.317191,103.780204
276784,4,0,4,1.317509,103.780462
276785,2,6,8,1.317519,103.780452
276786,16,282,298,1.317568,103.780491
276787,1,653,654,1.317616,103.78053
276788,19,9,28,1.317713,103.780608
276789,0,3,3,1.331908,103.790963
276790,54,2,56,1.317908,103.780763
276791,0,5,5,1.318005,103.780841
276804,21,7,28,1.317111,103.781903
276805,1,1,2,1.330353,103.791762
276806,3,0,3,1.317811,103.780685
276807,71,1,72,1.317226,103.781767
276808,2,0,2,1.317134,103.781876
276809,5,0,5,1.317317,103.781658
276810,17,3,20,1.317409,103.781549
276811,3,2,5,1.31747,103.781468
276812,38,12,50,1.317522,103.781404
276813,0,11,11,1.31758,103.781336
276814,6,0,6,1.317624,103.781283
276815,1,28,29,1.317662,103.781235
276816,9,18,27,1.317701,103.781197
276817,9,0,9,1.317743,103.781144
276818,190,12,202,1.317776,103.781106
276819,10,8,18,1.3178,103.781072
276820,7,5,12,1.317833,103.781033
276821,2,0,2,1.317271,103.781712
276822,3,1,4,1.317892,103.780964
276823,5,16,21,1.317933,103.780918
276836,2,175,177,1.315526,103.783164
276837,96,63,159,1.315674,103.782678
276838,0,57,57,1.315501,103.783235
276839,3,1,4,1.315552,103.783074
276840,4,0,4,1.315449,103.783375
276842,3,2,5,1.315408,103.783506
276843,7,0,7,1.315398,103.783496
276844,10,165,175,1.315371,103.78359
276845,6,45,51,1.315371,103.78357
276846,1,3,4,1.315344,103.783663
276847,10,28,38,1.315344,103.783643
276848,2,0,2,1.31787,103.780993
276849,1,13,14,1.315235,103.783958
276850,9,54,63,1.315235,103.783938
276851,0,5,5,1.315181,103.784105
276853,0,24,24,1.315127,103.784252
276854,6,14,20,1.315127,103.784232
276855,77,60,137,1.315072,103.7844
276856,3,2,5,1.315072,103.78438
276857,1,149,150,1.315028,103.784537
276858,1,40,41,1.315018,103.784527
276859,1,44,45,1.315018,103.784527
276860,6,16,22,1.314969,103.784633
276861,2,107,109,1.314861,103.784732
276862,1,114,115,1.314804,103.78476
276863,14,120,134,1.314691,103.784817
276864,5,0,5,1.314578,103.784874
276865,3,92,95,1.314969,103.784653
276866,21,37,58,1.314465,103.784931
276867,0,317,317,1.314916,103.784716
276868,20,0,20,1.314352,103.784988
276869,0,23,23,1.314366,103.785335
276870,63,32,95,1.314239,103.785045
276871,0,33,33,1.314587,103.78489
276872,5,1,6,1.314126,103.785102
276873,6,3,9,1.314404,103.784982
276874,3,50,53,1.314012,103.785158
276875,24,165,189,1.314221,103.785073
276876,0,26,26,1.313899,103.785215
276877,2,73,75,1.314039,103.785165
276878,4,185,189,1.312942,103.785478
276879,9,41,50,1.313856,103.785257
276880,216,38,254,1.313511,103.786552
276881,16,308,324,1.312911,103.785532
276882,0,42,42,1.299509,103.837
276883,1,205,206,1.299509,103.837
276893,18,0,18,1.315496,103.780407
276894,190,5,195,1.315571,103.780342
276895,109,4,113,1.315528,103.78037
276896,3,2,5,1.315679,103.780221
276897,6,0,6,1.315593,103.780298
276898,3,2,5,1.315977,103.779974
276899,5,2,7,1.315657,103.780225
276900,5,40,45,1.316169,103.779847
276901,9,1,10,1.315722,103.780153
276902,17,0,17,1.316215,103.779938
276903,5,74,79,1.315786,103.78008
276904,9,97,106,1.316271,103.780039
276905,4,0,4,1.316384,103.78024
276906,943,348,1291,1.316049,103.777127
276907,1,11,12,1.316519,103.780475
276908,344,2,346,1.315702,103.77842
276909,15,0,15,1.315706,103.778391
276910,2,0,2,1.315289,103.783791
276911,6,0,6,1.315709,103.778398
276912,14,0,14,1.315678,103.778395
276913,22,0,22,1.315714,103.778428
276914,35,15,50,1.315676,103.778398
276915,11,0,11,1.315675,103.77842
276916,14,1,15,1.315713,103.778423
276917,154,0,154,1.315713,103.778402
276918,44,1,45,1.316519,103.780475
276919,11,83,94,1.315867,103.778976
276920,61,0,61,1.315867,103.778979
276921,19,0,19,1.31587,103.77898
276922,25,2,27,1.315895,103.778996
276923,152,0,152,1.315904,103.778969
276924,95,0,95,1.315872,103.778975
276925,26,0,26,1.315873,103.778977
276926,3,0,3,1.31718,103.781821
276927,83,0,83,1.315904,103.778969
276928,4,0,4,1.315878,103.779005
276929,29,0,29,1.315897,103.778981
276931,1,0,1,1.330511,103.791309
276932,1,2,3,1.315902,103.778998
276933,13,17,30,1.316741,103.780738
276934,4,1,5,1.316159,103.779837
276935,42,0,42,1.316158,103.779836
276936,96,0,96,1.316158,103.779836
276937,4,0,4,1.316158,103.779836
276938,1,0,1,1.315903,103.779003
276939,2,0,2,1.315676,103.778392
276940,174,1,175,1.316158,103.779836
276941,4,0,4,1.316158,103.779836
276942,14,0,14,1.316158,103.779836
276943,4,0,4,1.316158,103.779836
276944,2,0,2,1.316158,103.779836
276945,24,0,24,1.316158,103.779836
276946,22,0,22,1.316158,103.779836
276947,79,0,79,1.316158,103.779836
276948,20,3,23,1.31691,103.78088
276949,3,3,6,1.316856,103.780616
276950,1,0,1,1.316158,103.779836
276951,40,2,42,1.316933,103.780658
276952,1811,556,2367,1.31471,103.778771
276953,1362,509,1871,1.314687,103.778301
276954,2098,173,2271,1.314441,103.77788
276955,746,318,1064,1.315397,103.777529
276956,457,381,838,1.314999,103.777309
276957,1850,850,2700,1.315624,103.776904
276958,1522,198,1720,1.316108,103.776559
276959,71,0,71,1.314334,103.778343
276971,8,39,47,1.315367,103.781734
276972,3,0,3,1.31587,103.778975
276973,26,0,26,1.315516,103.781618
276974,48,3,51,1.315615,103.781541
276975,8,4,12,1.315715,103.781464
276976,3,0,3,1.315416,103.781696
276977,1,3,4,1.315914,103.781309
276978,1,0,1,1.31707,103.781012
276979,0,32,32,1.316113,103.781154
276980,0,9,9,1.316212,103.781077
276993,30,20,50,1.315182,103.784613
276994,9,38,47,1.315267,103.784664
276995,2,0,2,1.316158,103.779836
276996,8,19,27,1.315518,103.785002
276997,13,0,13,1.315267,103.784684
276998,24,0,24,1.315695,103.785381
276999,10,0,10,1.315498,103.785002
277000,6,3,9,1.315773,103.785349
277001,11,1,12,1.315685,103.785391
277002,8,1,9,1.315684,103.78539
277003,100,14,114,1.315818,103.785328
277004,64,6,70,1.31571,103.785445
277005,58,1,59,1.315736,103.785498
277006,28,542,570,1.316062,103.785221
277007,7,1,8,1.315787,103.785605
277008,17,0,17,1.316175,103.785177
277009,15,0,15,1.315837,103.785713
277010,3,9,12,1.315747,103.78548
277011,20,2,22,1.315888,103.78582
277012,7,22,29,1.31579,103.78557
277013,42,5,47,1.315939,103.785927
277014,79,0,79,1.315874,103.785748
277015,19,1,20,1.315949,103.785917
277050,363,4,367,1.315817,103.785326
277051,157,12,169,1.315482,103.784537
277052,197,9,206,1.315724,103.784156
277053,252,4,256,1.316046,103.784301
277054,145,6,151,1.316406,103.784647
277055,1327,6,1333,1.317061,103.784815
277056,990,18,1008,1.316828,103.78526
277057,408,4,412,1.316466,103.785326
277058,334,4,338,1.316954,103.785058
277059,7,104,111,1.31571,103.785377
277060,0,1,1,1.316013,103.781232
277061,20,0,20,1.315983,103.785837
277062,45,8,53,1.315884,103.782132
277063,10,57,67,1.315849,103.782219
277064,5,28,33,1.315884,103.782132
277065,3,35,38,1.315866,103.782186
277066,17,0,17,1.315996,103.782016
277067,2,0,2,1.315182,103.784633
277068,0,39,39,1.316045,103.781983
277069,4,9,13,1.315964,103.782066
277071,8,0,8,1.315964,103.782066
277072,5,5,10,1.316249,103.781846
277073,3,35,38,1.316055,103.781996
277074,4,90,94,1.316114,103.781957
277075,18,17,35,1.31646,103.781705
277076,83,3,86,1.316173,103.781918
277077,0,29,29,1.316534,103.781645
277078,3,10,13,1.31623,103.781879
277079,0,3,3,1.315814,103.781386
277080,1,8,9,1.316288,103.781841
277081,21,8,29,1.316687,103.781482
277082,0,10,10,1.316345,103.781802
277083,0,22,22,1.316761,103.781394
277085,0,6,6,1.316825,103.781315
277086,28,17,45,1.31646,103.781725
277087,0,8,8,1.316952,103.781159
277088,5,0,5,1.316534,103.781665
277089,20,27,47,1.31707,103.781012
277091,2,34,36,1.317153,103.78091
277092,3,104,107,1.316616,103.781578
277093,5,41,46,1.317226,103.780819
277095,47,45,92,1.317373,103.780635
277096,0,6,6,1.316697,103.781492
277097,0,33,33,1.317509,103.780462
277098,4,33,37,1.316718,103.781466
277099,4,39,43,1.31753,103.780439
277100,0,9,9,1.31674,103.78144
277101,69,289,358,1.31754,103.780425
277102,1,6,7,1.316782,103.781388
277103,3,0,3,1.316616,103.781558
277104,1,12,13,1.316867,103.781283
277106,1,19,20,1.316952,103.781179
277107,801,132,933,1.316909,103.779795
277108,9,11,20,1.316995,103.781126
277109,0,32,32,1.317037,103.781074
277110,3,28,31,1.31708,103.781022
277111,84,32,116,1.317095,103.781004
277112,7,9,16,1.317109,103.780985
277113,2130,562,2692,1.317502,103.779518
277114,72,247,319,1.318357,103.778884
277115,2,42,44,1.317139,103.780949
277116,1486,1002,2488,1.317173,103.777194
277117,12,9,21,1.317168,103.780912
277118,0,12,12,1.317197,103.780875
277119,3,30,33,1.317226,103.780839
277121,0,19,19,1.317285,103.780765
277122,25,15,40,1.317314,103.780729
277123,4,51,55,1.317343,103.780692
277125,653,151,804,1.318118,103.780352
277142,20,44,64,1.315725,103.782174
277143,57,11,68,1.31562,103.782095
277144,2,13,15,1.315408,103.781937
277145,54,24,78,1.315307,103.781763
277146,186,1,187,1.31529,103.78166
277147,4,0,4,1.315312,103.781529
277148,0,1,1,1.31585,103.785675
277149,2,1,3,1.316825,103.781335
277150,17,0,17,1.31544,103.780875
277151,1,1,2,1.315908,103.782124
277152,12,17,29,1.315696,103.782227
277163,0,1,1,1.315355,103.781266
277164,12,1,13,1.317141,103.782077
277165,27,0,27,1.317107,103.782014
277166,1,0,1,1.317186,103.78213
277167,19,6,25,1.317072,103.781955
277168,49,0,49,1.316535,103.781334
277169,39,13,52,1.317022,103.781899
277170,1,0,1,1.316616,103.781403
277171,7,10,17,1.316222,103.781067
277172,3,0,3,1.315383,103.781136
277173,16,2,18,1.316102,103.780963
277174,3,0,3,1.316157,103.78101
277175,1,4,5,1.315882,103.780774
277176,24,0,24,1.315772,103.78068
277177,1,16,17,1.315652,103.780596
277178,19,2,21,1.315672,103.780596
277179,66,12,78,1.315464,103.780463
277180,1,3,4,1.315474,103.780453
277181,6,0,6,1.315402,103.780415
277182,25,8,33,1.315409,103.780406
277183,8,0,8,1.31535,103.780378
277184,3,7,10,1.315344,103.780359
277185,10,10,20,1.315246,103.780303
277186,0,2,2,1.315652,103.780596
277187,23,5,28,1.315149,103.780197
277188,1,0,1,1.316374,103.781195
277189,0,2,2,1.315214,103.780265
277190,13,2,15,1.315149,103.780001
277191,3,0,3,1.315992,103.780869
277192,64,9,73,1.315227,103.779821
277193,3,1,4,1.315175,103.779886
277194,3,0,3,1.315149,103.779981
277195,9,0,9,1.315227,103.779801
277196,1,11,12,1.315418,103.779644
277197,39,0,39,1.315346,103.779689
277198,122,0,122,1.315538,103.779537
277199,4,13,17,1.315442,103.779603
277201,5,20,25,1.315538,103.779517
277202,24,39,63,1.315777,103.779322
277203,3,4,7,1.315633,103.779431
277204,0,1,1,1.315133,103.78008
277205,14,59,73,1.315767,103.779312
277218,11,613,624,1.319432,103.782022
277219,1,6,7,1.31936,103.781961
277220,98,1,99,1.319215,103.781841
277221,1,9,10,1.319081,103.78173
277222,17,10,27,1.319027,103.781703
277223,45,0,45,1.319004,103.781665
277225,2,0,2,1.315133,103.7801
277226,0,2,2,1.318938,103.78161
277227,8,1,9,1.318805,103.7815
277228,5,4,9,1.318805,103.78152
277229,1,1,2,1.318893,103.781594
277230,2,0,2,1.318671,103.78139
277231,27,6,33,1.318538,103.78128
277232,3,0,3,1.315298,103.779752
277233,16,3,19,1.318405,103.781171
277234,11,0,11,1.318538,103.7813
277235,7,3,10,1.318272,103.781061
277236,2,0,2,1.318716,103.781447
277237,6,8,14,1.318138,103.780951
277239,6,53,59,1.318015,103.780851
277240,2,4,6,1.318272,103.781081
277241,25,0,25,1.318183,103.781008
277242,5,0,5,1.318094,103.780934
277243,2,12,14,1.318005,103.780861
277244,14,10,24,1.318272,103.781061
277245,31,10,41,1.318102,103.780903
277246,0,1,1,1.315729,103.779345
277256,58,13,71,1.318608,103.782258
277257,0,2,2,1.318449,103.781227
277258,7,1,8,1.318569,103.782226
277259,19,0,19,1.318562,103.7822
277260,17,1,18,1.318491,103.782161
277261,2,0,2,1.318604,103.782235
277262,5,2,7,1.318413,103.782097
277263,3,3,6,1.318392,103.782059
277264,16,1,17,1.318335,103.782032
277266,2,0,2,1.318477,103.782129
277267,0,2,2,1.318257,103.781968
277268,2,0,2,1.318222,103.781919
277269,1,0,1,1.31806,103.780866
277270,10,1,11,1.318052,103.781778
277271,6,0,6,1.318024,103.781775
277272,72,0,72,1.317967,103.781708
277273,1,4,5,1.317946,103.78171
277274,2,0,2,1.318137,103.781848
277275,21,0,21,1.317868,103.781646
277276,89,5,94,1.317797,103.781567
277277,19,6,25,1.31779,103.781581
277278,8,1,9,1.317722,103.781507
277279,0,1,1,1.318102,103.781839
277292,8,19,27,1.319018,103.781809
277293,1,323,324,1.318965,103.781878
277294,9,96,105,1.318859,103.782015
277295,7,255,262,1.318753,103.782152
277296,18,36,54,1.318657,103.78228
277297,7,23,30,1.318603,103.782341
277298,19,165,184,1.318471,103.782495
277299,1,2,3,1.318627,103.781374
277300,1,7,8,1.318295,103.7827
277301,55,15,70,1.318217,103.782793
277302,4,13,17,1.318207,103.782803
277303,1,15,16,1.317993,103.783077
277304,9,32,41,1.318128,103.783176
277305,17,0,17,1.31806,103.783137
277307,4,0,4,1.317983,103.783087
277310,26,0,26,1.317817,103.782988
277311,17,0,17,1.317751,103.782948
277312,40,5,45,1.317685,103.782909
277313,7,0,7,1.317618,103.782869
277314,1,4,5,1.317552,103.782829
277315,2,0,2,1.317882,103.781638
277316,16,5,21,1.31742,103.78275
277317,21,12,33,1.317353,103.78271
277318,45,3,48,1.317287,103.782671
277319,55,10,65,1.317221,103.782631
277320,7,0,7,1.316316,103.782399
277321,8,1,9,1.316374,103.782316
277322,15,0,15,1.317022,103.782512
277323,3,2,5,1.316955,103.782472
277324,1,0,1,1.317712,103.781517
277325,32,0,32,1.316824,103.782388
277326,13,4,17,1.316632,103.782369
277327,5,0,5,1.317474,103.782506
277328,3,0,3,1.318383,103.782598
277341,2,3,5,1.318126,103.782739
277342,0,3,3,1.317498,103.782554
277343,1,2,3,1.318163,103.782748
277344,1,3,4,1.318119,103.782713
277345,17,0,17,1.317884,103.782546
277346,1,0,1,1.316889,103.782433
277347,6,1,7,1.317723,103.782418
277348,1,2,3,1.318046,103.782675
277349,19,7,26,1.317637,103.782367
277350,3,0,3,1.317943,103.782573
277351,14,6,20,1.317384,103.782226
277352,19,7,26,1.317767,103.782433
277353,1,0,1,1.318031,103.782643
277354,7,3,10,1.317586,103.782319
277356,33,0,33,1.317394,103.782216
277369,11,69,80,1.317803,103.787755
277370,2,15,17,1.318169,103.787345
277371,49,19,68,1.3181,103.787293
277373,18,15,33,1.318128,103.787251
277374,6,0,6,1.318345,103.78747
277375,137,25,162,1.318147,103.78722
277376,4,1,5,1.318462,103.787553
277377,18,75,93,1.318184,103.787157
277378,7,1,8,1.31857,103.787626
277379,25,16,41,1.318221,103.787093
277380,4,20,24,1.318633,103.787674
277381,5,3,8,1.318686,103.787712
277382,0,17,17,1.318294,103.786967
277383,0,1,1,1.317723,103.782398
277384,30,0,30,1.318331,103.786904
277385,3,0,3,1.317855,103.782503
277386,4,27,31,1.318368,103.78684
277387,2,6,8,1.319004,103.787939
277388,14,1,15,1.318405,103.786777
277390,8,20,28,1.318432,103.786724
277391,171,2,173,1.319217,103.78809
277392,1,24,25,1.318632,103.78754
277393,167,3,170,1.319323,103.788166
277394,10,0,10,1.318684,103.787465
277395,7,1,8,1.319429,103.788242
277396,23,0,23,1.318788,103.787314
277397,0,1,1,1.318792,103.787787
277398,4,1,5,1.318882,103.787173
277399,0,2,2,1.317486,103.78279
277400,1,0,1,1.319535,103.788317
277401,2,0,2,1.319631,103.788383
277402,5,10,15,1.319044,103.786927
277403,1,3,4,1.319704,103.788437
277404,65,13,78,1.318921,103.787185
277406,3,4,7,1.318951,103.787207
277407,2,1,3,1.318898,103.787863
277410,13,4,17,1.319068,103.787296
277411,16,0,16,1.319955,103.788611
277412,0,1,1,1.318892,103.787163
277413,1,0,1,1.319703,103.787561
277414,10,5,15,1.319815,103.787595
277416,1,0,1,1.320017,103.788655
277417,1,0,1,1.319733,103.78797
277418,95,0,95,1.319304,103.787473
277419,2,1,3,1.319829,103.788524
277421,2,0,2,1.319672,103.788415
277422,6,0,6,1.319421,103.787561
277423,16,0,16,1.320312,103.788818
277424,37,0,37,1.31948,103.787606
277425,1,0,1,1.320143,103.788742
277426,1,0,1,1.32038,103.788845
277427,1,0,1,1.319539,103.78765
277428,16,1,17,1.319598,103.787694
277430,2,0,2,1.320243,103.788791
277431,8,1,9,1.320587,103.788925
277432,18,0,18,1.318943,103.78743
277434,9,5,14,1.318825,103.78738
277435,26,1,27,1.320724,103.788979
277436,128,13,141,1.318639,103.787658
277437,0,2,2,1.319656,103.787738
277438,204,12,216,1.318698,103.7877
277439,1,0,1,1.320449,103.788871
277440,10,6,16,1.318816,103.787784
277441,3,0,3,1.320174,103.788764
277442,4,7,11,1.318934,103.787868
277443,5,0,5,1.320999,103.789086
277444,4,0,4,1.319052,103.787952
277445,1,0,1,1.320862,103.789032
277446,69,2,71,1.319169,103.788037
277447,4,51,55,1.320957,103.789904
277448,2,8,10,1.319287,103.788121
277450,11,5,16,1.319405,103.788205
277451,1,0,1,1.321058,103.789103
277452,11,3,14,1.319523,103.788289
277453,1,0,1,1.320974,103.789779
277454,4,1,5,1.319641,103.788373
277455,9,0,9,1.320998,103.789613
277456,2,2,4,1.319674,103.788396
277457,3,0,3,1.32093,103.789059
277458,1,0,1,1.320986,103.789696
277459,9,1,10,1.321021,103.789446
277460,81,1,82,1.319774,103.788466
277462,52,0,52,1.319841,103.788512
277463,14,0,14,1.321045,103.78928
277464,2,0,2,1.320793,103.789006
277466,48,0,48,1.319974,103.788605
277467,4,0,4,1.321078,103.789103
277469,21,0,21,1.320107,103.788698
277470,10,0,10,1.320174,103.788744
277471,3,0,3,1.32101,103.78953
277472,120,2,122,1.320281,103.788786
277473,1,1,2,1.319908,103.788558
277474,0,1,1,1.319708,103.788419
277475,72,1,73,1.320496,103.78887
277476,4,3,7,1.320567,103.788898
277477,2,1,3,1.32021,103.788758
277478,5,1,6,1.32071,103.788953
277480,81,10,91,1.320853,103.789009
277483,2,1,3,1.320639,103.788925
277484,14,0,14,1.321078,103.789103
277485,0,1,1,1.320424,103.788842
277487,10,28,38,1.317802,103.787754
277488,2,1,3,1.321068,103.789093
277499,7,180,187,1.318042,103.786576
277500,2,0,2,1.320353,103.788814
277501,190,9,199,1.318452,103.786724
277503,15,0,15,1.319171,103.786958
277504,6,0,6,1.319893,103.786719
277505,5,2,7,1.319189,103.786795
277506,6,3,9,1.319244,103.786509
277507,1,10,11,1.319243,103.786508
277508,6,0,6,1.318879,103.785989
277509,1,0,1,1.321191,103.789106
277510,11,0,11,1.320219,103.786027
277511,36,1,37,1.319707,103.786013
277512,12,3,15,1.320347,103.786037
277514,34,1,35,1.320333,103.786263
277515,3,0,3,1.317802,103.787754
277516,5,0,5,1.320298,103.786509
277517,2,1,3,1.320229,103.786017
277518,4,7,11,1.320357,103.786047
277519,54,2,56,1.320241,103.785872
277520,12,0,12,1.32119,103.786063
277521,10,3,13,1.320254,103.785593
277522,14,4,18,1.319424,103.787077
277523,41,2,43,1.320367,103.786037
277524,2,4,6,1.319677,103.787176
277525,0,14,14,1.320778,103.78604
277527,29,0,29,1.320939,103.785434
277528,7,0,7,1.319916,103.787276
277529,9,0,9,1.321185,103.78603
277530,6,0,6,1.321171,103.78593
277531,5,0,5,1.321807,103.786245
277532,12,0,12,1.321152,103.785797
277533,34,0,34,1.321142,103.78573
277534,9,1,10,1.318813,103.785764
277535,3,5,8,1.319161,103.786968
277536,32,18,50,1.32118,103.785996
277546,0,9,9,1.329424,103.792091
277547,6,0,6,1.329857,103.791635
277548,25,1,26,1.329513,103.792194
277549,26,0,26,1.329395,103.792019
277550,73,12,85,1.329724,103.79229
277551,3,1,4,1.329935,103.792385
277552,42,1,43,1.330146,103.792481
277553,39,4,43,1.330357,103.792576
277554,106,7,113,1.330779,103.792767
277555,16,2,18,1.330944,103.79282
277568,25,502,527,1.332281,103.792797
277569,5,20,25,1.331836,103.792638
277570,48,15,63,1.331826,103.792628
277571,3,19,22,1.331613,103.792551
277572,35,26,61,1.33142,103.792479
277573,3,11,14,1.33142,103.792479
277574,2,1,3,1.320175,103.785316
277575,9,0,9,1.331194,103.792323
277576,21,3,24,1.330875,103.792128
277577,5,1,6,1.330865,103.792118
277578,1,1,2,1.318442,103.786714
277579,17,1,18,1.330325,103.791838
277580,3,0,3,1.33136,103.792451
277581,2,4,6,1.329867,103.791645
277582,1,3,4,1.330206,103.791755
277583,4,7,11,1.330065,103.791694
277584,11,1,12,1.329942,103.791636
277594,2,11,13,1.330579,103.793928
277596,1,0,1,1.319327,103.78603
277597,1,1,2,1.3306,103.791983
277599,1,0,1,1.330445,103.793872
277600,3,0,3,1.330315,103.791828
277601,3,1,4,1.330087,103.793722
277602,0,2,2,1.330356,103.793834
277603,1,4,5,1.329552,103.793493
277604,5,4,9,1.329452,103.793467
277605,0,4,4,1.32949,103.793462
277606,13,2,15,1.329363,103.79343
277607,4,0,4,1.329438,103.793441
277608,0,12,12,1.329183,103.793357
277609,18,2,20,1.329334,103.793399
277610,0,7,7,1.329004,103.793284
277611,31,3,34,1.329231,103.793356
277612,4,2,6,1.328825,103.793211
277613,9,1,10,1.329127,103.793314
277614,8,3,11,1.328646,103.793138
277615,42,5,47,1.329023,103.793272
277616,18,16,34,1.3285,103.793088
277618,34,8,42,1.328307,103.793074
277619,6,0,6,1.328815,103.793188
277620,1,0,1,1.330176,103.79376
277621,28,0,28,1.328608,103.793103
277622,65,2,67,1.3285,103.793068
277623,21,5,26,1.328436,103.793063
277624,0,17,17,1.328317,103.793064
277671,48,6374,6422,1.310932,103.795153
277672,13,116,129,1.311048,103.795227
277673,27,147,174,1.311036,103.795157
277674,8,135,143,1.311102,103.795151
277675,50,2,52,1.311166,103.795136
277676,7,31,38,1.311228,103.795113
277677,24,153,177,1.311312,103.795059
277678,12,126,138,1.311368,103.795004
277679,5,6,11,1.311399,103.794969
277680,108,1948,2056,1.31107,103.795139
277681,61,375,436,1.311435,103.794912
277682,23,92,115,1.311459,103.794568
277683,100,219,319,1.311471,103.794855
277684,14,15,29,1.311259,103.795081
277685,31,23,54,1.311507,103.794799
277686,29,18,47,1.311471,103.794835
277687,26,11,37,1.311614,103.794608
277688,14,21,35,1.311578,103.794685
277689,221,39,260,1.311698,103.794478
277690,38,41,79,1.311614,103.794628
277691,56,73,129,1.311651,103.79457
277692,12,71,83,1.311876,103.794194
277693,12,290,302,1.311689,103.794513
277694,29,205,234,1.311726,103.794455
277695,26,11,37,1.311763,103.794398
277696,16,163,179,1.311782,103.794369
277697,11,36,47,1.311817,103.794314
277698,22,12,34,1.311851,103.794259
277699,38,1915,1953,1.311886,103.794204
277700,139,238,377,1.311099,103.794964
277711,128,158,286,1.327755,103.789651
277724,46,2957,3003,1.310873,103.795144
277725,128,10513,10641,1.310693,103.795096
277726,2,233,235,1.299509,103.837
277728,2,22,24,1.310645,103.795081
277730,56,35,91,1.310556,103.795041
277731,54,22,76,1.310506,103.795018
277732,4,13,17,1.310484,103.795002
277733,36,283,319,1.31044,103.794969
277734,6,333,339,1.310247,103.794667
277735,30,65,95,1.310358,103.794904
277737,7,10,17,1.310785,103.795098
277738,73,24,97,1.310318,103.794872
277739,3,3,6,1.310581,103.795033
277740,15,5,20,1.310278,103.794841
277741,1,9,10,1.310506,103.794998
277742,86,9,95,1.310238,103.794809
277743,5,9,14,1.310345,103.794874
277744,30,112,142,1.310198,103.794777
277745,34,1010,1044,1.310208,103.794767
277746,4,496,500,1.31075,103.794654
277747,30,44,74,1.310352,103.795081
277759,8,462,470,1.330264,103.794825
277760,10,144,154,1.330422,103.794617
277761,2,0,2,1.329814,103.793602
277762,1,0,1,1.328712,103.793145
277763,1,0,1,1.330308,103.79472
277765,4,6,10,1.330394,103.794509
277766,5,1,6,1.330451,103.794368
277767,7,1,8,1.33048,103.794298
277768,0,1,1,1.330336,103.794649
277769,0,1,1,1.330509,103.794228
277770,1,0,1,1.330538,103.794158
277771,3,1,4,1.330595,103.794017
277772,4,1,5,1.330614,103.793957
277773,67,0,67,1.330755,103.793477
277774,12,0,12,1.330698,103.793453
277775,89,1,90,1.330642,103.79343
277776,12,0,12,1.330585,103.793406
277777,4,0,4,1.330585,103.793406
277778,1,0,1,1.330566,103.794087
277779,2,0,2,1.330279,103.79479
277780,3,1,4,1.330414,103.793334
277782,2,0,2,1.330471,103.793358
277783,2,0,2,1.330301,103.793287
277784,3,0,3,1.330097,103.793732
277785,11,1,12,1.33083,103.793429
277786,0,1,1,1.330528,103.793382
277787,62,4,66,1.330886,103.793274
277788,1,0,1,1.330849,103.793378
277789,5,6,11,1.330784,103.793489
277801,2,59,61,1.32965,103.794781
277802,4,215,219,1.329652,103.794797
277803,9,15,24,1.329668,103.794738
277804,2,20,22,1.329671,103.794751
277806,1,0,1,1.330913,103.793181
277807,1,0,1,1.329709,103.79466
277808,1,0,1,1.329738,103.794569
277809,0,1,1,1.329747,103.794568
277812,3,1,4,1.329822,103.794384
277813,4,3,7,1.32986,103.794293
277814,1,0,1,1.329773,103.794484
277815,5,0,5,1.329898,103.794201
277816,0,3,3,1.330187,103.793239
277817,11,0,11,1.329936,103.794109
277818,25,0,25,1.329947,103.794061
277819,3,1,4,1.329974,103.794017
277820,2,4,6,1.329982,103.793976
277821,33,0,33,1.330011,103.793926
277822,5,0,5,1.330017,103.793891
277823,7,6,13,1.330049,103.793834
277824,1,4,5,1.330052,103.793807
277825,105,5,110,1.330087,103.793742
277826,1,3,4,1.330077,103.793732
277839,84,74,158,1.329176,103.794382
277840,4,1,5,1.32919,103.794348
277841,40,1,41,1.329218,103.794282
277842,2,0,2,1.330244,103.793263
277844,16,0,16,1.329302,103.794082
277845,6,3,9,1.32933,103.794016
277846,1,0,1,1.329877,103.79423
277847,1,0,1,1.329351,103.793965
277849,1,0,1,1.329372,103.793913
277850,2,1,3,1.329912,103.794145
277851,1,1,2,1.329246,103.794216
277852,1,10,11,1.329558,103.793465
277853,0,1,1,1.329457,103.793708
277854,452,0,452,1.329606,103.793352
277855,7,0,7,1.329639,103.793276
277856,4,0,4,1.329671,103.7932
277857,57,2,59,1.329703,103.793125
277858,9,0,9,1.329735,103.793049
277859,7,3,10,1.329768,103.792973
277860,36,0,36,1.3298,103.792898
277861,5,1,6,1.329832,103.792822
277862,13,2,15,1.329774,103.792798
277864,5,1,6,1.329599,103.792728
277865,1,0,1,1.329574,103.793427
277866,2,1,3,1.3295,103.793606
277867,3,0,3,1.329366,103.792633
277868,2,0,2,1.329542,103.793503
277869,15,0,15,1.329016,103.792491
277870,3,0,3,1.329249,103.792586
277871,6,0,6,1.328783,103.792397
277872,35,0,35,1.328667,103.79235
277875,3,0,3,1.3289,103.792444
277876,6,2,8,1.328694,103.792161
277877,3,7,10,1.328317,103.792208
277878,3,0,3,1.328434,103.792255
277879,25,1,26,1.327889,103.792142
277880,2,0,2,1.329133,103.792539
277881,0,1,1,1.329482,103.79268
277882,2,0,2,1.328327,103.792198
277883,2,3,5,1.299509,103.837
277884,0,2,2,1.327813,103.792025
277885,1,1,2,1.299509,103.837
277895,2,2,4,1.32932,103.794006
277896,3,0,3,1.328822,103.792393
277897,1,9,10,1.32926,103.793967
277898,0,2,2,1.299509,103.837
277899,2,10,12,1.328839,103.793812
277900,6,0,6,1.32919,103.793938
277901,2,5,7,1.328348,103.793607
277902,1,11,12,1.328348,103.793607
277903,3,2,5,1.329049,103.793879
277904,70,25,95,1.328321,103.79377
277905,188,13,201,1.328318,103.793682
277906,4,0,4,1.328909,103.793821
277907,10,2,12,1.328338,103.793597
277908,16,2,18,1.328337,103.793596
277909,34,1,35,1.328769,103.793762
277910,5,2,7,1.328334,103.793429
277911,2,1,3,1.32932,103.794006
277912,1,2,3,1.328333,103.793428
277913,2,0,2,1.328839,103.793812
277914,0,3,3,1.328629,103.793704
277915,27,7,34,1.328358,103.793597
277916,1,0,1,1.328317,103.792188
277917,17,4,21,1.328298,103.792909
277918,32,36,68,1.32829,103.792745
277919,10,11,21,1.328281,103.79258
277920,11,0,11,1.328288,103.792486
277921,1,0,1,1.328303,103.792992
277922,0,2,2,1.328488,103.793645
277923,7,0,7,1.328317,103.793064
277924,109,1,110,1.328327,103.792198
277937,0,3,3,1.328297,103.793064
277938,0,3,3,1.316197,103.787953
277939,15,10,25,1.316271,103.787867
277940,1,1,2,1.328307,103.792198
277941,0,1,1,1.328303,103.792337
277942,2,3,5,1.31636,103.787783
277943,1,2,3,1.316182,103.78799
277944,22,4,26,1.316478,103.787645
277945,2,3,5,1.316715,103.78735
277946,2,1,3,1.316567,103.787522
277947,6,0,6,1.316863,103.787177
277948,3,0,3,1.316597,103.787508
277949,1,1,2,1.316241,103.787921
277950,0,1,1,1.316419,103.787694
277951,7,1,8,1.317102,103.786878
277952,4,3,7,1.316952,103.787094
277953,0,1,1,1.316833,103.787232
277954,0,1,1,1.317193,103.78675
277955,50,0,50,1.317266,103.786537
277956,106,2,108,1.317193,103.78677
277957,15,1,16,1.317313,103.786329
277958,19,2,21,1.317243,103.786661
277959,3,0,3,1.316715,103.78737
277960,0,1,1,1.317072,103.78694
277962,1,8,9,1.317369,103.786131
277975,6,1,7,1.312063,103.798442
277977,19,3,22,1.311978,103.798387
277978,5,0,5,1.311922,103.79835
277979,4,2,6,1.311865,103.798313
277980,1,1,2,1.317011,103.787005
277982,40,4,44,1.311696,103.798202
277984,27,0,27,1.311639,103.798165
277986,0,10,10,1.311583,103.798129
277988,4,3,7,1.311526,103.798092
277989,35,2,37,1.31147,103.798055
277990,1,1,2,1.311809,103.798276
277991,24,7,31,1.311348,103.797947
277992,8,0,8,1.311327,103.797911
277993,1,1,2,1.311403,103.798008
277994,17,5,22,1.311275,103.79781
277995,3,2,5,1.311245,103.797744
277996,59,8,67,1.311214,103.797679
277997,61,3,64,1.311183,103.797614
277998,27,6,33,1.311159,103.797548
277999,1,0,1,1.317289,103.786453
278000,5,3,8,1.311121,103.797417
278001,173,0,173,1.311102,103.797352
278002,1,2,3,1.317349,103.786131
278003,83,0,83,1.311093,103.797213
278004,23,5,28,1.311095,103.797172
278005,17,18,35,1.311099,103.797089
278006,5,0,5,1.311106,103.797053
278007,37,8,45,1.311119,103.796982
278008,33,3,36,1.311138,103.796915
278009,54,20,74,1.311162,103.796852
278010,17,1,18,1.311185,103.79679
278011,25,9,34,1.311209,103.796727
278012,19,62,81,1.311233,103.796665
278025,1,27,28,1.30863,103.799048
278026,1,28,29,1.30863,103.799077
278027,0,3,3,1.311097,103.797282
278028,23,0,23,1.308655,103.799041
278029,29,3,32,1.30869,103.798961
278030,14,1,15,1.30873,103.798903
278031,27,4,31,1.308754,103.798898
278032,263,1,264,1.30877,103.798845
278033,30,17,47,1.308803,103.798827
278034,75,0,75,1.30881,103.798787
278035,1,0,1,1.31114,103.797483
278036,4,2,6,1.308902,103.798684
278037,29,0,29,1.308891,103.798672
278038,1,4,5,1.308952,103.798612
278039,0,1,1,1.308853,103.798755
278040,5,7,12,1.309001,103.798541
278041,113,0,113,1.308971,103.798556
278042,2,0,2,1.311306,103.797875
278043,108,0,108,1.309011,103.798498
278044,18,5,23,1.309109,103.798402
278045,2,0,2,1.309051,103.798469
278047,25,0,25,1.309079,103.798414
278048,0,2,2,1.309031,103.798469
278049,5,0,5,1.309126,103.798359
278050,3,0,3,1.30865,103.799019
278051,0,1,1,1.308931,103.798614
278052,26,5,31,1.309313,103.798166
278053,1,0,1,1.309174,103.798304
278054,15,0,15,1.309381,103.798093
278055,45,5,50,1.309269,103.798194
278056,18,4,22,1.309447,103.798042
278057,17,2,19,1.309293,103.798166
278058,13,1,14,1.309513,103.79799
278059,5,1,6,1.309361,103.798093
278060,152,2,154,1.309578,103.797939
278062,2,3,5,1.309644,103.797888
278063,0,2,2,1.309226,103.798267
278065,52,1,53,1.309776,103.797785
278066,0,5,5,1.30958,103.797922
278067,0,17,17,1.309842,103.797734
278068,56,1,57,1.309635,103.797879
278069,0,4,4,1.309907,103.797683
278070,17,4,21,1.30969,103.797836
278071,35,9,44,1.309973,103.797631
278072,9,8,17,1.310029,103.79759
278073,150,3,153,1.3098,103.797751
278074,5,0,5,1.309855,103.797708
278075,131,1,132,1.309909,103.797666
278077,2,32,34,1.310019,103.79758
278078,24,5,29,1.308704,103.79897
278079,3,10,13,1.30971,103.797836
278080,1,0,1,1.309222,103.798249
278090,2,141,143,1.311556,103.799264
278091,0,3,3,1.309284,103.7982
278092,9,12,21,1.311681,103.799047
278093,135,7,142,1.311754,103.798912
278094,136,4,140,1.311816,103.798824
278095,5,3,8,1.311867,103.798745
278096,148,2,150,1.31197,103.798589
278097,1,1,2,1.309471,103.798008
278098,17,2,19,1.312102,103.798381
278099,56,5,61,1.31213,103.79833
278100,17,172,189,1.311805,103.797534
278101,156,9,165,1.312187,103.798228
278102,1438,109,1547,1.312245,103.798024
278103,0,5,5,1.312244,103.798126
278104,988,7,995,1.311552,103.797656
278105,13,0,13,1.312276,103.79793
278106,1136,232,1368,1.312023,103.797278
278107,158,23,181,1.312276,103.79793
278108,7,3,10,1.312268,103.797825
278109,4,1,5,1.312245,103.797728
278110,20,30,50,1.312192,103.797613
278111,117,0,117,1.312139,103.797498
278112,4,8,12,1.312086,103.797383
278113,0,28,28,1.312033,103.797268
278114,6,21,27,1.312001,103.79721
278115,468,27,495,1.311356,103.796665
278116,913,16,929,1.31197,103.797152
278117,24,39,63,1.311906,103.797036
278118,52,54,106,1.311833,103.796954
278119,55,32,87,1.311712,103.796857
278120,27,63,90,1.311585,103.796782
278121,49,239,288,1.311466,103.796728
278122,88,79,167,1.311392,103.796704
278123,31,25,56,1.311253,103.796665
278124,15,217,232,1.311185,103.796644
278125,33,178,211,1.311127,103.796633
278126,17,13,30,1.311011,103.796611
278127,6,17,23,1.310895,103.796588
278128,7,17,24,1.310779,103.796566
278129,8,22,30,1.310673,103.796554
278130,2,26,28,1.310597,103.796534
278131,25,22,47,1.310531,103.796525
278132,15,15,30,1.310398,103.796506
278133,12,63,75,1.310342,103.796498
278134,13,375,388,1.310144,103.796477
278147,28,12,40,1.309225,103.799183
278148,36,3,39,1.309239,103.799182
278149,2,1,3,1.311597,103.799192
278150,13,4,17,1.30927,103.799132
278151,0,1,1,1.309745,103.797794
278152,0,1,1,1.309279,103.799097
278153,11,1,12,1.309315,103.79904
278154,36,13,49,1.309397,103.798931
278155,1,0,1,1.309334,103.799031
278156,22,0,22,1.30946,103.79883
278157,34,0,34,1.309388,103.798925
278158,2,2,4,1.309498,103.798791
278159,54,1,55,1.309575,103.798713
278160,1,2,3,1.309243,103.799155
278161,81,8,89,1.309651,103.798635
278162,17,1,18,1.309483,103.798786
278163,59,4,63,1.309727,103.798557
278164,3,3,6,1.30953,103.798738
278165,168,5,173,1.309804,103.798479
278166,1,0,1,1.309352,103.798982
278167,4,1,5,1.30988,103.798401
278169,15,6,21,1.30988,103.798401
278171,56,2,58,1.310063,103.798276
278172,0,1,1,1.309577,103.798691
278173,3,12,15,1.310162,103.798203
278175,13,12,25,1.310211,103.798166
278176,65,0,65,1.30981,103.798452
278177,122,0,122,1.309857,103.798405
278178,190,1,191,1.309908,103.798364
278179,71,0,71,1.309964,103.798329
278180,4,2,6,1.310019,103.798288
278181,5,0,5,1.310074,103.798248
278182,5,2,7,1.310129,103.798207
278183,7,0,7,1.310184,103.798166
278184,66,16,82,1.310201,103.798156
278197,17,11,28,1.311754,103.798912
278198,30,17,47,1.311754,103.798892
278199,34,0,34,1.311725,103.798895
278200,1,6,7,1.311719,103.798871
278201,62,8,70,1.311667,103.79886
278202,2,6,8,1.31165,103.79883
278203,1,1,2,1.312063,103.798442
278204,159,8,167,1.311581,103.798788
278205,3,1,4,1.311552,103.798791
278206,1,1,2,1.31161,103.798826
278207,9,3,12,1.311373,103.798664
278208,30,1,31,1.311379,103.798688
278209,12,7,19,1.311304,103.798623
278210,283,0,283,1.311321,103.798653
278211,78,0,78,1.311234,103.798582
278212,106,1,107,1.311263,103.798619
278213,20,4,24,1.311165,103.79854
278214,56,0,56,1.311205,103.798584
278215,1,8,9,1.311096,103.798499
278216,8,11,19,1.311148,103.79855
278217,19,4,23,1.311024,103.798446
278218,69,0,69,1.31109,103.798515
278219,1,0,1,1.309717,103.798548
278220,41,5,46,1.311036,103.798476
278221,20,10,30,1.310929,103.798349
278222,1,1,2,1.311511,103.798747
278223,36,11,47,1.31088,103.798262
278224,0,1,1,1.310996,103.798423
278225,2,1,3,1.30946,103.79881
278226,4,0,4,1.310893,103.79832
278227,5,5,10,1.310806,103.79812
278228,0,1,1,1.310931,103.798374
278229,3,0,3,1.310843,103.798191
278230,67,3,70,1.310829,103.798203
278231,12,25,37,1.31076,103.79801
278232,14,0,14,1.310799,103.798144
278233,13,15,28,1.310732,103.797935
278234,4,5,9,1.310768,103.798085
278235,1,6,7,1.310704,103.79786
278236,17,0,17,1.310745,103.798022
278237,2,0,2,1.310976,103.798423
278238,0,8,8,1.310721,103.79796
278239,26,4,30,1.310648,103.79771
278240,8,0,8,1.310698,103.797898
278241,7,0,7,1.310629,103.797632
278242,59,13,72,1.310675,103.797835
278243,61,15,76,1.31061,103.797555
278244,19,0,19,1.310651,103.797772
278245,1,0,1,1.31086,103.798262
278246,3,5,8,1.310628,103.79771
278247,3,11,14,1.310571,103.7974
278249,39,0,39,1.310552,103.797322
278250,122,17,139,1.310596,103.797581
278251,4,16,20,1.310536,103.797223
278252,9,0,9,1.31058,103.797516
278253,2,2,4,1.310532,103.797174
278254,12,16,28,1.310564,103.797451
278255,126,3,129,1.310538,103.797086
278256,2,0,2,1.310676,103.797785
278257,5,3,8,1.310557,103.79701
278258,8,5,13,1.310532,103.797322
278259,1,2,3,1.310788,103.798085
278260,119,0,119,1.310521,103.797256
278261,3,7,10,1.310596,103.796858
278262,8,2,10,1.310513,103.79719
278263,30,3,33,1.310615,103.796782
278264,15,0,15,1.310508,103.797124
278265,2,9,11,1.310634,103.796706
278266,274,4,278,1.310517,103.79709
278267,8,1,9,1.310654,103.79663
278268,5,2,7,1.310534,103.797023
278269,5,63,68,1.310663,103.796564
278270,149,0,149,1.310551,103.796956
278271,0,3,3,1.310576,103.796934
278272,16,0,16,1.310585,103.796822
278273,23,13,36,1.310602,103.796755
278275,17,1,18,1.310636,103.796621
278276,4,54,58,1.310653,103.796554
278277,2,0,2,1.310548,103.797387
278278,48,5,53,1.311442,103.798706
278289,96,5,101,1.31449,103.78033
278290,5,0,5,1.31449,103.78033
278291,24,2,26,1.314487,103.780429
278292,1,7,8,1.314495,103.780153
278293,1,0,1,1.31059,103.797477
278294,0,1,1,1.314495,103.780153
278295,47,0,47,1.314504,103.779798
278296,5,0,5,1.314515,103.779834
278298,13,0,13,1.314524,103.779433
278299,157,4,161,1.314524,103.779433
278300,14,32,46,1.314495,103.780133
278301,10,1,11,1.314524,103.779433
278302,4,0,4,1.314523,103.779432
278303,1,0,1,1.314488,103.78037
278305,4,1,5,1.31466,103.779315
278306,42,0,42,1.314504,103.779778
278307,16,4,20,1.314475,103.779379
278308,31,1,32,1.314508,103.77966
278309,44,2,46,1.314426,103.779325
278310,42,30,72,1.314511,103.779541
278311,1,2,3,1.310568,103.796889
278312,3,4,7,1.313975,103.779118
278313,6,3,9,1.314229,103.77911
278314,22,2,24,1.314131,103.779002
278315,1,3,4,1.314033,103.778894
278316,8,2,10,1.313977,103.778856
278317,12,2,14,1.313786,103.778857
278319,2,1,3,1.314328,103.779217
278320,27,5,32,1.31451,103.77954
278331,13,0,13,1.316412,103.788357
278332,3,2,5,1.316123,103.788059
278333,21,8,29,1.316113,103.788049
278334,4,5,9,1.315716,103.787713
278335,25,7,32,1.316123,103.788039
278337,38,14,52,1.315726,103.787703
278338,2,0,2,1.311494,103.798757
278339,2,0,2,1.315618,103.787622
278340,17,2,19,1.315716,103.787693
278341,125,0,125,1.315422,103.78744
278342,2,2,4,1.315334,103.787339
278343,3,1,4,1.315324,103.787349
278344,27,8,35,1.315408,103.787285
278345,7,10,17,1.315385,103.787282
278346,7,4,11,1.315491,103.787221
278347,1,4,5,1.315446,103.787236
278348,5,7,12,1.315658,103.787094
278349,0,4,4,1.315568,103.787142
278350,14,3,17,1.315825,103.786966
278351,4,1,5,1.31569,103.787049
278352,96,1,97,1.315993,103.786838
278353,1,3,4,1.315813,103.786956
278354,10,4,14,1.31616,103.786711
278355,2,3,5,1.315935,103.786862
278356,6,12,18,1.316327,103.786583
278357,0,2,2,1.31552,103.787531
278358,0,2,2,1.316057,103.786769
278359,20,23,43,1.316179,103.786676
278361,165,60,225,1.316301,103.786583
278362,3,1,4,1.316828,103.7862
278363,1,0,1,1.314498,103.780015
278364,21,0,21,1.316912,103.786136
278365,5,0,5,1.316546,103.786396
278366,4,2,6,1.317155,103.786113
278368,43,5,48,1.317349,103.786131
278369,14,0,14,1.31679,103.786209
278370,1,1,2,1.316494,103.786455
278371,19,0,19,1.317053,103.786079
278372,1,1,2,1.316912,103.786116
278373,13,8,21,1.317359,103.786121
278374,1,44,45,1.299509,103.837
278386,13,5,18,1.315768,103.787664
278387,36,0,36,1.315768,103.787643
278388,3,2,5,1.31582,103.787614
278389,3,2,5,1.31582,103.787594
278390,165,24,189,1.315924,103.787515
278391,48,2,50,1.315924,103.787495
278392,1,1,2,1.317206,103.7861
278393,14,2,16,1.316028,103.787396
278394,4,1,5,1.316132,103.787317
278395,10,2,12,1.316132,103.787297
278396,5,2,7,1.316235,103.787218
278397,40,1,41,1.316235,103.787198
278398,0,1,1,1.316423,103.786489
278400,73,2,75,1.316443,103.78702
278401,337,5,342,1.316443,103.787
278402,10,2,12,1.316547,103.786921
278403,18,2,20,1.316537,103.786911
278416,20,7,27,1.310493,103.798838
278417,1,5,6,1.310493,103.798818
278418,51,36,87,1.310443,103.798869
278419,13,0,13,1.310443,103.798849
278420,20,39,59,1.310342,103.798931
278421,68,10,78,1.310342,103.798911
278422,10,34,44,1.310242,103.798993
278423,37,3,40,1.310242,103.798973
278424,0,6,6,1.309628,103.799531
278425,1,4,5,1.310141,103.799035
278426,55,1,56,1.310041,103.799098
278427,0,10,10,1.30994,103.79918
278428,1,1,2,1.316028,103.787416
278429,36,14,50,1.30984,103.799242
278430,1,1,2,1.30994,103.79916
278431,1,4,5,1.309739,103.799304
278432,5,4,9,1.309739,103.799284
278433,33,4,37,1.309639,103.799366
278434,34,1,35,1.309639,103.799346
278435,7,2,9,1.309516,103.799358
278436,44,0,44,1.309516,103.799338
278437,5,13,18,1.309454,103.799333
278438,0,7,7,1.309454,103.799313
278439,80,5,85,1.309331,103.799282
278440,0,2,2,1.30984,103.799222
278441,19,11,30,1.309207,103.799232
278442,7,22,29,1.309217,103.799222
278443,45,1,46,1.309165,103.799222
278444,41,6,47,1.308178,103.798811
278445,4,0,4,1.309123,103.799211
278446,1,5,6,1.308198,103.798774
278447,32,2,34,1.309039,103.799191
278448,9,13,22,1.308236,103.798701
278449,4,2,6,1.308955,103.79917
278450,1,12,13,1.308275,103.798628
278451,10,2,12,1.308872,103.799149
278452,61,64,125,1.308314,103.798555
278454,6,33,39,1.308352,103.798482
278455,0,2,2,1.309331,103.799262
278456,5,191,196,1.308391,103.798409
278457,11,1,12,1.30862,103.799087
278458,10,36,46,1.30843,103.798336
278459,26,5,31,1.308581,103.799062
278460,4,42,46,1.308476,103.798269
278461,13,2,15,1.308552,103.799047
278462,85,12,97,1.30853,103.798208
278463,2,2,4,1.308495,103.799017
278464,1,32,33,1.308584,103.798146
278465,48,4,52,1.308437,103.798987
278466,1,0,1,1.316339,103.787119
278467,0,2,2,1.308704,103.799108
278468,0,6,6,1.308691,103.798023
278470,18,2,20,1.308745,103.797962
278471,4,1,5,1.308264,103.798897
278472,92,9,101,1.308799,103.7979
278473,6,3,9,1.308207,103.798867
278474,46,0,46,1.308853,103.797838
278475,1718,5,1723,1.307937,103.79877
278476,0,1,1,1.308637,103.798085
278477,0,1,1,1.308906,103.797777
278478,14,11,25,1.309014,103.797654
278479,1,3,4,1.309041,103.797623
278480,1,11,12,1.309116,103.797557
278481,52,165,217,1.308482,103.798062
278482,8,0,8,1.309184,103.797507
278483,22,6,28,1.308531,103.798041
278484,3,37,40,1.309252,103.797458
278485,68,20,88,1.308537,103.797972
278486,13,0,13,1.30932,103.797408
278487,3,16,19,1.308585,103.797937
278488,2,11,13,1.309388,103.797358
278489,86,4,90,1.308652,103.797915
278490,6,0,6,1.309456,103.797309
278491,28,7,35,1.308673,103.797868
278492,0,2,2,1.30838,103.798957
278493,7,3,10,1.308427,103.798322
278494,6,10,16,1.309592,103.797209
278495,0,2,2,1.309524,103.797259
278496,0,4,4,1.30966,103.79716
278497,1,5,6,1.308548,103.798167
278498,17,1,18,1.309728,103.79711
278499,1,3,4,1.308613,103.798092
278500,1,7,8,1.309728,103.79711
278501,23,2,25,1.308679,103.798017
278502,10,0,10,1.30985,103.797041
278503,0,5,5,1.308745,103.797942
278504,17,21,38,1.309894,103.797028
278505,1,4,5,1.308811,103.797866
278506,35,8,43,1.309981,103.797001
278507,0,6,6,1.308877,103.797791
278508,0,6,6,1.308942,103.797716
278509,0,13,13,1.309008,103.797641
278510,4,4,8,1.309008,103.797641
278511,3,5,8,1.309116,103.797537
278512,26,5,31,1.309197,103.797478
278513,106,7,113,1.309277,103.797419
278514,13,4,17,1.309358,103.79736
278516,0,2,2,1.308482,103.798242
278517,29,4,33,1.309601,103.797183
278518,0,7,7,1.309681,103.797124
278519,0,3,3,1.314809,103.779189
278520,32,3,35,1.309806,103.797043
278521,1,21,22,1.309916,103.797001
278522,139,19,158,1.309971,103.796991
278535,1030,225,1255,1.311438,103.802332
278536,165,610,775,1.310667,103.802678
278537,342,98,440,1.310621,103.802603
278539,416,301,717,1.31071,103.802385
278540,0,612,612,1.310906,103.802558
278541,303,369,672,1.310761,103.802216
278542,0,9,9,1.311017,103.802172
278543,803,208,1011,1.31184,103.802045
278544,12,40,52,1.31085,103.801991
278545,9,0,9,1.31124,103.801399
278546,39,55,94,1.31089,103.801795
278547,269,520,789,1.311689,103.801814
278548,20,205,225,1.310973,103.801576
278550,63,206,269,1.311001,103.801441
278551,114,736,850,1.311811,103.801487
278552,22,77,99,1.311113,103.801188
278553,205,59,264,1.312157,103.801611
278554,21,80,101,1.311135,103.801031
278555,659,337,996,1.311886,103.801245
278556,22,101,123,1.310914,103.800267
278559,63,23,86,1.311348,103.800514
278561,189,14,203,1.311438,103.800335
278563,120,23,143,1.311572,103.80015
278565,15,364,379,1.311667,103.799976
278568,100,659,759,1.311934,103.799398
278569,5,95,100,1.31212,103.79937
278570,1,24,25,1.312243,103.799163
278571,2,57,59,1.312339,103.798988
278572,4,10,14,1.312433,103.79886
278573,1,36,37,1.312558,103.79883
278574,6,14,20,1.312714,103.798535
278575,225,105,330,1.312816,103.798287
278576,370,137,507,1.31306,103.798187
278577,23,30,53,1.312854,103.798085
278578,1,32,33,1.312867,103.797906
278579,18,64,82,1.312745,103.797424
278580,395,422,817,1.312466,103.79683
278581,5,6,11,1.312347,103.796578
278582,32,668,700,1.312472,103.796159
278583,50,48,98,1.312411,103.795118
278584,14,30,44,1.312466,103.795042
278585,14,34,48,1.312168,103.795395
278586,130,513,643,1.312208,103.7952
278587,118,4,122,1.312273,103.795011
278588,5,16,21,1.312422,103.794742
278589,75,12,87,1.31257,103.794473
278590,25,9,34,1.312709,103.794214
278591,0,7,7,1.312843,103.794019
278592,40,139,179,1.312842,103.794018
278596,0,1,1,1.30896,103.797715
278597,12,47,59,1.314028,103.791137
278598,32,160,192,1.314571,103.790759
278599,39,60,99,1.314344,103.789764
278600,199,4,203,1.313971,103.789152
278602,1,1,2,1.30952,103.797242
278603,11,12,23,1.315539,103.789676
278604,4,76,80,1.314973,103.789936
278605,55,119,174,1.315725,103.789434
278606,0,11,11,1.315353,103.789186
278607,6,128,134,1.316112,103.788954
278608,1,59,60,1.316608,103.788799
278609,1,49,50,1.316545,103.788463
278610,2,33,35,1.316511,103.788252
278611,1,1,2,1.314531,103.789242
278612,41,19,60,1.316599,103.788157
278613,3,5,8,1.317451,103.787538
278614,0,14,14,1.316777,103.787967
278615,1,58,59,1.316954,103.787777
278616,45,38,83,1.317132,103.787587
278617,1,35,36,1.317299,103.787407
278618,1,5,6,1.317376,103.787309
278619,22,10,32,1.317376,103.787115
278620,5,3,8,1.317578,103.787046
278621,8,7,15,1.317712,103.78687
278622,7,19,26,1.317786,103.786737
278623,4,6,10,1.317858,103.786536
278624,11,47,58,1.317873,103.786493
278625,105,25,130,1.317878,103.78646
278626,25,326,351,1.318352,103.786259
278627,15,451,466,1.318095,103.786218
278628,3536,3722,7258,1.317728,103.785876
278629,22,443,465,1.317848,103.785484
278630,11,366,377,1.319788,103.781414
278631,1,0,1,1.313273,103.793324
278632,5,55,60,1.319527,103.781233
278633,7,40,47,1.319401,103.781179
278634,2,6,8,1.31927,103.781077
278635,2,342,344,1.319177,103.780997
278636,1411,363,1774,1.318877,103.780645
278637,168,262,430,1.31986,103.781139
278638,492,62,554,1.318986,103.780589
278639,1810,320,2130,1.318986,103.780589
278640,1879,2023,3902,1.320046,103.780684
278641,2,4,6,1.322564,103.78359
278642,0,3,3,1.309762,103.797065
278643,1,3,4,1.322477,103.783997
278644,0,4,4,1.322899,103.784139
278645,5,9,14,1.322968,103.784307
278646,10,0,10,1.323005,103.784483
278647,18,67,85,1.323042,103.784901
278648,166,0,166,1.323069,103.78509
278649,4,0,4,1.322931,103.785264
278650,69,9,78,1.32289,103.785548
278651,31,9,40,1.322938,103.785696
278652,25,5,30,1.323525,103.786069
278653,22,1,23,1.323771,103.785887
278654,5,25,30,1.323864,103.785814
278655,3,3,6,1.324419,103.785291
278656,7,1,8,1.323514,103.785521
278657,8,6,14,1.323903,103.785419
278658,117,24,141,1.324669,103.784875
278659,26,1,27,1.324662,103.784812
278660,1,0,1,1.319652,103.781316
278661,5,24,29,1.32463,103.784559
278662,31,0,31,1.324615,103.784433
278664,28,1,29,1.33031,103.786498
278665,7,2,9,1.329631,103.786078
278666,40,1,41,1.330384,103.786941
278667,29,39,68,1.329749,103.787567
278668,12,0,12,1.329802,103.787724
278670,0,14,14,1.329828,103.787803
278671,18,24,42,1.330039,103.788303
278672,24,0,24,1.3301,103.788378
278673,1,0,1,1.324646,103.784686
278677,6,0,6,1.331048,103.788947
278678,1,7,8,1.330653,103.789687
278679,8,0,8,1.330658,103.789848
278680,1,2,3,1.322644,103.7838
278681,0,2,2,1.317152,103.788241
278682,53,12,65,1.330646,103.790155
278683,4,71,75,1.330653,103.790282
278684,694,3,697,1.331833,103.790215
278685,11,9,20,1.332249,103.790586
278686,48,16,64,1.332423,103.790664
278687,59,11,70,1.332773,103.790822
278688,82,14,96,1.333112,103.790969
278689,11,313,324,1.3327,103.790737
278690,48,24,72,1.33274,103.790747
278691,30,11,41,1.330216,103.78855
278692,1,6,7,1.330403,103.788787
278693,35,11,46,1.33059,103.789024
278694,64,0,64,1.330632,103.789638
278695,4,10,14,1.330653,103.790413
278696,8,457,465,1.312333,103.795515
278697,3,0,3,1.330662,103.79001
278698,2116,329,2445,1.318929,103.780004
278699,67,0,67,1.324521,103.785303
278700,6,5,11,1.324595,103.785186
278701,31,3,34,1.324634,103.785158
278702,13,2,15,1.324745,103.785136
278704,1,8,9,1.31326,103.792066
278705,1,49,50,1.313615,103.792224
278707,0,8,8,1.313459,103.791221
278708,2,19,21,1.313139,103.791157
278710,228,24,252,1.313329,103.790866
278711,15,0,15,1.313466,103.790491
278714,0,1,1,1.330099,103.788377
278718,8,153,161,1.313522,103.792212
278730,48,157,205,1.309582,103.802753
278731,274,76,350,1.309519,103.802436
278732,68,169,237,1.309928,103.801743
278733,9,449,458,1.310049,103.802599
278734,6,162,168,1.309106,103.801713
278735,1946,129,2075,1.30938,103.800448
278736,12,451,463,1.309572,103.800153
278737,1523,5,1528,1.308899,103.800486
278738,468,386,854,1.309147,103.802528
278739,1801,38,1839,1.309236,103.800414
278740,2351,85,2436,1.308891,103.801475
278741,828,212,1040,1.309035,103.802168
278742,106,407,513,1.309849,103.802914
278743,2424,153,2577,1.31015,103.800958
278744,970,172,1142,1.310126,103.800789
278745,1935,265,2200,1.310709,103.799848
278746,5138,313,5451,1.309895,103.7999
278750,4,4,8,1.314634,103.78122
278751,37,0,37,1.314678,103.781209
278752,46,0,46,1.314456,103.781183
278753,2,0,2,1.330666,103.790171
278754,17,12,29,1.3141,103.781111
278755,18,0,18,1.314278,103.781127
278756,29,5,34,1.313744,103.781038
278758,2,8,10,1.313754,103.781028
278759,0,14,14,1.314304,103.781167
278771,3,3,6,1.314655,103.782543
278772,2,0,2,1.314545,103.781182
278773,8,0,8,1.314743,103.781868
278774,34,6,40,1.314822,103.781246
278775,31,5,36,1.314822,103.781246
278776,49,1,50,1.314858,103.780943
278777,1,0,1,1.313465,103.79049
278778,62,0,62,1.314776,103.781686
278779,14,5,19,1.314853,103.78117
278780,21,1,22,1.299509,103.837
278781,21,5,26,1.299509,103.837
278782,76,1,77,1.299509,103.837
278790,718,18,736,1.316871,103.784132
278791,4,338,342,1.317862,103.783939
278793,5,0,5,1.317771,103.783902
278794,1,41,42,1.317589,103.78383
278795,2,0,2,1.314743,103.781868
278796,19,68,87,1.317226,103.783684
278797,2,114,116,1.317044,103.783611
278798,24,15,39,1.317495,103.783501
278799,21,111,132,1.317453,103.783482
278800,8,374,382,1.316839,103.78353
278801,0,1,1,1.314914,103.780619
278802,0,1,1,1.316998,103.783593
278806,1,0,1,1.316933,103.783141
278807,1,0,1,1.316649,103.782798
278808,2,0,2,1.317407,103.783757
278810,1,1,2,1.316375,103.782655
278812,0,34,34,1.315948,103.782661
278813,1,174,175,1.315915,103.782745
278814,0,99,99,1.31585,103.782874
278815,0,142,142,1.315819,103.782984
278817,300,13,313,1.299509,103.837
278818,34,1,35,1.299509,103.837
278819,51,0,51,1.299509,103.837
278820,30,10,40,1.299509,103.837
278828,4,5,9,1.314562,103.781848
278829,18,7,25,1.314562,103.781828
278830,53,1,54,1.31439,103.781818
278831,19,1,20,1.31439,103.781798
278832,10,12,22,1.314047,103.781759
278834,1,10,11,1.313704,103.781699
278835,2,3,5,1.313714,103.781689
278848,4,7,11,1.315674,103.782678
278849,11,5,16,1.315632,103.782701
278850,1,14,15,1.315511,103.782646
278851,13,2,15,1.315164,103.782621
278852,278,0,278,1.315338,103.782623
278853,29,6,35,1.314645,103.782553
278854,33,6,39,1.314991,103.782578
278855,8,4,12,1.314645,103.782553
278856,8,0,8,1.314655,103.782543
278857,5,4,9,1.314568,103.782539
278858,45,7,52,1.314611,103.782527
278859,7,4,11,1.314413,103.782512
278860,15,2,17,1.314576,103.782521
278861,43,6,49,1.314508,103.782509
278862,3,10,13,1.314104,103.782457
278863,6,7,13,1.313848,103.78215
278864,161,0,161,1.31395,103.782429
278865,2,1,3,1.323067,103.784698
278866,49,0,49,1.313795,103.782402
278867,80,21,101,1.313652,103.782309
278868,0,1,1,1.316546,103.782748
278869,60,0,60,1.313673,103.781999
278870,23,16,39,1.313684,103.781844
278871,31,0,31,1.313694,103.781689
278872,38,1,39,1.313709,103.781596
278876,2,0,2,1.316156,103.78255
278877,68,1,69,1.313746,103.78093
278878,79,1,80,1.313748,103.780842
278879,18,1,19,1.313752,103.780666
278880,8,0,8,1.313757,103.780489
278882,11,1,12,1.313762,103.780261
278883,20,2,22,1.313763,103.780209
278884,14,3,17,1.313765,103.780105
278885,7,3,10,1.313766,103.780001
278886,59,6,65,1.313979,103.78001
278887,84,2,86,1.313768,103.779897
278888,1,0,1,1.313662,103.782154
278889,44,1,45,1.31377,103.779793
278890,4,2,6,1.313765,103.780125
278891,13,13,26,1.313772,103.779689
278892,0,1,1,1.313763,103.780229
278893,5,0,5,1.313774,103.779585
278894,11,0,11,1.313772,103.779709
278895,6,2,8,1.313775,103.779481
278896,2,2,4,1.313775,103.779501
278897,6,2,8,1.313777,103.779377
278898,0,5,5,1.313779,103.779293
278899,7,3,10,1.313779,103.779273
278900,4,0,4,1.313782,103.779085
278901,22,2,24,1.313781,103.779169
278902,56,2,58,1.313796,103.778867
278903,1,0,1,1.313768,103.779917
278904,0,1,1,1.313782,103.779065
278905,7,1,8,1.313776,103.778867
278907,15,2,17,1.313776,103.778867
278908,2,20,22,1.313794,103.782401
278909,8,3,11,1.315109,103.782629
278910,17,2,19,1.313773,103.778674
278911,4,6,10,1.31377,103.778481
278912,5,1,6,1.313796,103.778867
278913,14,7,21,1.299509,103.837
278914,4,0,4,1.299509,103.837
278915,11,5,16,1.299509,103.837
278917,38,0,38,1.299509,103.837
278920,0,1,1,1.313784,103.778961
278921,7,0,7,1.314485,103.780508
278922,14,0,14,1.314475,103.780498
278923,5,2,7,1.314123,103.78042
278924,9,7,16,1.313761,103.780333
278937,0,1850,1850,1.308714,103.793103
278938,147,117,264,1.310761,103.792811
278940,5,25,30,1.299509,103.837
278965,312,192,504,1.311885,103.796454
278966,308,69,377,1.309972,103.796311
278967,7342,93743,101085,1.310177,103.795313
278968,9,0,9,1.310258,103.795461
278969,46,1369,1415,1.310316,103.795499
278970,28,588,616,1.310424,103.795685
278971,12,605,617,1.310475,103.795699
278972,6,393,399,1.310578,103.795725
278973,15,159,174,1.310682,103.795752
278974,18,153,171,1.310785,103.795778
278975,95,7289,7384,1.310823,103.795777
278976,142,10616,10758,1.310977,103.795762
278977,39,265,304,1.311079,103.795575
278978,13,43,56,1.311083,103.795766
278979,6,0,6,1.311137,103.795619
278980,30,1438,1468,1.311185,103.79574
278981,13,724,737,1.311261,103.795719
278982,76,440,516,1.311346,103.795699
278983,2,0,2,1.313734,103.781028
278984,16,66,82,1.31148,103.795521
278985,27,147,174,1.311553,103.795628
278986,19,0,19,1.311682,103.795351
278987,43,59,102,1.31179,103.795265
278988,5,0,5,1.311613,103.795566
278989,3,0,3,1.313949,103.782428
278990,5,0,5,1.31174,103.795487
278991,9,0,9,1.311791,103.795452
278992,6,0,6,1.311832,103.795398
278993,3,0,3,1.311699,103.795527
278994,9,27,36,1.31184,103.795198
278995,104,1012,1116,1.312255,103.796415
278996,11,149,160,1.299509,103.837
278997,426,880,1306,1.310595,103.79599
279007,14,16,30,1.314735,103.783367
279008,253,6,259,1.31475,103.783283
279009,17,6,23,1.31471,103.78344
279010,32,8,40,1.31451,103.78401
279011,45,3,48,1.31466,103.783588
279012,8,1,9,1.313395,103.784526
279013,10,1,11,1.31461,103.783735
279014,3,0,3,1.31178,103.795252
279015,17,2,19,1.31456,103.783883
279016,108,5,113,1.313238,103.78495
279017,163,2,165,1.31452,103.78402
279018,62,1,63,1.314476,103.784112
279019,31,0,31,1.314442,103.784195
279020,139,0,139,1.314351,103.784286
279021,30,8,38,1.314281,103.784323
279022,13,0,13,1.314142,103.784398
279023,0,2,2,1.311429,103.795667
279024,1,4,5,1.313862,103.784547
279025,1,3,4,1.313723,103.784622
279026,9,0,9,1.313583,103.784696
279027,1,12,13,1.313444,103.784771
279028,4,14,18,1.313374,103.784808
279029,0,6,6,1.313248,103.78496
279042,2,1,3,1.313138,103.784363
279043,2,109,111,1.315292,103.783459
279044,1,0,1,1.314894,103.780619
279045,62,7,69,1.315185,103.783422
279046,1,0,1,1.314043,103.783209
279047,2,0,2,1.314002,103.784472
279048,5,1,6,1.313987,103.783485
279049,36,0,36,1.31477,103.783283
279050,5,3,8,1.313493,103.783006
279051,97,1,98,1.314692,103.78325
279052,3,0,3,1.31406,103.783138
279053,1,1,2,1.314973,103.783347
279054,3,1,4,1.314486,103.783182
279055,3,29,32,1.313473,103.783143
279056,1,0,1,1.31401,103.783352
279057,0,24,24,1.313465,103.783198
279058,7,0,7,1.314213,103.783091
279059,13,0,13,1.313457,103.783252
279060,1,3,4,1.314086,103.783056
279061,1,7,8,1.313449,103.783307
279062,9,0,9,1.31398,103.783031
279063,16,0,16,1.313441,103.783362
279064,45,0,45,1.313883,103.783017
279065,0,2,2,1.314623,103.783228
279066,9,0,9,1.31369,103.782988
279067,6,0,6,1.313424,103.783471
279068,19,5,24,1.313507,103.782969
279069,4,9,13,1.313416,103.783526
279070,16,3,19,1.313497,103.782959
279071,1,14,15,1.313408,103.78358
279072,1,0,1,1.31435,103.783137
279073,35,0,35,1.3134,103.783635
279074,1,4,5,1.313105,103.782945
279075,8,6,14,1.312908,103.78325
279076,6,0,6,1.312896,103.783035
279077,25,0,25,1.312823,103.783321
279078,212,3,215,1.312885,103.783012
279079,0,3,3,1.313489,103.783034
279080,4,7,11,1.312865,103.782978
279081,92,8,100,1.312402,103.78346
279082,86,0,86,1.312823,103.782911
279084,6,2,8,1.312782,103.782844
279085,17,0,17,1.312454,103.783506
279086,0,2,2,1.313432,103.783416
279087,10,0,10,1.312489,103.783536
279088,5,0,5,1.312699,103.78271
279089,21,0,21,1.312523,103.783567
279090,12,1,13,1.312896,103.783035
279091,6,1,7,1.312558,103.783597
279092,16,5,21,1.312761,103.783122
279093,6,10,16,1.312592,103.783628
279094,1,1,2,1.31274,103.782777
279095,57,0,57,1.312627,103.783658
279096,0,53,53,1.312385,103.783445
279097,13,3,16,1.312661,103.783689
279098,8,3,11,1.312337,103.78354
279100,5,16,21,1.31229,103.783636
279101,21,7,28,1.31176,103.784819
279102,0,1,1,1.31335,103.782946
279103,5,2,7,1.311776,103.784835
279104,1,3,4,1.312099,103.784018
279105,2,0,2,1.312546,103.783269
279106,1,0,1,1.312194,103.783827
279107,6,8,14,1.312069,103.784084
279108,84,0,84,1.311875,103.784928
279109,6,1,7,1.31204,103.784149
279112,1,0,1,1.311842,103.784897
279113,3,0,3,1.312801,103.78333
279115,6,0,6,1.311862,103.784542
279116,0,3,3,1.311921,103.784411
279117,73,0,73,1.311802,103.784673
279119,8,1,9,1.311743,103.784804
279120,7,1,8,1.312074,103.785113
279121,1,0,1,1.311942,103.78499
279122,6,0,6,1.312107,103.785144
279123,7,0,7,1.311706,103.784876
279124,1,0,1,1.311725,103.78484
279125,26,0,26,1.311632,103.785021
279126,20,3,23,1.311596,103.785094
279128,72,0,72,1.311559,103.785166
279129,10,6,16,1.312273,103.785299
279130,3,20,23,1.311522,103.785239
279131,2,1,3,1.312008,103.785052
279132,4,23,27,1.311485,103.785311
279133,2,6,8,1.312339,103.785361
279134,9,13,22,1.31284,103.783054
279137,24,0,24,1.312337,103.785334
279139,0,1,1,1.311669,103.784949
279140,3,0,3,1.312306,103.78533
279141,0,2,2,1.311809,103.784866
279143,1,26,27,1.299509,103.837
279144,0,66,66,1.299509,103.837
279145,56,1,57,1.312107,103.784628
279146,12,0,12,1.313376,103.783799
279147,4,4,8,1.314365,103.783974
279148,17,2,19,1.312587,103.784419
279149,8,0,8,1.31422,103.783938
279150,12,2,14,1.31393,103.783867
279151,14,0,14,1.31364,103.783795
279152,8,1,9,1.313376,103.783779
279153,12,8,20,1.313323,103.783787
279154,15,0,15,1.313271,103.783794
279155,16,0,16,1.313218,103.783802
279156,1,0,1,1.312337,103.785334
279157,13,0,13,1.313017,103.783913
279159,3,5,8,1.312915,103.784027
279160,5,0,5,1.312848,103.784104
279161,0,5,5,1.31278,103.78418
279162,2,0,2,1.312337,103.785334
279163,0,6,6,1.312645,103.784333
279164,2,0,2,1.312712,103.784256
279165,17,2,19,1.312661,103.784366
279177,0,81,81,1.313642,103.785322
279178,2,0,2,1.312577,103.784409
279179,1,8,9,1.313611,103.785295
279180,1,3,4,1.312587,103.784419
279181,103,0,103,1.313549,103.785241
279182,0,3,3,1.312337,103.785334
279183,3,0,3,1.312537,103.784376
279184,5,3,8,1.312497,103.784344
279189,0,5,5,1.312258,103.784148
279190,1,10,11,1.313238,103.78497
279191,11,0,11,1.312179,103.784083
279192,1,0,1,1.313108,103.783845
279193,2,1,3,1.313487,103.785187
279194,9,0,9,1.313178,103.784921
279195,2,6,8,1.313118,103.784872
279196,0,3,3,1.312109,103.784028
279197,2,16,18,1.312998,103.784773
279198,31,0,31,1.312938,103.784724
279199,9,2,11,1.312877,103.784675
279200,5,2,7,1.312817,103.784626
279201,2,0,2,1.313238,103.78495
279202,1,3,4,1.312697,103.784527
279203,1,1,2,1.312757,103.784577
279204,3,0,3,1.313058,103.784822
279205,3,2,5,1.312543,103.784401
279206,1,1,2,1.312637,103.784478
279207,6,0,6,1.31244,103.784317
279208,1,0,1,1.313208,103.784945
279209,33,3,36,1.312304,103.784206
279211,7,4,11,1.312167,103.784094
279212,5,16,21,1.312099,103.784038
279225,50,32,82,1.322547,103.783341
279226,33,0,33,1.322215,103.783382
279227,5,17,22,1.322205,103.783392
279228,20,0,20,1.322194,103.78316
279241,41,11,52,1.321617,103.783538
279242,17,3,20,1.321597,103.78354
279243,3,1,4,1.32163,103.783593
279244,5,3,8,1.321611,103.783597
279245,5,0,5,1.321656,103.783704
279246,15,0,15,1.321638,103.783713
279247,1,11,12,1.321682,103.783815
279248,7,2,9,1.321664,103.783828
279249,24,2,26,1.321707,103.783927
279250,36,6,42,1.321691,103.783943
279251,6,2,8,1.321733,103.784038
279252,25,0,25,1.321718,103.784058
279253,11,3,14,1.321745,103.784174
279254,9,0,9,1.321785,103.78426
279255,4,1,5,1.321772,103.784289
279256,46,1,47,1.321811,103.784371
279257,2,0,2,1.312509,103.784373
279258,1,3,4,1.321837,103.784482
279259,71,10,81,1.321825,103.784519
279260,247,0,247,1.321863,103.784593
279261,29,0,29,1.321852,103.784635
279262,22,1,23,1.321888,103.784705
279263,17,2,19,1.321879,103.78475
279264,58,4,62,1.321914,103.784816
279265,4,0,4,1.321906,103.784865
279266,160,0,160,1.32194,103.784927
279267,14,2,16,1.321933,103.78498
279268,3,5,8,1.321966,103.785038
279269,1,0,1,1.312372,103.784261
279270,71,2,73,1.321992,103.785149
279271,18,2,20,1.321986,103.785211
279272,26,14,40,1.322018,103.78526
279273,3,0,3,1.312577,103.784429
279274,6,0,6,1.322044,103.785371
279275,22,2,24,1.32204,103.785441
279276,28,20,48,1.322069,103.785483
279277,45,0,45,1.322067,103.785557
279278,0,11,11,1.322095,103.785594
279279,1,0,1,1.321959,103.785096
279280,16,0,16,1.322121,103.785705
279281,10,0,10,1.32212,103.785787
279282,4,10,14,1.322147,103.785816
279283,6,1,7,1.322147,103.785902
279284,7,3,10,1.322173,103.785927
279285,33,4,37,1.322174,103.786018
279286,17,11,28,1.322199,103.786038
279287,1,1,2,1.321799,103.784404
279288,3,38,41,1.322225,103.786149
279290,2,4,6,1.32225,103.786261
279291,3,3,6,1.322254,103.786363
279292,28,1,29,1.322276,103.786372
279293,25,0,25,1.322281,103.786479
279294,6,2,8,1.322302,103.786483
279295,140,25,165,1.322308,103.786594
279296,3,2,5,1.322328,103.786594
279297,6,6,12,1.322319,103.786669
279298,30,17,47,1.322343,103.786694
279299,88,74,162,1.32233,103.786744
279300,10,28,38,1.322358,103.786794
279301,0,4,4,1.322352,103.786893
279302,1,3,4,1.322387,103.786993
279303,0,11,11,1.322375,103.787043
279304,3,0,3,1.322013,103.785326
279305,5,0,5,1.322397,103.787193
279306,22,1,23,1.322417,103.787193
279307,1,0,1,1.322093,103.785672
279308,8,1,9,1.322463,103.787451
279309,9,1,10,1.322052,103.787274
279310,2,0,2,1.322201,103.786133
279311,2,1,3,1.322417,103.787193
279312,8,0,8,1.322443,103.787451
279313,96,0,96,1.322443,103.787451
279314,5,0,5,1.322479,103.787824
279315,8,7,15,1.322417,103.787193
279316,6,0,6,1.299509,103.837
279319,19,0,19,1.299509,103.837
279327,18,3,21,1.319815,103.787134
279328,3,0,3,1.322397,103.787193
279329,112,5,117,1.3202,103.787039
279330,57,1,58,1.320447,103.786985
279331,0,2,2,1.322407,103.787203
279332,19,7,26,1.32057,103.786948
279333,23,1,24,1.320682,103.786921
279334,5,10,15,1.320461,103.78704
279335,7,0,7,1.320908,103.786866
279336,79,13,92,1.320476,103.787096
279337,7,3,10,1.321123,103.786822
279339,144,7,151,1.32133,103.786774
279340,0,3,3,1.319944,103.787102
279341,4,1,5,1.321528,103.786736
279342,13,0,13,1.320561,103.787429
279344,23,1,24,1.322308,103.786594
279346,42,0,42,1.323514,103.786357
279347,92,9,101,1.324071,103.786089
279348,185,9,194,1.324287,103.785863
279349,63,3,66,1.323923,103.785419
279350,1,5,6,1.321207,103.786818
279351,3,2,5,1.321281,103.786804
279352,4,0,4,1.321429,103.786775
279353,2,0,2,1.320385,103.786908
279354,0,3,3,1.320532,103.787318
279359,9,4,13,1.32407,103.786088
279360,16,0,16,1.32407,103.786088
279361,13,1,14,1.32407,103.786088
279362,49,3,52,1.320199,103.787038
279363,3,3,6,1.319814,103.787133
279364,2,2,4,1.319814,103.787133
279368,1,11,12,1.322316,103.786591
279371,83,5,88,1.324865,103.787709
279372,4,2,6,1.324785,103.7877
279373,37,0,37,1.324625,103.787681
279374,30,0,30,1.324465,103.787662
279375,29,3,32,1.324305,103.787644
279376,9,0,9,1.32426,103.787639
279377,16,1,17,1.324126,103.787624
279378,1,1,2,1.321577,103.786746
279379,1,1,2,1.324036,103.787614
279380,4,1,5,1.323856,103.787595
279381,6,0,6,1.323767,103.787585
279382,22,0,22,1.323677,103.787575
279384,58,0,58,1.323577,103.787561
279385,9,0,9,1.323476,103.787547
279386,3,1,4,1.323376,103.787532
279387,18,0,18,1.323276,103.787518
279388,3,0,3,1.321725,103.786718
279389,8,0,8,1.323075,103.78749
279390,4,1,5,1.322997,103.787486
279391,210,50,260,1.32292,103.787483
279392,5,0,5,1.322764,103.787476
279394,21,2,23,1.322453,103.787461
279395,4,10,14,1.323881,103.787564
279407,2,12,14,1.324642,103.785732
279408,5,0,5,1.324659,103.78571
279409,121,2,123,1.324652,103.7858
279410,0,2,2,1.323946,103.787605
279411,12,0,12,1.324672,103.785937
279412,171,0,171,1.32468,103.78585
279413,45,7,52,1.324693,103.786073
279414,76,0,76,1.324693,103.785943
279415,2,4,6,1.324713,103.786209
279416,1,4,5,1.324707,103.786036
279417,10,0,10,1.324733,103.786345
279419,27,3,30,1.324735,103.786221
279420,16,0,16,1.324773,103.786618
279421,23,1,24,1.324748,103.786314
279422,1,2,3,1.323175,103.787504
279423,2,0,2,1.324666,103.785757
279424,90,1,91,1.324814,103.78689
279425,8,5,13,1.324776,103.7865
279426,123,0,123,1.324834,103.787027
279427,23,1,24,1.32479,103.786593
279428,22,1,23,1.324854,103.787163
279430,187,0,187,1.324874,103.787299
279431,105,0,105,1.324817,103.786779
279432,2,0,2,1.324762,103.786407
279433,59,0,59,1.324831,103.786872
279434,36,7,43,1.324915,103.787572
279435,7,0,7,1.324845,103.786965
279436,6,6,12,1.324935,103.787708
279437,16,4,20,1.324859,103.787058
279438,3,0,3,1.324794,103.786754
279439,4,25,29,1.324886,103.787243
279440,6,1,7,1.3249,103.787336
279441,6,0,6,1.324914,103.787429
279442,2,1,3,1.324872,103.787151
279443,3,0,3,1.324927,103.787522
279444,2,4,6,1.324955,103.787708
279445,4,6,10,1.324955,103.787708
279446,25,0,25,1.324979,103.787906
279447,72,0,72,1.325003,103.788104
279460,9,23,32,1.321155,103.786873
279461,20,27,47,1.321142,103.786903
279462,1,8,9,1.321167,103.786924
279463,5,8,13,1.321162,103.786984
279464,1,1,2,1.324895,103.787435
279465,1,0,1,1.321708,103.787334
279466,5,0,5,1.321215,103.787126
279467,8,2,10,1.321239,103.787309
279468,154,15,169,1.32124,103.787228
279469,6,0,6,1.321277,103.787472
279470,2,0,2,1.321191,103.787025
279471,15,2,17,1.321316,103.787634
279472,6,0,6,1.321312,103.787532
279473,6,0,6,1.321336,103.787634
279486,17,5,22,1.323531,103.786421
279487,32,7,39,1.323513,103.786434
279488,12,2,14,1.323539,103.786476
279489,10,1,11,1.323522,103.7865
279490,0,1,1,1.3212,103.787147
279491,63,0,63,1.32354,103.786633
279492,3,4,7,1.323568,103.786694
279493,90,4,94,1.323558,103.786766
279494,17,3,20,1.323583,103.786803
279495,25,4,29,1.323576,103.786899
279496,55,12,67,1.323598,103.786912
279497,12,3,15,1.323595,103.787033
279498,7,0,7,1.323613,103.787166
279499,2,0,2,1.321264,103.78733
279500,0,4,4,1.323631,103.787299
279501,48,5,53,1.323643,103.787238
279502,7,0,7,1.323649,103.787432
279503,53,0,53,1.323657,103.787347
279504,19,9,28,1.323667,103.787565
279505,2,7,9,1.323672,103.787456
279506,21,10,31,1.323687,103.787565
279518,8,2,10,1.322254,103.78352
279519,9,12,21,1.322218,103.783449
279520,44,17,61,1.322231,103.783506
279521,55,0,55,1.322341,103.783905
279522,2,0,2,1.323628,103.787129
279524,2,0,2,1.322257,103.78362
279525,14,1,15,1.322308,103.783848
279526,33,4,37,1.322516,103.784674
279527,73,0,73,1.322334,103.783962
279528,2,1,3,1.324941,103.787615
279529,1,0,1,1.323554,103.786585
279530,107,0,107,1.322386,103.784189
279531,1,0,1,1.322632,103.785186
279532,1,1,2,1.322458,103.784417
279533,2,2,4,1.322748,103.785699
279534,15,0,15,1.322438,103.784417
279535,2,3,5,1.322464,103.784531
279536,4,1,5,1.322865,103.786212
279537,2,0,2,1.322412,103.784303
279538,5,3,8,1.322923,103.786468
279539,6,0,6,1.322515,103.784759
279540,7,0,7,1.322541,103.784873
279541,2,0,2,1.322489,103.784645
279542,7,0,7,1.322593,103.785101
279543,11,0,11,1.322619,103.785215
279544,47,1,48,1.322644,103.785329
279545,5,0,5,1.32267,103.785443
279546,78,3,81,1.322696,103.785557
279547,8,1,9,1.322722,103.785671
279548,20,1,21,1.322748,103.785784
279549,8,0,8,1.322774,103.785898
279550,0,1,1,1.32269,103.785443
279551,11,1,12,1.322825,103.786126
279552,42,0,42,1.322851,103.78624
279553,8,5,13,1.322877,103.786354
279554,2,1,3,1.32236,103.784076
279555,1,2,3,1.322903,103.786468
279556,10,2,12,1.322935,103.78654
279557,7,1,8,1.322926,103.786613
279558,4,3,7,1.322946,103.786613
279559,6,0,6,1.322949,103.786757
279560,200,3,203,1.322969,103.786757
279561,1,0,1,1.3228,103.786012
279562,68,3,71,1.322992,103.786902
279563,1,0,1,1.322972,103.786902
279564,9,13,22,1.323016,103.787046
279565,38,0,38,1.323019,103.787191
279566,3,0,3,1.322915,103.78654
279567,11,0,11,1.323042,103.787335
279568,15,0,15,1.323062,103.787335
279569,0,44,44,1.323065,103.78748
279570,4,0,4,1.323085,103.78748
279571,2,2,4,1.322774,103.785789
279572,9,10,19,1.322292,103.783642
279573,6,10,16,1.322254,103.78352
279574,45,0,45,1.299509,103.837
279583,11,3,14,1.324099,103.786144
279584,20,14,34,1.324081,103.786159
279585,3,2,5,1.324107,103.786199
279586,1,2,3,1.323039,103.787191
279587,31,1,32,1.324123,103.78631
279588,67,11,78,1.324112,103.78637
279589,0,35,35,1.324139,103.78642
279590,0,1,1,1.322996,103.787046
279591,0,2,2,1.322567,103.784987
279592,0,2,2,1.324155,103.78653
279593,4,0,4,1.324171,103.786641
279594,2,1,3,1.324091,103.786229
279596,17,1,18,1.324203,103.786862
279597,25,1,26,1.324214,103.787072
279598,59,0,59,1.324219,103.786972
279599,6,3,9,1.324234,103.787213
279600,19,0,19,1.324235,103.787082
279601,3,0,3,1.324173,103.786791
279602,0,6,6,1.324251,103.787193
279603,51,10,61,1.324275,103.787494
279604,0,1,1,1.324132,103.78651
279605,55,5,60,1.324295,103.787634
279606,5,9,14,1.324283,103.787413
279607,44,2,46,1.324299,103.787524
279608,9,7,16,1.324315,103.787634
279621,974,14,988,1.312055,103.78889
279622,403,353,756,1.310312,103.786551
279623,96,341,437,1.312044,103.786068
279624,21,4,25,1.299509,103.837
279641,6,7,13,1.329748,103.789904
279642,16,26,42,1.329826,103.790325
279643,85,11,96,1.329825,103.790324
279644,10,7,17,1.329326,103.79056
279645,20,5,25,1.328827,103.790794
279646,2,0,2,1.324152,103.786651
279647,2,8,10,1.328808,103.79074
279648,73,9,82,1.328874,103.790876
279649,22,1,23,1.328778,103.790676
279650,8,0,8,1.32891,103.790948
279651,4,1,5,1.32825,103.790062
279652,2,12,14,1.328984,103.791093
279653,75,12,87,1.328661,103.790421
279654,8,2,10,1.329047,103.791227
279655,38,28,66,1.328602,103.790293
279656,37,1,38,1.328501,103.790976
279657,5,0,5,1.3285,103.790975
279658,1,24,25,1.328587,103.79118
279659,13,2,15,1.328684,103.791394
279660,13,4,17,1.32788,103.791532
279661,15,2,17,1.327834,103.791486
279662,13,4,17,1.327797,103.791451
279663,13,0,13,1.327725,103.79138
279664,53,19,72,1.327652,103.791309
279665,17,2,19,1.327506,103.791167
279666,30,4,34,1.327434,103.791096
279667,32,9,41,1.327371,103.791035
279668,13,1,14,1.327803,103.792015
279669,13,5,18,1.327741,103.791996
279670,15,1,16,1.327618,103.791959
279671,10,1,11,1.326989,103.79154
279672,30,0,30,1.326169,103.791916
279673,16,0,16,1.326394,103.791973
279674,33,0,33,1.327002,103.79177
279675,2,3,5,1.326879,103.791733
279676,15,3,18,1.326756,103.791695
279677,2,2,4,1.327284,103.792106
279678,45,10,55,1.327531,103.792197
279679,89,4,93,1.330013,103.789872
279680,1,1,2,1.329667,103.790955
279681,6,12,18,1.330503,103.790402
279682,3,15,18,1.326656,103.791521
279683,23,5,28,1.326609,103.791566
279684,1,3,4,1.326487,103.791579
279685,167,6,173,1.326467,103.791591
279686,7,7,14,1.32635,103.791615
279687,0,10,10,1.326325,103.791597
279691,6,3,9,1.33186,103.792551
279692,10,4,14,1.33186,103.792571
279693,3,2,5,1.331884,103.792484
279694,11,3,14,1.331884,103.792504
279695,3,1,4,1.331933,103.79235
279696,9,1,10,1.331933,103.79237
279697,0,1,1,1.324267,103.787303
279698,98,2,100,1.331981,103.792236
279699,9,2,11,1.332029,103.792082
279700,7,5,12,1.332029,103.792102
279701,156,0,156,1.332078,103.791948
279702,0,1,1,1.331981,103.792216
279703,0,1,1,1.332078,103.791968
279704,1,0,1,1.332126,103.791815
279705,2,0,2,1.330663,103.790423
279706,1,1,2,1.332175,103.791681
279708,3,0,3,1.324254,103.787353
279709,3,0,3,1.332223,103.791567
279710,1,2,3,1.332271,103.791413
279711,9,1,10,1.33232,103.791279
279712,8,3,11,1.33232,103.791299
279713,10,4,14,1.332358,103.791155
279714,0,5,5,1.332368,103.791165
279727,90,2,92,1.325846,103.782614
279729,12,0,12,1.325784,103.782943
279730,18,8,26,1.325758,103.783002
279733,31,0,31,1.325376,103.783397
279734,31,1,32,1.325321,103.783414
279735,70,2,72,1.325247,103.783431
279736,8,0,8,1.325228,103.784267
279737,34,4,38,1.325646,103.782745
279739,134,14,148,1.325492,103.783153
279740,85,2,87,1.32495,103.783249
279741,17,16,33,1.324907,103.783236
279742,39,1,40,1.325014,103.782597
279743,1,2,3,1.332271,103.791433
279744,20,6,26,1.323891,103.782542
279745,1,0,1,1.332126,103.791835
279746,89,5,94,1.323246,103.782725
279747,37,44,81,1.322769,103.782744
279748,3,22,25,1.323044,103.783081
279749,10,0,10,1.323165,103.783191
279750,7,1,8,1.323483,103.783519
279751,9,0,9,1.323719,103.78375
279753,2,5,7,1.323994,103.784292
279756,227,21,248,1.323986,103.784583
279757,9,1,10,1.323956,103.784737
279758,9,15,24,1.32405,103.784852
279759,30,0,30,1.324123,103.784466
279760,37,0,37,1.324113,103.784176
279761,72,2,74,1.323276,103.78314
279762,28,11,39,1.323349,103.782823
279763,440,16,456,1.323586,103.78278
279764,0,11,11,1.324462,103.783002
279765,8,0,8,1.324518,103.783057
279766,4,5,9,1.324631,103.783163
279771,42,0,42,1.324214,103.782737
279772,20,1,21,1.325823,103.78265
279773,11,2,13,1.323921,103.784878
279774,4,6,10,1.32446,103.782823
279775,19,5,24,1.323981,103.78255
279776,19,3,22,1.324152,103.783847
279777,1,0,1,1.323327,103.782695
279778,9,54,63,1.323478,103.782758
279779,8,0,8,1.332291,103.791115
279780,3,2,5,1.332215,103.791084
279781,8,0,8,1.332061,103.791024
279782,2,0,2,1.332175,103.791701
279795,3,59,62,1.31444,103.790539
279796,24,1,25,1.314273,103.790365
279797,9,0,9,1.31394,103.790016
279798,7,2,9,1.313549,103.789676
279799,6,3,9,1.313338,103.789958
279800,2,25,27,1.313367,103.790513
279801,6,0,6,1.313371,103.790535
279802,24,2,26,1.313137,103.79025
279803,10,0,10,1.313337,103.790506
279804,45,0,45,1.313344,103.790512
279805,13,6,19,1.312936,103.790542
279806,8,1,9,1.312735,103.790834
279808,5,0,5,1.312534,103.791126
279809,1,69,70,1.312472,103.791222
279810,10,3,13,1.311942,103.790628
279811,15,55,70,1.312094,103.791172
279812,4,1,5,1.311649,103.790729
279813,11,64,75,1.311765,103.790813
279814,7,29,36,1.311775,103.790803
279815,5,6,11,1.313438,103.789812
279827,36,18,54,1.330908,103.792018
279828,7,3,10,1.330904,103.792048
279829,6,2,8,1.33094,103.791927
279830,1,2,3,1.324495,103.782879
279831,0,1,1,1.325816,103.782699
279832,4,5,9,1.330991,103.791807
279833,21,3,24,1.331071,103.791566
279834,7,2,9,1.331049,103.791646
279835,16,9,25,1.331136,103.791385
279836,3,3,6,1.331107,103.791485
279837,2,15,17,1.331201,103.791204
279838,2,3,5,1.331165,103.791325
279839,4,9,13,1.331266,103.791024
279840,22,5,27,1.331223,103.791164
279841,13,3,16,1.331332,103.790843
279842,0,2,2,1.331918,103.790973
279843,2,1,3,1.330933,103.791967
279844,4,17,21,1.331367,103.790529
279845,1,0,1,1.331006,103.791746
279846,1,7,8,1.331377,103.790519
279847,1,2,3,1.331339,103.790843
279848,4,0,4,1.299509,103.837
279859,5,344,349,1.332315,103.79272
279860,2,22,24,1.332338,103.792652
279861,4,411,415,1.332385,103.792517
279862,17,3,20,1.332432,103.792383
279863,0,96,96,1.332479,103.792248
279864,2,215,217,1.332526,103.792113
279865,10,468,478,1.332574,103.791978
279866,3,73,76,1.332621,103.791843
279867,0,194,194,1.332668,103.791708
279868,5,409,414,1.332715,103.791574
279869,1,51,52,1.332762,103.791439
279870,200,279,479,1.332799,103.791314
279871,344,2,346,1.332161,103.792996
279872,494,19,513,1.331366,103.792921
279883,112,2,114,1.331665,103.795271
279884,2,1,3,1.330888,103.792041
279885,32,3068,3100,1.331686,103.795214
279886,466,1484,1950,1.331902,103.79444
279887,693,594,1287,1.331328,103.794358
279888,418,18,436,1.330977,103.793842
279889,456,16,472,1.331388,103.794371
279890,260,32,292,1.331065,103.793661
279892,117,26,143,1.33299,103.791362
279893,221,627,848,1.332901,103.79163
279894,13,1,14,1.332753,103.791044
279895,52,186,238,1.332772,103.790974
279896,115,91,206,1.332742,103.790932
279909,161,3,164,1.319191,103.785107
279910,7,23,30,1.318738,103.784794
279911,5,7,12,1.318939,103.784708
279912,11,0,11,1.31934,103.784537
279913,0,18,18,1.319541,103.784452
279914,3,0,3,1.331672,103.795252
279915,2,3,5,1.320348,103.784694
279916,35,1,36,1.320202,103.784405
279917,85,1,86,1.320596,103.784766
279918,1,0,1,1.331397,103.790682
279919,53,0,53,1.321027,103.784773
279920,13,9,22,1.321017,103.784763
279921,0,9,9,1.321017,103.784763
279922,5,1,6,1.320827,103.783945
279923,4,0,4,1.32106,103.784962
279924,15,4,19,1.321104,103.78516
279925,0,6,6,1.321005,103.784627
279926,21,16,37,1.320974,103.78449
279927,29,8,37,1.32091,103.784218
279928,18,0,18,1.320847,103.783945
279929,112,217,329,1.318537,103.784879
279930,3,452,455,1.318536,103.784878
279931,27,5,32,1.319009,103.785409
279932,13,0,13,1.31919,103.785106
279941,10,3,13,1.330194,103.78554
279942,35,16,51,1.330104,103.785884
279943,280,3,283,1.330103,103.785883
279944,3,0,3,1.319991,103.784508
279945,0,5,5,1.331013,103.785625
279946,2,5,7,1.330823,103.785832
279947,92,7,99,1.33055,103.78588
279948,3,5,8,1.330719,103.785858
279949,92,0,92,1.330594,103.786694
279950,8,9,17,1.330946,103.786139
279951,21,0,21,1.330946,103.786012
279952,1,1,2,1.331281,103.791003
279953,58,5,63,1.331664,103.78642
279954,47,2,49,1.331804,103.786185
279955,62,3,65,1.332069,103.786215
279956,157,5,162,1.331915,103.786516
279957,1,7,8,1.33106,103.7875
279958,8,0,8,1.331802,103.786846
279959,55,18,73,1.3313,103.786605
279960,29,20,49,1.331476,103.787303
279961,16,8,24,1.331212,103.787234
279962,0,2,2,1.331299,103.786741
279963,11,31,42,1.33106,103.78752
279964,16,47,63,1.330895,103.787982
279965,18,3,21,1.299509,103.837
279978,26,12,38,1.33066,103.794598
279979,57,0,57,1.33139,103.794598
279980,2,1,3,1.330103,103.785883
279981,0,28,28,1.331389,103.794597
279982,36,34,70,1.331148,103.794545
279983,1,0,1,1.320521,103.784326
279985,18,33,51,1.331148,103.794545
279986,27,0,27,1.330681,103.794705
279987,8,21,29,1.330383,103.794981
286557,1,8,9,1.299509,103.837
286558,1,14,15,1.299509,103.837
286559,5,0,5,1.299509,103.837
286569,0,1,1,1.331147,103.794544
286570,1,0,1,1.299509,103.837
286571,0,2,2,1.331322,103.786924
286574,0,1,1,1.299509,103.837
286576,0,1,1,1.299509,103.837
286608,2,43,45,1.299509,103.837
286620,0,1,1,1.299509,103.837
286622,21,156,177,1.299509,103.837
286623,246,0,246,1.299509,103.837
286627,4,7,11,1.299509,103.837
286628,5,5,10,1.299509,103.837
286632,44,235,279,1.299509,103.837
286637,4,0,4,1.328571,103.80885
286638,30,0,30,1.328547,103.808887
286639,265,0,265,1.3285,103.808923
286640,3,2,5,1.328468,103.808951
286641,76,0,76,1.328452,103.808998
286642,9,3,12,1.328412,103.809058
286647,22,0,22,1.328462,103.808656
286649,51,1,52,1.328462,103.808656
286650,0,1,1,1.299509,103.837
286651,12,0,12,1.328462,103.808656
286653,391,8,399,1.327056,103.812886
286654,108,121,229,1.327069,103.812655
286655,618,2,620,1.327932,103.812339
286656,4,1,5,1.299509,103.837
286657,29,14,43,1.328606,103.804808
286658,28,118,146,1.328668,103.80476
286659,12,2,14,1.328204,103.805648
286660,83,7,90,1.328238,103.805618
286661,16,1,17,1.328277,103.80555
286662,33,1,34,1.328296,103.805521
286663,5,0,5,1.328322,103.805481
286664,17,1,18,1.328382,103.805437
286665,9,1,10,1.32839,103.80537
286666,35,2,37,1.328418,103.805329
286667,1,0,1,1.328462,103.808656
286668,4,2,6,1.328479,103.805239
286669,3,1,4,1.328501,103.805213
286670,18,1,19,1.32853,103.805149
286671,54,1,55,1.328566,103.805121
286672,0,1,1,1.328478,103.805278
286673,72,1,73,1.328652,103.805036
286674,3,1,4,1.328652,103.804965
286675,51,0,51,1.328686,103.804918
286677,10,1,11,1.328763,103.804857
286678,3,87,90,1.328275,103.80597
286679,38,22,60,1.328275,103.80597
286680,4,57,61,1.328275,103.80597
286681,25,2,27,1.328275,103.80597
286682,0,4,4,1.328364,103.805857
286683,10,6,16,1.328408,103.805781
286684,107,5,112,1.328456,103.805744
286685,49,2,51,1.328489,103.805688
286686,20,3,23,1.328516,103.805627
286687,3,6,9,1.328552,103.805605
286688,3,7,10,1.328558,103.805559
286689,12,6,18,1.328609,103.805517
286690,18,1,19,1.328634,103.805449
286691,6,1,7,1.32867,103.805427
286692,5,1,6,1.328693,103.805348
286693,20,3,23,1.328704,103.805312
286694,45,0,45,1.328726,103.805271
286695,12,1,13,1.328782,103.805244
286696,9,2,11,1.328817,103.805181
286697,3,2,5,1.328811,103.805152
286698,17,2,19,1.32888,103.80512
286699,10,1,11,1.328883,103.805043
286700,7,3,10,1.3289,103.805023
286701,3,7,10,1.328968,103.804981
286702,17,7,24,1.328512,103.805827
286703,1,4,5,1.32856,103.805777
286704,0,5,5,1.328596,103.805763
286705,1,3,4,1.328599,103.805686
286706,39,6,45,1.328633,103.805678
286707,0,9,9,1.328656,103.805626
286708,4,1,5,1.328711,103.805555
286709,11,0,11,1.328719,103.805512
286710,7,0,7,1.328769,103.805468
286711,0,1,1,1.328598,103.80506
286712,5,1,6,1.328835,103.805407
286713,0,1,1,1.328775,103.80542
286714,1,1,2,1.299509,103.837
286715,13,0,13,1.328917,103.805242
286716,0,2,2,1.328892,103.80531
286717,21,2,23,1.328983,103.805184
286718,84,2,86,1.328976,103.805113
286719,19,2,21,1.329013,103.805092
286720,18,1,19,1.329062,103.805044
286721,4,4,8,1.328425,103.806071
286722,33,1,34,1.328425,103.806071
286723,1,2,3,1.331389,103.794597
286724,34,3,37,1.328425,103.806071
286725,2,5,7,1.328425,103.806071
286726,7,7,14,1.328574,103.806252
286727,2,0,2,1.328952,103.805196
286728,2,2,4,1.328574,103.806252
286729,11,2,13,1.328574,103.806252
286730,11,2,13,1.328574,103.806252
286731,3,7,10,1.328612,103.806264
286732,13,6,19,1.32875,103.805935
286733,29,3,32,1.328781,103.805872
286734,1,5,6,1.328818,103.805825
286735,24,5,29,1.328838,103.805779
286736,9,4,13,1.328866,103.805738
286737,46,1,47,1.328877,103.805695
286738,7,7,14,1.328922,103.805674
286739,1,6,7,1.328956,103.805599
286740,6,1,7,1.328994,103.805583
286741,5,3,8,1.329014,103.805536
286742,0,9,9,1.32905,103.805495
286743,7,7,14,1.329082,103.805458
286744,0,4,4,1.329109,103.80536
286745,12,5,17,1.329162,103.805313
286746,4,0,4,1.329199,103.805248
286747,0,6,6,1.329231,103.80521
286748,70,5,75,1.32923,103.80518
286749,1,9,10,1.329284,103.805121
286750,33,2,35,1.328684,103.806311
286751,3,5,8,1.32883,103.806005
286752,6,12,18,1.328887,103.805959
286753,35,6,41,1.328886,103.805892
286754,31,4,35,1.328943,103.805882
286755,44,6,50,1.328944,103.805836
286756,0,3,3,1.328425,103.806071
286757,36,8,44,1.329005,103.805742
286758,0,6,6,1.32907,103.805697
286759,28,6,34,1.329097,103.805656
286760,17,4,21,1.329119,103.805587
286761,4,7,11,1.329152,103.805567
286762,26,3,29,1.329181,103.80549
286763,23,2,25,1.329177,103.805451
286764,13,2,15,1.329211,103.805406
286765,2,8,10,1.329235,103.805366
286766,47,3,50,1.329273,103.805311
286767,49,7,56,1.329301,103.805306
286768,27,12,39,1.329351,103.805258
286769,31,1,32,1.329389,103.805186
286770,33,2,35,1.328729,103.806307
286771,243,1,244,1.328729,103.806307
286772,2,2,4,1.328729,103.806307
286774,23,2,25,1.328729,103.806307
286775,6,7,13,1.328903,103.80639
286776,19,1,20,1.328903,103.80639
286777,0,5,5,1.328903,103.80639
286778,13,8,21,1.328903,103.80639
286779,6,20,26,1.328903,103.80639
286780,5,6,11,1.328903,103.80639
286781,13,0,13,1.329042,103.806175
286782,13,2,15,1.329068,103.806143
286783,33,1,34,1.329059,103.806098
286784,8,1,9,1.329094,103.806052
286785,11,4,15,1.329124,103.805976
286786,18,1,19,1.329184,103.805931
286787,20,1,21,1.329181,103.805911
286788,5,2,7,1.329241,103.805876
286789,5,7,12,1.329265,103.80583
286790,10,1,11,1.329273,103.805791
286791,27,2,29,1.329297,103.805744
286792,12,2,14,1.329362,103.805667
286793,1,5,6,1.329385,103.805626
286794,3,1,4,1.329413,103.805576
286795,0,1,1,1.328856,103.805328
286796,18,4,22,1.329449,103.805513
286797,68,3,71,1.329497,103.805472
286798,72,2,74,1.329503,103.805426
286799,2,2,4,1.329538,103.805357
286800,18,5,23,1.329595,103.805306
286801,7,4,11,1.329105,103.805402
286802,4,1,5,1.336404,103.807374
286803,99,0,99,1.299509,103.837
286804,2,0,2,1.328574,103.806252
286806,18,8,26,1.299509,103.837
286807,1,0,1,1.329437,103.805531
286820,1,0,1,1.337365,103.805857
286825,1,0,1,1.337222,103.805914
286846,1859,1378,3237,1.342773,103.796703
286852,36,15,51,1.336211,103.806162
286853,34,1,35,1.336263,103.806128
286854,58,1,59,1.336317,103.8061
286855,3,0,3,1.329001,103.805787
286856,9,0,9,1.33643,103.806062
286858,4,1,5,1.336608,103.806016
286859,2,2,4,1.336653,103.806004
286860,47,4,51,1.336729,103.805959
286861,32,2,34,1.336713,103.805994
286862,25,0,25,1.336774,103.805985
286863,112,1,113,1.336834,103.805975
286870,105,0,105,1.337574,103.805599
286871,7,0,7,1.337524,103.805503
286872,15,0,15,1.337516,103.805454
286873,1,0,1,1.337016,103.805947
286874,95,0,95,1.337498,103.80535
286875,10,1,11,1.337482,103.805292
286876,25,0,25,1.337486,103.805237
286877,6,0,6,1.337471,103.80519
286878,4,0,4,1.337473,103.805144
286879,2,0,2,1.299509,103.837
286880,6,1,7,1.337465,103.805048
286881,63,1,64,1.337464,103.805013
286882,13,44,57,1.337446,103.804973
286883,38,8,46,1.337511,103.804969
286885,2,0,2,1.337469,103.8051
286886,15,0,15,1.33753,103.805077
286887,70,1,71,1.337534,103.805124
286888,586,42,628,1.325543,103.811374
286889,815,65,880,1.325994,103.811252
286890,466,5,471,1.325635,103.810749
286891,280,20,300,1.325224,103.810967
286892,8,7,15,1.325637,103.811064
286893,29,0,29,1.337544,103.805151
286894,128,0,128,1.337565,103.805236
286895,0,3,3,1.336409,103.806076
286897,3,0,3,1.337467,103.804966
286898,3,0,3,1.337478,103.805042
286903,2,0,2,1.337525,103.805023
286905,1,0,1,1.337501,103.805391
286906,2,0,2,1.337519,103.805346
286909,27,0,27,1.33785,103.805557
286911,44,0,44,1.337893,103.805631
286912,49,0,49,1.337867,103.805705
286914,59,0,59,1.337906,103.805806
286915,47,0,47,1.337897,103.805826
286916,41,58,99,1.337925,103.80588
286917,56,0,56,1.337607,103.805525
286918,2,0,2,1.33754,103.805498
286919,5,8,13,1.336616,103.805994
286920,52,0,52,1.337603,103.805452
286921,6,1,7,1.336579,103.806004
286922,82,0,82,1.337597,103.805425
286923,36,0,36,1.336504,103.806023
286924,58,0,58,1.337584,103.805335
286925,15,2,17,1.33643,103.806042
286926,7,0,7,1.337576,103.805301
286927,12,0,12,1.336356,103.806062
286928,88,0,88,1.337568,103.805259
286929,0,1,1,1.337533,103.805447
286930,17,0,17,1.336207,103.806101
286931,7,2,9,1.33617,103.806125
286932,23,0,23,1.336136,103.806135
286941,14,4,18,1.336533,103.805443
286942,99,2,101,1.336536,103.805491
286943,15,1,16,1.336539,103.805553
286944,1,0,1,1.336281,103.806082
286945,10,0,10,1.33667,103.805621
286946,5,2,7,1.336558,103.805673
286947,18,1,19,1.336682,103.805689
286948,1,0,1,1.336557,103.805616
286949,13,0,13,1.336694,103.805756
286950,2,3,5,1.336705,103.805824
286952,68,3,71,1.336729,103.805959
286953,1,3,4,1.33602,103.805274
286954,59,12,71,1.336033,103.805358
286955,1,1,2,1.337605,103.805503
286956,0,4,4,1.336082,103.805694
286957,20,0,20,1.336082,103.805694
286958,6,1,7,1.336082,103.805694
286959,0,4,4,1.332702,103.797997
286965,1522,35,1557,1.341017,103.798896
286966,5046,1060,6106,1.345705,103.796626
286967,18,14,32,1.336021,103.805275
286968,2,9,11,1.335943,103.805239
286969,10,0,10,1.336034,103.805359
286970,26,7,33,1.335949,103.805281
286971,8,0,8,1.336058,103.805527
286972,3,0,3,1.337485,103.805093
286973,2,0,2,1.336057,103.805526
286974,7,16,23,1.336026,103.805443
286975,3,0,3,1.335962,103.805365
286976,7,0,7,1.335986,103.805533
286978,16,3,19,1.335999,103.805617
286979,47,2,49,1.335768,103.805797
286980,43,6,49,1.336011,103.805701
286981,83,2,85,1.335674,103.805813
286983,8,0,8,1.33555,103.805867
286984,3,3,6,1.335468,103.80588
286985,15,0,15,1.335376,103.805907
286986,62,5,67,1.335294,103.805907
286987,55,3,58,1.335209,103.805769
286989,9,0,9,1.335185,103.805639
286990,5,1,6,1.335183,103.805568
286991,22,0,22,1.335211,103.805472
286992,195,15,210,1.336582,103.805115
286993,2,9,11,1.336498,103.805165
286994,5,3,8,1.336588,103.805149
286995,176,0,176,1.336507,103.805214
286996,1,0,1,1.336572,103.805737
286997,36,5,41,1.336524,103.805311
286998,1,0,1,1.3366,103.805216
286999,16,0,16,1.336525,103.805374
287000,31,0,31,1.336623,103.805351
287001,10,7,17,1.336635,103.805419
287002,4,0,4,1.336647,103.805486
287003,22,1,23,1.336658,103.805554
287004,0,34,34,1.299509,103.837
287005,1,48,49,1.299509,103.837
287006,0,10,10,1.299509,103.837
287020,0,1,1,1.336611,103.805284
287022,1,0,1,1.299509,103.837
287024,53,10,63,1.335261,103.80517
287026,354,65,419,1.335294,103.805169
287028,7,26,33,1.335359,103.805165
287030,0,4,4,1.335424,103.805162
287032,60,4,64,1.335489,103.805159
287034,0,1,1,1.299509,103.837
287036,16,1,17,1.335619,103.805152
287038,4,0,4,1.335684,103.805149
287042,10,0,10,1.335814,103.805143
287044,5,2,7,1.335879,103.805139
287046,15,3,18,1.335934,103.805146
287048,13,1,14,1.33599,103.805129
287050,1,1,2,1.336083,103.805695
287052,34,1,35,1.336128,103.805109
287054,7,0,7,1.336221,103.805095
287056,0,2,2,1.336036,103.805123
287058,36,2,38,1.336405,103.805068
287060,11,0,11,1.336487,103.805065
287062,19,0,19,1.336675,103.804987
287064,5,0,5,1.336709,103.80498
287066,71,0,71,1.336777,103.804968
287068,65,1,66,1.336846,103.804955
287070,33,16,49,1.336914,103.804943
287072,126,22,148,1.336982,103.80493
287074,21,3,24,1.337051,103.804917
287076,17,4,21,1.336978,103.805018
287078,4,4,8,1.337185,103.804903
287080,232,15,247,1.337244,103.804918
287081,214,36,250,1.337467,103.804904
287082,33,4,37,1.337652,103.804706
287083,15,0,15,1.337693,103.80474
287084,2,3,5,1.337735,103.804747
287085,33,0,33,1.337769,103.804782
287086,21,2,23,1.337844,103.804805
287087,26,0,26,1.337862,103.804838
287088,4,2,6,1.337932,103.804856
287089,94,234,328,1.337986,103.804871
287090,10,4,14,1.337586,103.80507
287091,55,0,55,1.337591,103.805085
287092,82,0,82,1.337592,103.805105
287093,128,0,128,1.337595,103.805129
287094,84,0,84,1.337597,103.805144
287095,60,1,61,1.3376,103.805164
287096,16,2,18,1.337599,103.805183
287097,6,4,10,1.337979,103.805382
287098,123,0,123,1.337604,103.805233
287099,9,0,9,1.337608,103.805291
287101,1,43,44,1.333141,103.796853
287102,0,3,3,1.335922,103.805761
287103,0,1,1,1.335554,103.805156
287104,0,3,3,1.332907,103.796925
287105,0,1,1,1.333039,103.797094
287106,0,3,3,1.332833,103.797084
287107,0,7,7,1.332894,103.79751
287109,0,4,4,1.332815,103.797761
287110,0,10,10,1.332727,103.7979
287111,0,49,49,1.332651,103.79809
287113,0,1,1,1.332951,103.797301
287117,0,7,7,1.33302,103.797997
287118,0,26,26,1.33292,103.797984
287119,0,3,3,1.332751,103.797351
287120,13,1,14,1.329725,103.809899
287121,3,1,4,1.329778,103.809788
287122,86,3,89,1.329987,103.809524
287123,5,2,7,1.329851,103.809626
287125,2,2,4,1.329852,103.809822
287126,0,1,1,1.332809,103.797166
287127,35,2,37,1.32988,103.809767
287128,2,0,2,1.336313,103.805082
287130,13,0,13,1.329933,103.809656
287131,5,3,8,1.329932,103.809655
287132,2,0,2,1.329879,103.809766
287133,25,1,26,1.329987,103.809544
287134,4,2,6,1.329986,103.809543
287135,5,3,8,1.330005,103.809223
287136,11,0,11,1.330032,103.809425
287137,1,7,8,1.330031,103.809424
287138,57,4,61,1.330044,103.809123
287139,18,0,18,1.330078,103.809306
287140,13,1,14,1.330077,103.809305
287141,4,0,4,1.330082,103.809022
287142,16,0,16,1.330123,103.809187
287143,1,0,1,1.32989,103.809525
287144,1,2,3,1.329698,103.809955
287145,4,2,6,1.330096,103.809126
287146,8,0,8,1.330105,103.809096
287147,39,0,39,1.330208,103.80887
287148,48,22,70,1.330225,103.808977
287149,204,1,205,1.33029,103.808815
287150,4,0,4,1.330246,103.808959
287152,0,1,1,1.330122,103.809186
287154,4,0,4,1.330383,103.808907
287155,4,1,5,1.330551,103.80877
287156,3,0,3,1.330138,103.80894
287157,1,0,1,1.330484,103.80877
287158,1,2,3,1.330442,103.80886
287159,80,0,80,1.330541,103.808835
287160,1,0,1,1.330474,103.808852
287161,144,3,147,1.330782,103.808776
287162,193,8,201,1.330711,103.808833
287163,1,7,8,1.330864,103.80883
287164,7,7,14,1.330639,103.808875
287165,3,0,3,1.330684,103.80877
287166,16,5,21,1.330931,103.808922
287167,83,4,87,1.330772,103.808875
287169,4,0,4,1.330962,103.809017
287170,14,2,16,1.33087,103.808881
287171,17,0,17,1.330869,103.80888
287172,7,1,8,1.330962,103.809017
287173,74,0,74,1.330892,103.809187
287174,1,0,1,1.330563,103.808835
287175,14,0,14,1.330986,103.809225
287176,26,3,29,1.330923,103.809282
287177,4,1,5,1.330922,103.809281
287178,3,5,8,1.330996,103.809333
287179,28,3,31,1.330938,103.809381
287180,1,0,1,1.330891,103.809186
287181,2,0,2,1.329967,103.809324
287182,54,0,54,1.330948,103.8095
287183,0,1,1,1.330937,103.80938
287184,1,0,1,1.330947,103.809499
287185,0,2,2,1.331005,103.809442
287187,4,8,12,1.331024,103.809659
287189,6,3,9,1.331059,103.809808
287190,9,0,9,1.331013,103.809849
287192,12,0,12,1.331065,103.80995
287193,1,4,5,1.331157,103.809982
287194,2,0,2,1.330959,103.80962
287195,5,2,7,1.331225,103.810053
287196,5,1,6,1.331182,103.810074
287197,11,0,11,1.33126,103.810076
287198,22,6,28,1.331247,103.810123
287199,58,5,63,1.331349,103.810141
287200,2,3,5,1.331361,103.810186
287201,1,17,18,1.331438,103.810206
287202,88,3,91,1.33147,103.810211
287203,186,7,193,1.331428,103.810216
287225,2,17,19,1.326719,103.809098
287226,9,30,39,1.326787,103.809053
287227,30,4,34,1.326797,103.808965
287228,3,0,3,1.330638,103.808874
287229,6,0,6,1.326836,103.808933
287230,1,8,9,1.326952,103.808841
287232,19,0,19,1.326978,103.808753
287233,4,0,4,1.326992,103.808713
287234,0,3,3,1.326861,103.808963
287236,6,0,6,1.327177,103.808473
287237,7,0,7,1.327276,103.808332
287238,127,1,128,1.327226,103.808382
287239,26,1,27,1.32736,103.808261
287240,29,0,29,1.327305,103.808272
287241,128,1,129,1.327438,103.808159
287242,2,0,2,1.331119,103.810013
287244,1,0,1,1.331434,103.809055
287245,45,0,45,1.327607,103.807922
287246,17,0,17,1.327539,103.807942
287247,1,0,1,1.327461,103.808052
287248,3,0,3,1.327077,103.808613
287249,1,4,5,1.327859,103.807698
287252,5,3,8,1.327722,103.807675
287253,1,2,3,1.327571,103.80787
287254,2,2,4,1.327391,103.807231
287255,0,2,2,1.327383,103.808162
287256,54,3,57,1.327736,103.807555
287257,6,0,6,1.327824,103.807651
287258,40,1,41,1.327876,103.807691
287259,18,0,18,1.327979,103.80777
287260,0,6,6,1.328081,103.807848
287262,1,1,2,1.328277,103.808016
287280,9,0,9,1.322316,103.786591
287284,2,1,3,1.328116,103.807895
287285,0,12,12,1.329476,103.808183
287286,1,4,5,1.329651,103.80802
287287,2,0,2,1.328287,103.808006
287288,0,4,4,1.329498,103.808174
287290,14,3,17,1.329475,103.808205
287291,0,2,2,1.329455,103.808212
287293,1,1,2,1.329368,103.80833
287295,7,1,8,1.329282,103.808446
287296,4,2,6,1.329238,103.808505
287297,200,0,200,1.329292,103.808453
287298,34,12,46,1.329195,103.808564
287299,0,4,4,1.329277,103.808498
287300,29,2,31,1.329152,103.808622
287301,36,2,38,1.3292,103.808577
287302,45,4,49,1.328516,103.809117
287303,9,0,9,1.328589,103.809071
287304,25,0,25,1.328716,103.809063
287305,5,0,5,1.328716,103.809063
287306,14,1,15,1.329154,103.808639
287307,43,21,64,1.32893,103.808626
287308,7,0,7,1.328929,103.808625
287309,0,1,1,1.327639,103.807875
287310,15,0,15,1.328929,103.808625
287311,37,6,43,1.329145,103.808665
287312,77,1,78,1.328887,103.808685
287313,1,0,1,1.328929,103.808625
287314,22,0,22,1.328567,103.808368
287315,6,0,6,1.3285,103.808369
287316,42,2,44,1.329134,103.808699
287317,23,0,23,1.328453,103.808293
287318,21,0,21,1.328437,103.808295
287320,3,0,3,1.329727,103.807882
287321,2,2,4,1.329099,103.80874
287322,6,0,6,1.328786,103.808778
287323,22,0,22,1.328785,103.808778
287324,4,0,4,1.328785,103.808778
287325,8,0,8,1.328427,103.808518
287326,84,41,125,1.329071,103.808789
287327,5,1,6,1.328237,103.808544
287328,1,0,1,1.328886,103.808683
287329,13,0,13,1.328153,103.808516
287330,3,0,3,1.328317,103.808208
287331,3,0,3,1.328196,103.808544
287332,11,0,11,1.328848,103.808808
287333,9,0,9,1.328829,103.808845
287334,9,1,10,1.328799,103.808878
287335,16,0,16,1.328778,103.808895
287336,9,3,12,1.328982,103.808918
287337,1,0,1,1.328119,103.808482
287341,1,3,4,1.328958,103.808945
287346,14,6,20,1.328933,103.808998
287347,1,0,1,1.328806,103.80909
287350,3,0,3,1.329033,103.808839
287351,100,1,101,1.328898,103.809034
287356,1,2,3,1.328718,103.809206
287361,0,4,4,1.328763,103.809209
287366,0,7,7,1.328707,103.809282
287367,30,23,53,1.328561,103.809512
287368,2,19,21,1.328554,103.809646
287369,4,1,5,1.328521,103.809609
287370,0,2,2,1.329325,103.808388
287371,0,1,1,1.328719,103.809207
287372,62,8,70,1.328491,103.809892
287373,0,8,8,1.32843,103.809864
287374,1,2,3,1.328871,103.809086
287375,4,0,4,1.328371,103.810005
287376,5,4,9,1.328372,103.810055
287377,3,3,6,1.328315,103.810204
287378,8,2,10,1.328258,103.810353
287379,85,3,88,1.328201,103.810502
287380,36,6,42,1.328159,103.810587
287381,18,5,23,1.328097,103.810698
287382,5,16,21,1.328028,103.810808
287383,54,0,54,1.329693,103.807936
287384,6,1,7,1.328462,103.808656
287385,26,0,26,1.328462,103.808656
287386,38,1,39,1.328462,103.808656
287387,9,2,11,1.328462,103.808656
287388,1,5,6,1.328867,103.808747
287389,18,9,27,1.328824,103.808812
287390,3,0,3,1.328609,103.810047
287391,14,0,14,1.328724,103.808587
287392,8,0,8,1.328297,103.808194
287394,2,0,2,1.32854,103.809738
287395,9,0,9,1.328462,103.808656
287396,76,0,76,1.328305,103.808441
287397,5,0,5,1.328262,103.80838
287398,30,0,30,1.328254,103.808356
287399,2,0,2,1.328462,103.808656
287400,2,5,7,1.32818,103.808308
287402,79,0,79,1.328462,103.808656
287403,4,1,5,1.328462,103.808656
287404,0,252,252,1.326267,103.808825
287405,0,1,1,1.328463,103.809753
287406,5,3,8,1.326396,103.808647
287407,3,35,38,1.326482,103.808528
287408,1,1,2,1.328185,103.808332
287409,11,3,14,1.326655,103.80829
287410,3,3,6,1.326741,103.808171
287411,6,3,9,1.326827,103.808051
287412,1,6,7,1.326913,103.807932
287413,17,10,27,1.326999,103.807813
287414,0,6,6,1.327086,103.807694
287415,12,10,22,1.327172,103.807575
287416,3,0,3,1.328742,103.808579
287417,325,14,339,1.327295,103.807372
287418,5,5,10,1.327416,103.807185
287419,3,3,6,1.327482,103.807092
287420,18,0,18,1.327536,103.806982
287421,118,29,147,1.327733,103.806913
287443,81,3,84,1.331479,103.808439
287444,198,2,200,1.331418,103.808403
287445,67,2,69,1.331294,103.80833
287446,9,1,10,1.331258,103.808325
287447,10,0,10,1.331142,103.808272
287448,20,2,22,1.331065,103.808243
287449,0,1,1,1.32631,103.808766
287450,1,0,1,1.330967,103.808187
287451,2,4,6,1.330658,103.808068
287452,1,0,1,1.330722,103.808084
287453,0,1,1,1.331007,103.807969
287454,97,6,103,1.330912,103.807886
287455,1,0,1,1.330584,103.80809
287456,3,0,3,1.327258,103.807456
287457,1,0,1,1.330257,103.808102
287458,2,0,2,1.326569,103.808409
287459,1,5,6,1.330185,103.808222
287460,4,1,5,1.330582,103.807978
287461,2,3,5,1.330122,103.808328
287462,150,0,150,1.33054,103.808002
287463,2,0,2,1.330677,103.807978
287464,130,9,139,1.330346,103.80804
287465,4,3,7,1.329386,103.809335
287466,3,0,3,1.330791,103.807845
287467,95,0,95,1.329318,103.809427
287468,2,0,2,1.329541,103.809325
287469,55,4,59,1.329238,103.809564
287471,39,9,48,1.329078,103.809833
287472,4,3,7,1.329883,103.808531
287473,26,6,32,1.329043,103.809922
287474,11,3,14,1.329837,103.808599
287475,57,5,62,1.328967,103.810062
287476,0,2,2,1.330112,103.80822
287477,3,10,13,1.328919,103.810168
287478,3,0,3,1.330257,103.808082
287479,1,1,2,1.329746,103.808733
287480,10,2,12,1.329471,103.809137
287481,48,1,49,1.32938,103.809272
287482,17,3,20,1.329288,103.809407
287483,6,0,6,1.32923,103.809468
287484,5,2,7,1.329162,103.809569
287485,1,15,16,1.329072,103.809756
287486,0,1,1,1.330325,103.808137
287487,17,6,23,1.328974,103.809997
287488,36,3,39,1.328909,103.810158
287511,1,0,1,1.32904,103.809837
287514,26,14,40,1.326769,103.809316
287515,3,0,3,1.329654,103.808868
287516,8,5,13,1.32664,103.809529
287517,0,1,1,1.299509,103.837
287518,7,4,11,1.32652,103.809748
287519,9,0,9,1.326564,103.809797
287520,1,2,3,1.326727,103.809409
287521,2,8,10,1.327816,103.809291
287524,2,3,5,1.32809,103.809127
287525,9,0,9,1.327226,103.809458
287526,16,0,16,1.328117,103.809084
287527,4,0,4,1.327333,103.809468
287528,84,2,86,1.32817,103.809
287530,185,10,195,1.328187,103.808979
287531,9,3,12,1.327582,103.809404
287532,8,0,8,1.328239,103.808894
287533,4,5,9,1.327649,103.809395
287534,196,11,207,1.328292,103.80881
287535,58,5,63,1.327729,103.809375
287536,7,0,7,1.328335,103.808735
287537,35,15,50,1.327875,103.80934
287538,25,0,25,1.3299,103.809958
287539,0,1,1,1.326594,103.809622
287540,2,1,3,1.326642,103.809649
287541,3,1,4,1.329963,103.809992
287543,4,9,13,1.32808,103.809299
287544,3,0,3,1.328134,103.809261
287545,5,0,5,1.330056,103.80999
287546,2,11,13,1.328246,103.809295
287547,0,2,2,1.329563,103.809003
287548,6,2,8,1.330129,103.81003
287549,3,2,5,1.329368,103.810062
287550,10,2,12,1.330181,103.810083
287551,1,1,2,1.33015,103.810065
287552,7,12,19,1.329462,103.809978
287553,19,2,21,1.330253,103.810107
287554,21,1,22,1.330303,103.810078
287555,34,6,40,1.329425,103.809977
287556,25,1,26,1.330355,103.810114
287557,7,1,8,1.330376,103.810108
287558,248,15,263,1.329661,103.810021
287559,1,3,4,1.330398,103.810134
287560,3,5,8,1.330449,103.810154
287561,47,8,55,1.330494,103.809549
287562,36,0,36,1.330667,103.80966
287563,4,0,4,1.330566,103.809544
287566,1,0,1,1.329951,103.809967
287567,5,2,7,1.330565,103.809601
287569,45,0,45,1.330472,103.809554
287573,8,0,8,1.330475,103.809549
287575,1,0,1,1.330674,103.80959
287577,296,5,301,1.330737,103.809778
287578,28,11,39,1.330608,103.810299
287579,109,0,109,1.330674,103.810365
287580,1,0,1,1.330493,103.809549
287581,3,5,8,1.330711,103.810466
287582,17,2,19,1.330859,103.81053
287583,55,2,57,1.330835,103.810578
287584,8,0,8,1.33098,103.810616
287585,18,3,21,1.330946,103.810655
287587,2,7,9,1.33106,103.810799
287588,36,4,40,1.331209,103.810719
287589,39,0,39,1.331042,103.810931
287590,0,3,3,1.330033,103.810036
287591,1,2,3,1.331317,103.810735
287592,0,5,5,1.331415,103.810748
287593,28,1,29,1.331028,103.811031
287594,115,6,121,1.331602,103.810619
287595,1,5,6,1.331051,103.811053
287596,96,0,96,1.331056,103.811033
287597,5,0,5,1.331332,103.810798
287598,5,1,6,1.331508,103.81076
287599,19,11,30,1.333009,103.810107
287600,65,19,84,1.332836,103.81069
287601,1163,39,1202,1.332212,103.810962
287602,12,9,21,1.331967,103.809587
287603,8,0,8,1.332483,103.809617
287604,1,2,3,1.331041,103.810972
287605,82,3,85,1.332111,103.808964
287606,46,3,49,1.332259,103.809001
287607,140,0,140,1.332484,103.809009
287608,88,0,88,1.332687,103.809019
287609,1,4,5,1.332571,103.808954
287610,10,0,10,1.332446,103.808921
287611,26,13,39,1.332063,103.80876
287612,36,7,43,1.33207,103.808616
287613,57,8,65,1.332066,103.808342
287614,12,11,23,1.332077,103.808142
287615,42,17,59,1.332251,103.808066
287616,564,21,585,1.331877,103.810194
287617,10,0,10,1.332187,103.810317
287618,20,0,20,1.332315,103.810352
287619,30,3,33,1.332284,103.810176
287620,43,0,43,1.332296,103.809996
287621,32,0,32,1.332126,103.810014
287622,307,18,325,1.331955,103.81
287624,67,12,79,1.331925,103.809646
287625,22,7,29,1.331978,103.809649
287626,2,0,2,1.330214,103.810055
287627,24,7,31,1.332118,103.809662
287628,3,3,6,1.332315,103.809669
287629,58,0,58,1.332394,103.809671
287630,3,2,5,1.331996,103.809579
287631,193,2,195,1.332103,103.809579
287632,113,3,116,1.332189,103.809592
287633,84,1,85,1.332287,103.809583
287634,48,0,48,1.332326,103.809586
287635,90,6,96,1.330611,103.810398
287636,2,0,2,1.332036,103.809651
287637,31,1315,1346,1.32734,103.806526
287638,3,25,28,1.327925,103.807071
287641,0,62,62,1.327461,103.806635
287642,29,1,30,1.328004,103.807113
287644,0,10,10,1.328093,103.807177
287645,2,0,2,1.326799,103.809448
287647,0,15,15,1.327673,103.806831
287648,109,22,131,1.32826,103.807278
287649,37,0,37,1.328384,103.807367
287650,6,1,7,1.327761,103.806896
287651,0,5,5,1.328419,103.807411
287652,2,0,2,1.327643,103.80681
287653,214,10,224,1.328526,103.807494
287654,2,0,2,1.32782,103.806938
287655,0,5,5,1.328574,103.807558
287656,16,8,24,1.327938,103.807024
287658,11,0,11,1.327997,103.807067
287659,57,0,57,1.328711,103.807634
287660,17,20,37,1.328056,103.80711
287661,3,52,55,1.328881,103.807746
287662,3,0,3,1.332492,103.809666
287663,28,0,28,1.328919,103.807862
287664,11,0,11,1.328174,103.807195
287665,7,5,12,1.328892,103.807901
287666,1,0,1,1.330738,103.810443
287667,36,0,36,1.328857,103.807951
287668,12,0,12,1.328292,103.807281
287669,0,1,1,1.328233,103.807238
287671,5,0,5,1.328777,103.808056
287672,0,3,3,1.328115,103.807153
287673,3,0,3,1.328411,103.807367
287674,234,0,234,1.32847,103.80741
287675,74,3,77,1.328723,103.808147
287676,1,1,2,1.327879,103.806981
287677,2,0,2,1.328529,103.807452
287678,1,6,7,1.328588,103.807495
287679,18,11,29,1.328739,103.808293
287680,21,0,21,1.328647,103.807538
287681,4,5,9,1.328773,103.808208
287682,3,7,10,1.328706,103.807581
287683,12,0,12,1.328794,103.808171
287684,6,0,6,1.328765,103.807624
287685,22,13,35,1.328816,103.808114
287686,21,3,24,1.328824,103.807667
287688,14,0,14,1.328883,103.807709
287689,1,11,12,1.328912,103.80801
287691,8,0,8,1.328944,103.807954
287692,3,1,4,1.329001,103.807795
287693,1,0,1,1.328806,103.808019
287694,43,0,43,1.329037,103.807821
287695,8,16,24,1.328989,103.807865
287696,1,4,5,1.329072,103.807846
287697,15,0,15,1.329143,103.807898
287698,11,0,11,1.329214,103.807949
287699,1,0,1,1.328975,103.807898
287700,22,9,31,1.329356,103.808051
287701,99,0,99,1.329427,103.808103
287702,8,4,12,1.329461,103.808124
287724,45,12,57,1.32725,103.809319
287725,10,12,22,1.327422,103.809113
287726,6,5,11,1.327319,103.809212
287727,10,10,20,1.327448,103.809077
287728,17,3,20,1.327387,103.809138
287729,1,4,5,1.327498,103.809007
287731,4,0,4,1.327549,103.808936
287732,2,0,2,1.328672,103.808228
287733,20,2,22,1.327599,103.808866
287734,0,4,4,1.327582,103.808845
287735,0,1,1,1.329285,103.808
287737,1,0,1,1.32765,103.808795
287739,16,1,17,1.327763,103.808618
287740,9,2,11,1.327741,103.808689
287741,49,1,50,1.327836,103.808516
287742,2,0,2,1.327507,103.808946
287743,7,0,7,1.327861,103.808466
287745,22,2,24,1.327982,103.808312
287746,85,0,85,1.327954,103.808371
287747,28,0,28,1.328045,103.80822
287748,51,2,53,1.328004,103.808301
287749,2,1,3,1.328753,103.808101
287771,176,502,678,1.331149,103.798416
287772,23,79,102,1.331318,103.79857
287773,13,35,48,1.331616,103.798518
287774,2,6,8,1.331511,103.798586
287775,13,78,91,1.331752,103.798482
287776,53,8,61,1.33163,103.798601
287777,75,0,75,1.331812,103.798604
287778,7,8,15,1.331878,103.798596
287779,1,38,39,1.332032,103.798654
287780,11,0,11,1.332657,103.799263
287781,3,6,9,1.332804,103.799273
287782,5,2,7,1.332718,103.799342
287783,8,0,8,1.332868,103.799358
287785,22,10,32,1.332955,103.799445
287786,1,9,10,1.332826,103.799481
287787,68,3,71,1.33301,103.799522
287788,2,1,3,1.328055,103.80823
287790,2,6,8,1.332957,103.799665
287791,6,0,6,1.333156,103.79971
287792,2,0,2,1.327853,103.808512
287793,22,3,25,1.333235,103.799815
287794,7,2,9,1.333061,103.799826
287795,30,0,30,1.33332,103.799895
287796,6,0,6,1.333121,103.799924
287797,0,1,1,1.327689,103.80872
287798,1,7,8,1.33318,103.799972
287799,1,0,1,1.333349,103.799993
287800,24,0,24,1.333261,103.80007
287801,2,3,5,1.3335,103.800159
287802,0,4,4,1.333327,103.80015
287803,2,0,2,1.333024,103.799752
287804,9,4,13,1.333907,103.800841
287805,4,1,5,1.333809,103.800584
287806,33,2,35,1.333896,103.80091
287807,212,27,239,1.333965,103.801047
287808,54,3,57,1.333875,103.801047
287809,8,8,16,1.333927,103.801223
287811,36,20,56,1.333887,103.801447
287812,52,5,57,1.333833,103.801321
287813,11,1,12,1.334042,103.801776
287814,30,3,33,1.333812,103.801458
287815,35,0,35,1.333791,103.801595
287816,18,12,30,1.33376,103.801664
287817,2,0,2,1.333561,103.800247
287818,126,8,134,1.333731,103.801852
287819,9,24,33,1.332328,103.799144
287840,35,9,44,1.332149,103.799491
287841,2,4,6,1.332206,103.799117
287842,4,0,4,1.332194,103.799554
287844,13,1,14,1.332285,103.799678
287845,52,14,66,1.332051,103.799493
287846,3,0,3,1.33292,103.799601
287847,7,0,7,1.332008,103.799567
287848,1,3,4,1.332465,103.799928
287849,6,0,6,1.331922,103.799716
287850,36,0,36,1.332556,103.800053
287851,46,1,47,1.331905,103.799813
287852,1,0,1,1.33342,103.800054
287853,5,0,5,1.332616,103.800093
287854,7,8,15,1.332553,103.800351
287856,4,1,5,1.332642,103.800514
287857,93,0,93,1.332727,103.800215
287858,45,8,53,1.332825,103.800704
287859,7,0,7,1.332786,103.800302
287860,7,4,11,1.332944,103.800563
287861,0,8,8,1.332857,103.800405
287862,0,1,1,1.332235,103.799768
287863,5,9,14,1.332979,103.800458
287864,39,2,41,1.333203,103.800548
287865,12,0,12,1.333449,103.800494
287866,1,1,2,1.333736,103.801767
287867,4,10,14,1.333458,103.800255
287868,27,2,29,1.333484,103.80054
287869,0,2,2,1.333252,103.800521
287870,2,0,2,1.333594,103.800568
287891,11,2,13,1.33275,103.799191
287892,34,1,35,1.333195,103.798941
287893,9,0,9,1.332833,103.799128
287894,6,1,7,1.333236,103.798993
287895,7,1,8,1.332999,103.799004
287896,8,0,8,1.333316,103.799098
287897,1,1,2,1.299509,103.837
287898,23,0,23,1.333397,103.799202
287899,8,14,22,1.333224,103.798953
287900,1,0,1,1.332782,103.800393
287901,26,0,26,1.333274,103.799016
287903,3,0,3,1.332375,103.799803
287904,35,6,41,1.333384,103.799096
287905,3,0,3,1.333639,103.799515
287906,31,2,33,1.33357,103.799399
287907,8,0,8,1.333801,103.799723
287909,3,2,5,1.33382,103.799797
287910,4,0,4,1.333767,103.799654
287911,48,2,50,1.33392,103.799894
287912,1,0,1,1.333478,103.799306
287913,43,27,70,1.333976,103.799966
287914,26,0,26,1.333964,103.799909
287915,26,0,26,1.334053,103.800026
287916,8,3,11,1.334053,103.800046
287917,25,0,25,1.33382,103.800248
287918,19,2,21,1.333778,103.800318
287919,42,1,43,1.333963,103.799908
287920,2,0,2,1.333155,103.798889
287921,45,1,46,1.334052,103.800025
287922,16,6,22,1.334052,103.800025
287923,9,0,9,1.333961,103.800154
287940,29,2,31,1.334068,103.800854
287941,73,28,101,1.334346,103.801059
287942,2,0,2,1.334052,103.800025
287943,16,1,17,1.334416,103.801092
287944,18,1,19,1.334527,103.801041
287945,2,5,7,1.334664,103.801209
287946,49,11,60,1.334709,103.801156
287947,80,0,80,1.334705,103.801281
287948,57,0,57,1.334888,103.801284
287949,15,2,17,1.334947,103.80145
287950,36,11,47,1.335074,103.801428
287951,10,8,18,1.335092,103.801599
287952,25,49,74,1.335292,103.801613
287953,29,0,29,1.334255,103.801
287974,3,224,227,1.333849,103.795178
287975,1,134,135,1.33397,103.794875
287976,0,16,16,1.334787,103.79803
287977,0,8,8,1.335509,103.798304
287978,34,33,67,1.336209,103.79844
287979,93,0,93,1.341164,103.792254
287980,53,623,676,1.334943,103.794237
287981,23,22,45,1.339623,103.792348
287982,112,37,149,1.334689,103.793906
287983,18,5,23,1.334605,103.792816
287984,78,75,153,1.33505,103.79338
287985,42,20,62,1.335517,103.792627
287988,3624,728,4352,1.33624,103.796843
287992,1585,204,1789,1.335398,103.795463
287993,25,1,26,1.333944,103.79421
287994,9418,26089,35507,1.337685,103.793667
287995,5611,0,5611,1.336597,103.792993
287996,302,1574,1876,1.335554,103.796003
287997,256,47,303,1.335687,103.796378
287998,9,34,43,1.335787,103.796676
287999,1,0,1,1.334262,103.799214
288000,239,729,968,1.335964,103.797139
288001,2575,114,2689,1.340423,103.795036
288007,158,27,185,1.346451,103.789459
288008,8,9,17,1.346435,103.789836
288009,202,14,216,1.34704,103.789691
288010,15,1,16,1.347004,103.789987
288011,379,8,387,1.347684,103.789965
288012,2,1,3,1.33372,103.799619
288013,11,11,22,1.348123,103.790271
288014,44,2,46,1.347112,103.790057
288015,19,15,34,1.348278,103.790495
288016,2,0,2,1.334382,103.800957
288017,2,1,3,1.347065,103.790027
288018,0,1,1,1.335876,103.79693
288019,0,4,4,1.348305,103.790573
288020,1,10,11,1.347289,103.790128
288021,9,3,12,1.348337,103.790665
288023,0,2,2,1.347197,103.790074
288024,0,4,4,1.347428,103.790179
288025,2,0,2,1.348359,103.790689
288026,110,1,111,1.347488,103.790177
288027,4,0,4,1.34845,103.790848
288028,14,1,15,1.347518,103.790225
288029,0,1,1,1.347263,103.790077
288030,6,10,16,1.347668,103.790279
288031,5,0,5,1.348101,103.790507
288032,11,1,12,1.347693,103.790366
288033,0,2,2,1.348388,103.79077
288034,61,12,73,1.347731,103.790403
288035,71,2,73,1.348359,103.791126
288036,2,2,4,1.347755,103.790435
288037,14,15,29,1.348403,103.791296
288038,1,4,5,1.347831,103.790496
288039,6,291,297,1.348713,103.791313
288040,27,0,27,1.347864,103.79055
288041,137,6,143,1.348668,103.791314
288042,75,12,87,1.34792,103.790546
288043,73,15,88,1.34858,103.791314
288044,62,2,64,1.347988,103.790691
288045,7,0,7,1.348492,103.791315
288046,69,1,70,1.347981,103.790729
288047,33,23,56,1.348413,103.791306
288048,100,10,110,1.348029,103.790828
288049,0,5,5,1.348361,103.791321
288050,4,4,8,1.348052,103.790876
288051,46,7,53,1.348318,103.791327
288052,4,2,6,1.347922,103.790315
288053,31,0,31,1.348234,103.791338
288054,46,6,52,1.348028,103.790443
288055,1,6,7,1.34815,103.791348
288056,2,3,5,1.348081,103.790507
288057,4,57,61,1.348075,103.791349
288058,51,8,59,1.348195,103.790672
288059,15,16,31,1.348231,103.790765
288060,6,57,63,1.348277,103.79092
288061,802,7,809,1.34767,103.79083
288062,477,31,508,1.347222,103.791082
288063,783,19,802,1.347057,103.790662
288085,27,38,65,1.334227,103.791064
288086,2,9,11,1.33505,103.790664
288087,3,8,11,1.334509,103.790938
288088,0,25,25,1.334945,103.790739
288089,43,18,61,1.335034,103.790872
288090,24,4,28,1.335123,103.790958
288091,67,3,70,1.335242,103.791028
288092,102,18,120,1.335217,103.790507
288093,23,2,25,1.335287,103.790962
288094,2,12,14,1.334423,103.790845
288095,56,0,56,1.335984,103.791201
288096,4,1,5,1.334679,103.790665
288097,1,2,3,1.348311,103.790525
288098,71,6,77,1.335003,103.790457
288099,28,2,30,1.336766,103.790266
288100,2,5,7,1.33558,103.790299
288101,2,1,3,1.334917,103.790512
288102,12,2,14,1.335981,103.790242
288103,5,1,6,1.336178,103.790223
288104,14,2,16,1.336483,103.790192
288105,64,27,91,1.337563,103.790192
288106,1,20,21,1.336841,103.790129
288107,80,14,94,1.337762,103.790168
288108,49,2,51,1.3378,103.790163
288109,52,12,64,1.337926,103.791099
288111,7,3,10,1.338312,103.790114
288112,127,1,128,1.336964,103.789448
288113,0,11,11,1.337809,103.790065
288114,7,0,7,1.338702,103.790077
288115,1,0,1,1.348461,103.790909
288116,7,9,16,1.339608,103.789984
288117,17,0,17,1.339516,103.790706
288118,16,10,26,1.338825,103.789719
288119,16,0,16,1.340327,103.789906
288120,2,0,2,1.348251,103.790765
288121,5,16,21,1.340539,103.789862
288122,4,2,6,1.340286,103.790454
288123,94,11,105,1.340277,103.790584
288124,23,1,24,1.340267,103.79088
288125,10,9,19,1.339334,103.789612
288126,94,0,94,1.340926,103.789866
288127,11,0,11,1.339739,103.789569
288128,8,22,30,1.341309,103.790003
288129,4,2,6,1.341312,103.790293
288130,16,1,17,1.34123,103.790576
288131,3,0,3,1.335787,103.790267
288132,20,18,38,1.341439,103.790299
288133,35,19,54,1.341381,103.789953
288134,23,12,35,1.341019,103.789721
288135,130,37,167,1.34117,103.789714
288136,8,7,15,1.341276,103.789715
288137,5,0,5,1.342184,103.79076
288138,26,343,369,1.341742,103.789658
288139,4384,494,4878,1.343649,103.790849
288140,1282,1,1283,1.342963,103.790748
288141,1,2,3,1.341441,103.79055
288143,0,2,2,1.338952,103.789447
288144,9,14,23,1.340093,103.789766
288145,5,0,5,1.340008,103.789591
288146,1,10,11,1.3352,103.790376
288147,17,141,158,1.341927,103.789871
288148,1,0,1,1.338557,103.789971
288162,750,118,868,1.342539,103.78957
288184,21,2,23,1.337654,103.790763
288185,86,3,89,1.337338,103.790758
288186,2,0,2,1.336116,103.790348
288187,18,18,36,1.337338,103.791345
288188,15,9,24,1.337318,103.791345
288210,1,17,18,1.336567,103.790371
288211,5,16,21,1.336547,103.790371
288212,6,0,6,1.336566,103.790496
288213,3,3,6,1.336546,103.790496
288214,15,1,16,1.336563,103.790747
288216,4,4,8,1.336561,103.790997
288217,53,7,60,1.336541,103.790997
288218,1,2,3,1.335712,103.790389
288219,132,2,134,1.336538,103.791248
288220,1,23,24,1.336556,103.791498
288221,33,3,36,1.336536,103.791498
288243,33,7,40,1.337145,103.802985
288244,3,1,4,1.335268,103.803089
288246,35,1,36,1.336938,103.803041
288247,7,10,17,1.334786,103.803056
288248,16,0,16,1.33634,103.802978
288249,4,0,4,1.334673,103.8032
288250,5,0,5,1.336271,103.802985
288251,16,0,16,1.334433,103.803288
288252,31,0,31,1.336181,103.803017
288253,19,2,21,1.334377,103.803341
288254,19,0,19,1.33584,103.803052
288255,6,0,6,1.334344,103.803445
288256,4,1,5,1.334613,103.803706
288257,50,0,50,1.335633,103.8031
288258,8,3,11,1.334466,103.804242
288259,24,1,25,1.335436,103.803139
288260,132,0,132,1.335041,103.803215
288261,4,1,5,1.334742,103.803339
288262,0,2,2,1.337088,103.791146
288285,10,92,102,1.335644,103.819316
288286,48,2,50,1.336131,103.81951
288287,40,0,40,1.336297,103.819526
288288,7,8,15,1.336526,103.819585
288289,93,2,95,1.336593,103.819625
288290,7,1,8,1.336751,103.819672
288291,5,1,6,1.336881,103.819687
288292,81,27,108,1.336904,103.81956
288293,4,5,9,1.336808,103.819547
288294,1,2,3,1.336558,103.791248
288295,20,0,20,1.336624,103.819496
288296,29,29,58,1.336478,103.819454
288297,6,2,8,1.336378,103.819426
288298,3,2,5,1.336162,103.819343
288299,16,6,22,1.336113,103.819333
288300,3,7,10,1.338232,103.812644
288301,10,4,14,1.337381,103.814071
288303,4163,416,4579,1.342042,103.810843
288304,6,56,62,1.336003,103.819302
288305,51,633,684,1.335821,103.819268
288306,4,2,6,1.335854,103.819407
288307,93,4,97,1.336018,103.819468
288325,43,21,64,1.339513,103.811703
288326,20,7,27,1.339261,103.811423
288327,42,2,44,1.33917,103.81143
288350,5,13,18,1.325478,103.812494
288351,11,45,56,1.325692,103.812332
288352,836,74,910,1.324807,103.812281
288353,886,26,912,1.325868,103.812468
288354,23,609,632,1.326042,103.812521
288370,7,8,15,1.299509,103.837
288371,2,44,46,1.299509,103.837
288372,0,40,40,1.299509,103.837
288373,2,26,28,1.299509,103.837
288374,34,21,55,1.324985,103.812295
288375,44,2,46,1.324956,103.812232
288376,18,1,19,1.324917,103.812116
288377,42,3,45,1.324893,103.812024
288378,8,57,65,1.32485,103.811951
288382,0,16,16,1.324792,103.811753
288383,1003,34,1037,1.326506,103.812645
288407,773,81,854,1.327314,103.812824
288408,5210,83,5293,1.32604,103.812201
288411,850,89,939,1.327354,103.81239
288413,651,77,728,1.327845,103.812358
288415,145,9,154,1.328091,103.812238
288416,42,0,42,1.328182,103.812171
288417,13,67,80,1.328274,103.812089
288418,4,0,4,1.299509,103.837
288419,2,0,2,1.334721,103.803636
288420,755,113,868,1.328698,103.812264
288421,125,107,232,1.328571,103.811799
288422,712,76,788,1.329327,103.811874
288423,631,62,693,1.32964,103.811706
288424,15,10,25,1.328408,103.811291
288426,54,112,166,1.328252,103.811089
288428,13,77,90,1.327974,103.811042
288429,754,85,839,1.328662,103.811121
288430,5,44,49,1.3276,103.810927
288431,496,46,542,1.32901,103.811254
288432,8,27,35,1.32755,103.811259
288433,843,19,862,1.32984,103.811027
288434,2,2,4,1.327582,103.811395
288435,485,19,504,1.329253,103.810627
288436,8,1,9,1.327783,103.811699
288437,167,77,244,1.328673,103.810573
288438,35,9,44,1.327539,103.811783
288439,15,10,25,1.327532,103.811405
288440,10,18,28,1.32749,103.811343
288441,18,3,21,1.327466,103.811282
288442,8,25,33,1.327647,103.810628
288443,55,0,55,1.327447,103.811086
288444,2,0,2,1.299509,103.837
288445,3,29,32,1.327367,103.810736
288446,8,0,8,1.327664,103.810525
288447,4,5,9,1.327148,103.810681
288448,1,1,2,1.327656,103.810613
288449,3,9,12,1.327195,103.810676
288451,42,8,50,1.326946,103.810623
288452,2,0,2,1.32768,103.810469
288453,15,16,31,1.326787,103.810569
288454,47,0,47,1.327768,103.810322
288455,1092,46,1138,1.326514,103.810813
288456,218,0,218,1.327815,103.81023
288457,7,48,55,1.326354,103.81047
288458,3,4,7,1.326331,103.810547
288459,0,2,2,1.327737,103.810407
288460,27,8,35,1.326259,103.810745
288461,12,6,18,1.327818,103.810174
288462,17,70,87,1.326232,103.810421
288463,5,3,8,1.326209,103.810498
288464,1,1,2,1.326287,103.810671
288465,0,2,2,1.326165,103.810622
288466,6,0,6,1.32784,103.810149
288467,4,59,63,1.325811,103.810259
288468,11,0,11,1.325788,103.810336
288469,0,1,1,1.341841,103.79051
288470,1,0,1,1.325744,103.81046
288471,24,8,32,1.327854,103.81007
288472,25,0,25,1.327867,103.810016
288473,5,56,61,1.325543,103.810308
288474,40,0,40,1.32791,103.809962
288475,1,1,2,1.326137,103.810696
288476,1,2,3,1.336682,103.819502
288477,5,0,5,1.327928,103.809806
288478,0,2,2,1.327891,103.809904
288479,8,4,12,1.327527,103.8099
288480,6,3,9,1.327509,103.809953
288481,8,0,8,1.327478,103.810017
288482,8,0,8,1.327491,103.81007
288483,14,4,18,1.327455,103.810096
288485,0,6,6,1.327375,103.810264
288486,8,2,10,1.327361,103.810321
288487,13,4,17,1.327374,103.810354
288489,3,0,3,1.327914,103.809884
288490,14,34,48,1.327302,103.810508
288491,1,53,54,1.327105,103.810437
288492,1,2,3,1.327353,103.810453
288493,40,2,42,1.327127,103.810349
288494,6,4,10,1.327145,103.810262
288496,7,0,7,1.327206,103.810183
288497,0,2,2,1.327975,103.809741
288498,16,0,16,1.327257,103.810046
288499,6,0,6,1.327287,103.81
288500,17,0,17,1.327269,103.809928
288501,8,1,9,1.32683,103.810102
288503,12,0,12,1.326813,103.810196
288505,2,69,71,1.326763,103.810301
288506,33,2,35,1.326612,103.810177
288509,1,24,25,1.326448,103.810108
288510,4,0,4,1.32637,103.810067
288511,6,0,6,1.326341,103.810043
288512,17,6,23,1.326287,103.81007
288514,12,3,15,1.326146,103.810025
288515,73,0,73,1.327599,103.810926
288517,7,0,7,1.327599,103.810926
288518,114,445,559,1.324957,103.81254
288519,131,4,135,1.327447,103.811197
288520,13,12,25,1.3256,103.810082
288521,2,20,22,1.325465,103.81002
288522,51,41,92,1.325196,103.809897
288523,115,4640,4755,1.324954,103.809874
288524,10,0,10,1.327958,103.811581
288525,31,37,68,1.325039,103.81241
288526,3,3,6,1.325039,103.81241
288527,56,8,64,1.325039,103.81241
288529,0,20,20,1.327366,103.810735
288530,6,8,14,1.327366,103.810735
288533,1105,6,1111,1.32522,103.811752
288534,415,14,429,1.325559,103.812229
288535,891,287,1178,1.325559,103.812229
288536,8,7,15,1.336035,103.80219
288537,2,5,7,1.335895,103.802642
288560,6,17,23,1.330064,103.810395
288561,3,7,10,1.330044,103.810395
288562,3,0,3,1.32713,103.810407
288563,12,37,49,1.330067,103.81069
288564,620,44,664,1.33001,103.811618
288565,70,0,70,1.33012,103.810784
288566,57,1,58,1.330559,103.811474
288567,210,7,217,1.330271,103.811155
288568,44,0,44,1.33071,103.811433
288569,3,21,24,1.330321,103.81124
288570,16,0,16,1.33093,103.81139
288571,2,0,2,1.327205,103.810116
288572,2,0,2,1.331549,103.811177
288573,67,2,69,1.331167,103.811441
288574,2,1,3,1.330054,103.810493
288575,21,2,23,1.330009,103.810502
288576,1,26,27,1.33001,103.810593
288595,20,6,26,1.335733,103.802809
288596,0,7,7,1.335495,103.802576
288597,0,3,3,1.33032,103.811239
288598,16,2,18,1.335043,103.80238
288599,24,0,24,1.3349,103.802687
288600,1,0,1,1.325716,103.810534
288601,2,5,7,1.334622,103.802589
288602,1,4,5,1.334683,103.80247
288603,15,1,16,1.334472,103.802697
288604,1,8,9,1.334487,103.80247
288605,67,0,67,1.334323,103.802776
288606,2,0,2,1.331157,103.811451
288608,17,2,19,1.332636,103.802735
288609,8,0,8,1.333816,103.802684
288610,3,5,8,1.332393,103.802623
288611,98,1,99,1.332808,103.80269
288612,22,5,27,1.332127,103.802645
288613,5,8,13,1.332553,103.802554
288614,59,10,69,1.331743,103.80267
288615,5,9,14,1.332302,103.802539
288616,2,0,2,1.334324,103.802553
288618,105,9,114,1.331984,103.803209
288619,118,15,133,1.331738,103.802285
288620,1,1,2,1.331766,103.803134
288621,4,5,9,1.331442,103.803178
288622,17,0,17,1.332397,103.803216
288623,48,1,49,1.331769,103.803322
288624,26,1,27,1.332885,103.803908
288625,67,44,111,1.331998,103.803362
288626,5,4,9,1.33229,103.803504
288627,18,5,23,1.333001,103.80424
288628,11,0,11,1.332598,103.803579
288629,0,1,1,1.33489,103.80255
288630,21,4,25,1.332798,103.803936
288631,29,2,31,1.333683,103.804473
288632,1,2,3,1.335368,103.802748
288633,1,0,1,1.333487,103.804447
288634,1,9,10,1.33302,103.804564
288635,2,1,3,1.332915,103.80425
288636,47,15,62,1.334803,103.804488
288637,4,7,11,1.333282,103.804573
288638,27,2,29,1.335114,103.804466
288639,60,4,64,1.333577,103.80453
288640,23,0,23,1.335431,103.804479
288641,6,2,8,1.334115,103.804517
288642,16,22,38,1.335661,103.804487
288643,44,3,47,1.334511,103.804642
288644,172,4,176,1.33585,103.804517
288645,33,19,52,1.334824,103.804509
288646,1,0,1,1.334111,103.804428
288647,129,5,134,1.335108,103.804539
288649,18,5,23,1.335337,103.804523
288650,60,1,61,1.336607,103.804371
288651,61,5,66,1.335679,103.804532
288652,18,2,20,1.336887,103.804314
288653,4,0,4,1.33585,103.804537
288654,17,2,19,1.337167,103.804258
288655,79,1,80,1.336203,103.804473
288656,9,1,10,1.337382,103.804199
288657,5,0,5,1.336514,103.80441
288658,10,5,15,1.336825,103.804347
288660,88,11,99,1.337411,103.804259
288661,3,2,5,1.299509,103.837
288682,9,846,855,1.330195,103.80079
288683,850,3,853,1.330651,103.802221
288684,2,17,19,1.330428,103.801
288685,11,2,13,1.331042,103.802822
288686,23,3,26,1.331131,103.802663
288687,2,1,3,1.333093,103.804825
288688,14,198,212,1.331122,103.801376
288689,4,1,5,1.331211,103.802452
288690,2,5,7,1.331338,103.802124
288691,0,23,23,1.331528,103.801833
288692,1,5,6,1.331732,103.801883
288693,45,6,51,1.332269,103.801891
288694,22,20,42,1.332451,103.801936
288695,1,19,20,1.331637,103.801657
288696,1,0,1,1.336047,103.804484
288697,36,12,48,1.333084,103.802349
288698,61,7,68,1.332221,103.801653
288699,6,1,7,1.33379,103.802175
288700,3,0,3,1.331097,103.802708
288701,8,2,10,1.333962,103.80194
288702,85,5,90,1.332342,103.801311
288703,2,0,2,1.332138,103.803177
288704,3,4,7,1.332468,103.801125
288705,3,5,8,1.334615,103.801817
288706,1,0,1,1.332811,103.802058
288707,36,0,36,1.334822,103.801855
288708,18,2,20,1.33256,103.801151
288709,18,9,27,1.335132,103.801977
288710,5,0,5,1.332389,103.801354
288711,21,7,28,1.335425,103.80212
288712,310,9,319,1.332286,103.801614
288713,10,2,12,1.335712,103.80229
288714,5,4,9,1.332475,103.801833
288715,0,1,1,1.332507,103.801102
288716,291,16,307,1.336791,103.802005
288717,93,2,95,1.336791,103.801968
288718,7,43,50,1.337295,103.800903
288719,74,4,78,1.336564,103.80154
288721,20,0,20,1.336608,103.801602
288722,28,6,34,1.33717,103.800984
288723,100,13,113,1.336383,103.801021
288724,1,0,1,1.333421,103.802164
288725,75,0,75,1.336417,103.801102
288726,1,0,1,1.337154,103.800971
288727,12,7,19,1.336424,103.800604
288728,203,0,203,1.337163,103.801008
288729,38,0,38,1.336594,103.80051
288730,14,0,14,1.337291,103.800893
288731,3,0,3,1.332268,103.801457
288732,14,0,14,1.332581,103.80187
288733,16,2,18,1.332644,103.801896
288734,12,0,12,1.333026,103.801936
288735,488,0,488,1.33167,103.800657
288736,7,0,7,1.334261,103.801706
288737,10,2,12,1.331043,103.801325
288753,5,11,16,1.335321,103.789778
288754,0,12,12,1.335561,103.789689
288755,19,0,19,1.3353,103.789477
288757,1,1,2,1.334144,103.801881
288758,50,0,50,1.335988,103.789662
288759,20,3,23,1.335713,103.789467
288760,0,4,4,1.336198,103.789686
288761,22,3,25,1.335937,103.789444
288762,46,5,51,1.33619,103.789473
288763,45,3,48,1.33643,103.789419
288764,14,1,15,1.336478,103.78963
288786,71,13,84,1.33303,103.801871
288787,22,2,24,1.333039,103.802029
288788,17,0,17,1.333049,103.801778
288789,3,5,8,1.333048,103.801969
288790,2,0,2,1.335533,103.789446
288792,1,0,1,1.337146,103.80095
288793,4,0,4,1.333083,103.801732
288794,4,8,12,1.333117,103.801488
288796,5,0,5,1.333139,103.801343
288797,1,0,1,1.333084,103.801576
288798,31,0,31,1.333161,103.801198
288799,13,0,13,1.333137,103.801376
288800,2,1,3,1.299509,103.837
288802,2,0,2,1.333069,103.801637
288803,87,1,88,1.333173,103.801139
288805,10,5,15,1.33319,103.80102
288806,1,0,1,1.333119,103.801495
288807,6,0,6,1.333236,103.800773
288829,6,5,11,1.331476,103.798944
288830,15,0,15,1.331475,103.798943
288831,8,9,17,1.33142,103.799023
288832,145,2,147,1.331454,103.798915
288833,1,5,6,1.331483,103.798851
288834,1,7,8,1.331434,103.799133
288836,7,0,7,1.331388,103.799205
288837,0,1,1,1.333208,103.800902
288838,15,3,18,1.33133,103.799379
288839,12,3,15,1.33133,103.799359
288840,13,1,14,1.331321,103.799471
288841,3,1,4,1.331271,103.799533
288842,3,25,28,1.331303,103.799557
288843,34,5,39,1.331235,103.799581
288844,0,1,1,1.331349,103.799239
288845,2,28,30,1.331213,103.799727
288846,4,0,4,1.331154,103.7999
288848,14,0,14,1.331144,103.799968
288849,1,1,2,1.333204,103.800908
288850,111,2,113,1.33111,103.800099
288851,5,1,6,1.331137,103.800017
288852,1,0,1,1.331171,103.799814
288853,4,1,5,1.331106,103.800133
288854,2,0,2,1.331167,103.799901
288856,14,2,16,1.331003,103.800466
288857,2,1,3,1.333182,103.801053
288858,9,0,9,1.330982,103.800508
288859,0,1,1,1.331076,103.80023
288860,1,2,3,1.33106,103.800331
288861,5,6,11,1.33103,103.800523
288863,62,7,69,1.331011,103.800597
288864,2,0,2,1.331042,103.80036
288865,2,3,5,1.330981,103.800701
288866,3,15,18,1.330847,103.80092
288867,2,3,5,1.330964,103.800771
288868,5,54,59,1.330755,103.801065
288869,138,6,144,1.330921,103.800875
288870,2,0,2,1.330887,103.800848
288871,19,95,114,1.330863,103.801069
288893,1135,328,1463,1.328072,103.805853
288894,17,3277,3294,1.3278,103.806046
288895,4,56,60,1.327858,103.806084
288896,8,143,151,1.32792,103.806136
288898,10,154,164,1.328037,103.80618
288899,174,0,174,1.328155,103.806258
288900,2,37,39,1.328272,103.806335
288902,7,81,88,1.328436,103.806452
288904,11,39,50,1.328573,103.806568
288905,0,37,37,1.328664,103.806646
288906,4,12,16,1.328756,103.806723
288907,0,58,58,1.328837,103.806791
288908,10,25,35,1.328897,103.806839
288909,3,42,45,1.328946,103.806878
288910,0,2,2,1.330898,103.800946
288912,1,22,23,1.329145,103.807031
288913,500,46,546,1.329973,103.804488
288914,11,31,42,1.329245,103.807107
288915,7,134,141,1.329334,103.807174
288916,325,52,377,1.331975,103.804629
288917,3,0,3,1.33095,103.800657
288918,69,41,110,1.329445,103.807266
288919,19,24,43,1.329546,103.807347
288920,0,12,12,1.329597,103.807388
288921,24,6,30,1.329694,103.807457
288922,1,53,54,1.329747,103.807347
288923,8,54,62,1.329675,103.807562
288924,3,1,4,1.329838,103.807374
288925,15,80,95,1.329952,103.807464
288926,7,34,41,1.329936,103.807371
288927,5,2,7,1.329913,103.807473
288928,8,4,12,1.330023,103.807361
288930,6,3,9,1.330128,103.807347
288931,62,0,62,1.32997,103.807491
288932,1,1,2,1.329046,103.806954
288933,3,39,42,1.330136,103.807461
288934,2,27,29,1.33033,103.807317
288935,0,11,11,1.330227,103.807445
288936,100,5,105,1.33039,103.807315
288937,2,16,18,1.330296,103.807434
288938,1,14,15,1.330531,103.807288
288939,100,74,174,1.330398,103.80741
288940,67,2,69,1.33059,103.807252
288941,31,0,31,1.330583,103.807414
288942,6,0,6,1.33135,103.807536
288943,3,5,8,1.331365,103.807541
288944,7,70,77,1.330659,103.807436
288945,31,0,31,1.331422,103.807554
288946,2,0,2,1.330213,103.807352
288947,1,97,98,1.330813,103.807454
288948,23,0,23,1.331527,103.807612
288949,40,16,56,1.331472,103.807608
288950,11,73,84,1.330927,103.807488
288951,251,0,251,1.331587,103.807631
288952,4,87,91,1.331606,103.807642
288953,2,19,21,1.33105,103.807574
288954,6,18,24,1.331769,103.807551
288955,3,69,72,1.331157,103.80763
288956,131,1,132,1.331944,103.807837
288957,0,13,13,1.331266,103.807692
288958,3,66,69,1.332173,103.807861
288959,7,20,27,1.331372,103.807744
288960,213,38,251,1.332459,103.808051
288961,31,64,95,1.331609,103.807807
288962,6,1,7,1.332642,103.808088
288963,13,23,36,1.331915,103.807898
288964,16,3,19,1.332783,103.808119
288965,3,0,3,1.329395,103.807225
288966,29,1,30,1.333056,103.80812
288967,36,0,36,1.333149,103.808149
288968,2,0,2,1.331451,103.807569
288969,0,1,1,1.33105,103.800408
288971,3,0,3,1.332931,103.80814
288972,10,0,10,1.332402,103.808124
288973,5,1,6,1.333599,103.807828
288974,64,1,65,1.332488,103.808141
288975,129,5,134,1.333567,103.808167
288976,95,1,96,1.332644,103.808175
288977,12,3,15,1.333731,103.808145
288978,28,1,29,1.332745,103.808206
288979,13,2,15,1.333931,103.808118
288980,34,6,40,1.332836,103.808228
288981,10,3,13,1.334003,103.808104
288982,68,3,71,1.333059,103.808334
288983,50,1,51,1.334132,103.80807
288984,106,2,108,1.332557,103.808539
288985,3,8,11,1.334221,103.80792
288986,3,1,4,1.33304,103.808525
288987,4,2,6,1.333033,103.808635
288988,1,0,1,1.333411,103.808153
288989,104,1,105,1.33288,103.808238
288990,2,0,2,1.333306,103.808143
288991,5,1,6,1.332912,103.809089
288992,11,0,11,1.334192,103.807551
288993,25,1,26,1.333121,103.808886
288995,5,1,6,1.333134,103.808705
288996,15,6,21,1.333187,103.808609
288997,3,0,3,1.333567,103.807796
288998,27,6,33,1.333415,103.808593
288999,3,2,5,1.334271,103.807853
289000,0,6,6,1.333095,103.808347
289001,17,1,18,1.3343,103.807919
289002,45,1,46,1.333135,103.808256
289003,3,0,3,1.334249,103.807817
289004,7,10,17,1.333184,103.808258
289005,9,0,9,1.334814,103.807705
289007,62,0,62,1.334769,103.807586
289008,8,2,10,1.333383,103.808264
289009,9,0,9,1.334741,103.807511
289010,2,2,4,1.333472,103.808258
289011,107,1,108,1.334718,103.807437
289012,13,0,13,1.333544,103.808271
289013,2,0,2,1.334156,103.807582
289014,6,3,9,1.333668,103.808251
289015,49,3,52,1.334791,103.807546
289016,1,1,2,1.334763,103.807422
289017,0,3,3,1.334852,103.807831
289018,8,7,15,1.333788,103.808231
289019,0,3,3,1.334871,103.807699
289020,4,5,9,1.333889,103.808206
289021,10,2,12,1.335316,103.80772
289022,0,4,4,1.333991,103.80818
289023,9,1,10,1.335283,103.807568
289024,3,6,9,1.334093,103.808154
289025,4,1,5,1.335245,103.807386
289026,65,3,68,1.334194,103.808129
289027,74,0,74,1.335206,103.807219
289028,22,6,28,1.334296,103.808103
289029,68,1,69,1.335283,103.807199
289030,3,0,3,1.334879,103.807793
289031,40,3,43,1.335299,103.807383
289032,93,7,100,1.334414,103.80806
289033,27,0,27,1.335342,103.807537
289034,0,2,2,1.333723,103.808296
289035,39,4,43,1.335375,103.807703
289036,0,11,11,1.33465,103.807973
289037,1,0,1,1.334176,103.807722
289038,12,0,12,1.335952,103.807277
289039,13,3,16,1.335825,103.807072
289040,9,0,9,1.335799,103.807014
289042,71,3,74,1.334768,103.80793
289043,4,1,5,1.335878,103.807681
289044,24,1,25,1.335942,103.807554
289045,13,3,16,1.336114,103.807503
289046,4,3,7,1.334886,103.807887
289047,1,0,1,1.335842,103.807623
289048,0,8,8,1.334947,103.807878
289049,5,1,6,1.336053,103.807911
289050,2,2,4,1.335008,103.807869
289051,9,4,13,1.336149,103.807999
289052,2,5,7,1.335058,103.807876
289053,17,0,17,1.336289,103.80802
289054,7,1,8,1.336328,103.807811
289055,8,3,11,1.336294,103.807616
289056,44,1,45,1.336238,103.807521
289057,13,0,13,1.336164,103.807403
289058,1,0,1,1.335918,103.807821
289059,13,2,15,1.335918,103.807089
289061,309,4,313,1.335103,103.807858
289062,122,0,122,1.336439,103.808207
289063,40,1,41,1.335183,103.807847
289064,102,37,139,1.336487,103.808278
289065,8,1,9,1.335283,103.807842
289066,25,6,31,1.336643,103.808347
289067,1,4,5,1.33547,103.807827
289068,67,149,216,1.336939,103.808252
289069,2,0,2,1.334532,103.808017
289070,1,2,3,1.334355,103.808081
289071,95,5,100,1.335691,103.807847
289072,409,35,444,1.330302,103.806788
289073,6,10,16,1.33634,103.808143
289075,10,63,73,1.328147,103.805591
289076,7,8,15,1.328133,103.805645
289077,68,13,81,1.328162,103.80555
289078,40,10,50,1.328198,103.805506
289079,2,14,16,1.32822,103.805456
289080,5,13,18,1.328253,103.805387
289081,1,3,4,1.328259,103.805368
289082,0,18,18,1.328281,103.805328
289083,3,6,9,1.328318,103.805287
289084,8,5,13,1.328375,103.805209
289085,5,18,23,1.328401,103.805187
289086,12,1,13,1.328426,103.805144
289087,15,8,23,1.328437,103.805111
289088,26,11,37,1.328491,103.805028
289089,5,6,11,1.328519,103.804985
289090,17,11,28,1.32854,103.80494
289091,33,3,36,1.328555,103.804923
289092,39,10,49,1.328606,103.804851
289093,1,0,1,1.336029,103.80726
289094,5,2,7,1.333696,103.805381
289095,22,0,22,1.333729,103.805353
289096,28,6,34,1.3337,103.805435
289097,3,1,4,1.333728,103.805403
289098,21,2,23,1.333711,103.805488
289099,4,0,4,1.333751,103.805566
289100,55,2,57,1.333731,103.805566
289101,34,0,34,1.333796,103.805737
289102,28,7,35,1.333776,103.805737
289103,7,7,14,1.333808,103.805813
289104,40,2,42,1.333798,103.805823
289126,2,0,2,1.335565,103.807838
289127,3,0,3,1.335614,103.80785
289129,1,0,1,1.333742,103.80526
289130,6,3,9,1.333086,103.805709
289131,87,2,89,1.33309,103.805821
289132,11,0,11,1.333093,103.805774
289133,5,1,6,1.333104,103.805908
289134,6,0,6,1.333145,103.805914
289135,3,0,3,1.332984,103.805594
289157,6,0,6,1.334514,103.805434
289158,1,0,1,1.333015,103.80566
289159,1,0,1,1.33446,103.805458
289160,21,0,21,1.334451,103.805465
289163,10,0,10,1.334478,103.805824
289164,1,0,1,1.334507,103.80552
289165,10,3,13,1.334462,103.805697
289166,6,0,6,1.334458,103.805824
289188,4,5,9,1.330787,103.807146
289189,220,57,277,1.331191,103.807444
289190,74,21,95,1.33118,103.807412
289191,22,5,27,1.330806,103.80711
289192,11,1,12,1.331172,103.807336
289193,5,1,6,1.331168,103.807306
289194,15,10,25,1.330856,103.807076
289195,397,5,402,1.331151,103.807242
289196,6,46,52,1.331159,103.80727
289197,33,11,44,1.330907,103.807029
289198,29,0,29,1.331136,103.80719
289199,81,0,81,1.331131,103.80714
289200,128,94,222,1.33094,103.807008
289201,392,0,392,1.331116,103.807081
289202,153,110,263,1.331115,103.80708
289203,17,6,23,1.330974,103.806984
289204,351,69,420,1.331224,103.807015
289205,122,127,249,1.331223,103.807014
289206,2,0,2,1.333061,103.805575
289207,19,21,40,1.331254,103.806983
289208,3,10,13,1.331049,103.806897
289209,238,0,238,1.331318,103.80692
289210,13,19,32,1.331317,103.806919
289211,2,6,8,1.331121,103.806831
289212,250,37,287,1.33138,103.806857
289213,5,0,5,1.331379,103.806856
289214,21,4,25,1.331228,103.80673
289215,55,0,55,1.331442,103.806794
289216,11,5,16,1.331441,103.806793
289217,21,47,68,1.331204,103.806531
289218,92,14,106,1.331505,103.80673
289219,37,0,37,1.331504,103.806729
289220,32,21,53,1.331285,103.806421
289221,37,1,38,1.33149,103.806701
289222,31,21,52,1.331489,103.8067
289223,77,10,87,1.331366,103.806407
289224,10,8,18,1.331552,103.806638
289226,4,35,39,1.331441,103.806301
289227,52,30,82,1.331614,103.806575
289228,1,0,1,1.334466,103.80557
289229,30,10,40,1.331501,103.80626
289230,15,0,15,1.331677,103.806511
289231,2,0,2,1.331255,103.806984
289232,1,54,55,1.331556,103.806169
289233,3,1,4,1.331739,103.806448
289235,9,12,21,1.331648,103.80616
289236,188,5,193,1.331801,103.806385
289237,9,15,24,1.3318,103.806384
289238,37,8,45,1.331634,103.806082
289239,52,2,54,1.331864,103.806321
289240,8,23,31,1.331863,103.80632
289241,1,9,10,1.331758,103.806017
289242,87,36,123,1.331916,103.806268
289243,7,7,14,1.331915,103.806267
289244,3,3,6,1.331851,103.805946
289245,5,30,35,1.331921,103.806126
289246,0,5,5,1.331899,103.805894
289247,45,20,65,1.331989,103.806067
289248,70,1,71,1.332001,103.80594
289249,3,4,7,1.332125,103.805949
289250,89,14,103,1.332101,103.80585
289251,34,32,66,1.332261,103.805831
289252,15,0,15,1.332202,103.805781
289253,4,9,13,1.332343,103.805757
289254,3,0,3,1.333187,103.806044
289255,8,0,8,1.332425,103.805684
289256,5,0,5,1.332392,103.805611
289257,0,8,8,1.33259,103.805536
289258,3,10,13,1.332495,103.8055
289259,6,8,14,1.332752,103.805419
289260,153,10,163,1.332609,103.805405
289261,4,7,11,1.332932,103.805497
289262,7,8,15,1.332664,103.805371
289263,12,9,21,1.333009,103.805339
289264,26,1,27,1.332796,103.805286
289265,1,2,3,1.332302,103.805701
289266,21,5,26,1.33289,103.805271
289267,60,1,61,1.332984,103.805241
289268,3,8,11,1.333258,103.80526
289269,4,12,16,1.333288,103.805133
289270,0,3,3,1.333092,103.805313
289271,18,0,18,1.333394,103.805082
289272,5,1,6,1.333519,103.805185
289273,187,4,191,1.333502,103.805067
289274,6,11,17,1.333735,103.805166
289275,21,1,22,1.333672,103.805051
289276,0,13,13,1.333819,103.805178
289278,17,1,18,1.333894,103.805181
289279,9,2,11,1.333847,103.805037
289280,0,4,4,1.334043,103.805185
289281,37,2,39,1.333968,103.805048
289282,3,2,5,1.334191,103.80519
289283,3,0,3,1.333354,103.80523
289284,1,0,1,1.331613,103.806574
289285,0,1,1,1.33434,103.805194
289286,25,6,31,1.334463,103.805331
289287,66,6,72,1.334269,103.80508
289288,46,22,68,1.334402,103.805074
289289,5,9,14,1.334497,103.805074
289290,77,7,84,1.334512,103.805295
289291,6,9,15,1.334617,103.805202
289292,29,3,32,1.33467,103.805214
289293,6,10,16,1.334682,103.805114
289294,4,5,9,1.334713,103.805216
289295,16,9,25,1.33472,103.805116
289296,14,1,15,1.3348,103.805221
289297,62,5,67,1.334795,103.80512
289298,88,4,92,1.334886,103.805225
289299,48,3,51,1.334871,103.805124
289300,2,6,8,1.334973,103.80523
289301,0,11,11,1.334946,103.805128
289302,8,11,19,1.335059,103.805234
289303,35,10,45,1.335022,103.805131
289304,0,4,4,1.335118,103.805238
289305,186,3,189,1.335098,103.805135
289306,17,11,28,1.335201,103.80533
289307,25,2,27,1.335173,103.805139
289309,29,2,31,1.335229,103.805172
289311,0,11,11,1.333094,103.80738
289312,2,0,2,1.331676,103.80651
289313,4,0,4,1.333031,103.807245
289314,1,0,1,1.334188,103.805067
289315,43,3,46,1.332969,103.807084
289316,32,0,32,1.333139,103.806544
289317,5,3,8,1.332917,103.806896
289318,4,2,6,1.33333,103.806405
289319,0,1,1,1.333052,103.806987
289320,27,5,32,1.333584,103.806327
289321,106,4,110,1.332969,103.806572
289322,11,1,12,1.333775,103.806257
289323,5,2,7,1.334014,103.806205
289324,11,14,25,1.333023,103.806501
289325,4,3,7,1.334224,103.806215
289326,59,0,59,1.333189,103.806333
289327,3,1,4,1.334419,103.806232
289328,1,0,1,1.332917,103.806734
289329,44,6,50,1.334621,103.806249
289330,12,4,16,1.333584,103.806182
289331,21,0,21,1.334813,103.80644
289332,1,1,2,1.333135,103.807157
289334,105,7,112,1.334155,103.80611
289335,1,1,2,1.333804,103.806116
289336,1,4,5,1.33456,103.80614
289337,342,6,348,1.33469,103.80615
289338,11,9,20,1.334849,103.806251
289339,5,13,18,1.334954,103.806453
289340,0,1,1,1.333367,103.806263
289341,6,5,11,1.333211,103.806546
289342,29,4,33,1.299509,103.837
289343,6,1,7,1.299509,103.837
289344,0,1,1,1.334907,103.806352
289361,41,0,41,1.336868,103.807858
289362,11,2,13,1.336672,103.80764
289363,2,0,2,1.334347,103.806138
289364,26,5,31,1.33661,103.807299
289365,17,7,24,1.336693,103.807154
289366,82,0,82,1.336645,103.806998
289367,63,3,66,1.336521,103.806821
289368,16,6,22,1.336407,103.806633
289369,0,5,5,1.336361,103.806549
289370,63,2,65,1.336223,103.806365
289372,0,30,30,1.336844,103.807043
289394,41,6,47,1.332327,103.80776
289395,18,10,28,1.332848,103.807686
289396,3,1,4,1.332438,103.80777
289397,36,20,56,1.33292,103.807637
289398,42,2,44,1.332616,103.807671
289399,24,0,24,1.33309,103.807772
289400,5,1,6,1.332815,103.807605
289401,1,2,3,1.334061,103.805072
289402,14,5,19,1.333194,103.807336
289403,25,2,27,1.333278,103.807482
289405,0,6,6,1.333341,103.807455
289407,25,0,25,1.333783,103.807112
289408,12,2,14,1.33359,103.807348
289409,11,1,12,1.333672,103.806882
289410,2,2,4,1.333715,103.807294
289411,25,3,28,1.333635,103.806751
289412,13,1,14,1.333767,103.807289
289413,8,1,9,1.333678,103.806657
289414,1,4,5,1.333898,103.80722
289415,0,5,5,1.33378,103.806867
289416,1,0,1,1.299509,103.837
289417,21,2,23,1.33382,103.807058
289418,6,3,9,1.334073,103.807159
289419,4,2,6,1.334236,103.807007
289420,2,1,3,1.333166,103.807707
289421,1,0,1,1.333957,103.807199
289422,6,6,12,1.334306,103.807078
289423,0,1,1,1.33429,103.806959
289424,15,2,17,1.334423,103.807037
289425,289,0,289,1.334233,103.806467
289426,0,3,3,1.33419,103.807118
289427,82,0,82,1.334318,103.806623
289429,8,3,11,1.334415,103.80687
289430,27,4,31,1.334656,103.806943
289431,10,1,11,1.334714,103.8069
289433,2,0,2,1.336594,103.807459
289434,8,9,17,1.334889,103.80685
289435,0,1,1,1.33428,103.806667
289436,0,5,5,1.335006,103.806803
289437,82,0,82,1.335331,103.806676
289438,2,3,5,1.33514,103.806778
289439,1,0,1,1.335169,103.806729
289440,1,0,1,1.335416,103.80665
289441,46,2,48,1.335761,103.806454
289442,1,4,5,1.33539,103.806726
289445,11,3,14,1.335608,103.806682
289446,2,0,2,1.334898,103.806713
289447,190,9,199,1.33578,103.806541
289448,9,0,9,1.335857,103.806516
289449,4,0,4,1.333605,103.806685
289450,16,14,30,1.333586,103.806601
289470,92,10,102,1.331988,103.806976
289471,34,2,36,1.332105,103.806983
289472,4,0,4,1.332341,103.806999
289495,88,17,105,1.331755,103.807325
289496,29,1,30,1.331758,103.807296
289497,3,0,3,1.334481,103.807014
289498,47,0,47,1.331775,103.807233
289499,8,0,8,1.331779,103.807221
289500,15,22,37,1.331787,103.807373
289501,246,0,246,1.33179,103.807164
289502,15,28,43,1.331811,103.807105
289503,18,5,23,1.331959,103.807132
289504,3,5,8,1.331816,103.807074
289505,8,0,8,1.331821,103.807035
289506,8,4,12,1.331932,103.806818
289507,38,0,38,1.332,103.80664
289508,61,1,62,1.332065,103.806444
289509,6,0,6,1.332363,103.806172
289510,3,0,3,1.331774,103.807479
289512,1,1,2,1.335682,103.806634
289513,1,0,1,1.335255,103.806756
289514,1,0,1,1.299509,103.837
289533,63,74,137,1.333802,103.79873
289534,6,0,6,1.333802,103.79873
289535,14,0,14,1.333802,103.79873
289536,8,0,8,1.333802,103.79873
289537,67,0,67,1.333802,103.79873
289538,16,0,16,1.333802,103.79873
289539,72,0,72,1.333802,103.79873
289540,54,0,54,1.334222,103.798854
289541,36,0,36,1.334222,103.798854
289542,64,0,64,1.334222,103.798854
289543,145,0,145,1.334222,103.798854
289544,6,0,6,1.334222,103.798854
289545,43,0,43,1.334222,103.798854
289546,30,110,140,1.334222,103.798854
289547,1,0,1,1.299509,103.837
289548,28,1,29,1.334884,103.799202
289549,4,1,5,1.334864,103.799437
289550,45,0,45,1.33486,103.799747
289551,33,1,34,1.33486,103.800054
289552,54,0,54,1.334863,103.800273
289553,17,13,30,1.334952,103.800378
289554,28,5,33,1.335131,103.800491
289555,52,3,55,1.335328,103.800621
289556,23,0,23,1.335519,103.800688
289557,54,3,57,1.335743,103.801073
289558,1,0,1,1.334899,103.798927
289559,125,14,139,1.335821,103.801038
289560,17,8,25,1.33575,103.800793
289561,159,25,184,1.335807,103.800393
289562,11,2,13,1.335606,103.800523
289563,101,7,108,1.335873,103.800117
289564,1,1,2,1.299509,103.837
289565,5,2,7,1.336144,103.799707
289566,45,6,51,1.335763,103.799976
289567,113,0,113,1.335553,103.79991
289568,0,3,3,1.332262,103.806238
289569,2,3,5,1.335202,103.799753
289570,3,5,8,1.334956,103.799228
289571,1,0,1,1.335848,103.801282
289572,50,32,82,1.334972,103.798842
289573,7,14,21,1.335559,103.798739
289574,13,0,13,1.335591,103.798718
289575,41,2,43,1.335831,103.798795
289576,39,3,42,1.33608,103.798869
289577,1,17,18,1.336375,103.799481
289578,10,8,18,1.33489,103.798741
289579,8,4,12,1.335126,103.800079
289599,79,6,85,1.324529,103.8118
289600,6,0,6,1.324563,103.81183
289601,112,130,242,1.324535,103.811793
289604,3,128,131,1.324146,103.811471
289605,0,10,10,1.324145,103.81147
289606,10,8,18,1.324212,103.811202
289607,11,119,130,1.32434,103.810783
289608,229,130,359,1.324339,103.810782
289609,170,234,404,1.324514,103.81043
289610,10,144,154,1.324513,103.810429
289611,3,170,173,1.324623,103.81024
289613,39,394,433,1.325115,103.809643
289615,5,145,150,1.325403,103.809301
289616,7,16,23,1.325517,103.809154
289617,2,372,374,1.325632,103.809184
289618,6,1155,1161,1.326951,103.806912
289619,2,178,180,1.330261,103.800602
289620,1,221,222,1.330346,103.800364
289622,0,68,68,1.330402,103.800063
289623,2,368,370,1.330443,103.799958
289624,3,1,4,1.330476,103.799849
289625,0,56,56,1.330517,103.799726
289626,3,153,156,1.33055,103.799604
289627,8,259,267,1.330675,103.799342
289628,0,80,80,1.330719,103.79929
289629,17,174,191,1.33079,103.799036
289630,10,509,519,1.330924,103.798641
289632,14,46,60,1.332262,103.794702
289633,2,118,120,1.3324,103.794409
289670,18,57,75,1.333572,103.790876
289671,1,107,108,1.333631,103.790646
289672,1,1,2,1.335669,103.800057
289673,6,225,231,1.334075,103.789332
289674,168,148,316,1.324797,103.80996
289675,1,117,118,1.324145,103.81147
289676,2,1,3,1.335381,103.799821
289677,61,3157,3218,1.333331,103.791495
289695,18,14,32,1.333769,103.802979
289696,41,9,50,1.333736,103.803019
289697,5,0,5,1.333793,103.803094
289698,21,30,51,1.333589,103.803375
289699,7,8,15,1.333657,103.803412
289700,32,3,35,1.333474,103.803594
289701,8,14,22,1.333592,103.803865
289702,4,1,5,1.333405,103.803806
289704,6,4,10,1.33346,103.803898
289706,46,2,48,1.333613,103.803958
289707,20,0,20,1.333913,103.803965
289708,13,0,13,1.334737,103.803721
289709,49,0,49,1.334164,103.803968
289710,17,2,19,1.335324,103.803597
289711,13,1,14,1.3345,103.803968
289712,9,0,9,1.335543,103.803595
289713,29,3,32,1.334794,103.803953
289714,4,0,4,1.335802,103.803463
289715,5,2,7,1.335089,103.803958
289716,56,1,57,1.336096,103.803432
289717,0,1,1,1.334964,103.799115
289718,66,9,75,1.336355,103.803365
289719,44,7,51,1.335545,103.803871
289720,2,2,4,1.336648,103.80333
289721,42,1,43,1.335785,103.803818
289722,11,0,11,1.336889,103.803233
289723,26,5,31,1.335952,103.803771
289724,0,3,3,1.333657,103.794031
289725,4,0,4,1.336217,103.803721
289726,3,9,12,1.336481,103.803671
289727,28,7,35,1.336745,103.803621
289728,1,0,1,1.335272,103.803916
289729,25,14,39,1.337273,103.803521
289730,6,2,8,1.334463,103.803766
289751,18,0,18,1.342721,103.789095
289752,38,0,38,1.342818,103.789107
289753,27,0,27,1.343607,103.788981
289754,34,261,295,1.343012,103.789759
289755,67,33,100,1.344498,103.789155
289756,14,49,63,1.343142,103.789209
289757,1458,392,1850,1.34573,103.78992
289758,726,90,816,1.34603,103.790561
289759,724,330,1054,1.34598,103.790439
289760,3545,834,4379,1.346096,103.791641
289761,6976,665,7641,1.345831,103.792638
289762,2,0,2,1.333772,103.790244
289763,38,171,209,1.345537,103.790554
289783,2,1,3,1.337163,103.80322
289784,285,5,290,1.333343,103.802723
289785,4,5,9,1.333259,103.802623
289786,129,4,133,1.333246,103.80299
289787,98,3,101,1.333049,103.802915
289788,2,2,4,1.332907,103.803311
289789,22,2,24,1.332907,103.803291
289790,43,3,46,1.332758,103.803499
289791,50,10,60,1.332623,103.803443
289813,2,42,44,1.334113,103.790013
289814,27,170,197,1.333949,103.790013
289815,1,2,3,1.333481,103.802311
289816,21,0,21,1.334113,103.790033
289817,4,1,5,1.334562,103.789781
289818,0,1,1,1.337009,103.803571
289819,0,1,1,1.334461,103.789857
289820,3,5,8,1.334763,103.789689
289821,4,5,9,1.334936,103.789659
289843,4507,801,5308,1.33336,103.811299
289844,3881,1126,5007,1.333923,103.810271
289845,341,17,358,1.333398,103.809528
289846,64,40,104,1.334441,103.809819
289847,634,82,716,1.334859,103.809825
289848,142,435,577,1.334859,103.809825
289849,1154,33,1187,1.33411,103.809412
289850,3513,99,3612,1.333794,103.808799
289851,2057,152,2209,1.334366,103.808671
289852,891,39,930,1.335024,103.808383
289853,1242,50,1292,1.335792,103.808396
289854,958,126,1084,1.335644,103.809026
289876,474,2587,3061,1.324088,103.814086
289877,19,405,424,1.32497,103.813354
289878,0,3,3,1.334159,103.790005
289879,13,12,25,1.324996,103.813183
289880,100,13,113,1.325063,103.812929
289881,19,32,51,1.325013,103.812885
289882,103,0,103,1.325072,103.812825
289883,31,24,55,1.325066,103.812771
289884,50,1,51,1.325074,103.812733
289885,213,843,1056,1.325006,103.813335
289886,723,706,1429,1.325709,103.812871
289889,500,9,509,1.326157,103.813616
289890,50,161,211,1.326393,103.813637
289891,359,14,373,1.326793,103.813451
289892,11,310,321,1.326852,103.813691
289893,2,7,9,1.327526,103.813169
289894,193,433,626,1.327415,103.813763
289895,589,14,603,1.327832,103.813715
289896,74,361,435,1.328166,103.813678
289897,13,20,33,1.327299,103.814053
289898,5,1,6,1.327254,103.814633
289899,6716,3546,10262,1.330625,103.815523
289900,260,85,345,1.327832,103.813715
289901,672,179,851,1.328108,103.812559
289902,222,3,225,1.328308,103.812863
289903,11,3,14,1.328052,103.812951
289921,35,4,39,1.329657,103.812921
289922,67,13,80,1.330217,103.812609
289923,9,7,16,1.330662,103.812515
289924,9,30,39,1.331024,103.812374
289925,30,96,126,1.331349,103.812167
289926,6,34,40,1.329469,103.813889
289927,4,419,423,1.330006,103.814002
289928,99,10,109,1.330355,103.813666
289929,18,15,33,1.330941,103.81348
289930,2,1,3,1.324979,103.813272
289931,50,5,55,1.33167,103.812944
289932,12,241,253,1.331859,103.812882
289933,21,8,29,1.331922,103.812395
289934,10,11,21,1.332266,103.811516
289935,48,7,55,1.331836,103.811457
289936,69,43,112,1.330629,103.814113
289937,0,67,67,1.331288,103.814216
289938,3,148,151,1.331363,103.814188
289939,2,73,75,1.331615,103.813464
289961,126,291,417,1.335169,103.816516
289962,1,22,23,1.335436,103.816141
289963,70,9,79,1.335698,103.815607
289964,38,1,39,1.336587,103.815782
289965,88,14,102,1.33668,103.816021
289966,49,4,53,1.336642,103.815807
289967,38,7,45,1.337178,103.815585
289968,121,0,121,1.336985,103.815161
289969,4,8,12,1.33632,103.814886
289970,56,0,56,1.336297,103.8145
289971,43,0,43,1.336196,103.814267
289972,197,13,210,1.336058,103.814087
289973,60,2,62,1.336332,103.813203
289974,33,0,33,1.336615,103.813532
289975,77,1,78,1.336845,103.812022
289979,1,0,1,1.334926,103.789649
297624,3,158,161,1.299509,103.837
297625,0,6,6,1.299509,103.837
297626,0,6,6,1.299509,103.837
297627,3,29,32,1.299509,103.837
297629,0,1,1,1.335835,103.813657
297630,0,2,2,1.345751,103.790836
297631,1,0,1,1.299509,103.837
297634,20,49,69,1.299509,103.837
297650,0,1,1,1.299509,103.837
297651,4,0,4,1.299509,103.837
297652,2,0,2,1.299509,103.837
297653,3,0,3,1.33121,103.81336
297654,3,0,3,1.299509,103.837
297655,2,0,2,1.299509,103.837
297657,15,0,15,1.299509,103.837
297658,1,0,1,1.299509,103.837
297664,1,0,1,1.299509,103.837
297665,0,1,1,1.299509,103.837
297667,0,2,2,1.299509,103.837
297670,7,1,8,1.299509,103.837
297675,1,12,13,1.299509,103.837
297676,3,0,3,1.299509,103.837
297677,8,0,8,1.299509,103.837
297678,31,0,31,1.299509,103.837
297679,3,0,3,1.299509,103.837
297682,2,0,2,1.299509,103.837
297689,2,30,32,1.299509,103.837
297690,0,3,3,1.299509,103.837
297691,2,1,3,1.299509,103.837
297699,10,0,10,1.299509,103.837
297700,1,1,2,1.299509,103.837
297701,0,6,6,1.299509,103.837
297702,6,3,9,1.299509,103.837
297703,8,93,101,1.299509,103.837
297705,1,164,165,1.299509,103.837
297706,0,4,4,1.299509,103.837
297707,2,4,6,1.299509,103.837
297708,1,7,8,1.299509,103.837
297709,2,0,2,1.299509,103.837
297714,5,38,43,1.326628,103.836993
297715,555,328,883,1.326995,103.840933
297716,7,2,9,1.299509,103.837
297717,5,0,5,1.299509,103.837
297719,91,1,92,1.327011,103.822772
297720,6,0,6,1.326985,103.822662
297721,16,0,16,1.322832,103.823028
297722,3929,5,3934,1.322454,103.823547
297723,7,6,13,1.299509,103.837
297724,1805,553,2358,1.331265,103.84061
297725,1563,625,2188,1.331276,103.841038
297726,2161,430,2591,1.33145,103.841405
297727,1664,351,2015,1.331677,103.841706
297728,151,2148,2299,1.330278,103.84022
297729,40,3,43,1.338174,103.820168
297730,0,3,3,1.299509,103.837
297731,27,4,31,1.338174,103.820168
297732,32,2,34,1.341655,103.832701
297733,43,3,46,1.299509,103.837
297738,14,0,14,1.338174,103.820168
297739,2,0,2,1.299509,103.837
297740,0,8,8,1.327441,103.822549
297741,17,1,18,1.299509,103.837
297743,1025,180,1205,1.33043,103.840554
297744,15,0,15,1.325913,103.824668
297745,16,9,25,1.325863,103.824803
297746,23,0,23,1.327021,103.823118
297747,139,0,139,1.327038,103.82295
297748,121,25,146,1.32458,103.82492
297749,2,0,2,1.327611,103.822848
297750,6,14,20,1.323328,103.820844
297751,47,77,124,1.322414,103.824405
297752,7,52,59,1.322562,103.82405
297753,2454,2282,4736,1.322014,103.82437
297754,602,455,1057,1.340206,103.839485
297755,7,1,8,1.330491,103.830441
297756,2,0,2,1.324475,103.824946
297758,13,32,45,1.325026,103.817694
297759,261,0,261,1.324954,103.817684
297760,31,0,31,1.324882,103.817675
297761,3,0,3,1.338174,103.820168
297762,50,2,52,1.324739,103.817656
297763,14,0,14,1.324667,103.817646
297764,2,3,5,1.324595,103.817637
297765,2,10,12,1.32517,103.817693
297766,9,3,12,1.324523,103.817627
297767,94,3,97,1.32509,103.817682
297768,5,3,8,1.324451,103.817618
297769,2,4,6,1.325009,103.817672
297770,3,1,4,1.324379,103.817608
297771,19,2,21,1.324929,103.817661
297772,6,36,42,1.324307,103.817599
297773,9,2,11,1.324849,103.81765
297774,70,14,84,1.324235,103.817589
297775,3,1,4,1.324768,103.81764
297776,82,9,91,1.324163,103.81758
297777,5,1,6,1.324688,103.817629
297778,21,2,23,1.324092,103.81757
297779,4,1,5,1.324608,103.817618
297780,9,4,13,1.32402,103.817561
297781,10,2,12,1.324527,103.817608
297782,67,2,69,1.323948,103.817551
297783,6,5,11,1.324447,103.817597
297784,47,9,56,1.323876,103.817542
297785,8,2,10,1.324366,103.817587
297786,57,6,63,1.32384,103.817537
297787,2,3,5,1.324286,103.817576
297788,13,1,14,1.323794,103.817522
297789,29,11,40,1.324206,103.817565
297791,12,5,17,1.324125,103.817555
297792,1,4,5,1.323716,103.817513
297793,0,6,6,1.324045,103.817544
297794,26,8,34,1.323694,103.817508
297795,131,1,132,1.323965,103.817533
297796,165,34,199,1.323794,103.817522
297797,5,3,8,1.323884,103.817523
297798,18,27,45,1.323856,103.81712
297799,2,52,54,1.323844,103.817517
297800,9,243,252,1.326959,103.840923
297801,11,19,30,1.326964,103.840874
297802,66,88,154,1.32697,103.840826
297803,4,17,21,1.326805,103.840141
297804,18,0,18,1.326976,103.838734
297805,0,19,19,1.326871,103.838244
297806,0,22,22,1.326874,103.838157
297808,3,10,13,1.32686,103.837874
297809,37,163,200,1.326628,103.836993
297810,5,19,24,1.326629,103.836994
297811,6,0,6,1.326212,103.837299
297812,49,2,51,1.326211,103.837298
297813,9,0,9,1.32561,103.837525
297814,131,0,131,1.326207,103.837098
297815,6,5,11,1.326243,103.837017
297816,25,0,25,1.325804,103.836973
297817,32,0,32,1.325726,103.836955
297818,13,4,17,1.325673,103.836912
297819,80,0,80,1.325617,103.836876
297820,1311,61,1372,1.324805,103.837121
297821,28,25,53,1.324668,103.835545
297822,1280,0,1280,1.324641,103.83554
297823,178,74,252,1.325979,103.827582
297824,1238,166,1404,1.325427,103.827251
297825,10,152,162,1.324942,103.826986
297826,34,263,297,1.324976,103.826906
297827,1,80,81,1.32449,103.827344
297828,3,327,330,1.324994,103.836614
297829,532,407,939,1.323375,103.826878
297830,46,496,542,1.322902,103.826504
297831,106,31,137,1.326825,103.84009
297832,13,0,13,1.326957,103.840935
297833,4,26,30,1.326962,103.840899
297834,1,0,1,1.299509,103.837
297835,3,0,3,1.324811,103.817665
297837,1,0,1,1.325231,103.837455
297838,2,27,29,1.326769,103.837875
297839,2,3,5,1.326859,103.837873
297840,14,3,17,1.326859,103.837873
297841,3,1,4,1.326628,103.836993
297843,0,1,1,1.326521,103.837739
297844,1,0,1,1.326629,103.836994
297845,1,1,2,1.32516,103.817703
297846,2,1,3,1.326968,103.838823
297847,19,0,19,1.326628,103.836993
297848,3,0,3,1.326628,103.836993
297849,13,0,13,1.326628,103.836993
297850,37,0,37,1.339171,103.821021
297851,40,4,44,1.339328,103.82128
297852,122,2,124,1.339456,103.821539
297853,3,193,196,1.339644,103.821851
297874,2,0,2,1.326628,103.836993
297875,0,3,3,1.326628,103.836993
297876,0,7,7,1.325258,103.817275
297878,15,6,21,1.325913,103.817353
297879,5,0,5,1.325939,103.817298
297880,106,17,123,1.326278,103.817439
297881,261,34,295,1.326704,103.81747
297882,1,14,15,1.326837,103.817514
297883,18,0,18,1.327129,103.817488
297884,12,15,27,1.327203,103.817705
297885,4,1,5,1.328459,103.817661
297886,8,0,8,1.328559,103.817682
297887,90,0,90,1.328757,103.817724
297888,7,6,13,1.32885,103.817733
297890,81,3,84,1.329009,103.81768
297891,3,0,3,1.32478,103.817221
297892,2,10,12,1.329193,103.817714
297893,40,30,70,1.329312,103.81773
297894,8,0,8,1.329372,103.817776
297895,80,0,80,1.329486,103.817812
297897,4,0,4,1.329569,103.817989
297898,6,11,17,1.32897,103.817787
297899,14,0,14,1.329579,103.818071
297900,15,0,15,1.329212,103.817997
297901,16,3,19,1.329589,103.818177
297902,93,0,93,1.329599,103.81858
297903,20,2,22,1.329595,103.818301
297904,29,2,31,1.329672,103.818699
297905,0,1,1,1.326628,103.836993
297906,3,2,5,1.32981,103.819096
297907,3,0,3,1.32909,103.817691
297908,42,1,43,1.32972,103.819145
297909,4,0,4,1.329901,103.819046
297910,62,1,63,1.329629,103.819195
297911,3,2,5,1.33001,103.819112
297913,99,3,102,1.329448,103.819294
297915,21,1,22,1.32987,103.819227
297916,6,1,7,1.330018,103.819432
297917,34,2,36,1.329856,103.819071
297918,1,0,1,1.329891,103.819056
297919,4,4,8,1.329357,103.819344
297920,123,3,126,1.329267,103.819393
297921,93,15,108,1.325735,103.81735
297922,0,4,4,1.32972,103.819145
297937,142,12,154,1.32639,103.820384
297938,22,9,31,1.326337,103.820507
297939,2,30,32,1.326372,103.820434
297940,3,9,12,1.326378,103.820446
297941,66,0,66,1.326448,103.820321
297942,49,3,52,1.326459,103.820325
297943,8,0,8,1.326523,103.820209
297944,1,0,1,1.329774,103.819055
297945,15,0,15,1.326599,103.820096
297946,4,0,4,1.326674,103.819983
297947,1,11,12,1.326863,103.819721
297948,8,0,8,1.326891,103.819626
297949,2,3,5,1.326931,103.81943
297950,44,0,44,1.326933,103.819352
297951,0,1,1,1.32654,103.820204
297952,3,0,3,1.329562,103.818471
297953,17,8,25,1.327477,103.819507
297954,36,0,36,1.326776,103.819002
297955,35,0,35,1.327197,103.819016
297956,91,0,91,1.326898,103.819222
297957,9,1,10,1.32718,103.819013
297959,53,9,62,1.327189,103.818997
297960,26,12,38,1.327152,103.818996
297961,26,2,28,1.326916,103.819019
297962,73,34,107,1.32689,103.819017
297963,7,0,7,1.326837,103.819014
297964,13,0,13,1.326795,103.81902
297965,62,0,62,1.327757,103.819455
297966,151,7,158,1.32759,103.819215
297967,5,2,7,1.327126,103.819059
297968,25,45,70,1.326903,103.819471
297969,36,0,36,1.326825,103.819757
297970,17,0,17,1.326675,103.819895
297971,228,0,228,1.326904,103.819541
297972,4,0,4,1.326935,103.819254
297973,58,0,58,1.32694,103.819099
297974,6,0,6,1.326939,103.819098
297975,12,21,33,1.326896,103.819187
297978,75,4,79,1.32693,103.819429
297979,38,3,41,1.326932,103.819351
297980,49,3,52,1.326932,103.819351
297985,62,11,73,1.32759,103.820981
297986,230,1,231,1.327601,103.821085
297987,9,5,14,1.327628,103.821008
297988,29,1,30,1.327659,103.821128
297989,12,3,15,1.327704,103.821063
297990,5,0,5,1.327715,103.821167
297991,2,3,5,1.327779,103.821117
297992,2,1,3,1.326952,103.819031
297993,0,1,1,1.327855,103.821172
297994,8,0,8,1.327859,103.821222
297995,14,0,14,1.327931,103.821226
298017,0,6,6,1.323355,103.820684
298018,1,11,12,1.323447,103.820227
298019,6,2,8,1.323259,103.821105
298020,21,0,21,1.323411,103.82037
298021,3,6,9,1.323211,103.821526
298022,3,0,3,1.327778,103.821185
298023,0,9,9,1.323168,103.821743
298024,5,4,9,1.323323,103.820675
298025,0,4,4,1.323041,103.822122
298026,49,0,49,1.323302,103.820806
298027,4,0,4,1.323277,103.820925
298028,2,2,4,1.323217,103.821003
298029,9,14,23,1.322753,103.823261
298030,57,0,57,1.323189,103.821242
298031,25,58,83,1.322709,103.823407
298032,4,0,4,1.323167,103.821383
298033,2,1,3,1.323364,103.820532
298034,8,0,8,1.323139,103.821509
298035,5,2,7,1.322473,103.824186
298036,1,0,1,1.327855,103.821172
298037,1,2,3,1.322586,103.823822
298038,2,88,90,1.322881,103.824819
298040,9,175,184,1.323254,103.824901
298041,7,2,9,1.323033,103.821934
298042,27,10,37,1.323691,103.824962
298043,2,0,2,1.324542,103.817193
298044,19,40,59,1.323952,103.824997
298045,4,12,16,1.324146,103.825001
298046,8,2,10,1.322949,103.82226
298047,5,16,21,1.324347,103.824976
298048,0,15,15,1.32474,103.824867
298049,29,11,40,1.324882,103.824854
298050,8,9,17,1.325095,103.824784
298051,41,8,49,1.325232,103.824739
298052,8,0,8,1.325434,103.824663
298053,63,10,73,1.325581,103.824611
298054,55,0,55,1.325804,103.82451
298056,0,1,1,1.322458,103.824264
298057,22,0,22,1.326071,103.824365
298059,9,1,10,1.326374,103.82404
298060,1,0,1,1.325996,103.82441
298061,94,1,95,1.326572,103.823703
298062,123,4,127,1.326691,103.823417
298063,757,26,783,1.323734,103.825699
298064,6,0,6,1.326628,103.823292
298065,307,230,537,1.324003,103.825367
298066,3,0,3,1.323102,103.82165
298067,1007,62,1069,1.324508,103.825305
298068,17,0,17,1.326708,103.822918
298069,2012,27,2039,1.325391,103.825296
298070,59,0,59,1.326687,103.82274
298071,1707,12,1719,1.324657,103.825751
298073,6,0,6,1.326645,103.822335
298075,17,0,17,1.327324,103.821152
298076,1,0,1,1.326455,103.823703
298077,3,0,3,1.326793,103.823087
298078,17,18,35,1.32734,103.820869
298079,54,1,55,1.326934,103.823428
298080,2,0,2,1.322983,103.822098
298081,19,16,35,1.326988,103.82325
298082,2,6,8,1.326726,103.823887
298083,104,0,104,1.326792,103.823769
298084,1,31,32,1.32686,103.823615
298085,58,4,62,1.326904,103.823508
298086,14,4,18,1.326335,103.82444
298087,2,5,7,1.326418,103.824403
298088,714,316,1030,1.32289,103.825643
298089,415,1394,1809,1.322423,103.82543
298090,1349,200,1549,1.322792,103.824969
298091,13,0,13,1.326757,103.821981
298092,23,5,28,1.326802,103.821819
298093,133,7,140,1.326944,103.821702
298094,58,6,64,1.322662,103.823559
298095,46,43,89,1.322635,103.823647
298096,49,0,49,1.322609,103.823718
298097,7,4,11,1.322566,103.823907
298098,33,0,33,1.322549,103.824
298099,44,26,70,1.322518,103.824088
298100,7,92,99,1.322431,103.824341
298101,14,215,229,1.338142,103.838464
298103,1,216,217,1.338141,103.839005
298104,431,347,778,1.33813,103.839803
298105,223,209,432,1.338887,103.839989
298106,80,238,318,1.338356,103.840677
298107,5,31,36,1.33725,103.837981
298108,25,4,29,1.337231,103.838285
298109,162,3,165,1.337259,103.838579
298110,1,0,1,1.327291,103.821066
298111,3,75,78,1.337229,103.839149
298112,0,10,10,1.337248,103.839396
298113,405,544,949,1.337788,103.839476
298127,2136,547,2683,1.327207,103.84183
298128,705,3857,4562,1.327674,103.84172
298129,2,5,7,1.315775,103.845016
298130,2048,172,2220,1.32836,103.841408
298132,9,17,26,1.318478,103.843757
298133,450,1640,2090,1.331968,103.840697
298135,1091,779,1870,1.333573,103.839126
298136,733,16722,17455,1.333665,103.839502
298137,881,3970,4851,1.333502,103.839769
298139,153,466,619,1.335925,103.836842
298140,1161,1233,2394,1.336374,103.83675
298141,7,1390,1397,1.337783,103.837607
298142,6,221,227,1.338934,103.83794
298143,1,7,8,1.316057,103.844913
298144,529,3984,4513,1.340507,103.837082
298179,24,18,42,1.333805,103.839739
298180,27,395,422,1.335673,103.836869
298181,528,1998,2526,1.337237,103.836778
298182,338,1040,1378,1.337747,103.836795
298183,249,56,305,1.339746,103.836594
298184,622,487,1109,1.33872,103.83686
298185,15,787,802,1.318513,103.843717
298186,115,507,622,1.340025,103.837489
298187,1631,123,1754,1.34066,103.837583
298188,37,77,114,1.34125,103.837799
298189,3003,1163,4166,1.340616,103.838148
298190,5054,752,5806,1.341129,103.83875
298191,2527,185,2712,1.333719,103.840822
298192,15,241,256,1.334861,103.836669
298193,10,3,13,1.335006,103.836635
298194,12,31,43,1.335125,103.836663
298199,50,12,62,1.325755,103.817124
298200,125,4,129,1.325774,103.816918
298201,279,22,301,1.325813,103.816507
298202,2,0,2,1.326957,103.823342
298203,19,5,24,1.325881,103.815694
298204,101,4,105,1.325881,103.815694
298205,99,4,103,1.325944,103.815262
298226,35,1,36,1.327101,103.833625
298227,0,224,224,1.326877,103.83361
298228,6,0,6,1.326857,103.833593
298229,70,1,71,1.32819,103.833346
298230,12,9,21,1.328501,103.833184
298251,1,5,6,1.338205,103.836236
298252,27,4,31,1.338106,103.835933
298253,60,7,67,1.337723,103.835748
298254,2,6,8,1.336672,103.834705
298255,16,2,18,1.337043,103.834811
298256,19,17,36,1.337484,103.835142
298257,4,7,11,1.33799,103.835182
298258,22,14,36,1.338018,103.836178
298259,4,7,11,1.338466,103.835228
298260,7,8,15,1.336498,103.835194
298261,16,0,16,1.338913,103.835151
298262,10,3,13,1.336342,103.834897
298263,4,13,17,1.339279,103.834781
298264,9,6,15,1.336485,103.834606
298265,8,10,18,1.339298,103.834438
298266,17,25,42,1.339247,103.834172
298267,1,57,58,1.339162,103.833862
298268,99,40,139,1.336918,103.834515
298269,29,430,459,1.339004,103.833322
298270,32,14,46,1.337248,103.834386
298271,3,180,183,1.339072,103.83304
298272,4,13,17,1.337633,103.834235
298273,22,39,61,1.339182,103.832736
298274,2,109,111,1.339162,103.832484
298275,13,0,13,1.336498,103.835194
298276,0,5,5,1.299509,103.837
298277,17,3,20,1.299509,103.837
298278,7,6,13,1.299509,103.837
298295,36,4,40,1.323457,103.821413
298296,6,4,10,1.323457,103.821413
298297,7,0,7,1.323697,103.82137
298298,3,1,4,1.323691,103.821459
298299,48,4,52,1.323952,103.821489
298300,160,6,166,1.323948,103.82151
298301,1,2,3,1.327343,103.820947
298302,17,2,19,1.324579,103.821641
298303,0,7,7,1.324555,103.821588
298304,2,3,5,1.324777,103.821685
298305,12,0,12,1.324925,103.8217
298306,1,0,1,1.337258,103.838902
298307,3,5,8,1.325178,103.821771
298308,7,0,7,1.325342,103.821763
298309,179,2,181,1.325576,103.821854
298311,50,1,51,1.325817,103.82186
298313,5,1,6,1.325052,103.82174
298314,10,1,11,1.325696,103.821877
298315,0,5,5,1.325839,103.821906
298316,14,4,18,1.325328,103.821801
298317,27,6,33,1.325441,103.821823
298318,5,0,5,1.32432,103.821525
298333,124,80,204,1.329754,103.834232
298334,3812,2372,6184,1.333189,103.835846
298335,172,11,183,1.332823,103.834102
298336,23,6,29,1.332637,103.834548
298337,131,117,248,1.332977,103.834907
298339,0,2,2,1.325852,103.816095
298340,21,12,33,1.333107,103.83427
298341,244,612,856,1.331531,103.835838
298342,29,12,41,1.333278,103.833581
298343,2,4,6,1.332576,103.833485
298344,71,12,83,1.333056,103.83286
298345,129,4,133,1.332554,103.832321
298346,1,1,2,1.331917,103.834334
298349,1,6,7,1.332965,103.832216
298350,70,12,82,1.332142,103.831712
298351,8,14,22,1.332717,103.831515
298352,11,2,13,1.33194,103.831146
298353,178,9,187,1.33235,103.83069
298354,4,2,6,1.331967,103.831118
298355,69,21,90,1.331763,103.830045
298356,66,13,79,1.331499,103.829443
298357,79,13,92,1.33111,103.828937
298358,1,0,1,1.325181,103.821753
298359,30,135,165,1.327991,103.82712
298360,1,56,57,1.327367,103.826589
298361,2,0,2,1.33173,103.832398
298381,24,85,109,1.330686,103.828754
298382,151,27,178,1.330705,103.828668
298383,1,1,2,1.331949,103.833989
298384,57,2,59,1.331423,103.8272
298385,67,7,74,1.330841,103.828325
298386,29,4,33,1.331218,103.826741
298387,47,1,48,1.330598,103.826447
298388,45,13,58,1.331293,103.826385
298409,6,54,60,1.324996,103.825912
298410,0,18,18,1.324957,103.825933
298411,2,0,2,1.331332,103.82781
298413,26,11,37,1.325019,103.825993
298414,3,0,3,1.324201,103.821521
298415,5,9,14,1.325046,103.826044
298416,4,0,4,1.32503,103.826109
298417,1,0,1,1.328332,103.826518
298418,4,1,5,1.325048,103.826147
298419,0,1,1,1.325063,103.826096
298420,7,2,9,1.325065,103.826186
298421,0,3,3,1.325009,103.826058
298422,0,5,5,1.325117,103.826225
298423,23,4,27,1.325097,103.826271
298424,8,8,16,1.325139,103.826273
298425,20,15,35,1.325114,103.826312
298426,0,2,2,1.325001,103.825949
298427,0,3,3,1.325082,103.826229
298428,2,8,10,1.32521,103.826427
298449,75,3,78,1.327352,103.821696
298450,2,11,13,1.327503,103.821997
298451,88,5,93,1.327471,103.821806
298453,16,46,62,1.327244,103.822279
298454,1,0,1,1.325081,103.826141
298455,24,1,25,1.327616,103.822112
298456,1,8,9,1.327284,103.822263
298457,1,0,1,1.327244,103.822352
298458,2,3,5,1.327535,103.82245
298459,49,5,54,1.327743,103.822474
298460,1,0,1,1.327635,103.82227
298461,4,1,5,1.327919,103.822576
298462,6,2,8,1.32762,103.822953
298464,2,7,9,1.327684,103.822833
298466,3,5,8,1.327706,103.822979
298467,175,1,176,1.32746,103.823154
298468,10,61,71,1.328052,103.823046
298469,86,2,88,1.327676,103.823479
298470,18,50,68,1.32808,103.823112
298471,14,0,14,1.327315,103.823615
298472,2,0,2,1.325162,103.826319
298473,14,12,26,1.327757,103.823305
298475,1,6,7,1.327744,103.823534
298476,45,18,63,1.327726,103.823594
298477,5,0,5,1.32722,103.823671
298478,87,44,131,1.327884,103.823821
298479,124,10,134,1.327412,103.823841
298480,87,34,121,1.327867,103.823854
298481,4,16,20,1.327064,103.824373
298482,28,4,32,1.327623,103.823887
298483,25,0,25,1.326874,103.82421
298484,14,7,21,1.327488,103.824111
298486,42,21,63,1.32763,103.824428
298487,37,9,46,1.326716,103.824158
298488,1,29,30,1.327586,103.824445
298489,183,1,184,1.32695,103.824432
298490,29,21,50,1.327279,103.824379
298491,1,0,1,1.327567,103.822669
298492,16,11,27,1.327185,103.824573
298493,23,8,31,1.326573,103.824903
298494,35,25,60,1.327226,103.824974
298495,3,2,5,1.326457,103.82469
298496,24,5,29,1.327176,103.825011
298497,31,10,41,1.326395,103.824595
298498,80,1,81,1.326297,103.824543
298499,4,5,9,1.326562,103.825165
298500,73,0,73,1.326341,103.824561
298501,10,18,28,1.326708,103.82537
298502,16,32,48,1.326492,103.824921
298503,106,16,122,1.326622,103.825318
298504,6,6,12,1.326,103.825134
298505,192,5,197,1.326573,103.825274
298506,38,3,41,1.325922,103.824862
298507,7,0,7,1.326115,103.825417
298508,0,5,5,1.325699,103.824716
298509,18,5,23,1.326285,103.825779
298510,9,9,18,1.325763,103.824814
298511,100,11,111,1.326248,103.825892
298512,28,11,39,1.325862,103.825007
298513,20,1,21,1.326154,103.825663
298514,11,17,28,1.325929,103.825249
298515,1,1,2,1.328033,103.823123
298516,4,0,4,1.324368,103.826261
298517,5,24,29,1.324312,103.826282
298518,11,8,19,1.324229,103.826316
298519,7,38,45,1.324164,103.826354
298520,7,66,73,1.324067,103.826382
298521,7,3,10,1.326903,103.824892
298522,4,1,5,1.326793,103.824965
298523,1,45,46,1.326676,103.825416
298524,10,3,13,1.325931,103.825154
298525,198,11,209,1.326626,103.825271
298526,139,9,148,1.327666,103.823316
298527,64,7,71,1.327782,103.823815
298528,71,0,71,1.326405,103.824666
298529,5,10,15,1.32764,103.822312
298530,2,0,2,1.326056,103.82544
298531,10,1,11,1.32654,103.825211
298532,9,21,30,1.327646,103.823667
298533,14,10,24,1.327022,103.824465
298534,1,9,10,1.327875,103.822459
298535,8,1,9,1.327112,103.824668
298536,75,4,79,1.327706,103.822943
298537,2,25,27,1.326285,103.825779
298538,16,4,20,1.327409,103.821891
298539,47,0,47,1.326008,103.825086
298540,8,2,10,1.327297,103.823719
298541,40,150,190,1.323945,103.826162
298542,6,3,9,1.323899,103.826099
298543,0,21,21,1.323863,103.826044
298544,3,3,6,1.323829,103.826006
298545,27,0,27,1.323795,103.825954
298546,11,13,24,1.323757,103.825905
298547,41,0,41,1.323734,103.82586
298548,23,17,40,1.323699,103.825809
298549,18,0,18,1.323677,103.825787
298550,10,0,10,1.323651,103.825755
298551,33,13,46,1.323633,103.82572
298572,1,9,10,1.32451,103.826175
298573,3,0,3,1.325181,103.826365
298574,4,1,5,1.32455,103.826253
298576,1,0,1,1.327022,103.824465
298577,0,11,11,1.324617,103.826396
298578,1,14,15,1.324647,103.826449
298599,26,9,35,1.325512,103.825717
298600,9,0,9,1.325539,103.825759
298601,13,2,15,1.325566,103.825803
298602,1,0,1,1.324593,103.826344
298603,12,7,19,1.325567,103.825702
298604,7,1,8,1.325622,103.825946
298605,9,1,10,1.325624,103.825815
298606,6,2,8,1.325653,103.826011
298607,11,1,12,1.32567,103.825963
298608,2,0,2,1.326115,103.825417
298609,97,0,97,1.325727,103.826077
298610,1,10,11,1.325694,103.826119
298611,0,17,17,1.325802,103.826214
298612,4,0,4,1.325716,103.826153
298613,8,1,9,1.325728,103.826181
298614,42,1,43,1.325751,103.826227
298615,25,29,54,1.325785,103.826289
298637,3,31,34,1.335,103.822322
298659,118,23,141,1.339087,103.82022
298660,5,2,7,1.33904,103.820276
298661,5,0,5,1.338947,103.820388
298662,2,2,4,1.338853,103.820501
298663,6,1,7,1.339124,103.820154
298664,95,0,95,1.33876,103.820613
298665,4,1,5,1.338666,103.820705
298666,17,5,22,1.338676,103.820715
298667,12,0,12,1.338837,103.820969
298668,1,1,2,1.325676,103.826067
298669,1,0,1,1.325584,103.825879
298670,69,1,70,1.338726,103.820831
298671,23,0,23,1.338656,103.820715
298672,2,4,6,1.338459,103.820558
298693,17,22,39,1.337319,103.819369
298694,7,34,41,1.337608,103.819516
298695,11,0,11,1.337934,103.819674
298696,17,132,149,1.337984,103.819685
298697,2,0,2,1.338815,103.820944
298698,25,16,41,1.338205,103.819764
298699,20,22,42,1.338065,103.819711
298700,124,6,130,1.338174,103.820168
298701,12,34,46,1.338248,103.820159
298702,26,1,27,1.338247,103.820158
298703,24,0,24,1.338247,103.820158
298704,51,0,51,1.338247,103.820158
298705,3,21,24,1.338247,103.820158
298706,8,51,59,1.338372,103.819742
298709,30,1,31,1.338797,103.819993
298710,38,28,66,1.338917,103.820018
298713,37,0,37,1.339443,103.820441
298714,56,16,72,1.339673,103.820732
298715,7,208,215,1.340132,103.831184
298717,7,3,10,1.339988,103.833401
298718,13,264,277,1.340124,103.832293
298719,5,50,55,1.339986,103.832442
298720,12,8,20,1.339854,103.832674
298721,37,0,37,1.339761,103.832832
298722,0,1,1,1.338759,103.820874
298723,53,0,53,1.339346,103.833253
298724,44,1370,1414,1.339085,103.833597
298725,97,2,99,1.339338,103.833671
298726,4,16,20,1.340036,103.834252
298727,1,0,1,1.339399,103.833053
298728,58,1756,1814,1.340565,103.835058
298729,5,16,21,1.33767,103.819546
298730,2,1,3,1.324531,103.826214
298731,8,2,10,1.337849,103.81964
298732,5,37,42,1.340304,103.834662
298733,50,26,76,1.339824,103.821045
298734,17,23,40,1.339936,103.82131
298735,63,108,171,1.340038,103.821588
298736,67,0,67,1.33811,103.81973
298737,33,1,34,1.338034,103.8197
298738,22,0,22,1.337958,103.81968
298739,67,0,67,1.338174,103.820168
298740,10,0,10,1.338174,103.820168
298741,44,0,44,1.337511,103.81991
298742,2,0,2,1.338157,103.819756
298743,72,0,72,1.337497,103.820053
298744,1,0,1,1.340151,103.834782
298745,23,0,23,1.337432,103.820222
298746,5,0,5,1.338174,103.820168
298747,6,1,7,1.338174,103.820168
298749,71,9,80,1.325338,103.816486
298750,53,12,65,1.325362,103.816218
298751,60,9,69,1.325383,103.816081
298752,104,5,109,1.325408,103.815696
298753,162,5,167,1.325408,103.815696
298774,94,1226,1320,1.32297,103.819877
298775,4,185,189,1.322928,103.820067
298776,177,14,191,1.323072,103.819902
298777,40,1,41,1.323163,103.820102
298778,3,10,13,1.323229,103.819914
298779,0,6,6,1.323267,103.819946
298780,83,20,103,1.323406,103.819972
298781,2,14,16,1.323456,103.81999
298782,128,33,161,1.323625,103.820178
298783,17,5,22,1.323674,103.820071
298784,41,11,52,1.324036,103.820309
298785,138,0,138,1.323836,103.820095
298786,7,3,10,1.324371,103.82034
298787,30,0,30,1.323914,103.819841
298788,342,25,367,1.324951,103.820646
298789,4,8,12,1.323972,103.819881
298790,23,13,36,1.325388,103.820632
298791,800,44,844,1.32552,103.819316
298792,1,20,21,1.325851,103.820733
298793,8,15,23,1.326126,103.820769
298794,2,2,4,1.326529,103.820785
298795,42,2,44,1.326944,103.820906
298796,110,7,117,1.327917,103.82075
298797,60,0,60,1.327923,103.820723
298798,34,1,35,1.327969,103.820674
298799,6,1,7,1.328035,103.820621
298800,43,1,44,1.328071,103.820571
298801,7,75,82,1.328136,103.820494
298802,37,6,43,1.328081,103.820905
298803,4,5,9,1.328102,103.820869
298804,7,3,10,1.328145,103.820794
298805,18,4,22,1.328224,103.820765
298806,10,2,12,1.328271,103.820694
298808,497,3,500,1.328625,103.820132
298809,1,40,41,1.328962,103.820435
298810,1,0,1,1.337456,103.820123
298811,18,0,18,1.32896,103.820619
298812,315,0,315,1.329058,103.820176
298813,39,0,39,1.329199,103.820185
298814,10,0,10,1.326902,103.82061
298815,63,0,63,1.329134,103.820176
298816,6,2,8,1.32695,103.820621
298817,44,0,44,1.329249,103.820167
298818,7,1,8,1.326842,103.82063
298819,22,51,73,1.329377,103.82016
298820,20,3,23,1.326978,103.820651
298821,7,9,16,1.329517,103.820127
298822,0,15,15,1.327244,103.820663
298823,11,5,16,1.327243,103.820662
298824,265,43,308,1.329704,103.820011
298825,13,0,13,1.327515,103.820664
298826,9,0,9,1.327514,103.820663
298827,48,47,95,1.329898,103.820076
298828,0,9,9,1.327846,103.820257
298829,64,9,73,1.327721,103.820082
298830,94,1,95,1.327686,103.820033
298831,87,1,88,1.327732,103.819957
298832,5,9,14,1.327787,103.820097
298833,17,6,23,1.328294,103.820016
298834,15,2,17,1.328434,103.819701
298836,22,33,55,1.328859,103.81993
298837,7,95,102,1.330125,103.819841
298838,48,0,48,1.328808,103.819763
298839,108,4,112,1.329135,103.819861
298840,3,0,3,1.337796,103.819608
298843,8,5,13,1.326679,103.820777
298844,24,12,36,1.326801,103.820854
298845,0,28,28,1.329076,103.820203
298846,65,0,65,1.328861,103.820549
298847,2,7,9,1.324594,103.8205
298848,0,4,4,1.325601,103.820699
298849,95,12,107,1.329371,103.819799
298850,138,0,138,1.328154,103.819646
298851,78,12,90,1.325248,103.820636
298852,13,2,15,1.329951,103.819652
298853,0,9,9,1.32316,103.819933
298854,2,11,13,1.327002,103.820877
298855,56,0,56,1.327088,103.82096
298856,43,0,43,1.327137,103.820943
298857,26,0,26,1.325953,103.82073
298858,126,11,137,1.323625,103.820178
298859,86,21,107,1.323625,103.820178
298860,3,9,12,1.299509,103.837
298861,9,4,13,1.299509,103.837
298862,16,29,45,1.299509,103.837
298863,37,1,38,1.337192,103.833693
298864,74,0,74,1.336839,103.833933
298865,66,10,76,1.337448,103.833838
298866,25,0,25,1.337663,103.833948
298887,16,10,26,1.340219,103.83536
298888,6,3,9,1.339852,103.835462
298889,13,0,13,1.339493,103.835803
298890,12,0,12,1.339336,103.836164
298891,66,17,83,1.338597,103.835743
298892,8,8,16,1.33743,103.836281
298893,3,35,38,1.337095,103.836197
298894,2,3,5,1.336571,103.836121
298895,40,21,61,1.339379,103.836037
298896,4,22,26,1.340186,103.835519
298897,159,1200,1359,1.340368,103.835592
298898,1028,132,1160,1.339612,103.836083
298899,100,66,166,1.336725,103.836353
298900,133,2,135,1.335911,103.836293
298901,3,5,8,1.336017,103.836133
298903,10,0,10,1.336235,103.836085
298904,0,1,1,1.328856,103.820323
298905,29,23,52,1.338597,103.835743
298915,6,0,6,1.32365,103.818103
298916,4,1,5,1.323725,103.818121
298917,2,1,3,1.329533,103.819724
298918,115,0,115,1.323992,103.818157
298919,6,0,6,1.324094,103.818202
298921,0,7,7,1.324428,103.818259
298922,12,0,12,1.324562,103.818282
298923,1,0,1,1.336406,103.836116
298924,1,1,2,1.337489,103.820003
298925,116,0,116,1.32473,103.818303
298926,14,1,15,1.324853,103.8183
298930,5,4,9,1.325178,103.81834
298931,4,8,12,1.325301,103.818359
298932,1,11,12,1.325417,103.818377
298933,38,49,87,1.325835,103.818416
298934,15,1,16,1.325832,103.818305
298935,26,0,26,1.325713,103.818033
298936,2,1,3,1.323876,103.818155
298937,30,5,35,1.325859,103.81803
298938,35,16,51,1.325773,103.818087
298939,1,4,5,1.326188,103.818087
298940,3,0,3,1.325861,103.818102
298961,10,0,10,1.32359,103.81961
298962,10,4,14,1.323629,103.819391
298963,14,1,15,1.323792,103.819506
298964,1,11,12,1.32368,103.81906
298965,4,0,4,1.323605,103.819035
298966,4,1,5,1.32347,103.819008
298967,15,3,18,1.323395,103.818986
298968,7,25,32,1.323828,103.819264
298969,25,11,36,1.32371,103.8189
298970,18,5,23,1.323635,103.818875
298971,4,6,10,1.3235,103.818848
298972,1,0,1,1.324696,103.818305
298973,1,1,2,1.324829,103.818328
298974,13,14,27,1.323801,103.818563
298975,5,1,6,1.323726,103.818538
298977,3,0,3,1.323649,103.818102
298978,11,0,11,1.323926,103.81899
298979,5,1,6,1.324018,103.818598
298980,10,19,29,1.32382,103.818468
298981,4,3,7,1.323745,103.818443
298982,53,1,54,1.32361,103.818416
298984,63,2,65,1.324046,103.818459
298986,19,2,21,1.323765,103.819585
298987,98,0,98,1.323822,103.819433
298988,5,0,5,1.323969,103.818814
298989,9,1,10,1.323985,103.818746
298990,24,0,24,1.323946,103.818935
298991,4,0,4,1.323851,103.819172
298992,207,0,207,1.299509,103.837
299005,7,7,14,1.327273,103.817689
299007,5,11,16,1.327257,103.81782
299008,9,0,9,1.32725,103.817873
299009,59,0,59,1.327238,103.817932
299010,41,3,44,1.326997,103.818103
299011,5,0,5,1.327236,103.817983
299012,0,2,2,1.323869,103.819054
299013,4,1,5,1.326841,103.81807
299014,63,0,63,1.326764,103.81806
299016,6,3,9,1.326638,103.818047
299018,1,2,3,1.323516,103.818489
299020,5,1,6,1.326456,103.818013
299021,6,0,6,1.327223,103.818309
299023,27,1,28,1.327207,103.818431
299024,10,12,22,1.326538,103.818119
299025,11,0,11,1.327196,103.818486
299026,16,0,16,1.326651,103.818135
299027,101,0,101,1.327168,103.818547
299028,17,0,17,1.326729,103.818153
299029,14,0,14,1.327168,103.818616
299030,77,9,86,1.326834,103.818168
299031,118,0,118,1.326937,103.818184
299032,44,2,46,1.327052,103.818214
299053,10,1,11,1.328343,103.817409
299054,2,0,2,1.32723,103.818042
299055,6,1,7,1.328566,103.81714
299057,0,3,3,1.326558,103.818026
299058,7,1,8,1.329112,103.817037
299059,27,1,28,1.328835,103.817185
299060,47,2,49,1.328967,103.817208
299061,105,13,118,1.329273,103.817052
299062,1,1,2,1.32838,103.817206
299063,1,0,1,1.323425,103.818826
299064,4,2,6,1.329231,103.817259
299065,6,2,8,1.329665,103.817212
299066,31,1,32,1.329334,103.817276
299067,6,7,13,1.329868,103.817262
299068,16,14,30,1.329431,103.817327
299069,227,1,228,1.330028,103.817341
299070,10,1,11,1.329517,103.817361
299071,81,106,187,1.330177,103.817432
299072,0,4,4,1.329609,103.817418
299073,17,18,35,1.329706,103.817452
299074,55,1,56,1.329815,103.817498
299075,43,19,62,1.329941,103.817526
299076,27,4,31,1.330071,103.817596
299078,8,0,8,1.330002,103.817807
299079,25,4,29,1.330025,103.817927
299080,1,2,3,1.328934,103.817026
299083,32,0,32,1.330054,103.818369
299084,53,30,83,1.330106,103.818471
299085,2,0,2,1.329105,103.81723
299086,95,2,97,1.33022,103.818659
299087,4,0,4,1.330272,103.818744
299088,4,96,100,1.330324,103.818832
299089,5,0,5,1.328713,103.816999
299109,15,623,638,1.338915,103.831784
299110,10,9,19,1.339377,103.831484
299111,6,10,16,1.339213,103.831559
299112,3,0,3,1.330042,103.818057
299113,3,3,6,1.338983,103.831177
299114,23,143,166,1.339678,103.83126
299115,77,4,81,1.338766,103.831121
299116,204,5,209,1.339489,103.831262
299117,17,6,23,1.338424,103.831006
299118,12,2,14,1.33928,103.831205
299119,2,6,8,1.339059,103.831128
299120,6,6,12,1.338121,103.830873
299121,18,0,18,1.338895,103.831075
299122,63,3,66,1.338736,103.831009
299123,21,1,22,1.338619,103.830966
299124,3,9,12,1.338023,103.830851
299125,1,3,4,1.338389,103.830914
299126,10,0,10,1.338309,103.830877
299127,64,13,77,1.337852,103.830808
299128,46,12,58,1.338202,103.830829
299129,33,3,36,1.338098,103.830795
299130,20,5,25,1.337943,103.830731
299131,6,7,13,1.338001,103.830754
299132,10,0,10,1.299509,103.837
299152,37,14,51,1.328768,103.826025
299173,3,38,41,1.334517,103.83292
299174,257,44,301,1.334888,103.835001
299176,0,5,5,1.334042,103.832156
299177,160,5,165,1.335394,103.833043
299194,0,15,15,1.328944,103.817864
299195,1,5,6,1.32895,103.817802
299196,3,1,4,1.328931,103.817941
299198,41,0,41,1.328906,103.818097
299199,2,10,12,1.328933,103.817911
299200,0,1,1,1.329479,103.817141
299202,8,6,14,1.328857,103.818408
299203,76,0,76,1.32891,103.818056
299204,37,10,47,1.328832,103.818563
299205,52,9,61,1.328822,103.818637
299206,20,0,20,1.328898,103.818129
299207,1,23,24,1.328886,103.818201
299208,53,3,56,1.328792,103.818864
299209,1,0,1,1.328881,103.818252
299210,23,5,28,1.328863,103.818346
299211,2,0,2,1.330171,103.818593
299212,1,9,10,1.32884,103.818491
299213,2,0,2,1.328852,103.818419
299214,3,0,3,1.339956,103.831185
299215,90,20,110,1.328805,103.818709
299216,10,0,10,1.328794,103.818781
299217,22,2,24,1.328772,103.818864
299259,64,2,66,1.32628,103.817639
299260,6,10,16,1.326207,103.81763
299261,13,0,13,1.326265,103.81784
299262,8,6,14,1.326169,103.817811
299263,16,0,16,1.326169,103.817925
299264,9,0,9,1.329203,103.81873
299265,28,0,28,1.328955,103.818867
299266,5,11,16,1.326522,103.818537
299268,1,8,9,1.326725,103.818554
299269,1,5,6,1.326799,103.818563
299270,0,1,1,1.328875,103.818274
299271,0,1,1,1.326925,103.81857
299272,0,3,3,1.328817,103.818636
299273,0,4,4,1.326735,103.818757
299274,1,1,2,1.328828,103.818564
299282,0,1,1,1.326656,103.818752
299285,10,3,13,1.328975,103.818728
299287,72,0,72,1.329071,103.818658
299288,17,0,17,1.328203,103.81906
299289,8,0,8,1.32825,103.819062
299290,41,0,41,1.328298,103.819067
299291,10,2,12,1.328353,103.819068
299294,193,0,193,1.328471,103.819041
299295,67,0,67,1.32851,103.819022
299296,58,0,58,1.328547,103.819003
299297,0,2,2,1.327667,103.818834
299298,1,0,1,1.327981,103.818976
299299,2,2,4,1.328662,103.818936
299300,1,0,1,1.328624,103.818958
299301,4,0,4,1.328729,103.818901
299302,9,1,10,1.329318,103.818657
299303,25,7,32,1.329399,103.818605
299304,3,5,8,1.326194,103.818143
299305,22,0,22,1.326245,103.818175
299306,1,0,1,1.328694,103.818918
299307,12,0,12,1.326296,103.818369
299308,80,1,81,1.299509,103.837
299309,5,3,8,1.299509,103.837
299322,11,3,14,1.32792,103.817058
299323,243,15,258,1.327841,103.816485
299324,2,3,5,1.327901,103.81717
299325,6,0,6,1.327846,103.81701
299326,47,3,50,1.327828,103.81712
299327,1,0,1,1.326287,103.818245
299329,3,0,3,1.327001,103.818572
299330,14,13,27,1.327852,103.817727
299331,5,8,13,1.327707,103.817774
299332,23,1,24,1.327849,103.817762
299333,14,0,14,1.327703,103.81783
299334,12,0,12,1.327847,103.8178
299335,4,2,6,1.32784,103.817843
299336,38,1,39,1.327695,103.817907
299337,0,1,1,1.327819,103.817212
299338,7,0,7,1.327832,103.8179
299340,2,0,2,1.328586,103.818983
299341,16,0,16,1.327681,103.818082
299342,8,0,8,1.327818,103.818028
299343,4,0,4,1.327671,103.818141
299344,1,11,12,1.32781,103.818106
299345,11,1,12,1.327668,103.818194
299346,25,1,26,1.327803,103.818175
299347,1,0,1,1.327687,103.817974
299348,2,0,2,1.327827,103.817962
299349,2,1,3,1.3278,103.817346
299350,226,0,226,1.327788,103.818352
299351,9,0,9,1.327639,103.818467
299352,6,11,17,1.327774,103.818441
299353,4,1,5,1.32763,103.818538
299354,3,1,4,1.327767,103.818519
299357,41,1,42,1.327618,103.818669
299358,5,2,7,1.327752,103.818657
299359,3,0,3,1.327645,103.818401
299360,7,15,22,1.327731,103.818785
299362,2,0,2,1.327799,103.818268
299381,0,8,8,1.328454,103.817785
299382,2,7,9,1.328254,103.817799
299383,0,1,1,1.327653,103.818347
299385,3,0,3,1.327747,103.818714
299386,6,0,6,1.328234,103.817909
299387,9,0,9,1.328436,103.817944
299388,49,2,51,1.328221,103.817983
299389,10,0,10,1.328424,103.818004
299390,2,1,3,1.32844,103.817884
299391,1,6,7,1.328417,103.818053
299392,3,0,3,1.328211,103.81804
299393,9,0,9,1.328208,103.818111
299394,10,1,11,1.328193,103.81818
299395,7,0,7,1.328395,103.818212
299396,2,8,10,1.328188,103.818234
299397,26,6,32,1.328384,103.818291
299398,14,9,23,1.328177,103.818305
299399,4,2,6,1.328373,103.81837
299400,0,1,1,1.328443,103.817833
299401,27,0,27,1.328362,103.818449
299403,5,1,6,1.328351,103.818529
299404,15,0,15,1.328147,103.818537
299406,5,0,5,1.328138,103.818612
299407,6,19,25,1.328329,103.818687
299408,15,1,16,1.328125,103.818693
299409,33,0,33,1.328318,103.818766
299410,7,0,7,1.328115,103.818756
299411,5,4,9,1.328307,103.818846
299412,1,4,5,1.328104,103.818809
299413,1,4,5,1.328296,103.818925
299415,56,14,70,1.328288,103.818979
299416,23,17,40,1.328088,103.818909
299437,2,18,20,1.32301,103.822737
299438,1,3,4,1.323119,103.82276
299439,5,0,5,1.32324,103.822796
299440,0,1,1,1.328171,103.818391
299441,5,18,23,1.322989,103.822789
299443,5,0,5,1.323747,103.822918
299444,2,2,4,1.323906,103.82296
299445,3,0,3,1.328407,103.818133
299446,4,5,9,1.324073,103.822994
299447,10,2,12,1.324175,103.823021
299448,5,2,7,1.324285,103.823042
299449,3,0,3,1.324113,103.823045
299450,15,0,15,1.324386,103.823104
299451,3,14,17,1.324637,103.823124
299452,1,3,4,1.32473,103.823144
299453,20,0,20,1.324561,103.823131
299454,14,1,15,1.324723,103.823168
299455,185,0,185,1.324817,103.823189
299456,3,0,3,1.324387,103.823064
299457,21,5,26,1.325573,103.823465
299458,0,1,1,1.32337,103.82283
299459,7,16,23,1.32564,103.823592
299460,11,0,11,1.324476,103.823091
299461,9,35,44,1.324568,103.823116
299462,1,1,2,1.299509,103.837
299463,13,0,13,1.299509,103.837
299464,7,19,26,1.299509,103.837
299465,3,0,3,1.3249,103.823206
299466,3,0,3,1.299509,103.837
299479,61,2,63,1.331894,103.82824
299480,1,1,2,1.323084,103.822812
299481,133,6,139,1.332391,103.828613
299482,75,14,89,1.332454,103.828573
299483,47,6,53,1.332582,103.82888
299484,99,5,104,1.332199,103.82852
299504,4,391,395,1.322485,103.822281
299505,11,1,12,1.322673,103.822338
299526,19,1489,1508,1.322345,103.823186
299527,0,33,33,1.322123,103.822165
299528,0,11,11,1.322168,103.822025
299529,2,32,34,1.322214,103.821865
299530,0,19,19,1.322263,103.821694
299531,0,33,33,1.322307,103.821536
299532,26,5,31,1.322348,103.821392
299533,2,90,92,1.322392,103.82123
299534,2,33,35,1.322436,103.821088
299535,2,8,10,1.322476,103.82091
299536,1,25,26,1.322533,103.820713
299537,4,122,126,1.322584,103.820548
299539,1,770,771,1.322654,103.820293
299540,4,33,37,1.322696,103.820163
299541,10,1031,1041,1.322728,103.820031
299542,17,250,267,1.322897,103.819349
299543,4,645,649,1.322946,103.819092
299544,3,24,27,1.322948,103.818962
299545,4,369,373,1.322966,103.818809
299546,10,26,36,1.322983,103.818682
299547,3,67,70,1.323001,103.818577
299549,3,77,80,1.323029,103.818329
299550,1,0,1,1.325091,103.823249
299551,45,878,923,1.323306,103.817323
299552,59,485,544,1.323625,103.81443
299553,10,734,744,1.32368,103.814232
299554,2,40,42,1.323064,103.81806
299555,9,34,43,1.323068,103.81793
299556,0,34,34,1.32308,103.817794
299557,3,271,274,1.323134,103.817655
299559,12,0,12,1.322864,103.819528
299560,4,29,33,1.322864,103.819528
299574,81,468,549,1.323441,103.814752
299575,34,2,36,1.323868,103.814788
299576,1,1,2,1.32944,103.82584
299577,9,24,33,1.324305,103.814835
299578,16,0,16,1.324304,103.814834
299579,4,10,14,1.324304,103.814834
299580,1,98,99,1.324304,103.814834
299581,4,10,14,1.324436,103.814849
299582,1,0,1,1.32304,103.818206
299583,8,535,543,1.324794,103.814137
299584,22,3,25,1.325353,103.814944
299585,10,0,10,1.325343,103.814954
299586,68,627,695,1.325466,103.814148
299587,4,374,378,1.325456,103.814292
299588,1,4,5,1.325435,103.814427
299589,0,3,3,1.299509,103.837
299590,8,1,9,1.325363,103.814954
299591,81,2,83,1.325991,103.81485
299592,44,3,47,1.326013,103.8147
299593,36,76,112,1.326139,103.814216
299594,8,11,19,1.326057,103.814401
299595,1,51,52,1.326091,103.814112
299616,2,0,2,1.323867,103.814788
299618,0,4,4,1.323545,103.822031
299619,4,0,4,1.32343,103.82209
299620,5,0,5,1.323429,103.822089
299621,15,3,18,1.323866,103.822123
299622,1,1,2,1.323175,103.821991
299623,2,0,2,1.323795,103.822185
299624,51,6,57,1.323794,103.822184
299625,27,4,31,1.323794,103.822184
299626,15,4,19,1.324178,103.822211
299627,1,1,2,1.323794,103.822184
299628,31,13,44,1.32436,103.822243
299629,88,2,90,1.324441,103.822307
299630,12,1,13,1.324613,103.822292
299631,18,5,23,1.324769,103.822407
299632,45,0,45,1.324689,103.822344
299633,29,0,29,1.324945,103.822459
299634,17,0,17,1.324964,103.822409
299635,6,13,19,1.325413,103.822776
299636,2,1,3,1.325394,103.814695
299637,1,0,1,1.324567,103.814862
299638,20,0,20,1.325433,103.822776
299640,222,11,233,1.325294,103.823282
299641,18,0,18,1.324963,103.822408
299642,18,0,18,1.325239,103.822473
299643,2,1,3,1.325351,103.822868
299644,21,0,21,1.324769,103.822407
299645,24,0,24,1.325412,103.822775
299646,12,0,12,1.325386,103.822514
299647,4,2,6,1.325386,103.822514
299650,35,7661,7696,1.299509,103.837
299661,22,214,236,1.323516,103.816833
299662,1,38,39,1.323508,103.816827
299663,0,133,133,1.323663,103.816146
299664,9,0,9,1.323663,103.816146
299665,0,367,367,1.323663,103.816146
299666,9,0,9,1.323663,103.816146
299667,3,284,287,1.323663,103.816146
299668,43,394,437,1.323663,103.816146
299669,9,7,16,1.323697,103.816149
299670,6,4,10,1.323697,103.816149
299674,3,0,3,1.323752,103.822081
299675,0,4,4,1.323768,103.816876
299676,2,0,2,1.324151,103.82225
299678,0,10,10,1.324012,103.816986
299679,0,1,1,1.325387,103.822515
299681,16,0,16,1.324313,103.81688
299682,0,1,1,1.324289,103.817038
299683,2,0,2,1.323756,103.816881
299684,1,0,1,1.324319,103.816755
299685,3,5,8,1.324355,103.816448
299686,6,0,6,1.32436,103.816349
299687,0,1,1,1.324338,103.816556
299689,78,254,332,1.323699,103.815808
299690,6,3,9,1.323709,103.815711
299691,3,0,3,1.323697,103.816149
299692,12,73,85,1.323733,103.815467
299694,0,24,24,1.323884,103.815222
299695,0,4,4,1.323965,103.815149
299696,0,1,1,1.324372,103.816272
299697,3,0,3,1.323724,103.815601
299698,5,0,5,1.323773,103.815584
299699,1,0,1,1.324035,103.815064
299700,7,1,8,1.323748,103.815829
299704,0,2,2,1.324334,103.816674
299705,0,1,1,1.32376,103.815698
299706,11,0,11,1.324453,103.815591
299707,0,3,3,1.323788,103.815482
299708,9,0,9,1.324081,103.815394
299709,2,0,2,1.324432,103.815805
299710,3,0,3,1.324188,103.815402
299711,76,12,88,1.324419,103.815378
299715,2,0,2,1.324186,103.815345
299716,0,1,1,1.324441,103.81567
299718,0,1,1,1.324445,103.816101
299719,1,1,2,1.324461,103.815996
299720,1,0,1,1.324408,103.816418
299722,1,0,1,1.324379,103.816672
299723,55,0,55,1.323663,103.816146
299724,2,3,5,1.324505,103.815473
299743,37,46,83,1.326578,103.813984
299744,8,1,9,1.326472,103.814725
299745,30,11,41,1.326558,103.813984
299746,43,9,52,1.326234,103.814882
299747,1,4,5,1.326445,103.815389
299748,42,0,42,1.327053,103.814982
299749,42,1,43,1.326425,103.815389
299750,62,17,79,1.326473,103.815409
299751,23,6,29,1.326438,103.815512
299752,36,6,42,1.326586,103.8155
299753,2,0,2,1.324396,103.81656
299754,5,3,8,1.326706,103.815606
299755,10,2,12,1.326525,103.816374
299756,2,3,5,1.326548,103.816471
299758,33,3,36,1.326866,103.815925
299759,30,2,32,1.32673,103.817134
299760,0,2,2,1.326475,103.815881
299761,2,1,3,1.324284,103.815361
299762,8,2,10,1.32701,103.816248
299763,165,2,167,1.326099,103.815877
299764,438,18,456,1.326642,103.815796
299765,11,2,13,1.326206,103.816466
299766,8,2,10,1.326785,103.817111
299767,0,3,3,1.326938,103.816086
299768,5,0,5,1.32683,103.817098
299770,0,1,1,1.324356,103.816913
299791,14,117,131,1.327487,103.814256
299792,82,2,84,1.327271,103.814979
299793,13,0,13,1.327711,103.815181
299794,6,1,7,1.327659,103.815593
299795,15,1,16,1.328052,103.815844
299796,8,2,10,1.328436,103.816138
299797,6,0,6,1.328869,103.816403
299798,35,20,55,1.329074,103.815903
299799,9,0,9,1.328878,103.81579
299801,71,4,75,1.328207,103.815394
299802,25,4,29,1.32796,103.815217
299803,23,46,69,1.32791,103.814563
299805,82,91,173,1.328478,103.814524
299806,1,39,40,1.328931,103.81481
299807,2,1,3,1.325958,103.81663
299808,10,445,455,1.329329,103.815035
299809,7,11,18,1.329449,103.815401
299810,75,8,83,1.329007,103.816477
299811,43,485,528,1.32913,103.816063
299812,7,21,28,1.329662,103.815802
299813,226,4475,4701,1.32969,103.815175
299814,3835,60,3895,1.330031,103.816455
299816,22,0,22,1.328709,103.814675
299817,1,0,1,1.32709,103.81703
299818,1,1,2,1.32614,103.817326
299820,30,19,49,1.329129,103.816062
299836,4,7,11,1.32351,103.820619
299837,30,3,33,1.323628,103.820641
299838,8,1,9,1.32387,103.8207
299839,4,1,5,1.323555,103.820663
299840,5,16,21,1.324066,103.820739
299841,19,6,25,1.323842,103.820715
299842,7,2,9,1.324532,103.820826
299844,44,13,57,1.325056,103.820929
299845,9,3,12,1.325154,103.820947
299846,101,0,101,1.32442,103.820833
299847,9,1,10,1.325992,103.82108
299848,60,2,62,1.326076,103.821093
299849,7,0,7,1.324699,103.820885
299850,13,3,16,1.325021,103.820945
299851,49,14,63,1.3265,103.82108
299852,18,3,21,1.325557,103.821369
299853,58,0,58,1.326038,103.821137
299854,5,2,7,1.325733,103.821082
299855,16,1,17,1.327113,103.821586
299857,0,2,2,1.327459,103.814497
299858,11,15,26,1.324311,103.820782
299860,8,0,8,1.326666,103.821276
299861,0,11,11,1.326752,103.821333
299862,16,0,16,1.324137,103.82078
299863,6,0,6,1.32613,103.821164
299865,22,0,22,1.326552,103.821192
299866,3,6,9,1.326552,103.821192
299867,0,5,5,1.326552,103.821192
299877,10,4,14,1.32369,103.823211
299878,11,4,15,1.32329,103.822876
299879,85,0,85,1.323477,103.823517
299880,7,4,11,1.32341,103.823551
299881,3,2,5,1.323418,103.823701
299882,34,5,39,1.323332,103.823805
299883,3,1,4,1.323406,103.823786
299884,1,3,4,1.323272,103.824102
299885,2,6,8,1.323367,103.824214
299887,8,1,9,1.324127,103.823685
299888,4,0,4,1.323732,103.824264
299889,25,2,27,1.323903,103.82428
299890,61,1,62,1.324744,103.824127
299891,6,1,7,1.32408,103.824293
299892,15,4,19,1.324885,103.824055
299893,10,4,14,1.324246,103.824295
299894,6,3,9,1.324454,103.824241
299895,5,6,11,1.325023,103.823981
299896,1,13,14,1.324677,103.824186
299897,55,4,59,1.324899,103.82409
299898,1,0,1,1.327285,103.815254
299899,49,1,50,1.32508,103.823993
299900,1,0,1,1.325444,103.823766
299901,32,6,38,1.325467,103.823794
299902,6,7,13,1.32565,103.82371
299903,35,0,35,1.325963,103.823455
299904,1,1,2,1.324938,103.820903
299905,1,0,1,1.32529,103.823889
299906,12,0,12,1.326141,103.82309
299907,2,0,2,1.326055,103.82333
299908,144,0,144,1.326142,103.823314
299909,3,0,3,1.329123,103.814914
299910,7,4,11,1.326194,103.82319
299911,0,4,4,1.326149,103.82233
299912,0,3,3,1.32611,103.822466
299913,31,1,32,1.326179,103.82176
299914,31,0,31,1.326259,103.822196
299915,8,0,8,1.326299,103.821455
299916,31,2,33,1.326384,103.821885
299917,25,6,31,1.326467,103.821656
299918,7,3,10,1.326541,103.821488
299919,3,1,4,1.325718,103.823628
299920,50,1,51,1.323342,103.823995
299921,14,1,15,1.326115,103.823185
299922,16,0,16,1.326159,103.822954
299923,1,0,1,1.325971,103.823504
299924,12,0,12,1.323617,103.82422
299925,39,1,40,1.323351,103.823934
299926,9,3,12,1.325865,103.823539
299927,5,0,5,1.323272,103.824148
299928,28,2,30,1.323861,103.824246
299929,19,3,22,1.324053,103.824249
299930,29,0,29,1.324689,103.823959
299931,16,0,16,1.324918,103.824024
299932,33,7,40,1.323313,103.823852
299933,23,0,23,1.323263,103.823978
299936,71,0,71,1.299509,103.837
299937,1,0,1,1.326152,103.822796
299939,3963,8681,12644,1.338223,103.832729
299940,17,209,226,1.340095,103.831843
299941,24,71,95,1.340204,103.83146
299942,47,11,58,1.339996,103.831563
299943,3,15,18,1.339741,103.832002
299944,4,29,33,1.339788,103.831666
299945,1,1,2,1.326194,103.823746
299946,12,34,46,1.33958,103.831768
299947,3,35,38,1.339295,103.832283
299948,11,32,43,1.339372,103.831871
299949,143,324,467,1.339164,103.831974
299950,6,86,92,1.338598,103.831572
299951,131,22,153,1.338283,103.831416
299952,4,2,6,1.337903,103.831354
299953,212,0,212,1.337712,103.831486
299955,0,7,7,1.337391,103.831869
299956,3,0,3,1.32623,103.822813
299957,144,24,168,1.336269,103.833805
299958,3,0,3,1.337325,103.831922
299959,17,0,17,1.336183,103.834063
299960,101,2,103,1.336946,103.832381
299961,43,21,64,1.336776,103.832587
299962,11,19,30,1.336004,103.834361
299963,23,10,33,1.336607,103.832793
299964,2,7,9,1.336437,103.832998
299965,34,3,37,1.336268,103.833204
299966,1,1,2,1.339536,103.832184
299967,7,3,10,1.3361,103.833645
299968,12,13,25,1.335959,103.83386
299969,86,18,104,1.335876,103.834085
299971,4,5,9,1.335719,103.834355
299973,67,1,68,1.335616,103.834929
299974,17,1,18,1.335595,103.835205
299975,6,1,7,1.335541,103.835646
299976,18,2,20,1.335479,103.835868
299977,2,9,11,1.335417,103.83609
299978,2,12,14,1.335683,103.83596
299979,3,80,83,1.335364,103.836456
299980,1,6,7,1.335753,103.835473
299981,12,10,22,1.335235,103.834595
299982,43,57,100,1.335357,103.836615
299983,10,7,17,1.335839,103.834831
299985,8,4,12,1.335753,103.835208
299986,9,0,9,1.337115,103.832175
300001,259,1497,1756,1.325357,103.842168
300069,414,2553,2967,1.319189,103.85057
301001,9,3,12,1.325761,103.843076
307392,0,3,3,1.337115,103.832175
307393,0,1,1,1.299509,103.837
307396,0,1,1,1.299509,103.837
307397,0,9,9,1.299509,103.837
307398,1,3,4,1.299509,103.837
307399,0,1,1,1.299509,103.837
307400,0,2,2,1.336162,103.833423
307401,0,2,2,1.324934,103.838906
307408,5,10,15,1.362419,103.854868
307412,0,27,27,1.299509,103.837
307417,51,0,51,1.299509,103.837
307418,4,2,6,1.299509,103.837
307419,4,0,4,1.299509,103.837
307420,34,0,34,1.299509,103.837
307421,50,20,70,1.299509,103.837
307422,8,0,8,1.324017,103.843571
307428,3,27,30,1.319055,103.841178
307429,3,1,4,1.319055,103.841178
307430,85,42,127,1.319055,103.841178
307431,1,4,5,1.299509,103.837
307432,20,0,20,1.318879,103.839213
307433,4,0,4,1.319055,103.841178
307434,10,0,10,1.319055,103.841178
307435,15,0,15,1.319055,103.841178
307436,19,0,19,1.319055,103.841178
307437,1,0,1,1.299509,103.837
307438,1,0,1,1.318714,103.836866
307439,19,0,19,1.318714,103.836866
307440,17,20,37,1.318714,103.836866
307441,33,34,67,1.299509,103.837
307442,2,2,4,1.299509,103.837
307443,49,10,59,1.299509,103.837
307447,75,1,76,1.318714,103.836866
307454,0,3,3,1.299509,103.837
307455,0,12,12,1.318714,103.836866
307456,2,0,2,1.299509,103.837
307458,1,0,1,1.318714,103.836866
307459,62,0,62,1.318748,103.839127
307460,7,40,47,1.318523,103.83891
307461,1,9,10,1.318857,103.839134
307462,1772,3576,5348,1.315303,103.844572
307463,80,6,86,1.315221,103.844451
307464,1724,437,2161,1.315172,103.844334
307465,1478,7,1485,1.31509,103.844232
307467,3234,133,3367,1.319705,103.845613
307468,3145,524,3669,1.319428,103.845055
307469,237,1558,1795,1.319275,103.845191
307470,4620,55731,60351,1.320287,103.845191
307472,8,0,8,1.319585,103.836392
307473,27,2,29,1.319505,103.836367
307474,8,1,9,1.319471,103.836362
307475,5,1,6,1.319471,103.836362
307476,3,16,19,1.319441,103.836347
307478,3,0,3,1.318714,103.836866
307479,174,1,175,1.321547,103.835432
307480,6,1,7,1.321512,103.835436
307481,18,29,47,1.321502,103.835466
307482,18,0,18,1.32151,103.83552
307483,10,1,11,1.321328,103.835688
307484,10,1,11,1.32142,103.83559
307485,2,0,2,1.318714,103.836866
307486,5,0,5,1.319648,103.8364
307487,0,1,1,1.318748,103.839127
307488,2,0,2,1.319623,103.836395
307489,3,0,3,1.321565,103.835366
307490,14,52,66,1.321226,103.836798
307491,3,0,3,1.321241,103.836748
307492,5,0,5,1.321193,103.836252
307493,8,0,8,1.32147,103.835658
307494,6,0,6,1.321436,103.835674
307495,4,0,4,1.321499,103.835603
307496,23,0,23,1.321554,103.835526
307497,155,0,155,1.32161,103.835468
307498,10,1,11,1.32165,103.835388
307499,29,0,29,1.321625,103.835433
307500,62,0,62,1.321605,103.835498
307501,8,0,8,1.321802,103.835636
307502,3,0,3,1.322692,103.835819
307503,16,0,16,1.3217,103.835584
307504,6,0,6,1.321665,103.83558
307505,163,83,246,1.321616,103.83567
307506,6382,34115,40497,1.321061,103.844476
307507,7,47,54,1.324229,103.842979
307508,15,7,22,1.324208,103.843035
307509,8,14,22,1.324169,103.843097
307510,5,1,6,1.324112,103.843169
307511,17,6,23,1.322791,103.839016
307512,55,114,169,1.324333,103.839039
307516,138,1,139,1.324729,103.84457
307518,0,23,23,1.32013,103.831226
307519,41,14,55,1.320322,103.830674
307520,23,0,23,1.320881,103.831008
307521,59,3,62,1.321064,103.830969
307522,40,10,50,1.321053,103.831308
307582,138,1931,2069,1.315081,103.844929
307583,16,0,16,1.315081,103.844929
307584,206,360,566,1.315081,103.844929
307585,9,681,690,1.315081,103.844929
307587,22,958,980,1.315571,103.84509
307588,33,95,128,1.315571,103.84509
307589,18,648,666,1.315573,103.845089
307590,372,367,739,1.315574,103.845089
307591,9094,2633,11727,1.317711,103.843491
307592,10,849,859,1.316794,103.844848
307593,3,162,165,1.316832,103.844857
307594,50,134,184,1.316878,103.84483
307595,6,427,433,1.316957,103.844816
307596,20,2369,2389,1.31703,103.844801
307605,2420,891,3311,1.318047,103.844687
307606,22,5309,5331,1.318071,103.844033
307607,5,261,266,1.318166,103.843961
307608,7,195,202,1.318166,103.843961
307610,1,223,224,1.318166,103.843961
307612,0,28,28,1.318166,103.843961
307614,1,166,167,1.318166,103.843961
307616,4,61,65,1.318166,103.843961
307618,5,48,53,1.318166,103.843961
307619,60,120,180,1.318166,103.843961
307621,1,46,47,1.318166,103.843961
307622,6,231,237,1.318014,103.843346
307623,80,5054,5134,1.317942,103.843306
307624,2,22,24,1.318264,103.843975
307625,0,47,47,1.318266,103.843975
307626,5,117,122,1.318268,103.843974
307627,11,240,251,1.318271,103.843973
307628,0,3,3,1.32177,103.835606
307629,0,1,1,1.321188,103.836615
307631,2,11,13,1.318281,103.843969
307632,0,188,188,1.318681,103.843452
307633,7,46,53,1.318194,103.843346
307634,4,50,54,1.318226,103.84329
307635,3,63,66,1.318264,103.843283
307636,12,103,115,1.318315,103.843229
307637,3,14,17,1.318431,103.84334
307638,25,6,31,1.318432,103.843278
307639,37,19,56,1.318301,103.843961
307640,5,19,24,1.318533,103.843226
307642,689,608,1297,1.320276,103.843517
307643,13,999,1012,1.315701,103.845042
307644,201,3110,3311,1.320286,103.842021
307645,67,1527,1594,1.321334,103.841622
307646,179,1436,1615,1.321674,103.841355
307652,94,24,118,1.322075,103.841087
307653,9,9,18,1.321876,103.843305
307654,0,53,53,1.32315,103.842054
307655,40,494,534,1.323225,103.842034
307656,4,270,274,1.323293,103.842045
307657,1,1,2,1.321176,103.836675
307658,23,326,349,1.323451,103.842096
307659,7,169,176,1.323512,103.842096
307660,46,58,104,1.323551,103.842114
307662,4,123,127,1.323634,103.84212
307663,39,13,52,1.32368,103.842108
307665,14,845,859,1.323777,103.842115
307666,127,726,853,1.323967,103.841456
307667,4,1,5,1.324301,103.841007
307668,72,7,79,1.324103,103.841024
307669,46,4,50,1.318448,103.843899
307670,6,17,23,1.324407,103.841263
307671,11,368,379,1.324384,103.841506
307672,48,1886,1934,1.324182,103.842211
307673,106,18989,19095,1.324793,103.841602
307674,248,44,292,1.324654,103.841361
307675,382,60,442,1.32534,103.840958
307676,90,5371,5461,1.325351,103.841441
307677,2976,1274,4250,1.325389,103.841475
307678,4,16,20,1.325364,103.841472
307679,0,55,55,1.32648,103.841291
307682,470,2581,3051,1.317722,103.844904
307683,6986,2340,9326,1.319826,103.843998
307684,2529,69775,72304,1.319831,103.843998
307685,523,1366,1889,1.319319,103.844186
307686,166,40,206,1.324615,103.841125
307687,117,52,169,1.324811,103.840862
307689,92,10,102,1.32124,103.841592
307690,123,144,267,1.299509,103.837
307701,28,19,47,1.326339,103.839977
307702,10,8,18,1.326261,103.840002
307703,30,1,31,1.32641,103.840168
307704,33,7,40,1.32645,103.840335
307705,11,0,11,1.326314,103.840241
307706,2,0,2,1.323382,103.842103
307707,3,3,6,1.326439,103.840701
307708,5,7,12,1.325942,103.840859
307709,31,1,32,1.325896,103.840673
307710,6,30,36,1.325812,103.840465
307711,7,2,9,1.326075,103.841009
307712,39,30,69,1.32576,103.84028
307713,1,7,8,1.325991,103.841142
307714,20,13,33,1.32605,103.841453
307715,13,342,355,1.325938,103.841479
307716,4,0,4,1.325894,103.841299
307717,99,3,102,1.325861,103.841129
307718,109,3,112,1.325805,103.840937
307719,2,0,2,1.326474,103.840905
307720,39,16,55,1.325629,103.840337
307721,228,1,229,1.326357,103.840439
307722,0,2,2,1.325725,103.840654
307723,107,6,113,1.326337,103.840946
307724,6,408,414,1.326148,103.841447
307725,38,1,39,1.326184,103.840975
307726,3,29,32,1.325762,103.841472
307727,7,14,21,1.299509,103.837
307740,342,1591,1933,1.316232,103.84173
307741,11,89,100,1.316232,103.84173
307742,48,740,788,1.316124,103.841692
307743,219,182,401,1.316213,103.841892
307745,126,71,197,1.316066,103.841914
307746,383,260,643,1.316148,103.842156
307747,80,101,181,1.31611,103.842261
307748,114,68,182,1.316021,103.842127
307750,186,195,381,1.315989,103.842248
307753,1,14,15,1.316001,103.842355
307754,32,44,76,1.315853,103.843197
307755,2,35,37,1.315938,103.842375
307758,2,139,141,1.315755,103.843096
307759,2,0,2,1.326369,103.84051
307760,17,0,17,1.315691,103.843302
307761,2,206,208,1.315877,103.842686
307762,1318,88,1406,1.315268,103.84239
307780,721,95,816,1.314487,103.84478
307781,276,18,294,1.314389,103.844664
307785,3,91,94,1.314365,103.84403
307786,298,327,625,1.314432,103.844255
307787,1,6,7,1.314385,103.844263
307788,335,36,371,1.314336,103.844173
307807,8,518,526,1.318414,103.846943
307808,11,499,510,1.318278,103.846997
307809,79,6,85,1.318157,103.847008
307810,11,9,20,1.31802,103.847035
307811,69,8,77,1.318098,103.846968
307813,8,194,202,1.318556,103.847036
307814,1,4,5,1.318543,103.847039
307815,35,1,36,1.318531,103.847041
307816,0,1,1,1.318276,103.843971
307817,1,0,1,1.318518,103.847044
307818,0,37,37,1.318022,103.847143
307819,9,2,11,1.318494,103.847049
307820,22,3,25,1.318031,103.847191
307821,4,23,27,1.318481,103.847051
307822,7,3,10,1.31848,103.84705
307823,31,7,38,1.318049,103.847288
307824,37,6,43,1.318067,103.847385
307825,29,4,33,1.318456,103.847056
307826,1,19,20,1.318085,103.847482
307827,49,20,69,1.318444,103.847059
307829,6,6,12,1.318138,103.847773
307830,2,0,2,1.315726,103.843201
307831,0,6,6,1.318155,103.847869
307833,1,0,1,1.318506,103.847046
307834,55,52,107,1.318438,103.848277
307835,3,2,5,1.318282,103.848548
307836,1,7,8,1.318299,103.848645
307837,14,18,32,1.318317,103.848742
307838,0,4,4,1.318353,103.848935
307839,3,24,27,1.318389,103.849129
307841,1,14,15,1.318407,103.849226
307842,100,24,124,1.318425,103.849323
307843,1,31,32,1.318443,103.84942
307845,47,3,50,1.31846,103.849516
307846,95,8,103,1.318478,103.849614
307847,6,6,12,1.318496,103.84971
307848,3,40,43,1.318532,103.849904
307849,0,25,25,1.31855,103.850001
307850,1,2,3,1.318273,103.843972
307851,1,79,80,1.318577,103.850198
307852,4,58,62,1.318558,103.850475
307853,3,72,75,1.318535,103.850583
307854,3,403,406,1.318651,103.849336
307855,9,6,15,1.318627,103.849478
307856,59,21,80,1.318702,103.84969
307857,0,5,5,1.318342,103.847891
307858,1,1,2,1.318156,103.84787
307876,15,13,28,1.324934,103.838138
307877,25,0,25,1.32476,103.838127
307878,148,8,156,1.324826,103.838189
307879,25,7,32,1.324672,103.838195
307880,43,1,44,1.324485,103.838155
307881,95,9,104,1.32458,103.838123
307882,29,1,30,1.32436,103.838105
307883,9,1,10,1.324472,103.838105
307903,74,1014,1088,1.321034,103.842393
307904,5,422,427,1.321034,103.842444
307905,2,1,3,1.318568,103.850098
307906,0,90,90,1.321094,103.842555
307908,20,21,41,1.321129,103.842658
307910,27,2,29,1.321172,103.842769
307911,3,7,10,1.32118,103.842828
307912,67,2,69,1.321206,103.842897
307913,9,81,90,1.321249,103.842965
307914,2,1,3,1.321051,103.842487
307915,0,19,19,1.321301,103.843093
307916,1,3,4,1.321335,103.843161
307917,3,60,63,1.321352,103.843221
307918,0,3,3,1.321275,103.843025
307919,1,8,9,1.321416,103.843326
307920,20,985,1005,1.321433,103.843372
307921,37,40,77,1.321456,103.843423
307922,2,71,73,1.321479,103.843474
307923,72,21977,22049,1.32149,103.843525
307943,1580,722,2302,1.313917,103.839665
307944,44,960,1004,1.314528,103.839689
307945,1618,1101,2719,1.314812,103.840148
307947,775,643,1418,1.313604,103.839798
307948,247,8,255,1.314613,103.839526
307951,151,63,214,1.315193,103.839975
307953,1616,685,2301,1.314627,103.841302
307954,403,3600,4003,1.314708,103.840682
307955,1439,415,1854,1.315028,103.840799
307956,763,2227,2990,1.315376,103.841282
307957,214,62,276,1.315696,103.841686
307959,0,23,23,1.316152,103.840403
307960,0,1,1,1.318192,103.848063
307962,3,134,137,1.316245,103.841127
307963,4,407,411,1.316386,103.84124
307964,1176,7977,9153,1.316825,103.841912
307965,61,6072,6133,1.316604,103.841276
307966,290,1601,1891,1.317183,103.84105
307968,71,3972,4043,1.317556,103.841209
307970,40,2,42,1.318051,103.841281
307971,67,553,620,1.318225,103.841479
307983,585,11003,11588,1.31873,103.843146
307984,4,8,12,1.316244,103.841126
307985,2,191,193,1.316244,103.841126
307986,2,103,105,1.316244,103.841126
307987,3733,6005,9738,1.319597,103.842258
307988,7,382,389,1.316385,103.841239
307989,589,3962,4551,1.314287,103.841141
307990,1613,160,1773,1.314808,103.841959
307991,2332,1512,3844,1.317523,103.841834
307992,2147,192,2339,1.316781,103.842515
307993,27,2931,2958,1.317163,103.842378
307994,1746,951,2697,1.317987,103.842058
307995,188,1436,1624,1.314218,103.840682
307996,110,23033,23143,1.320737,103.835621
307997,2344,290,2634,1.315004,103.83999
308003,5,2,7,1.322206,103.834116
308004,6,5,11,1.32205,103.834154
308005,89,2,91,1.322165,103.834131
308006,7,0,7,1.32195,103.834216
308007,0,2,2,1.318343,103.847973
308008,1,0,1,1.316453,103.84051
308009,1,2,3,1.321393,103.843269
308011,60,0,60,1.322022,103.834209
308012,0,1,1,1.321926,103.834228
308013,108,1,109,1.321967,103.834238
308014,12,0,12,1.321843,103.834273
308015,3,0,3,1.322071,103.834182
308035,148,22,170,1.321097,103.83681
308036,7,6,13,1.321366,103.836652
308037,36,0,36,1.321396,103.836658
308038,42,14,56,1.321525,103.836643
308040,3,1,4,1.321638,103.836335
308041,0,1,1,1.321872,103.834253
308042,34,25,59,1.322219,103.836568
308043,26,19,45,1.322223,103.836524
308044,17,1,18,1.322333,103.836375
308045,106,0,106,1.322347,103.836324
308046,16,2,18,1.322371,103.836263
308047,9,0,9,1.322602,103.835906
308048,9,4,13,1.322056,103.83586
308051,3,3,6,1.322795,103.835665
308053,25,0,25,1.322659,103.834775
308054,13,0,13,1.322536,103.834454
308056,0,7,7,1.322258,103.834095
308058,1,0,1,1.322248,103.836507
308059,1,0,1,1.322294,103.836443
308060,92,1,93,1.322261,103.836441
308061,15,0,15,1.322267,103.836478
308062,28,0,28,1.322307,103.836416
308063,44,6,50,1.322509,103.835934
308064,100,0,100,1.322522,103.835868
308065,14,8,22,1.322551,103.835822
308066,235,0,235,1.32259,103.8358
308067,124,17,141,1.322639,103.835773
308068,118,0,118,1.322514,103.833654
308069,2,0,2,1.322119,103.834158
308071,37,0,37,1.321045,103.836626
308072,9,0,9,1.320993,103.836589
308073,2,0,2,1.3211,103.836771
308074,8,0,8,1.321113,103.836491
308075,3,0,3,1.321869,103.834288
308076,26,906,932,1.319503,103.852021
308078,46,1052,1098,1.319144,103.850079
308079,1,30,31,1.319094,103.849816
308080,46,4113,4159,1.318942,103.849457
308081,27,1271,1298,1.318947,103.848952
308082,3,7,10,1.318894,103.848728
308083,116,571,687,1.318848,103.848575
308084,0,32,32,1.318802,103.848437
308085,3,286,289,1.318805,103.848301
308086,12,308,320,1.318731,103.84806
308087,107,631,738,1.319697,103.84792
308088,8,156,164,1.318703,103.847946
308089,412,222,634,1.318938,103.847747
308090,28,693,721,1.31852,103.847257
308091,368,620,988,1.318452,103.846747
308092,284,9,293,1.318406,103.846653
308093,28,265,293,1.318382,103.846392
308094,3,149,152,1.318382,103.846392
308095,266,1597,1863,1.318583,103.845507
308106,5,286,291,1.318692,103.847846
308107,1166,1261,2427,1.318602,103.845041
308108,664,2105,2769,1.318417,103.847735
308109,6,48,54,1.299509,103.837
308125,313,75,388,1.319628,103.846872
308129,10,25,35,1.319382,103.846651
308131,0,24,24,1.319379,103.846547
308133,609,35,644,1.319613,103.846341
308134,20,372,392,1.31929,103.846344
308135,0,22,22,1.319634,103.846291
308137,0,79,79,1.319695,103.846236
308138,2,112,114,1.319762,103.846179
308139,7,163,170,1.319803,103.846137
308140,8,900,908,1.319429,103.845991
308141,226,217,443,1.319883,103.846088
308142,28,5453,5481,1.319952,103.846026
308143,694,598,1292,1.31928,103.846886
308144,474,285,759,1.319314,103.846621
308162,1762,429,2191,1.323565,103.84994
308164,3,20,23,1.323746,103.84976
308165,0,9,9,1.323922,103.849569
308166,391,245,636,1.323826,103.849366
308167,1,8,9,1.324021,103.849481
308168,1,51,52,1.32401,103.849306
308169,1,19,20,1.32417,103.849329
308170,1,303,304,1.324317,103.849203
308172,457,10,467,1.324312,103.849006
308174,2,41,43,1.299509,103.837
308175,1,30,31,1.299509,103.837
308176,0,5,5,1.299509,103.837
308178,19,22,41,1.325037,103.848268
308179,1,8,9,1.325087,103.848219
308180,1,12,13,1.325158,103.848154
308181,0,3,3,1.321137,103.836518
308182,1,19,20,1.325284,103.848011
308183,2,167,169,1.325317,103.847956
308184,152,39,191,1.325315,103.848424
308185,168,20,188,1.325456,103.848193
308186,471,132,603,1.323338,103.850173
308205,1573,4378,5951,1.320073,103.849139
308206,8,199,207,1.321063,103.849499
308208,1184,517,1701,1.32244,103.849057
308214,1472,600,2072,1.32319,103.849128
308215,593,415,1008,1.323353,103.849253
308216,956,188,1144,1.323531,103.849254
308217,10,197,207,1.3234,103.84943
308225,778,104,882,1.324107,103.84975
308226,0,18,18,1.324107,103.84975
308227,233,337,570,1.324284,103.84996
308228,2,5,7,1.324284,103.84996
308231,57,20,77,1.324608,103.850328
308232,1422,387,1809,1.321838,103.848875
308251,2,4,6,1.324013,103.834969
308252,14,0,14,1.32404,103.834974
308253,26,4,30,1.323426,103.834319
308254,38,263,301,1.324899,103.833762
308255,99,100,199,1.324877,103.833767
308256,18,6,24,1.324718,103.833177
308257,47,22,69,1.324695,103.833153
308258,57,20,77,1.324401,103.83271
308259,308,162,470,1.325289,103.83174
308260,89,10,99,1.324205,103.832629
308261,25,3,28,1.324628,103.831846
308262,0,10,10,1.32401,103.831508
308263,622,9,631,1.323409,103.831223
308264,6,18,24,1.323734,103.83086
308265,20,9,29,1.323911,103.830676
308266,212,13,225,1.323579,103.83038
308267,163,6,169,1.32442,103.831096
308268,24,16,40,1.324206,103.830221
308269,84,0,84,1.32554,103.830384
308270,5,4,9,1.322754,103.829092
308271,8,7,15,1.322294,103.828733
308272,0,17,17,1.322201,103.827902
308273,34,39,73,1.3225,103.827445
308274,563,6,569,1.322914,103.828591
308275,14,4,18,1.32217,103.827174
308276,1,5,6,1.321765,103.826744
308278,3,133,136,1.324436,103.834385
308296,26,4,30,1.324534,103.83006
308297,76,65,141,1.324993,103.830322
308298,19,62,81,1.325005,103.8297
308299,0,11,11,1.325026,103.829691
308300,50,2,52,1.324941,103.829043
308301,27,5,32,1.324943,103.829015
308302,60,14,74,1.324943,103.829022
308322,553,1528,2081,1.318842,103.845943
308323,264,2863,3127,1.319145,103.845879
308342,3364,1608,4972,1.314224,103.84357
308343,281,6,287,1.31434,103.843747
308345,1142,74,1216,1.314849,103.843471
308346,285,139,424,1.314693,103.842779
308347,443,116,559,1.314486,103.842747
308349,462,338,800,1.314917,103.842741
308353,1282,560,1842,1.314762,103.842807
308362,580,258,838,1.316258,103.843161
308363,664,233,897,1.31491,103.843028
308364,3566,93,3659,1.314442,103.843166
308365,1019,1128,2147,1.313759,103.842678
308366,2472,132,2604,1.315161,103.84354
308380,1138,29301,30439,1.317164,103.843018
308381,1067,5266,6333,1.31741,103.84288
308401,5,2831,2836,1.313965,103.845034
308402,0,335,335,1.313975,103.845078
308404,11,23,34,1.313934,103.844857
308405,6,8,14,1.313884,103.844528
308409,1433,450,1883,1.313439,103.841163
308410,4,11,15,1.299509,103.837
308414,1828,632,2460,1.313536,103.842067
308433,8313,12701,21014,1.321097,103.84564
308434,18,327,345,1.320011,103.84804
308436,546,3617,4163,1.320539,103.849128
308437,134,962,1096,1.320537,103.849123
308438,181,144,325,1.323714,103.847153
308439,3,42,45,1.325373,103.847514
308440,133,1640,1773,1.320537,103.847773
308441,1024,81275,82299,1.322189,103.846468
308455,41,22,63,1.319168,103.837347
308456,19,43,62,1.319046,103.837479
308457,1,2,3,1.325219,103.848083
308458,104,1,105,1.319005,103.837788
308459,2,6,8,1.318889,103.837803
308462,6,2,8,1.318762,103.837568
308479,0,3,3,1.319065,103.837598
308480,0,4,4,1.323137,103.842508
308481,1,0,1,1.322245,103.836478
308482,0,1,1,1.323263,103.842468
308483,11,1,12,1.323361,103.842472
308485,2,1,3,1.323162,103.842468
308486,3,0,3,1.32345,103.842466
308487,75,0,75,1.323503,103.842469
308488,50,0,50,1.323372,103.842525
308491,12,0,12,1.323665,103.842487
308492,2,6,8,1.323578,103.842525
308494,11,1,12,1.323635,103.842536
308495,0,2,2,1.320978,103.836529
308496,1,0,1,1.3232,103.842513
308497,0,2,2,1.323804,103.842504
308498,1,0,1,1.323716,103.842554
308499,14,0,14,1.323914,103.842539
308500,2,1,3,1.323338,103.842513
308501,1,1,2,1.323862,103.842521
308503,0,1,1,1.323802,103.842577
308505,10,84,94,1.324118,103.842571
308506,12,4,16,1.324117,103.842633
308526,4,4,8,1.323216,103.843057
308527,7,3,10,1.323199,103.843109
308528,1,4,5,1.323176,103.84316
308529,6,18,24,1.323217,103.842986
308530,2,4,6,1.323159,103.843211
308531,2,0,2,1.323994,103.84255
308533,9,4,13,1.323119,103.843313
308536,2,0,2,1.323142,103.843262
308537,4,0,4,1.323055,103.843458
308538,9,0,9,1.323032,103.84352
308539,5,1,6,1.323009,103.843583
308559,1,5,6,1.322902,103.843558
308560,5,1,6,1.32282,103.843528
308561,14,3,17,1.322748,103.843516
308562,1,0,1,1.324049,103.84256
308563,36,0,36,1.322638,103.843459
308564,0,4,4,1.322609,103.843489
308565,28,0,28,1.322572,103.843438
308566,0,1,1,1.322688,103.843495
308567,1,2,3,1.323916,103.842582
308569,1,0,1,1.322549,103.843483
308570,5,2,7,1.322462,103.843427
308571,0,1,1,1.322465,103.843393
308572,9,1,10,1.322405,103.843399
308573,15,2,17,1.322363,103.843341
308574,5,2,7,1.322347,103.843376
308575,2,2,4,1.322322,103.843335
308577,13,0,13,1.322279,103.843316
308579,50,28,78,1.322234,103.843291
308580,9,3,12,1.322187,103.843319
308581,13,0,13,1.322182,103.843264
308582,7,176,183,1.322135,103.843302
308583,36,5,41,1.322128,103.843239
308584,1,7,8,1.322783,103.84349
308585,1,0,1,1.322411,103.843369
308603,131,904,1035,1.32295,103.842208
308604,40,86,126,1.322889,103.842202
308605,102,54,156,1.322796,103.842196
308606,7,41,48,1.322748,103.84219
308607,58,24,82,1.322676,103.842193
308608,10,25,35,1.32261,103.842193
308609,5,32,37,1.322538,103.842193
308610,10,16,26,1.322481,103.842178
308611,73,12,85,1.3224,103.842181
308612,3,28,31,1.322349,103.842175
308613,2,69,71,1.322277,103.842166
308614,13,608,621,1.322223,103.842175
308615,1,2,3,1.322518,103.843417
308616,7,1,8,1.322999,103.842619
308617,63,1,64,1.322987,103.842767
308618,1,7,8,1.322964,103.842924
308638,5,2,7,1.322733,103.8428
308639,132,2,134,1.322611,103.842773
308640,0,10,10,1.322821,103.842845
308641,4,3,7,1.322645,103.842791
308642,4,2,6,1.323087,103.842928
308645,1,0,1,1.322697,103.843471
308646,1,1,2,1.323072,103.843406
308647,11,1,12,1.323557,103.843007
308648,0,9,9,1.323626,103.84301
308649,1,0,1,1.32338,103.842984
308650,0,14,14,1.323689,103.843151
308651,11,9,20,1.323712,103.843133
308652,1,33,34,1.323666,103.843199
308655,2,0,2,1.323491,103.843
308656,1,8,9,1.323629,103.843305
308657,3,0,3,1.323006,103.842546
308658,1,5,6,1.323606,103.843369
308659,1,0,1,1.323717,103.843019
308660,9,0,9,1.323587,103.843422
308661,3,1,4,1.323668,103.843261
308662,3,4,7,1.32357,103.843474
308663,51,0,51,1.323659,103.843291
308664,35,17,52,1.323554,103.843534
308665,10,1,11,1.323649,103.843319
308666,19,0,19,1.323529,103.843586
308667,34,0,34,1.32364,103.843342
308668,3,5,8,1.323515,103.843639
308669,13,0,13,1.323634,103.843366
308670,18,0,18,1.323621,103.843403
308671,3,0,3,1.323685,103.843209
308672,7,0,7,1.323601,103.843469
308673,36,1,37,1.323588,103.843499
308674,54,3,57,1.322885,103.842872
308675,1,2,3,1.323612,103.843435
308676,0,3,3,1.322756,103.842842
308677,3,0,3,1.322803,103.842857
308678,1,2,3,1.322835,103.842876
308680,7,2,9,1.322936,103.842915
308681,1,7,8,1.322966,103.842936
308693,1,271,272,1.323039,103.841497
308694,10,550,560,1.323089,103.841414
308695,3,39,42,1.323189,103.841247
308696,47,13,60,1.323239,103.841183
308697,147,60,207,1.323239,103.841163
308698,0,5,5,1.323137,103.840839
308699,1,1,2,1.323695,103.843184
308700,1,0,1,1.323678,103.843238
308701,8,2,10,1.32312,103.840832
308702,0,2,2,1.32322,103.840996
308703,127,2,129,1.323021,103.840667
308704,0,2,2,1.323114,103.840464
308705,1,0,1,1.322971,103.840565
308706,0,9,9,1.32352,103.840227
308707,18,0,18,1.323134,103.840433
308708,12,15,27,1.32356,103.840324
308709,0,3,3,1.322868,103.842893
308710,6,1,7,1.32361,103.840432
308711,57,1,58,1.323443,103.840252
308712,1,3,4,1.323632,103.840541
308713,43,0,43,1.32351,103.840217
308714,9,1,10,1.323694,103.840676
308715,1,4,5,1.323572,103.840175
308716,0,2,2,1.323385,103.840306
308717,2,2,4,1.323623,103.840143
308718,17,7,24,1.323726,103.840078
308719,5,2,7,1.323831,103.840862
308720,37,0,37,1.32383,103.840014
308721,0,3,3,1.323288,103.840342
308723,1,0,1,1.322971,103.840565
308724,4,1,5,1.324026,103.839895
308725,6,0,6,1.323667,103.840168
308726,41,2,43,1.32388,103.840032
308727,210,0,210,1.323778,103.840066
308728,1,0,1,1.32365,103.840475
308729,574,20,594,1.323072,103.841462
308730,5,1,6,1.323189,103.841247
308731,1,0,1,1.324036,103.839905
308769,0,9,9,1.315482,103.844024
308770,0,4,4,1.315562,103.843964
308771,0,3,3,1.323771,103.840733
308772,0,2,2,1.323764,103.840812
308773,0,6,6,1.315826,103.84406
308774,6,37,43,1.31598,103.844205
308823,1,14,15,1.319741,103.832541
308824,0,18,18,1.319689,103.83257
308825,3,1,4,1.319798,103.832564
308826,4,0,4,1.319729,103.832587
308827,1,0,1,1.299509,103.837
308830,0,1,1,1.31985,103.832575
308832,14,0,14,1.319861,103.832638
308833,1,1,2,1.315662,103.843904
308834,33,4,37,1.319907,103.832644
308835,167,0,167,1.319959,103.832661
308836,5,0,5,1.320079,103.832649
308837,16,1,17,1.319999,103.832678
308838,2,2,4,1.320154,103.832683
308839,0,2,2,1.320022,103.832626
308840,0,33,33,1.320228,103.832712
308841,5,5,10,1.320329,103.832758
308842,14,15,29,1.320406,103.832739
308843,2,0,2,1.320248,103.83275
308863,10,0,10,1.319485,103.832838
308864,0,1,1,1.319821,103.832615
308865,0,2,2,1.320472,103.832643
308868,5,2,7,1.319594,103.832479
308869,60,3,63,1.319622,103.832411
308870,18,0,18,1.319651,103.832325
308871,1,4,5,1.319674,103.832246
308872,7,1,8,1.319708,103.832166
308873,5,0,5,1.319719,103.832103
308874,1,1,2,1.319531,103.832713
308875,4,1,5,1.319771,103.831967
308877,15,0,15,1.319805,103.831836
308878,0,1,1,1.319508,103.832775
308879,71,2,73,1.319857,103.831716
308899,795,22169,22964,1.318222,103.842817
308900,1023,600,1623,1.318222,103.842817
308920,1,12,13,1.321616,103.832904
308921,15,26,41,1.321642,103.832871
308922,1,1,2,1.319742,103.83203
308923,13,3,16,1.321665,103.832777
308924,2,0,2,1.321665,103.832823
308925,3,0,3,1.315642,103.843904
308926,1,0,1,1.319822,103.831785
308927,14,11,25,1.321646,103.832507
308928,58,0,58,1.32164,103.83243
308929,12,3,15,1.32166,103.83237
308930,3,7,10,1.321739,103.832283
308931,15,1,16,1.32169,103.832287
308950,97,7,104,1.319938,103.831912
308951,2,17,19,1.319898,103.831966
308953,9,1,10,1.319972,103.832
308954,4,1,5,1.320069,103.831974
308955,20,6,26,1.320052,103.832028
308956,11,8,19,1.320144,103.831986
308957,7,1,8,1.320131,103.832051
308958,2,0,2,1.321664,103.832726
308959,1,0,1,1.321652,103.832582
308960,1,1,2,1.320207,103.832003
308961,10,0,10,1.320278,103.832093
308963,0,1,1,1.320215,103.83207
308964,4,2,6,1.320421,103.832144
308965,1,0,1,1.320327,103.832048
308966,26,0,26,1.320495,103.832164
308967,24,3,27,1.320453,103.832082
308969,2,1,3,1.321657,103.832661
308970,26,4,30,1.320625,103.832207
308971,3,1,4,1.320596,103.832116
308972,1,0,1,1.32039,103.832065
308975,20,7,27,1.32074,103.832168
308976,3,1,4,1.320825,103.832264
308977,0,2,2,1.320276,103.832026
308978,0,2,2,1.32082,103.832185
308979,1,10,11,1.320894,103.832213
308999,2,189,191,1.319339,103.831585
309000,7,14,21,1.319329,103.833266
309001,2,56,58,1.31931,103.831682
309002,9,4,13,1.319454,103.83331
309003,1,0,1,1.320676,103.832224
309004,0,1,1,1.319259,103.831801
309005,5,3,8,1.319236,103.831881
309006,1,6,7,1.319685,103.833381
309007,31,2,33,1.319185,103.832012
309008,4,19,23,1.319156,103.832097
309009,4,23,27,1.319122,103.832234
309010,1,21,22,1.319099,103.832331
309011,16,152,168,1.319053,103.832456
309012,6,298,304,1.319024,103.832547
309013,3,0,3,1.320528,103.832099
309014,3,711,714,1.318946,103.832766
309015,2,74,76,1.31906,103.832971
309017,10,11,21,1.319429,103.833233
309018,3,0,3,1.31899,103.832672
309019,15,0,15,1.319759,103.833318
309020,5,3,8,1.319855,103.83334
309021,400,3,403,1.320766,103.83324
309022,1,1,2,1.320894,103.832286
309023,8,0,8,1.320835,103.833295
309024,21,0,21,1.320099,103.833276
309025,0,12,12,1.320888,103.83336
309026,1,0,1,1.319579,103.833364
309027,0,7,7,1.320655,103.833532
309028,1,0,1,1.320353,103.833187
309029,481,155,636,1.321314,103.833502
309030,0,12,12,1.321157,103.833768
309031,184,3,187,1.321514,103.833943
309032,0,3,3,1.319607,103.833311
309034,22,0,22,1.320978,103.832488
309035,12,2,14,1.321007,103.832414
309036,2,0,2,1.32,103.833316
309037,7,2,9,1.321047,103.832283
309039,189,3,192,1.321098,103.832152
309040,2,0,2,1.321035,103.832351
309041,30,0,30,1.321138,103.832027
309042,6,2,8,1.319091,103.833009
309043,174,4,178,1.319476,103.833256
309047,4,19,23,1.320135,103.833388
309048,2,2,4,1.320256,103.833349
309049,0,1,1,1.320462,103.833116
309050,1,11,12,1.320256,103.833349
309051,1,43,44,1.299509,103.837
309061,1528,1234,2762,1.315114,103.838436
309062,38,103,141,1.31556,103.838354
309063,46,29,75,1.315441,103.838244
309064,35,229,264,1.315561,103.838489
309065,691,172,863,1.315835,103.838689
309068,108,38,146,1.316229,103.838848
309069,27,69,96,1.316485,103.838833
309070,253,62,315,1.316698,103.838818
309071,165,75,240,1.317463,103.838745
309072,365,49,414,1.317034,103.839248
309073,52,4,56,1.317328,103.83875
309074,41,1,42,1.31738,103.838734
309075,13,47,60,1.317466,103.839266
309076,325,129,454,1.317592,103.83875
309077,5,63,68,1.317592,103.83875
309078,18,5,23,1.317666,103.839298
309079,237,26,263,1.317318,103.838062
309080,133,62,195,1.317911,103.839245
309081,0,4,4,1.317888,103.838714
309082,234,0,234,1.318161,103.839139
309083,327,29,356,1.318355,103.838637
309085,1,0,1,1.320256,103.833349
309086,65,2,67,1.318587,103.838854
309087,13,0,13,1.318658,103.838855
309088,10,0,10,1.318782,103.838994
309090,11,10,21,1.318909,103.839336
309091,80,12,92,1.31889,103.83927
309093,1,9,10,1.319157,103.839563
309094,245,36,281,1.318055,103.839645
309095,7,0,7,1.31921,103.839711
309096,1,2,3,1.320944,103.832624
309097,91,35,126,1.318867,103.839356
309098,84,9,93,1.31893,103.839616
309099,45,2,47,1.319208,103.83993
309101,108,3,111,1.319223,103.840193
309103,91,3,94,1.319013,103.839667
309104,274,132,406,1.318966,103.840335
309105,20,0,20,1.319611,103.840323
309106,4,12,16,1.318871,103.840602
309107,21,17,38,1.318786,103.840859
309108,1,41,42,1.319,103.840488
309109,1,7,8,1.318928,103.840679
309110,35,43,78,1.319071,103.841052
309111,1,3,4,1.31908,103.841122
309112,1,109,110,1.319099,103.841261
309113,4,2,6,1.319119,103.8414
309114,5,50,55,1.319138,103.841539
309115,3,14,17,1.319083,103.840167
309116,115,5930,6045,1.319147,103.841668
309117,9,0,9,1.318524,103.838911
309118,11,6,17,1.318523,103.83891
309119,25,15,40,1.318523,103.83891
309120,1,4,5,1.318523,103.83891
309121,93,11,104,1.318523,103.83891
309122,16,6,22,1.318523,103.83891
309123,70,166,236,1.318523,103.83891
309126,23,39,62,1.318749,103.839128
309127,11,18,29,1.318748,103.839127
309128,7,0,7,1.318748,103.839127
309129,6,2,8,1.318748,103.839127
309130,20,2,22,1.318748,103.839127
309131,1,14,15,1.318748,103.839127
309132,3,0,3,1.319201,103.839743
309133,9,0,9,1.318748,103.839127
309134,3,34,37,1.319157,103.841658
309135,4,266,270,1.319615,103.841174
309136,15,48,63,1.319931,103.840572
309137,1,0,1,1.299509,103.837
309138,7,1,8,1.320014,103.840654
309139,0,2,2,1.321121,103.832095
309140,0,3,3,1.318748,103.839127
309141,27,17,44,1.319773,103.840114
309142,3,9,12,1.31986,103.840061
309143,53,5,58,1.319694,103.839714
309144,26,0,26,1.319686,103.839585
309145,18,0,18,1.319685,103.839658
309146,10,1,11,1.31964,103.839371
309147,7,4,11,1.319752,103.839793
309148,2,0,2,1.319887,103.840509
309149,6,5,11,1.319585,103.83912
309150,275,3,278,1.319558,103.838989
309151,7,1,8,1.319661,103.839317
309152,4,1,5,1.31952,103.838862
309153,4,0,4,1.319483,103.838709
309154,4,0,4,1.319609,103.839027
309155,10,2,12,1.319406,103.838566
309156,0,17,17,1.319575,103.838844
309157,1,15,16,1.319313,103.838426
309158,48,0,48,1.319551,103.838764
309159,4,9,13,1.31928,103.83839
309160,19,0,19,1.319468,103.838592
309162,7,0,7,1.319095,103.838257
309163,60,1,61,1.319391,103.838463
309165,2,2,4,1.319346,103.838401
309166,61,5,66,1.318998,103.83824
309167,2,7,9,1.319223,103.838252
309168,81,7,88,1.318919,103.838187
309169,19,18,37,1.31903,103.838082
309170,12,6,18,1.318739,103.838103
309171,137,0,137,1.31852,103.837979
309173,7,2,9,1.318384,103.837904
309174,6,1,7,1.318567,103.837826
309175,3,1,4,1.318567,103.837826
309176,36,4,40,1.318321,103.837863
309177,0,1,1,1.319867,103.84044
309178,5,0,5,1.318408,103.837735
309179,1,65,66,1.318169,103.837786
309180,0,3,3,1.319989,103.840534
309181,8,2,10,1.318245,103.837646
309182,3,4,7,1.318014,103.837723
309183,2,0,2,1.319613,103.839251
309184,9,3,12,1.318,103.83752
309185,0,1,1,1.318242,103.837826
309186,4,2,6,1.317894,103.837479
309187,212,2,214,1.31786,103.837672
309188,10,3,13,1.317796,103.837654
309189,5,2,7,1.317732,103.837412
309190,4,12,16,1.317597,103.837361
309191,4,0,4,1.318834,103.838139
309192,13,0,13,1.318674,103.838068
309193,5,2,7,1.318585,103.838017
309194,11,32,43,1.31987,103.840968
309195,1,0,1,1.31793,103.837702
309196,16,6,22,1.319752,103.839989
309197,52,3,55,1.319727,103.839854
309198,84,18,102,1.320024,103.840807
309199,2,0,2,1.31807,103.83755
309200,30,0,30,1.31928,103.83839
309201,9,0,9,1.31928,103.83839
309202,3,0,3,1.317254,103.838238
309203,35,9,44,1.31928,103.83839
309204,16,0,16,1.31928,103.83839
309205,19,23,42,1.318998,103.838059
309206,2,59,61,1.318941,103.838028
309207,8,14,22,1.319345,103.838499
309208,18,259,277,1.319766,103.84111
309209,5,12,17,1.3198,103.841144
309210,4,70,74,1.319869,103.841214
309211,11,7,18,1.319924,103.841297
309212,4,13,17,1.320017,103.841362
309213,5,113,118,1.319979,103.841381
309214,8,2,10,1.320053,103.841421
309215,13,26,39,1.320034,103.841464
309216,2,6,8,1.320105,103.84149
309217,4,164,168,1.320089,103.841547
309218,5,12,17,1.320145,103.841547
309219,4,153,157,1.320144,103.84163
309220,4,8,12,1.320602,103.841289
309221,4,1260,1264,1.320171,103.841672
309222,10,0,10,1.320579,103.84126
309223,2,949,951,1.320181,103.841682
309224,0,8,8,1.320527,103.841175
309225,6,1390,1396,1.320224,103.841748
309226,1,1,2,1.31928,103.83839
309227,28,1127,1155,1.320277,103.841825
309228,9,0,9,1.320452,103.841059
309229,3,41,44,1.320256,103.841645
309230,2,1,3,1.31928,103.83839
309231,20,10,30,1.320313,103.841605
309232,6,0,6,1.320456,103.840968
309233,0,2,2,1.320499,103.841135
309234,0,1,1,1.319696,103.83954
309235,3,1,4,1.320439,103.841514
309236,61,6,67,1.320531,103.841099
309237,1,1,2,1.320399,103.841542
309238,48,17,65,1.320559,103.841134
309239,1,0,1,1.320485,103.841014
309240,1,2,3,1.320424,103.84101
309241,3,0,3,1.320611,103.841207
309242,32,36,68,1.320645,103.841259
309243,2,6,8,1.320769,103.841298
309244,12,14,26,1.321101,103.840984
309245,5,8,13,1.320809,103.84127
309246,2,2,4,1.321076,103.840945
309247,0,16,16,1.321015,103.841139
309248,28,7,35,1.321028,103.840867
309249,2,9,11,1.321049,103.841122
309250,0,10,10,1.320979,103.840789
309251,118,11,129,1.321135,103.841065
309252,3,2,5,1.320931,103.840711
309253,20,4,24,1.321169,103.84103
309254,41,1,42,1.320892,103.840643
309255,0,2,2,1.320502,103.841474
309256,14,0,14,1.320932,103.840682
309257,1,4,5,1.321312,103.840946
309258,2,9,11,1.320963,103.84073
309259,5,2,7,1.321375,103.840907
309260,1,0,1,1.320548,103.841445
309261,4,1,5,1.321398,103.840878
309262,2,10,12,1.321084,103.840926
309263,65,0,65,1.321432,103.840855
309264,4,17,21,1.321135,103.841013
309265,1,1,2,1.32126,103.840969
309266,205,10,215,1.321513,103.840671
309267,2,1,3,1.320688,103.841361
309268,7,2,9,1.321456,103.840574
309269,37,0,37,1.321512,103.84081
309270,3,0,3,1.321489,103.840821
309271,0,1,1,1.321024,103.840828
309274,34,15,49,1.321364,103.840426
309275,4,3,7,1.321588,103.840689
309276,24,9,33,1.321513,103.840581
309277,13,1,14,1.32144,103.840467
309278,93,3,96,1.321379,103.840376
309298,11,982,993,1.315504,103.840501
309299,3,92,95,1.315674,103.840261
309300,11,1461,1472,1.315808,103.840838
309301,40,7,47,1.315878,103.840732
309302,1,4,5,1.31598,103.840587
309303,4,20,24,1.315955,103.840672
309304,417,16,433,1.316123,103.84004
309305,3,0,3,1.321422,103.840517
309306,2261,263,2524,1.315444,103.839592
309307,345,79,424,1.316775,103.839662
309309,646,379,1025,1.316341,103.839155
309310,94,313,407,1.315754,103.838972
309311,2814,488,3302,1.316196,103.839472
309329,937,511,1448,1.317209,103.845041
309330,602,204,806,1.316818,103.845459
309331,371,43,414,1.317267,103.845562
309351,73,218,291,1.326982,103.839561
309352,8,29,37,1.326991,103.839445
309353,4,2,6,1.326734,103.839691
309354,6,59,65,1.326802,103.83934
309355,4,0,4,1.326739,103.839365
309356,2,4,6,1.326618,103.839608
309357,11,3,14,1.326566,103.839643
309359,7,0,7,1.326574,103.839038
309360,2,10,12,1.326148,103.83992
309361,5,1,6,1.326308,103.839643
309362,2,0,2,1.321461,103.840838
309363,16,0,16,1.326308,103.839643
309364,4,0,4,1.326227,103.839157
309365,12,0,12,1.325931,103.839993
309368,9,2,11,1.325808,103.83998
309370,6,0,6,1.325476,103.840173
309371,505,18,523,1.325437,103.839681
309372,232,8,240,1.325214,103.83949
309373,5,0,5,1.325213,103.839489
309374,14,3,17,1.325185,103.839542
309375,3,0,3,1.31575,103.840679
309377,0,1,1,1.321552,103.840784
309378,2,1,3,1.325123,103.839656
309379,2,3,5,1.324852,103.84007
309380,1,1,2,1.326308,103.839643
309381,5,3,8,1.324738,103.840295
309382,57,5,62,1.324777,103.840249
309383,81,5,86,1.324663,103.84037
309384,35,2,37,1.324601,103.840447
309385,36,0,36,1.324542,103.840502
309386,7,25,32,1.324489,103.840559
309387,7,2,9,1.324445,103.840606
309388,5,1,6,1.324355,103.840677
309389,16,3,19,1.324215,103.840733
309390,4,2,6,1.324404,103.840291
309391,1,1,2,1.324774,103.840197
309392,2,1,3,1.32493,103.839944
309393,0,6,6,1.324704,103.840227
309394,6,0,6,1.324779,103.840089
309395,1,5,6,1.324823,103.840031
309396,12,0,12,1.324878,103.83993
309397,80,3,83,1.32493,103.839886
309398,1,3,4,1.324999,103.839769
309399,1,0,1,1.325009,103.839817
309400,11,0,11,1.325086,103.839658
309401,31,1,32,1.324277,103.840666
309402,10,3,13,1.324321,103.840611
309403,6,5,11,1.32513,103.839574
309404,2,6,8,1.326641,103.839755
309405,6,8,14,1.325156,103.839612
309406,0,4,4,1.299509,103.837
309407,0,1,1,1.325065,103.839705
309408,0,1,1,1.299509,103.837
309409,1,4,5,1.299509,103.837
309420,822,1842,2664,1.314358,103.838911
309421,26,11,37,1.314101,103.838706
309422,324,0,324,1.314231,103.838563
309423,20,233,253,1.315376,103.837553
309424,2,93,95,1.31571,103.837216
309425,25,658,683,1.316208,103.836701
309426,142,22,164,1.316165,103.837834
309427,165,26,191,1.316389,103.83766
309428,160,25,185,1.316344,103.837553
309429,77,46,123,1.316849,103.837241
309430,48,2,50,1.317183,103.837096
309431,64,47,111,1.317074,103.836551
309432,70,1270,1340,1.316958,103.836462
309433,561,1210,1771,1.317471,103.835812
309434,29,372,401,1.32051,103.829411
309436,57,1549,1606,1.31872,103.833336
309437,1112,461,1573,1.321253,103.828017
309457,17,184,201,1.315788,103.845541
309458,22,135,157,1.315478,103.845369
309459,223,17,240,1.315923,103.845617
309460,0,101,101,1.316002,103.845786
309461,39,50,89,1.316104,103.845767
309462,76,0,76,1.316002,103.845786
309463,1,20,21,1.316104,103.845767
309464,0,83,83,1.316002,103.845786
309465,12,1,13,1.316002,103.845786
309466,1417,65,1482,1.316448,103.84629
309467,5,380,385,1.316346,103.845939
309468,1,42,43,1.316346,103.845939
309469,0,3,3,1.324522,103.840055
309470,386,382,768,1.315478,103.845369
309489,9,18,27,1.31816,103.836371
309490,21,3,24,1.31828,103.836562
309491,13,11,24,1.318417,103.836657
309492,39,0,39,1.318776,103.836837
309493,15,0,15,1.319255,103.837012
309494,167,260,427,1.317732,103.836668
309495,60,96,156,1.318174,103.836789
309496,77,21,98,1.318305,103.836867
309497,153,5,158,1.318367,103.836902
309498,6,0,6,1.318437,103.836948
309499,463,127,590,1.319358,103.837084
309500,50,51,101,1.318526,103.836986
309501,62,0,62,1.318624,103.837035
309502,605,4,609,1.319358,103.837084
309504,12,47,59,1.319358,103.837084
309505,2,1,3,1.316346,103.845939
309506,8,8,16,1.320108,103.836532
309507,5,4,9,1.319921,103.837922
309508,6,0,6,1.319778,103.838246
309509,270,101,371,1.320604,103.836812
309510,2,0,2,1.324496,103.840142
309511,1,0,1,1.299509,103.837
309512,3,52,55,1.319991,103.837325
309513,219,92,311,1.322563,103.837143
309514,113,18,131,1.322562,103.837142
309515,114,22,136,1.322562,103.837142
309516,41,7,48,1.322562,103.837142
309517,86,11,97,1.322562,103.837142
309518,154,21,175,1.322562,103.837142
309519,52,4,56,1.322562,103.837142
309520,76,5,81,1.322562,103.837142
309521,9,2,11,1.322562,103.837142
309522,24,0,24,1.323066,103.837213
309523,59,0,59,1.323115,103.837261
309524,60,0,60,1.323171,103.837261
309525,4,11,15,1.320474,103.837022
309526,75,2,77,1.323283,103.837487
309527,8,1,9,1.323365,103.83749
309528,9,3,12,1.323406,103.837494
309529,69,2,71,1.323485,103.837486
309530,0,3,3,1.319907,103.837323
309531,2,7,9,1.323573,103.837485
309532,46,10,56,1.32366,103.837444
309533,9,2,11,1.32369,103.837479
309534,132,5,137,1.323777,103.837464
309535,3,0,3,1.323524,103.837484
309537,10,4,14,1.320806,103.837094
309538,30,28,58,1.322626,103.837563
309539,213,3,216,1.322625,103.837562
309540,16,5,21,1.322625,103.837562
309541,9,6,15,1.322625,103.837562
309542,1,3,4,1.322625,103.837562
309543,0,2,2,1.319997,103.837803
309544,3,4,7,1.322625,103.837562
309545,91,5,96,1.323013,103.83745
309546,10,0,10,1.323071,103.83746
309547,16,1,17,1.323099,103.837433
309548,1,1,2,1.322625,103.837562
309549,117,15,132,1.321223,103.837116
309550,0,3,3,1.323834,103.837483
309551,4,0,4,1.323231,103.837724
309552,3,14,17,1.323335,103.837763
309553,2,16,18,1.321607,103.837091
309554,149,3,152,1.323885,103.837879
309555,1463,113,1576,1.324151,103.838074
309563,3,10,13,1.321976,103.836996
309564,2,51,53,1.322367,103.837923
309565,3,5,8,1.322401,103.838272
309566,3,0,3,1.322626,103.837563
309567,0,34,34,1.3224,103.838271
309568,661,96,757,1.32358,103.838732
309570,3,0,3,1.3224,103.838271
309571,132,47,179,1.322434,103.839434
309572,32,7,39,1.322376,103.839306
309573,80,26,106,1.322414,103.839609
309574,0,36,36,1.322261,103.839811
309575,54,2,56,1.322339,103.839973
309576,12,2,14,1.32225,103.840064
309577,0,130,130,1.322219,103.840313
309578,17,34,51,1.322372,103.84095
309579,3,16,19,1.322424,103.840953
309580,3,0,3,1.321847,103.838922
309581,12,0,12,1.322465,103.840967
309582,0,6,6,1.322422,103.840964
309583,46,0,46,1.322381,103.840962
309584,2,14,16,1.322145,103.84062
309585,4,12,16,1.32234,103.840962
309586,2,4,6,1.322311,103.84096
309587,1,0,1,1.319975,103.83756
309588,0,1,1,1.322272,103.840959
309589,14,38,52,1.322213,103.84095
309590,2,16,18,1.322872,103.837938
309591,5,3,8,1.322872,103.837938
309592,12,3,15,1.322872,103.837938
309593,62,80,142,1.322872,103.837938
309594,4,0,4,1.319358,103.837084
309595,17,1,18,1.319358,103.837084
309596,2,1,3,1.322474,103.840955
309598,0,15,15,1.3189,103.83718
309599,38,415,453,1.322229,103.840957
309600,1,10,11,1.323101,103.837711
309601,11,0,11,1.3224,103.838271
309602,86,0,86,1.3224,103.838271
309603,24,0,24,1.3224,103.838271
309604,2,81,83,1.3224,103.838271
309605,6,105,111,1.318714,103.836866
309606,2,0,2,1.323151,103.83746
309607,4,0,4,1.318714,103.836866
309608,24,1,25,1.318714,103.836866
309609,7,7,14,1.323604,103.839157
309610,33,0,33,1.323605,103.839285
309611,3,5,8,1.323512,103.839403
309612,41,71,112,1.323237,103.839538
309613,39,53,92,1.323218,103.839556
309614,8,16,24,1.323276,103.839495
309615,28,26,54,1.323589,103.839254
309616,6,7,13,1.323568,103.839387
309617,66,5,71,1.323443,103.839472
309618,40,12,52,1.323364,103.839525
309619,10,0,10,1.323299,103.839552
309620,5,1,6,1.323275,103.839494
309621,4,0,4,1.323275,103.839494
309622,5,0,5,1.323275,103.839494
309624,4,0,4,1.323275,103.839494
309625,3,0,3,1.318708,103.837075
309629,10,0,10,1.323197,103.839894
309630,9,3,12,1.323126,103.839939
309631,30,0,30,1.323069,103.839971
309632,259,1,260,1.299509,103.837
309633,23,0,23,1.299509,103.837
309634,188,0,188,1.299509,103.837
309635,82,60,142,1.322678,103.839038
309636,7,17,24,1.32302,103.838976
309637,7,37,44,1.32408,103.838829
309638,2,0,2,1.318714,103.836866
309639,5,0,5,1.324323,103.838938
309644,14,2,16,1.324921,103.838749
309645,8,2,10,1.32492,103.838748
309646,12,1,13,1.32492,103.838748
309647,2,9,11,1.325152,103.838439
309648,127,6,133,1.324644,103.837886
309649,59,1,60,1.324519,103.837609
309650,0,1,1,1.322243,103.840957
309651,6,2,8,1.324682,103.838947
309652,11,0,11,1.324682,103.838947
309653,32,23,55,1.324604,103.837402
309654,3,2,5,1.324951,103.838894
309655,8,7,15,1.32549,103.839029
309656,46,2,48,1.324876,103.837643
309657,341,5,346,1.325551,103.838314
309658,206,0,206,1.325478,103.83801
309659,1,0,1,1.32419,103.837567
309660,13,0,13,1.325259,103.837756
309661,19,0,19,1.325256,103.837779
309662,4,0,4,1.325235,103.837761
309663,26,0,26,1.325255,103.837789
309664,55,0,55,1.325136,103.838107
309666,2,0,2,1.324323,103.838938
309667,13,0,13,1.325073,103.838025
309668,514,6,520,1.324563,103.839094
309669,24,0,24,1.324333,103.839039
309670,13,0,13,1.324333,103.839039
309671,22,0,22,1.324333,103.839039
309672,18,0,18,1.324333,103.839039
309673,1,0,1,1.325228,103.837757
309674,122,0,122,1.324333,103.839039
309675,37,0,37,1.324631,103.839643
309676,11,0,11,1.324547,103.839668
309677,2,0,2,1.325103,103.838043
309678,29,0,29,1.324333,103.839039
309679,81,0,81,1.324333,103.839039
309680,171,0,171,1.324333,103.839039
309681,5,0,5,1.324333,103.839039
309682,18,0,18,1.324333,103.839039
309683,136,0,136,1.324333,103.839039
309684,43,0,43,1.324333,103.839039
309685,168,0,168,1.324333,103.839039
309686,40,1,41,1.324333,103.839039
309687,2,7,9,1.321893,103.837899
309688,10,11,21,1.322092,103.837648
309689,2,6,8,1.321532,103.837956
309691,2,1,3,1.323275,103.839494
309692,69,1,70,1.321824,103.83781
309693,15,18,33,1.320754,103.83824
309694,10,10,20,1.320858,103.837729
309695,209,21,230,1.320524,103.838505
309696,12,1,13,1.320533,103.837697
309697,14,0,14,1.320116,103.838392
309698,10,2,12,1.320299,103.838704
309699,20,1,21,1.321322,103.840114
309700,51,16,67,1.320279,103.838964
309701,1,2,3,1.321205,103.837985
309702,2,0,2,1.324333,103.839039
309703,24,0,24,1.32127,103.838827
309704,5,0,5,1.320297,103.839681
309705,34,0,34,1.321155,103.83937
309707,12,0,12,1.320332,103.8401
309708,1,2,3,1.321397,103.838682
309709,52,2,54,1.320564,103.840386
309710,15,9,24,1.321677,103.839004
309711,21,5,26,1.320841,103.84023
309712,685,2,687,1.321458,103.839356
309713,4,2,6,1.320981,103.84016
309714,13,2,15,1.321869,103.839348
309715,25,9,34,1.320781,103.84009
309716,10,1,11,1.321602,103.83989
309717,34,7,41,1.320454,103.839913
309719,2,1,3,1.321151,103.839281
309720,0,3,3,1.320531,103.839221
309721,42,6,48,1.321841,103.837628
309723,48,2,50,1.320726,103.838058
309724,18,0,18,1.320783,103.839229
309725,16,0,16,1.320676,103.838947
309740,5,45,50,1.316414,103.839884
309741,18,2,20,1.316542,103.840008
309742,4,3,7,1.316443,103.840025
309743,7,3,10,1.316443,103.840025
309744,119,42,161,1.316722,103.840275
309745,2,3,5,1.316735,103.840269
309746,0,3,3,1.320543,103.839254
309747,1,4,5,1.316735,103.840269
309748,45,1,46,1.316735,103.840269
309749,32,4,36,1.31648,103.840892
309750,0,3,3,1.316735,103.840269
309751,9,0,9,1.316496,103.840303
309752,230,164,394,1.317083,103.83998
309753,3,6,9,1.299509,103.837
309755,1,50,51,1.317021,103.840385
309756,23,3,26,1.317021,103.840385
309757,24,2,26,1.317021,103.840385
309758,8,8,16,1.317021,103.840385
309759,7,12,19,1.317093,103.840403
309760,6,155,161,1.316864,103.841005
309761,36,9,45,1.317312,103.83983
309762,290,42,332,1.317021,103.840385
309763,80,17,97,1.317162,103.840269
309764,0,22,22,1.317265,103.840446
309765,6,13,19,1.317491,103.840343
309766,1,221,222,1.317404,103.840531
309767,1651,21,1672,1.318329,103.840271
309768,11,43,54,1.317527,103.840568
309770,1,156,157,1.317629,103.840978
309771,1,114,115,1.317788,103.840635
309772,3,279,282,1.317798,103.840724
309773,11,107,118,1.318432,103.840537
309774,3,10,13,1.319106,103.840898
309775,0,1,1,1.324333,103.839039
309776,1211,228,1439,1.318161,103.840769
309777,4,1,5,1.299509,103.837
309778,3,1,4,1.319426,103.840736
309779,6,0,6,1.318399,103.840854
309780,1,0,1,1.319275,103.840906
309781,8,7,15,1.318637,103.840928
309782,1,4,5,1.319448,103.841014
309784,35,3,38,1.316443,103.840025
309787,54,5,59,1.299509,103.837
309788,3,38,41,1.299509,103.837
309803,0,2,2,1.320312,103.839386
309804,8,5,13,1.326698,103.83837
309805,7,6,13,1.326222,103.838589
309806,73,0,73,1.326606,103.83841
309807,2,4,6,1.326507,103.838432
309808,2,1,3,1.316432,103.840143
309809,5,3,8,1.326129,103.838623
309810,21,0,21,1.326017,103.83859
309811,8,29,37,1.326039,103.838652
309812,18,27,45,1.325989,103.838617
309813,29,0,29,1.325958,103.838692
309814,11,0,11,1.325995,103.838612
309815,20,201,221,1.326933,103.838349
309816,4,1,5,1.326756,103.838437
309817,1,0,1,1.319301,103.840977
309818,17,7,24,1.325989,103.838617
309819,3,1,4,1.326046,103.838644
309820,1,4,5,1.32626,103.838475
309821,33,1,34,1.326211,103.838552
309835,2,108,110,1.323103,103.848419
309836,282,349,631,1.322764,103.848305
309837,1386,305,1691,1.323291,103.847867
309838,1080,613,1693,1.324074,103.848284
309839,3,343,346,1.323669,103.847481
309840,9,127,136,1.323546,103.847512
309841,0,9,9,1.323444,103.847691
309859,31,223,254,1.31908,103.83373
309860,2,38,40,1.31923,103.833778
309861,5,8,13,1.319373,103.833804
309862,1,0,1,1.326685,103.838469
309863,1,20,21,1.31931,103.833949
309864,63,197,260,1.319369,103.833968
309865,0,3,3,1.326387,103.838466
309866,1,1,2,1.326314,103.838564
309867,0,8,8,1.319649,103.833897
309868,18,1,19,1.319598,103.834031
309870,1,0,1,1.319447,103.833837
309871,6,5,11,1.319826,103.834102
309872,12,15,27,1.319898,103.834122
309873,17,20,37,1.3198,103.833953
309874,18,1,19,1.319969,103.834137
309875,22,0,22,1.320035,103.834159
309876,9,0,9,1.320158,103.834058
309877,55,1,56,1.320239,103.834059
309878,1,0,1,1.319746,103.834075
309879,1,1,2,1.319523,103.834017
309880,3,2,5,1.320111,103.834188
309881,52,0,52,1.320172,103.834206
309882,0,4,4,1.32024,103.834219
309884,4,0,4,1.320366,103.834258
309885,4,4,8,1.320424,103.834275
309886,7,0,7,1.320469,103.834288
309887,11,1,12,1.320521,103.834304
309888,0,1,1,1.320359,103.834117
309889,0,12,12,1.320612,103.834329
309890,20,1,21,1.320718,103.834203
309891,1,5,6,1.320797,103.834466
309892,7,2,9,1.320974,103.834282
309893,0,16,16,1.321047,103.834562
309894,18,0,18,1.321473,103.834369
309895,3,0,3,1.319446,103.833993
309896,12,10,22,1.321667,103.834776
309897,1,0,1,1.320563,103.834317
309898,8,2,10,1.32177,103.835043
309900,1,1,2,1.32054,103.834144
309901,7,11,18,1.321813,103.835196
309902,10,0,10,1.321263,103.834727
309903,43,0,43,1.321975,103.835257
309904,3,2,5,1.321431,103.835202
309905,9,6,15,1.32177,103.835427
309906,7,1,8,1.321268,103.835285
309909,8,3,11,1.321355,103.835753
309910,3,2,5,1.321135,103.83565
309911,273,1,274,1.321158,103.835882
309912,1,0,1,1.321992,103.834994
309913,7,2,9,1.320981,103.836371
309914,2,15,17,1.320509,103.836038
309915,0,8,8,1.320451,103.836057
309916,23,3,26,1.31955,103.836385
309917,238,4,242,1.3191,103.834835
309918,265,1,266,1.318735,103.835345
309919,259,0,259,1.319611,103.835757
309921,8,6,14,1.321733,103.834849
309922,82,0,82,1.321921,103.834801
309923,17,0,17,1.321126,103.835905
309924,11,0,11,1.321203,103.835862
309925,16,1,17,1.321258,103.835842
309926,0,2,2,1.321819,103.835134
309927,6,1,7,1.32149,103.836159
309928,18,0,18,1.321569,103.836126
309929,26,1,27,1.321408,103.836197
309930,2,0,2,1.321532,103.836096
309931,8,21,29,1.32112,103.835932
309932,12,0,12,1.320619,103.83416
309933,13,0,13,1.320928,103.834258
309934,4,0,4,1.320803,103.834215
309935,16,2,18,1.321107,103.834226
309936,155,10,165,1.318914,103.834694
309937,244,0,244,1.320005,103.835033
309938,136,3677,3813,1.318657,103.83441
309939,13,0,13,1.320604,103.834745
309940,2,1,3,1.321124,103.834631
309942,14,3,17,1.320556,103.834896
309943,55,1,56,1.320543,103.834778
309944,0,37,37,1.320514,103.835029
309945,1,0,1,1.321267,103.836407
309946,1,8,9,1.320485,103.835212
309947,3,4,7,1.320479,103.834969
309948,1,0,1,1.320502,103.834886
309950,77,0,77,1.320629,103.835673
309952,0,2,2,1.321363,103.836229
309953,1,0,1,1.320581,103.835581
309955,2,0,2,1.320459,103.835423
309957,18,0,18,1.299509,103.837
309958,3,0,3,1.320504,103.834834
309961,15,0,15,1.299509,103.837
309962,1,0,1,1.299509,103.837
309963,0,1,1,1.299509,103.837
309964,65,8,73,1.299509,103.837
309965,56,0,56,1.299509,103.837
309966,2,0,2,1.320737,103.835621
309967,31,3,34,1.299509,103.837
309968,2,54,56,1.299509,103.837
309969,1,0,1,1.299509,103.837
309970,3,2,5,1.299509,103.837
309971,74,11,85,1.299509,103.837
309972,303,2080,2383,1.322789,103.848007
309973,1503,106,1609,1.322545,103.848121
309974,3,38,41,1.323002,103.848171
309975,6,108,114,1.323592,103.848407
309976,166,22,188,1.323592,103.848407
309977,1,31,32,1.323592,103.848407
309978,2263,716,2979,1.324106,103.848715
309979,2013,37,2050,1.324192,103.848794
309980,27,28,55,1.299509,103.837
310001,209,5107,5316,1.339442,103.853598
310002,363,651,1014,1.338599,103.854025
310003,623,795,1418,1.339175,103.854164
310004,858,1218,2076,1.339026,103.855302
310005,636,3133,3769,1.338694,103.855585
310006,947,64,1011,1.338527,103.857145
310007,544,396,940,1.338082,103.857233
310008,708,2914,3622,1.337857,103.856446
310009,809,279,1088,1.337444,103.857792
310010,814,2772,3586,1.337197,103.857012
310011,972,121,1093,1.337092,103.859005
310012,282,2122,2404,1.336721,103.857473
310013,639,327,966,1.3363,103.859036
310014,750,221,971,1.336683,103.858378
310015,212,118,330,1.335966,103.858847
310017,376,262,638,1.336212,103.856253
310018,162,8,170,1.335827,103.856404
310019,172,6158,6330,1.335312,103.856473
310020,339,98,437,1.334919,103.857148
310021,108,1165,1273,1.335216,103.857562
310022,7,0,7,1.335231,103.857027
310023,453,8147,8600,1.334599,103.857111
310025,425,1443,1868,1.333504,103.857011
310026,666,359,1025,1.332881,103.856797
310027,606,624,1230,1.332226,103.856286
310028,5,3647,3652,1.33383,103.853965
310029,663,511,1174,1.333111,103.853774
310030,11,296,307,1.333594,103.854451
310031,1078,288,1366,1.333181,103.85447
310032,6,4,10,1.332933,103.854958
310033,3,646,649,1.333667,103.855333
310034,594,6143,6737,1.33514,103.854164
310035,745,1176,1921,1.334416,103.854631
310036,787,382,1169,1.335034,103.855105
310037,570,930,1500,1.334693,103.85586
310038,580,78,658,1.335212,103.855267
310043,975,322,1297,1.335873,103.854263
310044,728,196,924,1.336438,103.853946
310045,725,2655,3380,1.336009,103.853705
310046,596,1116,1712,1.336425,103.85348
310047,164,614,778,1.336919,103.853967
310048,677,430,1107,1.337177,103.853636
310049,318,3599,3917,1.337749,103.853062
310050,633,5153,5786,1.337104,103.852796
310051,602,1637,2239,1.337804,103.852442
310052,602,5682,6284,1.338221,103.852422
310053,509,814,1323,1.337782,103.850717
310054,398,1557,1955,1.337392,103.850423
310055,479,2100,2579,1.33739,103.851258
310056,207,3055,3262,1.337025,103.850576
310057,53,838,891,1.337046,103.851358
310058,353,2629,2982,1.33674,103.850614
310059,129,550,679,1.336781,103.851802
310060,856,2485,3341,1.33647,103.850664
310061,405,527,932,1.33642,103.852298
310062,878,115,993,1.336242,103.851399
310063,378,329,707,1.336089,103.852228
310064,299,404,703,1.336035,103.852547
310066,438,770,1208,1.335012,103.85174
310068,169,594,763,1.334495,103.85304
310069,624,1804,2428,1.334215,103.852752
310070,13,2,15,1.334824,103.852258
310071,143,16,159,1.334132,103.852179
310072,71,1251,1322,1.333904,103.852154
310073,744,4881,5625,1.334105,103.851714
310074,30,6,36,1.334562,103.851982
310075,121,3827,3948,1.336115,103.853005
310080,370,115,485,1.335313,103.848535
310081,485,1182,1667,1.33542,103.850286
310082,350,247,597,1.33579,103.84831
310083,485,362,847,1.335808,103.847947
310084,357,298,655,1.335256,103.847802
310085,163,199,362,1.336337,103.848418
310086,343,78,421,1.336048,103.847766
310091,1588,922,2510,1.338296,103.848706
310092,313,7349,7662,1.338044,103.849374
310093,33,55,88,1.338254,103.850025
310094,203,249,452,1.338881,103.849803
310095,56,237,293,1.338873,103.848997
310096,247,41,288,1.338604,103.848492
310097,317,427,744,1.338482,103.847776
310098,422,108,530,1.339223,103.848432
310099,586,1490,2076,1.33891,103.846792
310100,871,656,1527,1.339561,103.848506
310101,240,1172,1412,1.339691,103.847092
310103,160,181,341,1.340132,103.848452
310104,150,582,732,1.340119,103.848759
310105,286,5987,6273,1.340432,103.848755
310106,109,2464,2573,1.340442,103.848442
310107,252,3649,3901,1.34131,103.847011
310108,242,130,372,1.341524,103.846995
310109,361,21172,21533,1.341253,103.846346
310110,172,112,284,1.341522,103.84646
310111,253,4672,4925,1.341269,103.845575
310112,21,64,85,1.341595,103.845511
310113,263,201,464,1.341228,103.84452
310114,296,99,395,1.340965,103.844238
310115,132,2573,2705,1.340641,103.844182
310116,473,4159,4632,1.340441,103.846087
310117,77,56,133,1.339918,103.845176
310118,231,634,865,1.339591,103.844865
310119,510,2009,2519,1.339165,103.844625
310120,166,49,215,1.339148,103.845363
310121,423,2399,2822,1.339217,103.846149
310122,744,1598,2342,1.339821,103.846152
310123,463,69,532,1.338662,103.845388
310124,648,840,1488,1.338664,103.844472
310125,327,688,1015,1.338334,103.845538
310126,486,617,1103,1.337869,103.845235
310127,69,204,273,1.338084,103.844724
310128,800,4497,5297,1.338293,103.844338
310130,2,8,10,1.299509,103.837
310131,2,1814,1816,1.299509,103.837
310138,214,192,406,1.336843,103.844899
310139,50,120,170,1.336248,103.84433
310141,10,285,295,1.335212,103.84559
310142,880,217,1097,1.335826,103.845143
310143,646,2963,3609,1.335914,103.843912
310144,814,1321,2135,1.335607,103.84403
310145,907,1869,2776,1.335247,103.846032
310146,626,1563,2189,1.334596,103.846427
310147,854,75,929,1.334687,103.844959
310148,241,6041,6282,1.334671,103.843533
310149,263,5289,5552,1.333821,103.843945
310150,276,178,454,1.333959,103.844393
310152,1291,285,1576,1.334101,103.845876
310153,688,284,972,1.33368,103.8456
310154,592,2428,3020,1.333424,103.846058
310155,600,474,1074,1.332922,103.845676
310156,493,363,856,1.332579,103.845053
310157,1284,2205,3489,1.332274,103.845188
310158,396,6376,6772,1.331541,103.844897
310159,232,689,921,1.330791,103.845495
310160,307,162,469,1.330945,103.844989
310161,259,330,589,1.330465,103.844911
310163,225,13607,13832,1.331982,103.844093
310168,254,1145,1399,1.331834,103.843468
310169,328,127,455,1.331728,103.842581
310170,305,303,608,1.33131,103.842528
310171,522,271,793,1.331086,103.842831
310172,664,2890,3554,1.330402,103.84311
310173,925,279,1204,1.33001,103.84244
310174,526,165,691,1.330686,103.841879
310175,721,4636,5357,1.333425,103.846844
310177,246,5679,5925,1.33388,103.84886
310178,61,189,250,1.333295,103.849135
310179,268,18920,19188,1.333926,103.850084
310181,38,1336,1374,1.333549,103.851364
310183,152,141,293,1.333338,103.848882
310184,56,225,281,1.332497,103.849241
310185,73,50,123,1.332716,103.850018
310186,151,379,530,1.33261,103.849972
310190,280,636,916,1.332654,103.84942
310191,391,298,689,1.33212,103.851282
310192,289,2953,3242,1.331679,103.850476
310193,180,2086,2266,1.33212,103.851282
310194,2378,531,2909,1.330951,103.858203
310195,1774,311,2085,1.330189,103.858792
310196,1106,405,1511,1.33134,103.859156
310199,717,493,1210,1.342013,103.85028
310200,720,102,822,1.341655,103.850548
310201,471,1174,1645,1.341166,103.850199
310202,398,464,862,1.341695,103.849489
310203,536,5689,6225,1.342027,103.849021
310204,527,2123,2650,1.341526,103.848966
310205,526,2619,3145,1.342221,103.847186
310206,788,813,1601,1.34231,103.846191
310207,1101,502,1603,1.342398,103.845517
310208,272,87,359,1.341957,103.845176
310209,35,20,55,1.341758,103.84474
310210,237,2793,3030,1.340213,103.854422
310211,283,8979,9262,1.340617,103.853781
310212,52,357,409,1.34066,103.854318
310213,1033,1017,2050,1.340995,103.854273
310214,755,1421,2176,1.34182,103.854344
310215,1236,464,1700,1.341744,103.85503
310216,978,460,1438,1.342491,103.854312
310217,1044,407,1451,1.342612,103.854652
310218,1498,699,2197,1.342695,103.855136
310219,796,823,1619,1.342751,103.855781
310220,725,5634,6359,1.342507,103.856416
310221,524,8495,9019,1.342445,103.856933
310222,1665,385,2050,1.341746,103.855946
310223,895,689,1584,1.341365,103.855576
310224,778,541,1319,1.341198,103.856116
310225,899,1085,1984,1.339482,103.855783
310226,649,3837,4486,1.339484,103.856914
310227,1329,8251,9580,1.339467,103.857697
310228,323,19,342,1.339081,103.85861
310229,222,27,249,1.3387,103.858995
310230,916,3612,4528,1.338271,103.859064
310231,764,6083,6847,1.337162,103.859393
310232,794,278,1072,1.337563,103.858741
310233,583,250,833,1.338249,103.858491
310234,198,106,304,1.338597,103.857812
310235,1119,251,1370,1.338902,103.856847
310236,458,1035,1493,1.340544,103.852295
310237,727,2107,2834,1.339934,103.851972
310238,1307,1335,2642,1.340346,103.851406
310239,863,2628,3491,1.340599,103.851029
310240,435,720,1155,1.340841,103.850829
310241,878,231,1109,1.330505,103.855799
310242,198,778,976,1.330097,103.855812
310243,133,63,196,1.330261,103.856526
310244,341,855,1196,1.330717,103.856386
310245,190,364,554,1.331078,103.856629
310246,995,284,1279,1.330667,103.855226
310247,622,2651,3273,1.331017,103.855049
310248,1007,993,2000,1.331355,103.855864
310249,912,619,1531,1.33134,103.856644
310250,546,389,935,1.332019,103.856671
310251,805,213,1018,1.331519,103.85718
310252,321,175,496,1.331238,103.857235
310253,148,190,338,1.331142,103.857779
310254,664,1033,1697,1.331723,103.858321
310255,260,349,609,1.331494,103.857735
310256,1068,1255,2323,1.332443,103.858778
310257,312,821,1133,1.332611,103.857253
310258,614,5100,5714,1.332614,103.857612
310259,893,3831,4724,1.333506,103.857786
310260,557,537,1094,1.3321,103.857435
310261,2,37,39,1.299509,103.837
310262,4,4382,4386,1.299509,103.837
310263,6,1769,1775,1.299509,103.837
310264,7,4795,4802,1.299509,103.837
310460,62,113,175,1.331948,103.849886
310470,220,58837,59057,1.332046,103.849342
310480,4165,2603,6768,1.332253,103.848538
310490,49,241,290,1.332516,103.848532
310500,9,2596,2605,1.333005,103.847064
310520,39,549,588,1.333189,103.847508
310530,138,1366,1504,1.331827,103.847565
311003,8,9611,9619,1.339519,103.854463
311004,2,84,86,1.339265,103.855793
311007,17,10,27,1.337771,103.857243
311010,3,76,79,1.337166,103.857792
311011,54,606,660,1.336383,103.859649
311014,1219,172,1391,1.336221,103.858479
311017,705,3166,3871,1.335928,103.857082
311018,377,219,596,1.336115,103.856561
311019,29,6583,6612,1.334852,103.856824
311021,12,6021,6033,1.3354,103.857698
311022,3,2,5,1.33561,103.85681
311034,18,3544,3562,1.334203,103.854098
311035,10,160,170,1.335351,103.854216
311052,8,1121,1129,1.338459,103.852374
311060,33,193,226,1.336484,103.851139
311062,13,3617,3630,1.335564,103.850835
311073,9,2662,2671,1.333766,103.851724
311078,16,1361,1377,1.334951,103.847558
311079,1012,883,1895,1.334381,103.84765
311080,664,368,1032,1.335346,103.849147
311081,374,352,726,1.33561,103.849961
311082,204,392,596,1.335969,103.848814
311084,428,1055,1483,1.335357,103.847054
311085,396,1128,1524,1.336318,103.849287
311093,29,3322,3351,1.338141,103.849934
311098,8,78,86,1.338894,103.848663
311099,353,195,548,1.338813,103.847068
311101,459,58,517,1.339575,103.84752
311106,45,7176,7221,1.340589,103.847952
311110,15,87,102,1.341966,103.846146
311118,7,46,53,1.339639,103.845507
311120,14,242,256,1.339828,103.845877
311123,33,3256,3289,1.33838,103.846018
311125,86,2577,2663,1.337527,103.845774
311128,44,6084,6128,1.337972,103.843815
311130,16,535,551,1.299509,103.837
311131,0,270,270,1.299509,103.837
311138,1338,1181,2519,1.336597,103.845298
311139,1168,3515,4683,1.336278,103.843943
311141,585,292,877,1.335828,103.845636
311142,11,315,326,1.335584,103.844747
311146,7,118,125,1.334521,103.845658
311147,21,327,348,1.334661,103.845355
311153,376,277,653,1.33368,103.845125
311156,40,125,165,1.333136,103.845299
311161,44,534,578,1.330213,103.844955
311171,8,196,204,1.330797,103.842255
311172,164,78,242,1.330317,103.842224
311194,44,601,645,1.331155,103.858559
311195,94,594,688,1.330428,103.858576
311196,76,671,747,1.33134,103.859156
311227,46,379,425,1.339039,103.857977
311228,7,62,69,1.338825,103.858308
311233,29,292,321,1.338252,103.85892
311261,7,2544,2551,1.299509,103.837
312010,855,166,1021,1.337187,103.858184
312014,296,2759,3055,1.335871,103.858367
312022,3,1,4,1.335571,103.857188
312062,375,437,812,1.335784,103.851177
312078,5,80,85,1.334398,103.848752
312079,691,1990,2681,1.334342,103.848249
312080,317,108,425,1.335339,103.849791
312081,372,3996,4368,1.336033,103.849597
312082,438,195,633,1.335593,103.848742
312084,297,4450,4747,1.335832,103.846725
312085,1135,359,1494,1.33632,103.848327
312099,417,68,485,1.339076,103.847366
312101,49,1180,1229,1.339375,103.846759
312130,5,1,6,1.299509,103.837
312131,0,44,44,1.299509,103.837
312138,1950,183,2133,1.336372,103.845598
312139,1555,2827,4382,1.336727,103.844026
312147,50,90,140,1.333973,103.845174
313010,6,39,45,1.336938,103.858587
313022,3,0,3,1.299509,103.837
313078,29,3105,3134,1.334416,103.849379
313079,765,1700,2465,1.33436,103.848924
313081,10,242,252,1.336128,103.849296
313084,13,93,106,1.335958,103.847072
313085,471,610,1081,1.336315,103.847346
313130,13,2031,2044,1.299509,103.837
313131,0,2,2,1.299509,103.837
313138,1816,225,2041,1.336253,103.844778
314022,2,0,2,1.299509,103.837
314079,675,1086,1761,1.334377,103.84956
315079,523,111,634,1.334357,103.850054
318876,30,381,411,1.334545,103.839912
318877,43,128,171,1.335159,103.841678
318878,92,83,175,1.352168,103.931529
318933,1,35,36,1.339045,103.84285
318990,608,282,890,1.34154,103.851956
318991,2,56,58,1.34209,103.84852
318992,511,138,649,1.342762,103.850985
318993,285,2781,3066,1.342662,103.850666
318994,3173,1727,4900,1.342617,103.848429
318995,336,2663,2999,1.343161,103.847145
318996,1040,350,1390,1.342803,103.845939
318997,9,898,907,1.342595,103.84992
318998,70,251,321,1.342802,103.846338
318999,7,1795,1802,1.299509,103.837
319000,2,37,39,1.402489,103.8604775
319001,27,785,812,1.343177,103.851306
319002,1516,932,2448,1.342593,103.849714
319053,12,93,105,1.335258,103.860372
319054,8,54,62,1.335292,103.861439
319055,10,278,288,1.335862,103.86045
319056,58,30,88,1.335843,103.861096
319057,8,207,215,1.335967,103.860465
319058,5,59,64,1.335958,103.861441
319059,40,23,63,1.33649,103.860413
319060,12,46,58,1.336495,103.861433
319061,65,2688,2753,1.336595,103.860404
319062,12,32,44,1.336581,103.861404
319063,29,15,44,1.337271,103.860353
319064,19,72,91,1.337329,103.861339
319074,199,59,258,1.334937,103.86062
319075,219,240,459,1.334582,103.860265
319076,273,156,429,1.334594,103.861258
319133,252,50,302,1.333187,103.85864
319134,2541,993,3534,1.333066,103.859938
319191,558,36,594,1.333791,103.850514
319193,158,8822,8980,1.334574,103.850728
319194,114,7409,7523,1.334687,103.850407
319196,4,143,147,1.333142,103.84961
319252,167,5248,5415,1.340145,103.855651
319253,423,225,648,1.340333,103.857018
319254,93,2254,2347,1.339924,103.858297
319255,344,2477,2821,1.339809,103.858861
319256,11,267,278,1.339476,103.859286
319257,17,1116,1133,1.339093,103.859696
319258,61,3554,3615,1.33516,103.859269
319259,104,4827,4931,1.335184,103.859075
319260,939,527,1466,1.33455,103.858986
319261,305,921,1226,1.340668,103.857721
319262,289,465,754,1.339953,103.858048
319263,15,384,399,1.338557,103.860755
319264,457,4339,4796,1.340103,103.857064
319317,17,3610,3627,1.33721,103.856268
319318,3,321,324,1.33862,103.856388
319319,532,10882,11414,1.334793,103.858176
319320,187,508,695,1.337371,103.85482
319376,40,1211,1251,1.337724,103.854031
319377,233,162,395,1.338568,103.851669
319378,10,538,548,1.337268,103.854614
319380,15,15,30,1.33635,103.854698
319381,161,2090,2251,1.335755,103.855494
319385,7,712,719,1.332092,103.855583
319387,2824,6421,9245,1.329911,103.854256
319388,40,158,198,1.330502,103.854417
319389,370,4417,4787,1.330012,103.851021
319390,206,179,385,1.330011,103.851015
319392,111,164,275,1.330668,103.851529
319393,37,182,219,1.330222,103.849185
319394,24,1893,1917,1.331626,103.84941
319398,92,4,96,1.332592,103.847554
319399,6,1007,1013,1.33124,103.847511
319400,58,3813,3871,1.336215,103.855197
319402,646,15862,16508,1.331579,103.849209
319455,361,21,382,1.333208,103.852864
319456,0,2459,2459,1.338594,103.850597
319457,231,1249,1480,1.333117,103.852359
319513,45,241,286,1.339634,103.850252
319515,65,1449,1514,1.334143,103.851244
319516,174,1224,1398,1.332673,103.851865
319518,5,745,750,1.332881,103.853143
319519,407,307,714,1.332759,103.853148
319521,439,35,474,1.332595,103.852213
319522,155,3263,3418,1.332353,103.851555
319523,7,478,485,1.333226,103.851252
319579,2319,975,3294,1.337838,103.848442
319580,193,9,202,1.337666,103.847796
319581,2714,1095,3809,1.337439,103.846552
319582,2259,853,3112,1.337797,103.846586
319583,2719,2074,4793,1.338108,103.847139
319637,510,81,591,1.340411,103.847086
319639,172,996,1168,1.336861,103.846169
319640,266,4610,4876,1.336284,103.846266
319641,219,780,999,1.334339,103.846869
319642,161,167,328,1.335402,103.845044
319755,163,7227,7390,1.341025,103.848871
319756,181,2866,3047,1.340703,103.84668
319757,11,1900,1911,1.340715,103.846735
319758,30,4175,4205,1.340602,103.845371
319759,19,42,61,1.340196,103.843209
319760,3,228,231,1.338432,103.84208
319761,415,2845,3260,1.335896,103.843101
319762,417,6,423,1.336153,103.842064
319763,2208,1978,4186,1.334669,103.842956
319764,143,69,212,1.332007,103.842993
319765,181,2,183,1.333107,103.841908
319771,1443,6067,7510,1.332989,103.843957
319772,1605,120,1725,1.332989,103.843957
319773,3487,1239,4726,1.331231,103.843945
319941,64,7,71,1.330335,103.857342
319944,278,1666,1944,1.329877,103.856487
320001,627,4526,5153,1.323537,103.8614
320002,128,19,147,1.325893,103.842931
320003,1134,1817,2951,1.322685,103.860954
320004,15,775,790,1.322645,103.860343
320005,855,286,1141,1.323141,103.85966
320006,850,165,1015,1.323199,103.858945
320007,657,265,922,1.323618,103.859037
320008,869,87,956,1.323505,103.859764
320009,322,142,464,1.323768,103.862937
320010,26,91,117,1.32379,103.863328
320011,327,24,351,1.323177,103.863176
320012,32,1897,1929,1.323016,103.862832
320013,671,10457,11128,1.323346,103.862767
320014,672,4682,5354,1.323861,103.861971
320015,660,1971,2631,1.324317,103.861679
320016,96,105,201,1.324373,103.862243
320017,26,58,84,1.323979,103.862281
320018,194,82,276,1.324205,103.862777
320019,61,18,79,1.324501,103.862594
320020,433,389,822,1.32666,103.859635
320021,735,2026,2761,1.326286,103.859793
320022,94,2908,3002,1.326445,103.859499
320023,175,119,294,1.32501,103.863005
320024,4,570,574,1.299509,103.837
320025,5,181,186,1.299509,103.837
320026,0,8,8,1.299509,103.837
320027,136,644,780,1.326008,103.858922
320028,84,187,271,1.32571,103.858754
320029,243,6534,6777,1.325383,103.859038
320030,164,7092,7256,1.325786,103.857883
320032,122,176,298,1.326108,103.858047
320033,383,7862,8245,1.326513,103.858429
320034,172,3742,3914,1.327004,103.857679
320035,156,15,171,1.326715,103.85747
320038,2,13,15,1.327257,103.856489
320039,4,79,83,1.327257,103.856489
320040,26,4,30,1.327257,103.856489
320041,33,29,62,1.327257,103.856489
320042,13,1,14,1.327257,103.856489
320043,5,99,104,1.327257,103.856489
320044,8,113,121,1.32743,103.857293
320045,7,1206,1213,1.327607,103.857298
320046,12,202,214,1.327806,103.856543
320047,2,2,4,1.327806,103.856543
320048,31,192,223,1.327806,103.856543
320049,161,276,437,1.327809,103.856496
320050,72,274,346,1.327809,103.856496
320051,11,173,184,1.327809,103.856496
320052,4,1451,1455,1.327809,103.856496
320053,14,32,46,1.327921,103.856386
320054,67,13,80,1.32831,103.856749
320055,2,322,324,1.327962,103.856432
320056,42,11,53,1.328305,103.856521
320057,29,40,69,1.328019,103.856411
320058,32,7,39,1.32825,103.856915
320059,45,24,69,1.32813,103.857139
320060,5,86,91,1.327962,103.856432
320061,20,266,286,1.32789,103.857578
320062,23,15,38,1.328317,103.857749
320063,115,70,185,1.328552,103.857496
320064,7,55,62,1.327896,103.857905
320065,31,117,148,1.328558,103.857872
320074,709,8477,9186,1.324803,103.857822
320075,482,845,1327,1.324592,103.858153
320076,535,162,697,1.325314,103.854356
320077,664,357,1021,1.325003,103.854658
320078,40,35,75,1.299509,103.837
320080,48,228,276,1.323673,103.855541
320081,42,337,379,1.32408,103.856339
320082,735,5546,6281,1.323995,103.856468
320083,251,857,1108,1.323592,103.856934
320084,105,226,331,1.323146,103.857007
320085,198,82,280,1.322824,103.856473
320086,154,1561,1715,1.323189,103.855791
320087,15,114,129,1.323282,103.855666
320088,9,141,150,1.323279,103.855144
320089,25,374,399,1.323644,103.854989
320090,208,124,332,1.32294,103.855159
320091,35,260,295,1.323415,103.854085
320092,110,430,540,1.323207,103.853863
320093,541,2462,3003,1.322154,103.85477
320094,327,435,762,1.322041,103.855723
320095,549,321,870,1.322144,103.85619
320096,232,256,488,1.32154,103.855581
320097,264,279,543,1.321294,103.85495
320098,280,49,329,1.321627,103.854064
320099,255,651,906,1.320826,103.853762
320100,387,285,672,1.320748,103.854244
320101,671,359,1030,1.327505,103.844521
320102,451,190,641,1.327942,103.844349
320103,276,570,846,1.327956,103.844781
320104,40,139,179,1.328436,103.844225
320105,290,1437,1727,1.328209,103.854079
320106,273,182,455,1.328593,103.844618
320107,274,896,1170,1.327646,103.855017
320108,545,56,601,1.327987,103.85538
320109,496,638,1134,1.321422,103.859044
320110,873,283,1156,1.321858,103.85866
320111,867,149,1016,1.321138,103.858367
320112,451,2186,2637,1.320932,103.858841
320113,157,907,1064,1.325746,103.857134
320114,167,3423,3590,1.325442,103.857548
320115,777,101,878,1.326175,103.857325
320116,75,141,216,1.299509,103.837
320117,33,775,808,1.299509,103.837
320119,520,189,709,1.319802,103.856882
320120,214,195,409,1.319295,103.856938
320121,521,157,678,1.318808,103.856457
320122,288,2727,3015,1.31851,103.856934
320123,404,1090,1494,1.318035,103.856516
320124,402,452,854,1.31833,103.855954
321002,7,7,14,1.326416,103.843711
321004,1122,113,1235,1.322292,103.860225
321013,12,206,218,1.316739,103.881314
321016,757,432,1189,1.327121,103.859381
321017,887,307,1194,1.327121,103.859381
321018,1533,404,1937,1.327121,103.859381
321019,341,888,1229,1.327121,103.859381
321020,771,254,1025,1.324793,103.862856
321021,700,1312,2012,1.324986,103.862097
321022,543,240,783,1.325216,103.862376
321025,0,13,13,1.299509,103.837
321026,10,31,41,1.299509,103.837
321032,9,198,207,1.325984,103.857688
321075,6,581,587,1.324478,103.857915
321078,3,126,129,1.299509,103.837
321085,44,8823,8867,1.323,103.856304
321093,9,61,70,1.321543,103.854252
321094,31,9199,9230,1.299509,103.837
321098,31,269,300,1.32156,103.85464
321101,673,788,1461,1.32872,103.850691
321102,932,654,1586,1.328219,103.851524
321103,798,611,1409,1.327517,103.852831
321104,1215,678,1893,1.32781,103.853185
321105,414,388,802,1.320823,103.861143
321106,515,288,803,1.32843,103.854601
321107,579,851,1430,1.319697,103.859896
321108,856,226,1082,1.321601,103.859577
321109,600,6972,7572,1.326976,103.855566
321110,164,311,475,1.326789,103.855812
321111,329,858,1187,1.326508,103.856161
321112,349,1214,1563,1.326124,103.856762
321113,31,42,73,1.299509,103.837
321114,3,80,83,1.299509,103.837
321115,2,43,45,1.299509,103.837
321116,650,627,1277,1.299509,103.837
321117,597,24,621,1.328064,103.861094
322002,743,691,1434,1.323445,103.860707
322004,653,279,932,1.322393,103.860695
322018,6,25,31,1.299509,103.837
322019,16,475,491,1.327121,103.859381
322022,89,10949,11038,1.326553,103.859118
322026,0,10,10,1.299509,103.837
322078,6,90,96,1.299509,103.837
322101,122,2018,2140,1.319673,103.861129
322102,136,8367,8503,1.320645,103.861876
322103,257,561,818,1.320746,103.861554
322104,371,526,897,1.319904,103.860993
322106,310,232,542,1.3211,103.860887
322108,37,515,552,1.320575,103.859406
322111,23,886,909,1.326111,103.855663
322112,53,246,299,1.32641,103.856624
322113,44,84,128,1.299509,103.837
322116,773,399,1172,1.327807,103.860717
322117,627,224,851,1.328814,103.861235
323019,25,4,29,1.327121,103.859381
323022,44,44,88,1.299509,103.837
323078,2,358,360,1.299509,103.837
323101,404,113,517,1.320483,103.853799
323104,159,2921,3080,1.320649,103.853325
323108,975,1570,2545,1.320463,103.858911
323113,70,61,131,1.321302,103.860446
324108,458,2438,2896,1.319771,103.859309
324113,99,13,112,1.299509,103.837
325113,265,41,306,1.320386,103.859626
327713,4,423,427,1.322554,103.852968
327715,64,20,84,1.322555,103.852973
327717,5,375,380,1.322555,103.852984
327718,6,2,8,1.322556,103.852994
327720,2,801,803,1.322557,103.853005
327725,63,1377,1440,1.322202,103.85394
327737,289,4639,4928,1.324623,103.856984
327803,15,4280,4295,1.318979,103.859695
327804,170,3888,4058,1.318709,103.860347
327805,17,4177,4194,1.319723,103.858682
327807,3,16,19,1.320264,103.858331
327808,28,14,42,1.320287,103.858291
327809,46,10,56,1.320224,103.858392
327810,24,12,36,1.32035,103.858223
327811,3,8,11,1.320373,103.858189
327812,122,13,135,1.320401,103.858149
327813,1,28,29,1.320418,103.858103
327814,233,19,252,1.320453,103.858069
327815,1,5,6,1.320641,103.857895
327816,25,9,34,1.32051,103.857995
327817,0,3,3,1.335481,103.85684
327818,1,2,3,1.320544,103.857961
327819,70,4,74,1.320596,103.857893
327820,16,4,20,1.320624,103.857858
327821,5,6,11,1.320653,103.857824
327822,5,4,9,1.320676,103.85779
327823,1,0,1,1.299509,103.837
327825,8,168,176,1.32075,103.857688
327826,13,2995,3008,1.320645,103.861876
327827,8,19,27,1.320017,103.860967
327828,1,12,13,1.320002,103.85952
327829,241,50,291,1.321704,103.857647
327830,319,119,438,1.319965,103.855659
327847,13,195,208,1.328693,103.865441
327848,110,643,753,1.328467,103.865736
327849,378,49,427,1.328654,103.865371
327850,1,51,52,1.328611,103.865432
327872,51,10637,10688,1.32823,103.84661
327873,257,355,612,1.328007,103.846766
327874,42,1082,1124,1.327947,103.846917
327919,237,344,581,1.32432,103.861002
327920,303,653,956,1.325385,103.861976
327944,4,349,353,1.325351,103.864632
327945,1,4,5,1.325392,103.864571
327946,0,3,3,1.320567,103.857927
327947,9,0,9,1.325486,103.864473
327948,2,9,11,1.325519,103.864419
327949,0,39,39,1.325572,103.864383
327950,301,5,306,1.325237,103.864567
327951,4,241,245,1.32576,103.864182
327952,4,37,41,1.325813,103.864118
327953,5,23,28,1.325865,103.864068
327954,0,171,171,1.325638,103.864167
327955,0,1,1,1.320699,103.857756
327956,96,32,128,1.325722,103.864078
327957,1,9,10,1.325759,103.864034
327958,0,21,21,1.325792,103.863995
327959,0,10,10,1.325826,103.863954
327960,0,25,25,1.325861,103.863916
327961,3,6,9,1.325894,103.86387
327962,2,9,11,1.325932,103.863827
327963,0,6,6,1.325968,103.863776
327964,11,24,35,1.325931,103.864015
327965,3,21,24,1.325976,103.863958
327966,3,29,32,1.326033,103.863893
327967,1,26,27,1.326091,103.863842
327968,6,45,51,1.326072,103.863673
327969,12,154,166,1.326108,103.863643
327970,3,6,9,1.326138,103.863605
327971,3,151,154,1.326182,103.863578
327973,6,456,462,1.32625,103.863494
327974,1,10,11,1.326275,103.863462
327975,7,270,277,1.32632,103.86341
327976,141,380,521,1.326476,103.863093
327977,386,381,767,1.326147,103.863759
327978,278,324,602,1.326536,103.863005
327979,1032,96,1128,1.326183,103.863727
327980,3,63,66,1.326633,103.862842
327981,1177,16,1193,1.326712,103.864111
327982,2,25,27,1.326685,103.862725
327983,8,15,23,1.327089,103.863824
327984,3,9,12,1.327007,103.863773
327985,37,5,42,1.326993,103.863755
327986,1,7,8,1.326355,103.863539
327987,0,12,12,1.326385,103.863496
327988,7,9,16,1.326405,103.863459
327989,3,0,3,1.325449,103.864517
327990,30,3,33,1.326474,103.863345
327991,1,8,9,1.326508,103.863256
327992,1,27,28,1.326536,103.863226
327993,3,428,431,1.326564,103.863185
327994,1648,142,1790,1.327112,103.863637
327995,149,2,151,1.327186,103.863697
327996,3,49,52,1.32726,103.863775
327997,12,1,13,1.327349,103.863846
327998,5,54,59,1.327431,103.863932
327999,5,7,12,1.327505,103.86401
328000,108,69,177,1.327205,103.863585
328002,308,478,786,1.326772,103.862815
328003,299,40,339,1.326059,103.862413
328004,26,1,27,1.327327,103.864212
328005,416,283,699,1.32611,103.863799
328006,1113,185,1298,1.324677,103.865157
328007,622,3,625,1.324828,103.864998
328008,294,0,294,1.327765,103.864055
328009,3,1,4,1.327579,103.86407
328023,7,37,44,1.323492,103.860672
328024,21,481,502,1.322365,103.863236
328025,15,1173,1188,1.322652,103.862944
328047,30,549,579,1.32273,103.861969
328069,16,191,207,1.324568,103.863465
328070,201,1,202,1.32465,103.86357
328071,1251,79,1330,1.324745,103.863654
328072,7,430,437,1.324844,103.863647
328073,4,0,4,1.32503,103.863811
328074,289,71,360,1.325207,103.863965
328075,168,9,177,1.325248,103.864002
328076,6,5,11,1.325279,103.864028
328077,45,1,46,1.325341,103.864082
328078,0,5,5,1.325402,103.864135
328079,0,1,1,1.325672,103.864131
328080,0,2,2,1.335446,103.857185
328081,3,463,466,1.325578,103.864285
328103,85,85,170,1.32583,103.846878
328104,29,2362,2391,1.326235,103.847451
328105,5,87,92,1.325214,103.846654
328106,29,59,88,1.325585,103.846547
328107,656,198,854,1.324428,103.84623
328108,765,550,1315,1.325551,103.846039
328127,381,731,1112,1.317285,103.859327
328128,6,764,770,1.321744,103.862901
328129,4,163,167,1.321765,103.862875
328136,0,99,99,1.321902,103.862891
328138,0,1,1,1.325464,103.864188
328142,0,1,1,1.321971,103.862749
328144,0,96,96,1.321876,103.862945
328145,0,24,24,1.321837,103.862978
328146,1,462,463,1.321831,103.863
328147,4,1605,1609,1.32223,103.863493
328148,7,492,499,1.322266,103.863519
328149,9,645,654,1.322296,103.863546
328150,5,626,631,1.322321,103.863568
328151,3,995,998,1.32235,103.863589
328152,19,768,787,1.322387,103.863611
328153,5,6,11,1.322586,103.863481
328154,0,1,1,1.322103,103.862568
328155,0,3,3,1.326443,103.863395
328156,2,14,16,1.322722,103.863318
328157,20,1906,1926,1.322579,103.863751
328158,0,3,3,1.322679,103.863373
328159,0,8,8,1.322709,103.863493
328162,1,0,1,1.322642,103.863426
328163,1,3,4,1.322854,103.863306
328165,18,629,647,1.322607,103.863774
328166,9,348,357,1.322635,103.863793
328167,6,248,254,1.322661,103.86382
328168,10,660,670,1.322675,103.863828
328169,11,2905,2916,1.322706,103.863852
328170,513,53,566,1.322914,103.86398
328172,5,0,5,1.323286,103.864321
328174,6,1551,1557,1.32332,103.864554
328175,3,28,31,1.323362,103.864572
328176,3,681,684,1.323402,103.864605
328177,0,34,34,1.323442,103.864647
328178,1,265,266,1.323483,103.864664
328179,5,65,70,1.323542,103.86471
328180,1,337,338,1.323582,103.864754
328182,92,26,118,1.323719,103.864596
328183,4,326,330,1.323658,103.864806
328184,0,87,87,1.3237,103.864845
328186,1,594,595,1.32375,103.864886
328187,3,133,136,1.323797,103.864918
328188,24,329,353,1.323835,103.864946
328189,7,273,280,1.323872,103.864961
328190,3115,297,3412,1.324029,103.864906
328191,1,115,116,1.323905,103.864969
328192,105,1829,1934,1.323928,103.864995
328193,14,1300,1314,1.324029,103.865068
328195,5,944,949,1.324106,103.86513
328196,3,27,30,1.324158,103.865171
328197,6,542,548,1.32421,103.865212
328198,0,246,246,1.324262,103.865253
328199,2,43,45,1.324313,103.865293
328200,4,937,941,1.324365,103.865334
328201,8,1286,1294,1.324417,103.865375
328203,7,3363,3370,1.32451,103.865447
328204,0,1054,1054,1.3245,103.865501
328205,2,0,2,1.325526,103.864242
328206,3,1307,1310,1.324611,103.865545
328207,95,1561,1656,1.324814,103.864777
328208,7,1598,1605,1.324653,103.865581
328209,40,130,170,1.324975,103.864794
328210,9,1939,1948,1.324688,103.865623
328211,0,56,56,1.325053,103.865724
328231,1,352,353,1.326262,103.866528
328232,28,397,425,1.326332,103.866605
328234,2,333,335,1.326777,103.866333
328235,45,829,874,1.326711,103.867095
328236,5,1554,1559,1.326752,103.867126
328237,0,90,90,1.326796,103.867165
328238,5,593,598,1.326851,103.867205
328239,1,29,30,1.326901,103.867238
328240,2,48,50,1.326942,103.867281
328241,32,766,798,1.326975,103.867308
328244,21,0,21,1.327087,103.867383
328245,1,0,1,1.322811,103.863349
328247,8,1191,1199,1.326336,103.866987
328248,0,382,382,1.32719,103.867451
328250,2,44,46,1.327245,103.867498
328251,0,1,1,1.32712,103.867405
328252,3,272,275,1.327295,103.867534
328253,2,277,279,1.327324,103.867552
328254,20,707,727,1.327345,103.867571
328256,1,26,27,1.322825,103.863951
328257,2,50,52,1.322836,103.863959
328258,1,22,23,1.322847,103.863968
328259,5,24,29,1.322859,103.863976
328260,2020,66462,68482,1.319683,103.861955
328261,4,3,7,1.322892,103.863266
328262,0,4,4,1.322843,103.86337
328276,1,3,4,1.327761,103.867142
328277,0,5,5,1.327761,103.867122
328279,2,2,4,1.327709,103.867082
328280,0,2,2,1.324577,103.865504
328281,0,2,2,1.327603,103.867022
328282,1,4,5,1.327498,103.866943
328283,0,1,1,1.32727,103.867511
328284,5,0,5,1.327392,103.866863
328286,2,0,2,1.327603,103.867002
328309,1,6,7,1.325195,103.849408
328310,1,6,7,1.325297,103.849454
328311,5,13,18,1.325166,103.849386
328312,0,5,5,1.325275,103.849437
328313,1,0,1,1.327498,103.866923
328314,4,10,14,1.325229,103.849391
328315,0,5,5,1.325097,103.849346
328316,67,46,113,1.325183,103.849357
328317,0,8,8,1.325074,103.849323
328318,433,0,433,1.325137,103.849323
328319,0,13,13,1.32504,103.8493
328320,1,42,43,1.325097,103.849295
328321,32,25,57,1.324931,103.849226
328322,0,14,14,1.325051,103.84926
328323,1,30,31,1.324903,103.849215
328324,1,31,32,1.324954,103.849198
328325,0,23,23,1.32488,103.849186
328326,0,20,20,1.324914,103.849164
328327,2,12,14,1.324851,103.849158
328328,0,21,21,1.324879,103.849135
328329,0,8,8,1.324817,103.849135
328330,0,15,15,1.324839,103.849107
328331,3,5,8,1.324788,103.849113
328332,0,12,12,1.324799,103.849079
328333,1,6,7,1.324754,103.84909
328334,1,32,33,1.324742,103.849022
328335,17,8,25,1.324719,103.849061
328336,0,15,15,1.324686,103.849035
328358,16,10,26,1.323006,103.851262
328359,0,1,1,1.325132,103.849363
328360,1,231,232,1.323369,103.851614
328361,3,10,13,1.323242,103.851423
328362,48,4,52,1.323291,103.851464
328363,79,0,79,1.323326,103.851515
328364,4,31,35,1.323376,103.851558
328365,1,0,1,1.323201,103.851378
328369,66,7,73,1.323139,103.85131
328373,516,131,647,1.323076,103.851247
328374,4,23,27,1.322931,103.851102
328396,196,12,208,1.327463,103.8675
328397,11,589,600,1.327454,103.867611
328398,3,24,27,1.327536,103.867425
328399,11,35,46,1.327493,103.867556
328400,4,3,7,1.327604,103.867346
328401,1,10,11,1.327556,103.867486
328402,2,9,11,1.327738,103.867216
328403,4,25,29,1.327606,103.867418
328404,46,18,64,1.327818,103.867127
328405,1,8,9,1.327663,103.867364
328406,2,6,8,1.327882,103.867069
328407,4,17,21,1.327704,103.867322
328408,2,0,2,1.327287,103.866783
328409,0,7,7,1.32776,103.867278
328410,0,8,8,1.327929,103.866999
328412,0,4,4,1.328015,103.866885
328413,0,2,2,1.327972,103.866939
328414,1,3,4,1.328031,103.866829
328415,4,116,120,1.327912,103.867085
328416,0,19,19,1.328041,103.866776
328418,3,4,7,1.32801,103.866989
328419,2,34,36,1.328036,103.866675
328420,2,246,248,1.328093,103.866856
328421,0,12,12,1.328018,103.866593
328422,0,35,35,1.327975,103.866508
328423,0,8,8,1.327941,103.866455
328424,7,32,39,1.327903,103.866407
328425,51,6,57,1.327842,103.866362
328426,1,16,17,1.327793,103.866316
328427,8,16,24,1.327734,103.866269
328428,7,125,132,1.327673,103.866233
328429,0,13,13,1.299509,103.837
328450,1,20,21,1.326811,103.866841
328451,0,9,9,1.326838,103.866816
328452,0,18,18,1.326861,103.866783
328454,101,1,102,1.326925,103.86671
328455,0,1,1,1.323416,103.851615
328456,2,29,31,1.327,103.866648
328457,6,1,7,1.326572,103.866184
328458,3,0,3,1.322657,103.863543
328459,1,36,37,1.326558,103.866048
328460,8,39,47,1.327081,103.866545
328461,6,1,7,1.327177,103.866446
328462,214,10,224,1.326709,103.865867
328463,3,30,33,1.327228,103.866401
328465,1538,217,1755,1.327436,103.866153
328466,6,45,51,1.327337,103.866303
328467,8,88,96,1.327599,103.865984
328468,24,156,180,1.327635,103.866062
328469,5,151,156,1.327704,103.865998
328470,8,9,17,1.327776,103.865937
328471,6,42,48,1.327835,103.865863
328474,0,146,146,1.327947,103.865701
328475,1,30,31,1.328036,103.865458
328476,7,44,51,1.328128,103.865439
328477,0,1,1,1.326969,103.866673
328479,0,6,6,1.32852,103.865521
328480,3,15,18,1.328084,103.864974
328481,5,7,12,1.328448,103.865455
328482,117,3,120,1.32819,103.864917
328483,1,0,1,1.32812,103.86535
328484,11,3,14,1.328278,103.864872
328485,27,16,43,1.328142,103.865012
328486,128,80,208,1.328339,103.864842
328487,4,136,140,1.328221,103.864967
328488,13,86,99,1.328413,103.864784
328489,404,130,534,1.328381,103.864877
328490,21,387,408,1.328496,103.864739
328492,1,1,2,1.327862,103.867153
328493,0,1,1,1.3283,103.865345
328494,2,7,9,1.328444,103.865407
328495,0,69,69,1.328289,103.865308
328496,1385,9,1394,1.32778,103.865772
328497,13,13,26,1.328222,103.864872
328498,584,7,591,1.328573,103.864761
328499,9,3,12,1.299509,103.837
328515,8,5344,5352,1.317892,103.856862
328516,6,77,83,1.318534,103.855813
328517,14,587,601,1.318497,103.857568
328518,10,72,82,1.318819,103.857506
328519,16,36,52,1.318841,103.857521
328520,1,3,4,1.318866,103.857543
328521,4,17,21,1.318891,103.857561
328522,1,2,3,1.327039,103.866601
328523,6,18,24,1.318915,103.857581
328524,186,2,188,1.31893,103.857604
328525,0,28,28,1.318952,103.857619
328526,4,0,4,1.318977,103.857641
328527,53,29,82,1.319002,103.857659
328528,91,1,92,1.319026,103.857679
328529,15,109,124,1.319042,103.857691
328530,0,1,1,1.328736,103.864553
328531,0,34,34,1.319737,103.857729
328532,7,0,7,1.319794,103.857756
328533,3,43,46,1.319805,103.857763
328534,33,7,40,1.319843,103.857828
328535,6,40,46,1.319889,103.857841
328536,1,1,2,1.328677,103.864633
328537,1,36,37,1.319986,103.857912
328538,2,5,7,1.320003,103.857947
328539,23,31,54,1.320043,103.857941
328540,18,0,18,1.320108,103.857975
328541,6,9,15,1.320149,103.85803
328542,10,0,10,1.32018,103.858041
328543,2,68,70,1.320224,103.85809
328544,107,3297,3404,1.319001,103.857448
328545,1,8,9,1.319395,103.857974
328546,72,119,191,1.31942,103.857996
328547,37,4,41,1.319445,103.858014
328548,78,223,301,1.319487,103.858048
328549,1,2,3,1.318206,103.857142
328550,37,104,141,1.319546,103.85809
328551,19,3,22,1.319574,103.858114
328552,0,88,88,1.319607,103.858138
328553,0,2,2,1.319926,103.857879
328554,5,115,120,1.319665,103.858185
328555,12,3,15,1.319704,103.858204
328556,25,101,126,1.319722,103.85822
328557,7,3,10,1.319741,103.858228
328558,9,157,166,1.319759,103.858243
328559,69,6,75,1.319781,103.858258
328560,10,152,162,1.319806,103.85828
328561,3,1,4,1.319678,103.85824
328562,97,4,101,1.319831,103.858298
328563,36,125,161,1.319855,103.858318
328564,2,261,263,1.321378,103.859646
328565,7,3,10,1.319866,103.858331
328566,4,150,154,1.319879,103.858343
328567,1,0,1,1.319686,103.857678
328568,3,245,248,1.319919,103.858373
328569,8,130,138,1.319944,103.858395
328591,33,80,113,1.321063,103.857847
328592,16,0,16,1.3212,103.857934
328593,305,32,337,1.322723,103.858114
328594,21,2,23,1.321294,103.858015
328595,1,1,2,1.319631,103.858154
328596,7,0,7,1.321465,103.85814
328597,7,5,12,1.320931,103.858158
328598,2,9,11,1.320906,103.858165
328599,20,6,26,1.320908,103.858218
328600,5,10,15,1.320855,103.858225
328601,20,6,26,1.320851,103.858296
328602,7,4,11,1.320796,103.858322
328603,3,48,51,1.320772,103.858362
328625,2,12,14,1.323882,103.851271
328626,126,0,126,1.323954,103.851195
328627,0,22,22,1.324023,103.851215
328628,1,2,3,1.319517,103.858074
328629,1,2,3,1.323839,103.851253
328630,1,10,11,1.323845,103.85112
328631,0,19,19,1.323796,103.851061
328632,0,8,8,1.323746,103.851028
328633,0,15,15,1.323708,103.850986
328634,0,12,12,1.323668,103.850939
328635,1,67,68,1.323623,103.850912
328636,5,6,11,1.323821,103.85122
328637,2,4,6,1.323798,103.851191
328638,2,0,2,1.321388,103.858088
328639,2,7,9,1.32374,103.851134
328640,8,2,10,1.323713,103.851113
328641,45,0,45,1.323689,103.851084
328642,0,5,5,1.323632,103.851044
328643,6,1,7,1.323591,103.851
328644,582,132,714,1.324085,103.850531
328645,84,10,94,1.32355,103.850958
328647,1,3,4,1.323499,103.850911
328649,28,0,28,1.32346,103.850877
328651,4,8,12,1.323422,103.850827
328652,3,6,9,1.323369,103.850783
328654,0,239,239,1.324125,103.850174
328655,0,7,7,1.323296,103.850705
328656,1,6,7,1.324059,103.850253
328657,1,36,37,1.32325,103.850654
328658,0,20,20,1.323955,103.850336
328659,0,17,17,1.323893,103.850411
328662,1,26,27,1.323705,103.850586
328664,1,11,12,1.323589,103.8507
328667,93,61,154,1.323028,103.850264
328668,162,2,164,1.323792,103.850806
328688,877,196,1073,1.327001,103.861742
328689,4407,354,4761,1.326401,103.862254
328691,11,0,11,1.327616,103.862359
328693,10,214,224,1.327665,103.862414
328694,7,51,58,1.327294,103.862044
328695,0,13,13,1.327765,103.862525
328697,0,79,79,1.327864,103.862637
328698,2,0,2,1.323769,103.851164
328700,1,290,291,1.327546,103.862303
328701,17,520,537,1.328063,103.862859
328702,1618,68,1686,1.327614,103.862379
328703,607,136,743,1.327613,103.862378
328704,1887,364,2251,1.328162,103.86297
328708,294,280,574,1.327952,103.862758
328710,1,5,6,1.328341,103.863221
328711,4,0,4,1.32839,103.863415
328712,1680,83,1763,1.328371,103.863614
328714,0,15,15,1.328092,103.864003
328715,0,6,6,1.32802,103.864066
328716,2,25,27,1.327833,103.864114
328717,0,9,9,1.327876,103.864102
328718,1,27,28,1.327841,103.864106
328741,296,23,319,1.324479,103.854355
328742,80,570,650,1.324283,103.854599
328743,301,55,356,1.323771,103.854833
328754,727,1011,1738,1.324699,103.854074
328775,4,608,612,1.325477,103.853882
328777,12,20,32,1.32563,103.853071
328778,55,2,57,1.325895,103.853302
328779,55,33,88,1.326031,103.853106
328780,1,0,1,1.319897,103.858358
328781,110,50,160,1.326623,103.852831
328782,28,32,60,1.326176,103.852488
328783,12,164,176,1.326768,103.852652
328784,660,144,804,1.326145,103.853492
328803,3,486,489,1.323916,103.852425
328804,79,812,891,1.324931,103.853343
328805,722,50,772,1.325152,103.853464
328806,11,449,460,1.324336,103.852978
328807,6,1887,1893,1.324388,103.853023
328808,21,828,849,1.32462,103.853228
328809,3,1408,1411,1.324657,103.853252
328810,3,551,554,1.32469,103.853281
328811,2,372,374,1.324724,103.853311
328812,10,341,351,1.324757,103.853335
328813,0,462,462,1.324793,103.853362
328814,83,513,596,1.325368,103.853633
328815,7,829,836,1.324828,103.8534
328816,30,304,334,1.324862,103.853429
328817,2,671,673,1.324891,103.853457
328818,11,853,864,1.32492,103.85348
328819,16,699,715,1.324965,103.853508
328820,2,24,26,1.325,103.853537
328821,18,1161,1179,1.325682,103.853944
328822,18,6409,6427,1.325028,103.853565
328823,67,1377,1444,1.325902,103.854104
328824,4,2041,2045,1.325051,103.853594
328825,22,2594,2616,1.325218,103.85374
328827,82,1937,2019,1.325307,103.853817
328835,58,6630,6688,1.326307,103.85472
328836,1007,1898,2905,1.326514,103.854634
328837,94,1656,1750,1.324512,103.852977
328838,1,529,530,1.324227,103.852892
328839,15,348,363,1.324279,103.852938
328840,3,444,447,1.32413,103.852801
328841,112,476,588,1.324044,103.85271
328842,18,694,712,1.324291,103.852746
328843,87,2236,2323,1.324094,103.852593
328844,2,246,248,1.323992,103.85267
328845,46,285,331,1.32396,103.852624
328846,27,448,475,1.324182,103.852847
328847,183,173,356,1.323789,103.85247
328858,1,3,4,1.32427,103.853362
328859,1,80,81,1.324262,103.853335
328860,1,4,5,1.324242,103.85339
328861,1,1,2,1.327462,103.862217
328862,0,7,7,1.324213,103.853424
328863,4,75,79,1.32418,103.853428
328864,3,3,6,1.324179,103.853458
328865,6,66,72,1.324142,103.853466
328866,0,3,3,1.323895,103.851125
328867,4,74,78,1.324022,103.853601
328868,4,6,10,1.324127,103.853527
328869,3,21,24,1.323987,103.853647
328870,0,1,1,1.326168,103.852909
328871,1,51,52,1.324098,103.853561
328872,1,60,61,1.323955,103.85369
328873,1,0,1,1.324098,103.853561
328874,2,118,120,1.323921,103.85373
328875,0,4,4,1.324032,103.853639
328877,1,0,1,1.324064,103.853601
328878,1,8,9,1.323922,103.853793
328882,911,710,1621,1.323791,103.854148
328913,0,22,22,1.323888,103.853362
328914,0,22,22,1.32388,103.85332
328915,1,17,18,1.323843,103.853317
328916,1,15,16,1.323851,103.85328
328917,3,13,16,1.323808,103.853288
328918,28,5,33,1.323805,103.853246
328919,1,7,8,1.323755,103.853245
328920,0,5,5,1.32376,103.853212
328921,0,17,17,1.323711,103.853214
328922,11,4,15,1.323719,103.853172
328923,2,11,13,1.323649,103.853159
328924,0,2,2,1.324224,103.853376
328925,1,17,18,1.323639,103.853098
328926,0,22,22,1.32359,103.853107
328927,0,22,22,1.323588,103.853064
328928,1,11,12,1.323545,103.853079
328929,7,64,71,1.323548,103.853018
328930,3,42,45,1.32351,103.853045
328931,4,37,41,1.32347,103.853005
328932,36,45,81,1.323436,103.852965
328933,379,30,409,1.323402,103.852933
328934,0,2,2,1.323679,103.853138
328935,0,2,2,1.299509,103.837
328958,239,145,384,1.328431,103.858322
328982,13,7,20,1.32578,103.864936
328983,0,2,2,1.323402,103.852933
328984,15,0,15,1.325875,103.864841
328985,15,22,37,1.325913,103.864802
328986,15,9,24,1.325957,103.864743
328987,2,0,2,1.325822,103.864909
328988,0,5,5,1.326147,103.865
328989,9,15,24,1.326074,103.864488
328990,1,0,1,1.323957,103.853747
328991,7,0,7,1.326095,103.864452
328992,0,11,11,1.326199,103.865056
328993,4,2,6,1.326153,103.864402
328994,127,3,130,1.326227,103.865076
328995,1,4,5,1.326186,103.864362
328997,1,3,4,1.326229,103.864325
328998,0,4,4,1.326276,103.864278
328999,21,14,35,1.326321,103.864241
329001,572,0,572,1.32645,103.864256
329002,13,25,38,1.326415,103.864303
329003,5,4,9,1.326371,103.864353
329004,2,2,4,1.326336,103.8644
329005,110,1,111,1.326292,103.864444
329007,2,20,22,1.326217,103.864535
329008,1,4,5,1.326169,103.864579
329009,4,0,4,1.326475,103.86483
329010,2,13,15,1.326602,103.864837
329011,3,0,3,1.32415,103.853493
329013,1,1,2,1.326106,103.864968
329014,17,0,17,1.32667,103.864773
329017,4,1,5,1.326589,103.864692
329018,1,0,1,1.326171,103.865019
329020,26,0,26,1.326766,103.864673
329021,2,5,7,1.326659,103.864636
329022,439,375,814,1.325254,103.865221
329023,950,106,1056,1.325356,103.865391
329043,1,82,83,1.324963,103.863595
329045,3,76,79,1.325031,103.863497
329047,1,3,4,1.325117,103.863423
329049,67,5,72,1.325199,103.863338
329050,4,8,12,1.325237,103.86331
329051,4,26,30,1.325265,103.863275
329052,6,1,7,1.325304,103.863242
329053,1,8,9,1.325419,103.863132
329055,9,6,15,1.32551,103.863031
329057,5,12,17,1.325591,103.862955
329058,26,0,26,1.325644,103.862898
329059,4,10,14,1.32569,103.862841
329060,15,7,22,1.325749,103.862784
329089,606,79,685,1.327023,103.849107
329100,11,19,30,1.327263,103.8492
329102,4,10,14,1.327354,103.849285
329104,2,2,4,1.327445,103.849362
329106,0,6,6,1.327535,103.849424
329110,0,3,3,1.326506,103.864801
329111,1620,247,1867,1.328097,103.849798
329112,1510,371,1881,1.328393,103.849245
329113,65,280,345,1.328119,103.849851
329133,3685,7294,10979,1.326894,103.847691
329134,100,124,224,1.327225,103.848088
329136,13,596,609,1.327137,103.847885
329137,731,806,1537,1.327294,103.847989
329138,619,341,960,1.327699,103.848057
329139,27,168,195,1.327819,103.848187
329141,850,263,1113,1.327609,103.848818
329146,2,47,49,1.328082,103.848812
329147,0,270,270,1.328427,103.84842
329148,1,11,12,1.328123,103.848835
329149,1,14,15,1.328166,103.848868
329150,0,45,45,1.32821,103.848902
329151,0,33,33,1.328257,103.848927
329152,5,224,229,1.328306,103.848966
329154,720,1105,1825,1.328276,103.853138
329161,72,89,161,1.326812,103.854066
329162,189,752,941,1.327431,103.854354
329185,4,601,605,1.326866,103.842144
329186,24,12,36,1.326798,103.84247
329187,4,27,31,1.327036,103.84243
329189,0,33,33,1.326853,103.842747
329190,3,20,23,1.327214,103.842424
329191,2,283,285,1.327148,103.842327
329192,150,87,237,1.327697,103.84234
329201,1,31,32,1.327598,103.842311
329202,0,10,10,1.327902,103.842355
329203,0,4,4,1.327738,103.842309
329205,2,1,3,1.327707,103.849565
329206,0,6,6,1.327934,103.84235
329208,0,1,1,1.326736,103.864699
329209,2,2,4,1.327738,103.842309
329210,3,23,26,1.327965,103.84235
329211,2,160,162,1.32789,103.842388
329212,1,100,101,1.327905,103.842384
329213,0,92,92,1.327919,103.842383
329214,3,312,315,1.327933,103.842383
329215,2916,62,2978,1.327765,103.842385
329216,2499,852,3351,1.328374,103.842401
329217,362,7,369,1.327286,103.842411
329236,12,78,90,1.325242,103.863926
329237,1,60,61,1.325242,103.863946
329238,0,7,7,1.325268,103.863898
329239,0,1,1,1.327951,103.842349
329240,2,0,2,1.326533,103.864763
329242,1,0,1,1.325268,103.863918
329244,1,0,1,1.325369,103.863783
329245,13,1,14,1.32542,103.863746
329246,2,3,5,1.32547,103.863668
329247,2,0,2,1.325318,103.86384
329248,162,0,162,1.325521,103.863611
329249,0,2,2,1.32547,103.863688
329250,6,6,12,1.325572,103.863554
329251,1,1,2,1.325521,103.863631
329253,2,0,2,1.325572,103.863574
329254,0,2,2,1.325622,103.863516
329255,4,2,6,1.325673,103.863459
329256,40,0,40,1.325723,103.863381
329257,7,1,8,1.325723,103.863401
329258,1,0,1,1.32542,103.863726
329259,4,0,4,1.325774,103.863344
329260,0,17,17,1.325825,103.863267
329261,2,0,2,1.325673,103.863439
329262,5,0,5,1.325875,103.863209
329263,2,1,3,1.327738,103.842309
329264,1,0,1,1.325774,103.863324
329265,0,1,1,1.325926,103.863152
329266,0,1,1,1.325926,103.863172
329269,0,2,2,1.325825,103.863287
329270,0,4,4,1.326068,103.86299
329271,7,5,12,1.326078,103.863
329317,7,88,95,1.32629,103.850307
329318,15,121,136,1.325966,103.849976
329319,3,71,74,1.326091,103.850092
329320,0,21,21,1.326176,103.85017
329321,0,18,18,1.326245,103.850224
329322,0,37,37,1.326311,103.850281
329323,11,22,33,1.326381,103.850341
329324,2,12,14,1.326461,103.850401
329325,954,152,1106,1.326647,103.850613
329326,3,54,57,1.326525,103.850454
329327,0,16,16,1.326576,103.850502
329328,5,30,35,1.326636,103.85055
329329,1,14,15,1.326687,103.850594
329330,1,10,11,1.326739,103.850638
329331,2,10,12,1.32679,103.850677
329332,10,30,40,1.326842,103.85072
329333,33,31,64,1.327076,103.851286
329335,5,120,125,1.327044,103.850864
329336,0,1,1,1.325977,103.863095
329337,0,10,10,1.327242,103.851027
329338,4,0,4,1.327408,103.851176
329339,0,4,4,1.327305,103.851107
329340,1,254,255,1.327484,103.851242
329341,1,55,56,1.327453,103.851304
329342,39,287,326,1.3271,103.850918
329363,583,16,599,1.327005,103.843839
329364,1,92,93,1.32707,103.843835
329365,1,32,33,1.32713,103.843814
329366,0,38,38,1.327211,103.843812
329367,3,18,21,1.327295,103.84381
329368,3,29,32,1.327373,103.843819
329370,75,77,152,1.327468,103.843761
329371,344,78,422,1.327726,103.84375
329374,0,9,9,1.328461,103.843726
329377,0,40,40,1.328935,103.843866
329378,16,934,950,1.328931,103.843814
329379,0,3,3,1.325875,103.863229
329380,0,33,33,1.328915,103.843606
329381,1,25,26,1.328907,103.843502
329382,2,42,44,1.3289,103.843397
329383,2,8,10,1.328892,103.843293
329384,0,9,9,1.328884,103.843189
329385,0,13,13,1.328876,103.843085
329386,1,15,16,1.328858,103.842971
329387,54,165,219,1.328026,103.843735
329410,2,515,517,1.326997,103.843103
329411,3,307,310,1.327149,103.843099
329412,1,105,106,1.327519,103.842922
329414,2,52,54,1.327915,103.842932
329415,286,543,829,1.327496,103.843146
329417,0,475,475,1.327811,103.843176
329420,5,1495,1500,1.328341,103.843135
329421,2,18,20,1.328027,103.843143
329422,0,16,16,1.328512,103.843116
329423,7,413,420,1.328634,103.843121
329424,0,147,147,1.328736,103.84307
329425,2238,107,2345,1.327918,103.84316
329426,1539,911,2450,1.327983,103.843155
329446,1,553,554,1.299509,103.837
329447,2,735,737,1.299509,103.837
329448,0,62,62,1.299509,103.837
329449,1,50,51,1.299509,103.837
329450,1,7,8,1.299509,103.837
329451,0,12,12,1.299509,103.837
329452,0,4,4,1.299509,103.837
329453,0,8,8,1.299509,103.837
329454,0,3,3,1.328923,103.84371
329455,1,1,2,1.326027,103.863057
329456,1,2,3,1.299509,103.837
329457,0,8,8,1.299509,103.837
329459,0,10,10,1.484241,103.885334
329460,1,1,2,1.299509,103.837
329504,28,202,230,1.325973,103.850864
329505,322,248,570,1.32535,103.851792
329506,97,53,150,1.326395,103.851195
329507,1500,373,1873,1.326104,103.851429
329508,4,82,86,1.326511,103.851475
329510,22,35,57,1.326889,103.851615
329511,1,71,72,1.325917,103.851989
329512,14,25,39,1.325921,103.851988
329513,67,23,90,1.32577,103.852259
329514,19,144,163,1.327063,103.852032
329515,3,20,23,1.32699,103.852168
329516,15,68,83,1.326432,103.851698
329517,32,32,64,1.325924,103.852353
329538,7,497,504,1.325777,103.845862
329539,1,137,138,1.325853,103.845855
329540,3,5,8,1.326451,103.845794
329542,0,74,74,1.326005,103.845842
329543,5689,226,5915,1.325701,103.845848
329544,4,25,29,1.3257,103.845847
329545,0,47,47,1.326157,103.84583
329546,0,76,76,1.326309,103.845817
329547,1,121,122,1.326461,103.845804
329548,2,233,235,1.325401,103.845902
329550,594,844,1438,1.325365,103.845535
329551,3,6,9,1.325319,103.84591
329552,963,25,988,1.32524,103.845923
329553,2,0,2,1.299509,103.837
329554,0,159,159,1.325024,103.845932
329557,327,642,969,1.32495,103.845977
329560,605,1083,1688,1.324142,103.845271
329561,94,7,101,1.323543,103.844241
329562,754,5360,6114,1.322947,103.845714
329563,6845,33109,39954,1.322126,103.844377
329564,1309,15,1324,1.325911,103.845756
329565,6,11,17,1.299509,103.837
329566,0,18,18,1.299509,103.837
329568,8,2051,2059,1.299509,103.837
329578,44,41,85,1.326085,103.849336
329579,1,8,9,1.32608,103.849353
329580,3,0,3,1.325696,103.845562
329581,0,4,4,1.326139,103.849633
329582,2,134,136,1.299509,103.837
329583,62,63,125,1.326813,103.849627
329584,50,0,50,1.326181,103.84966
329585,41,63,104,1.326798,103.849937
329586,452,2,454,1.326388,103.849646
329587,41,0,41,1.299509,103.837
329589,20,143,163,1.326499,103.849745
329591,2,22,24,1.326553,103.849785
329593,3,15,18,1.326599,103.849827
329595,1,15,16,1.326639,103.849867
329597,1,10,11,1.326688,103.849904
329598,9,36,45,1.326729,103.849943
329599,98,185,283,1.326994,103.850122
329600,8,21,29,1.326778,103.849976
329601,7,23,30,1.326829,103.850025
329602,947,110,1057,1.327591,103.850139
329603,1,28,29,1.326875,103.85007
329604,7,59,66,1.326915,103.850121
329605,94,12,106,1.326956,103.850161
329606,3,76,79,1.327001,103.850201
329607,8,218,226,1.327047,103.850241
329608,1006,433,1439,1.32785,103.850111
329609,147,36,183,1.32736,103.850475
329610,19,921,940,1.327744,103.850835
329632,0,35,35,1.325046,103.849827
329633,40,43,83,1.324783,103.849742
329634,93,19,112,1.324884,103.849834
329635,60,23,83,1.324937,103.849865
329636,3,25,28,1.324977,103.849775
329638,0,21,21,1.324914,103.849713
329640,397,22,419,1.32484,103.849662
329642,0,12,12,1.324777,103.849616
329644,0,7,7,1.324714,103.849571
329645,0,17,17,1.324576,103.849485
329646,2,17,19,1.324508,103.849434
329647,3,57,60,1.324459,103.849374
329648,0,136,136,1.324407,103.849315
329670,52,1326,1378,1.316385,103.858143
329671,1,294,295,1.316426,103.858098
329672,0,226,226,1.316485,103.858004
329673,0,101,101,1.316539,103.857903
329674,2,263,265,1.316585,103.85784
329675,17,2777,2794,1.316629,103.857779
329676,124,850,974,1.317448,103.856385
329677,596,4091,4687,1.317959,103.855412
329678,463,3068,3531,1.318566,103.854526
329680,70,197,267,1.319252,103.854075
329681,9,1256,1265,1.319381,103.85388
329682,896,2920,3816,1.320447,103.852677
329683,11,2332,2343,1.320902,103.852673
329684,790,4,794,1.321042,103.852958
329685,9,8403,8412,1.32115,103.85294
329686,0,6,6,1.321293,103.852923
329688,141,12340,12481,1.321505,103.853016
329690,17,3638,3655,1.321515,103.852899
329692,25,6810,6835,1.321554,103.852892
329694,7,6,13,1.321613,103.853262
329698,0,24,24,1.321613,103.853302
329699,3,11,14,1.321375,103.852246
329700,5,45,50,1.321621,103.853354
329701,61,7,68,1.321647,103.853355
329702,0,10,10,1.32164,103.853289
329704,0,12,12,1.321631,103.853243
329706,105,4866,4971,1.321832,103.852991
329707,5,2113,2118,1.321839,103.852861
329708,33,2352,2385,1.321761,103.852639
329709,2,5547,5549,1.321928,103.852848
329710,117,6059,6176,1.321995,103.852685
329714,207,77,284,1.322159,103.853124
329715,113,375,488,1.322391,103.852268
329716,1,261,262,1.322162,103.852681
329717,9,4161,4170,1.322287,103.852828
329719,5,1714,1719,1.322348,103.852824
329720,107,7344,7451,1.322181,103.852234
329721,8,1316,1324,1.322394,103.852814
329722,9,1310,1319,1.322369,103.852636
329723,23,1974,1997,1.322423,103.852812
329724,0,226,226,1.322433,103.852635
329725,1,122,123,1.322488,103.852622
329726,11,2905,2916,1.322546,103.852606
329727,465,943,1408,1.322862,103.852208
329731,23,4673,4696,1.322817,103.85283
329732,17,4187,4204,1.322786,103.85275
329733,3,857,860,1.322919,103.852675
329734,4,4,8,1.323021,103.852594
329735,9,2608,2617,1.32307,103.852562
329736,6,70,76,1.323116,103.852533
329737,16,4419,4435,1.323143,103.852513
329738,242,4,246,1.323291,103.852397
329739,2,838,840,1.323322,103.852365
329740,3,4058,4061,1.323366,103.852325
329741,2,173,175,1.323404,103.85229
329742,13,3911,3924,1.32343,103.852255
329743,1,729,730,1.323459,103.852229
329744,3,1034,1037,1.323582,103.852027
329745,10,1805,1815,1.324074,103.851473
329746,4,423,427,1.324058,103.851487
329747,11,2599,2610,1.324041,103.851503
329748,1,9,10,1.324022,103.851519
329749,4,1768,1772,1.324001,103.851535
329750,0,1,1,1.327148,103.850968
329754,2,27,29,1.323963,103.851572
329758,5,1192,1197,1.323736,103.851869
329760,0,124,124,1.323775,103.851838
329761,3,1033,1036,1.323887,103.851632
329762,6,667,673,1.323806,103.851811
329764,1,233,234,1.323844,103.851777
329765,28,4667,4695,1.323865,103.851652
329766,1,370,371,1.323886,103.851746
329767,4,2924,2928,1.323997,103.851665
329768,3,1074,1077,1.323916,103.851719
329770,4,938,942,1.323955,103.851685
329772,5,2530,2535,1.324096,103.851853
329773,7,1114,1121,1.324208,103.851328
329774,35,8194,8229,1.32403,103.851629
329775,1,5,6,1.324223,103.851312
329776,577,181,758,1.324843,103.852405
329777,73,1304,1377,1.324202,103.851198
329778,1069,772,1841,1.325137,103.852335
329779,705,1556,2261,1.324995,103.85076
329780,281,9,290,1.324652,103.851095
329781,5,9279,9284,1.32485,103.851308
329782,79,6070,6149,1.324535,103.850955
329783,1198,0,1198,1.324989,103.85119
329784,277,234,511,1.324701,103.850792
329785,40,15247,15287,1.324881,103.850592
329786,1,982,983,1.324902,103.850556
329787,1,1154,1155,1.324931,103.850527
329788,3,1795,1798,1.324977,103.850482
329789,0,678,678,1.325025,103.850437
329790,2,1887,1889,1.325081,103.85037
329791,0,384,384,1.325108,103.850329
329792,0,50,50,1.32514,103.850291
329793,13,3093,3106,1.325164,103.850256
329794,8,4626,4634,1.325178,103.850226
329795,368,2471,2839,1.325286,103.850051
329796,2,522,524,1.3253,103.850015
329797,17,449,466,1.325332,103.849954
329798,11,509,520,1.325369,103.849886
329799,1,424,425,1.325408,103.849801
329800,18,1299,1317,1.325446,103.849733
329801,22,1865,1887,1.325521,103.84956
329802,365,168,533,1.325601,103.850723
329803,89,2295,2384,1.325604,103.849438
329804,9,2865,2874,1.325724,103.849236
329805,7,3742,3749,1.325804,103.8494
329806,13,1053,1066,1.325742,103.849489
329808,128,10558,10686,1.325735,103.84963
329810,50,5224,5274,1.326152,103.849033
329811,4,3809,3813,1.325864,103.84893
329812,10,1,11,1.325911,103.848829
329813,71,3934,4005,1.326346,103.848587
329814,2,1430,1432,1.325949,103.848746
329815,1,0,1,1.324009,103.85153
329816,155,343,498,1.326172,103.848163
329819,17,5002,5019,1.326075,103.848498
329820,11,80,91,1.326057,103.848333
329821,0,6,6,1.326205,103.848221
329822,0,10,10,1.326208,103.849315
329824,0,1,1,1.326255,103.848644
329826,3,19,22,1.326216,103.848193
329827,1,57,58,1.326769,103.84894
329828,0,109,109,1.326241,103.848153
329829,3,120,123,1.326262,103.848103
329830,0,346,346,1.326343,103.848355
329831,0,342,342,1.326288,103.848056
329832,6,20,26,1.326409,103.848211
329833,1,321,322,1.326299,103.848033
329834,2,457,459,1.326478,103.848072
329835,0,1,1,1.326263,103.849356
329836,0,1,1,1.326318,103.847995
329837,41,11170,11211,1.326652,103.847936
329838,0,10,10,1.326364,103.847911
329839,0,204,204,1.326373,103.84789
329840,3,1778,1781,1.326384,103.847854
329841,0,52,52,1.326398,103.847806
329842,56,4767,4823,1.326325,103.847798
329843,8,1223,1231,1.326422,103.847731
329844,37,910,947,1.326446,103.84705
329846,1,1,2,1.32518,103.845915
329847,1,2,3,1.299509,103.837
329848,4,5909,5913,1.326448,103.846829
329849,2,872,874,1.326449,103.846783
329850,5,851,856,1.326451,103.846745
329851,22,8744,8766,1.32645,103.846703
329852,70,20,90,1.326345,103.846606
329853,17,1299,1316,1.327127,103.845804
329854,24,15,39,1.325956,103.84629
329856,29,6493,6522,1.326419,103.846056
329857,130,569,699,1.327097,103.845696
329858,45,3156,3201,1.326419,103.845978
329859,6,1597,1603,1.326593,103.845674
329860,0,221,221,1.326588,103.845609
329861,0,389,389,1.326589,103.845549
329862,2,2716,2718,1.326392,103.842645
329863,1,1,2,1.326445,103.84693
329864,8,942,950,1.326593,103.845407
329865,5,193,198,1.326415,103.845206
329866,7,440,447,1.326421,103.845126
329867,0,1,1,1.326333,103.847959
329868,5,1,6,1.326467,103.844898
329869,2,573,575,1.326478,103.844864
329870,8,1803,1811,1.326613,103.845103
329871,1,0,1,1.326433,103.845046
329872,12,559,571,1.326628,103.845008
329873,0,58,58,1.326501,103.84475
329874,10,488,498,1.326631,103.844942
329875,0,1,1,1.326496,103.844784
329876,35,489,524,1.326878,103.844637
329877,2,90,92,1.326507,103.844631
329878,5,264,269,1.326883,103.844508
329879,8,571,579,1.326513,103.844551
329880,8,551,559,1.326853,103.844335
329881,0,29,29,1.326188,103.844441
329883,4,234,238,1.326863,103.844214
329884,14,3395,3409,1.326516,103.844361
329885,61,492,553,1.326869,103.84407
329886,0,6,6,1.326517,103.844292
329887,1,619,620,1.326516,103.844224
329888,1,2,3,1.326448,103.846875
329889,2,1700,1702,1.326957,103.8436
329890,1,2288,2289,1.326511,103.844112
329891,1,421,422,1.326755,103.843708
329893,0,660,660,1.326757,103.843765
329894,26,1846,1872,1.326505,103.843991
329895,2,385,387,1.326773,103.843819
329896,1,610,611,1.32666,103.843319
329897,1,1409,1410,1.326648,103.843222
329898,13,137,150,1.326899,103.843165
329899,18,4278,4296,1.326648,103.843153
329900,23,5007,5030,1.326582,103.84302
329901,3911,257,4168,1.32658,103.842963
329902,22,1268,1290,1.326573,103.84291
329903,3,1582,1585,1.326428,103.843378
329904,11,268,279,1.326428,103.843321
329905,0,230,230,1.326428,103.843281
329906,1,237,238,1.326417,103.843235
329907,1,237,238,1.326411,103.843184
329908,0,247,247,1.326411,103.843139
329909,0,186,186,1.326418,103.843106
329910,2,204,206,1.326415,103.843052
329911,0,270,270,1.32641,103.843005
329912,2,320,322,1.326402,103.842965
329913,2,291,293,1.326402,103.842927
329914,0,287,287,1.326403,103.84288
329915,6,239,245,1.326397,103.842834
329916,1,107,108,1.326396,103.842781
329917,2,1,3,1.326513,103.84416
329918,1,900,901,1.326392,103.84267
329919,5,25,30,1.326145,103.842628
329920,5,1191,1196,1.326395,103.842604
329921,7,295,302,1.326387,103.842539
329922,14,827,841,1.326381,103.842475
329923,6,3832,3838,1.324238,103.851297
329924,18,13,31,1.323703,103.85191
329926,439,4771,5210,1.319936,103.852506
329927,166,22,188,1.325976,103.844562
329928,374,1163,1537,1.321274,103.852631
329929,158,52,210,1.321683,103.85246
329930,39,3099,3138,1.325948,103.849108
329946,0,5,5,1.322224,103.852312
329947,3,13,16,1.322221,103.852099
329948,1,21,22,1.322224,103.852162
329949,658,16,674,1.322269,103.851716
329950,17,250,267,1.322219,103.852216
329951,30,28,58,1.322412,103.852573
329973,212,20,232,1.327382,103.845057
329974,493,481,974,1.327245,103.844831
329975,114,1599,1713,1.328169,103.845627
329976,409,279,688,1.32809,103.847575
329977,115,84,199,1.328068,103.84836
329978,15,1957,1972,1.328499,103.847899
329979,1319,193,1512,1.329063,103.8485
329980,833,7,840,1.32857,103.84856
329981,775,82,857,1.32857,103.84856
329982,4408,180,4588,1.327079,103.846514
329983,408,10,418,1.32692,103.846279
329984,182,6032,6214,1.32707,103.846468
330004,351,139,490,1.315404,103.859772
330005,717,268,985,1.315404,103.859772
330006,138,340,478,1.315404,103.859772
330007,923,1409,2332,1.317077,103.86203
330008,895,592,1487,1.315404,103.859772
330009,1352,56,1408,1.315983,103.861321
330010,46,84,130,1.299509,103.837
330011,1,29,30,1.318507,103.861528
330022,276,4081,4357,1.318003,103.861592
330023,145,2772,2917,1.317814,103.863141
330024,30,50,80,1.318629,103.862329
330025,197,4,201,1.318626,103.862908
330026,35,11958,11993,1.318296,103.862925
330027,25,4,29,1.318858,103.862831
330028,99,15619,15718,1.318694,103.863233
330029,21,57,78,1.319142,103.863322
330030,150,4221,4371,1.319344,103.863927
330031,85,417,502,1.319428,103.863761
330032,228,19,247,1.319542,103.863603
330033,22,139,161,1.319661,103.862785
330034,428,511,939,1.320442,103.863755
330039,43,173,216,1.320829,103.866192
330043,1373,583,1956,1.321104,103.865851
330044,374,1992,2366,1.322123,103.866633
330045,633,5266,5899,1.322704,103.866185
330046,221,364,585,1.323002,103.865925
330047,290,1595,1885,1.323265,103.866596
330048,646,167,813,1.323325,103.866174
330049,572,435,1007,1.324448,103.866396
330053,55,1854,1909,1.322958,103.869896
330054,794,3409,4203,1.324051,103.867963
330055,256,2727,2983,1.322958,103.869896
330056,624,785,1409,1.322958,103.869896
330057,591,6358,6949,1.322958,103.869896
330058,470,125,595,1.322958,103.869896
330059,907,53,960,1.322958,103.869896
330060,565,619,1184,1.322958,103.869896
330061,385,749,1134,1.322958,103.869896
330062,775,130,905,1.322958,103.869896
330063,707,86,793,1.320065,103.869493
330064,798,69,867,1.320065,103.869493
330065,177,1577,1754,1.320065,103.869493
330066,332,7902,8234,1.320065,103.869493
330067,176,470,646,1.320065,103.869493
330068,512,85,597,1.322958,103.869896
330069,16,17,33,1.321461,103.870115
330070,165,17011,17176,1.321912,103.870346
330071,224,1702,1926,1.320553,103.870154
330072,248,1411,1659,1.321994,103.870953
330073,414,11973,12387,1.322632,103.870598
330093,356,278,634,1.321993,103.871588
330094,211,331,542,1.322333,103.871339
330095,229,283,512,1.322709,103.870818
330096,133,1297,1430,1.323298,103.870388
330097,247,865,1112,1.323741,103.87015
331006,32,1668,1700,1.317291,103.861374
331008,7,36,43,1.316679,103.861374
331010,440,834,1274,1.315085,103.860401
331011,1,5,6,1.299509,103.837
331022,29,751,780,1.318947,103.861917
331038,1915,535,2450,1.320005,103.866809
331039,1030,742,1772,1.320161,103.866388
331044,12,4167,4179,1.322867,103.866994
331047,23,309,332,1.323891,103.866804
331049,4,42,46,1.323895,103.866392
331057,15,10122,10137,1.322958,103.869896
331059,795,182,977,1.322958,103.869896
331060,7,193,200,1.322858,103.868673
331065,44,6571,6615,1.319837,103.869061
331070,36,55,91,1.321618,103.870337
332008,12,34,46,1.316409,103.861163
332010,131,80,211,1.315368,103.86084
332038,635,133,768,1.320531,103.866877
332059,318,644,962,1.322958,103.869896
333008,37,29,66,1.316589,103.861072
333010,110,59,169,1.315651,103.861043
333038,475,108,583,1.320821,103.866744
333059,21,93,114,1.322118,103.868331
334008,5,56,61,1.316983,103.861354
334038,878,1513,2391,1.32132,103.866751
338517,1174,196,1370,1.32165,103.864566
338518,275,1695,1970,1.299509,103.837
338519,1532,200,1732,1.299509,103.837
338520,1500,104,1604,1.299509,103.837
338521,1928,854,2782,1.299509,103.837
338522,20,55,75,1.299509,103.837
338523,6,11,17,1.299509,103.837
338524,17,46,63,1.299509,103.837
338525,21,11,32,1.299509,103.837
338526,10,22,32,1.299509,103.837
338527,29,29,58,1.299509,103.837
338528,129,249,378,1.299509,103.837
338529,26,17,43,1.299509,103.837
338530,5,6,11,1.299509,103.837
338531,4,11,15,1.299509,103.837
338532,4,8,12,1.299509,103.837
338533,3,10,13,1.299509,103.837
338534,8,25,33,1.299509,103.837
338535,3,92,95,1.299509,103.837
338536,24,39,63,1.299509,103.837
338537,2,18,20,1.299509,103.837
338538,29,18,47,1.299509,103.837
338539,26,129,155,1.299509,103.837
338540,3,210,213,1.299509,103.837
338710,160,822,982,1.309944,103.863099
338711,4,858,862,1.310087,103.863023
338712,16,3698,3714,1.310204,103.863487
338713,1,478,479,1.310255,103.862908
338714,6,585,591,1.310363,103.862813
338715,66,1591,1657,1.310472,103.862712
338716,249,3841,4090,1.310831,103.86232
338719,19,3643,3662,1.311033,103.862287
338720,8,134,142,1.311121,103.862234
338721,3,843,846,1.311168,103.862139
338722,46,6,52,1.311237,103.862068
338723,4,850,854,1.311237,103.862068
338724,22,2641,2663,1.311237,103.862068
338725,317,4169,4486,1.311459,103.86199
338728,90,2853,2943,1.311405,103.862492
338729,2122,1187,3309,1.311654,103.862322
338730,127,3936,4063,1.31187,103.862164
338731,15,881,896,1.312113,103.86161
338732,5,853,858,1.312208,103.86154
338733,2,111,113,1.312293,103.86148
338734,19,128,147,1.312328,103.861452
338735,6,1547,1553,1.312352,103.861433
338736,4,856,860,1.312402,103.861396
338737,340,3,343,1.312452,103.861359
338738,1,5,6,1.312501,103.861322
338739,648,268,916,1.31265,103.861212
338741,3,2607,2610,1.312726,103.861154
338742,1,326,327,1.312752,103.861133
338743,0,1770,1770,1.312805,103.861092
338744,0,26,26,1.312858,103.86105
338745,2,535,537,1.312911,103.861008
338746,0,41,41,1.312964,103.860966
338747,3,602,605,1.313018,103.860925
338748,0,37,37,1.313071,103.860883
338749,3,1218,1221,1.313124,103.860841
338750,90,1376,1466,1.313177,103.8608
338751,9,3171,3180,1.31322,103.860768
338753,0,240,240,1.312463,103.861533
338754,1,66,67,1.312541,103.861477
338755,3,73,76,1.31262,103.86142
338757,2,60,62,1.312766,103.861318
338758,15,3284,3299,1.313451,103.860239
338759,1,54,55,1.312869,103.861309
338760,0,6,6,1.312931,103.861255
338762,1,179,180,1.313097,103.861135
338763,13,61,74,1.314202,103.860058
338764,0,291,291,1.314178,103.860077
338765,3,352,355,1.314128,103.860116
338766,2,1,3,1.326396,103.84273
338767,18,427,445,1.314079,103.860155
338768,1,705,706,1.313244,103.861027
338769,1,269,270,1.314029,103.860194
338770,16,1684,1700,1.314394,103.859751
338771,30,977,1007,1.313374,103.861101
338772,12,565,577,1.314636,103.85969
338773,3,1926,1929,1.314658,103.859661
338774,2,78,80,1.314687,103.859633
338775,0,501,501,1.314716,103.859604
338776,10,227,237,1.314744,103.859576
338777,1,10,11,1.314779,103.859547
338778,3,262,265,1.314819,103.859513
338779,2,609,611,1.31487,103.859485
338780,3,30,33,1.314905,103.859456
338781,0,381,381,1.314956,103.859433
338782,0,24,24,1.314996,103.859405
338783,119,343,462,1.315042,103.859376
338784,0,93,93,1.315071,103.859354
338785,0,1,1,1.326501,103.844671
338787,7,200,207,1.315202,103.859262
338788,2,15,17,1.315244,103.859246
338789,10,189,199,1.315283,103.859219
338790,1,3,4,1.315318,103.859198
338791,2,178,180,1.315339,103.859185
338793,2,442,444,1.315393,103.859138
338794,2,0,2,1.326404,103.845291
338795,18,0,18,1.315456,103.859081
338797,1,429,430,1.315508,103.859021
338798,9,324,333,1.315542,103.859004
338799,6,936,942,1.314432,103.860076
338800,52,354,406,1.314457,103.860057
338801,1,1,2,1.315428,103.859109
338802,1,228,229,1.31456,103.859978
338803,6,3,9,1.314611,103.859939
338804,1,388,389,1.314662,103.8599
338805,5,254,259,1.314714,103.85986
338806,17,220,237,1.314755,103.859831
338807,9,777,786,1.314792,103.859802
338808,5,352,357,1.314818,103.859783
338809,6,21,27,1.314872,103.859744
338810,0,363,363,1.314925,103.859706
338811,19,16,35,1.314979,103.859668
338812,36,479,515,1.315032,103.85963
338813,29,336,365,1.315086,103.859591
338814,17,445,462,1.315129,103.859563
338815,30,417,447,1.315204,103.85952
338816,10,252,262,1.315247,103.859483
338817,4,117,121,1.31531,103.859447
338818,3,105,108,1.315357,103.859404
338819,0,132,132,1.315404,103.859353
338820,2,251,253,1.315493,103.859286
338821,15,371,386,1.315577,103.859224
338822,10,1017,1027,1.315665,103.859164
338823,100,3550,3650,1.309294,103.864561
338985,8,897,905,1.308724,103.865705
338986,44,85,129,1.307084,103.866855
338987,1271,858,2129,1.306139,103.866068
338988,8,81,89,1.308497,103.865902
339041,0,6,6,1.317465,103.864358
339096,75,465,540,1.308879,103.865919
339097,8,1275,1283,1.308845,103.865914
339098,2136,1001,3137,1.30983,103.868795
339152,38,79,117,1.317332,103.867376
339153,265,177,442,1.316519,103.86756
339154,394,71,465,1.316284,103.867902
339155,511,91,602,1.315684,103.868019
339156,541,131,672,1.31624,103.866544
339157,166,192,358,1.315409,103.86749
339158,512,176,688,1.314806,103.867244
339159,649,569,1218,1.314878,103.866184
339160,33,154,187,1.314876,103.867855
339161,3,80,83,1.314408,103.868209
339162,0,2,2,1.314509,103.860017
339163,4,9,13,1.314466,103.868326
339164,1,0,1,1.315117,103.859319
339165,1,0,1,1.314554,103.867992
339166,5,3,8,1.314339,103.868083
339167,41,1,42,1.314702,103.86879
339168,20,3,23,1.314329,103.868093
339169,39,4,43,1.314809,103.869013
339170,5,1,6,1.314166,103.86814
339171,2,5,7,1.314752,103.86893
339172,96,40,136,1.313992,103.868197
339173,12,2,14,1.314705,103.868837
339174,4,3,7,1.314611,103.868651
339175,5,3,8,1.314517,103.868465
339176,11,49,60,1.314423,103.868279
339177,130,51,181,1.3137,103.868513
339178,3,103,106,1.31446,103.867176
339183,1,0,1,1.314584,103.868558
339190,1,22,23,1.313571,103.867482
339191,0,21,21,1.313536,103.867455
339192,0,45,45,1.313501,103.867217
339193,0,4,4,1.313504,103.867174
339194,2,5,7,1.313595,103.867068
339196,0,7,7,1.313622,103.866987
339197,0,3,3,1.313179,103.861082
339198,0,5,5,1.313736,103.866869
339200,0,2,2,1.314768,103.8679
339201,0,6,6,1.314323,103.866622
339202,0,115,115,1.314281,103.866573
339203,4,415,419,1.314239,103.866524
339204,1,28,29,1.314196,103.866475
339205,0,9,9,1.314154,103.866426
339206,1,16,17,1.314112,103.866377
339207,0,11,11,1.31407,103.866327
339208,1,26,27,1.314288,103.86697
339209,2,42,44,1.314294,103.866997
339211,700,409,1109,1.31744,103.866612
339212,375,156,531,1.315857,103.867066
339263,27,5155,5182,1.312453,103.864183
339264,13,4280,4293,1.311816,103.864302
339265,403,606,1009,1.312765,103.864413
339266,0,154,154,1.311918,103.864394
339267,0,14,14,1.312124,103.864579
339268,5,0,5,1.312329,103.864764
339269,0,3,3,1.313664,103.866964
339270,2,10,12,1.312739,103.865134
339271,0,29,29,1.312945,103.865319
339272,22,644,666,1.31315,103.865484
339274,774,706,1480,1.313607,103.865792
339275,0,178,178,1.313243,103.865586
339276,4,116,120,1.313337,103.865668
339278,1,3,4,1.313709,103.865995
339279,55,630,685,1.313886,103.866149
339334,22,3058,3080,1.313955,103.863452
339335,1,2,3,1.312534,103.864949
339336,2,33,35,1.313955,103.863452
339338,697,408,1105,1.317453,103.865801
339339,58,35,93,1.315961,103.865179
339340,402,2462,2864,1.317453,103.865801
339341,687,1465,2152,1.318053,103.866329
339342,23,2,25,1.318371,103.865657
339343,85,95,180,1.318053,103.866329
339344,44,4,48,1.31821,103.865628
339346,516,112,628,1.318655,103.865807
339347,44,48,92,1.318927,103.865936
339348,96,37,133,1.319268,103.866176
339349,329,81,410,1.319044,103.866799
339350,77,6217,6294,1.319925,103.870723
339351,75,4181,4256,1.320843,103.870582
339353,10,370,380,1.320276,103.871214
339354,14,1679,1693,1.299509,103.837
339355,12,58,70,1.299509,103.837
339356,37,1036,1073,1.299509,103.837
339407,2608,3799,6407,1.311457,103.863447
339410,490,1571,2061,1.311418,103.865311
339411,6376,3493,9869,1.309974,103.865434
339412,491,16,507,1.312157,103.866051
339413,411,5604,6015,1.309943,103.865578
339414,42,243,285,1.311477,103.865932
339415,122,434,556,1.310435,103.866892
339416,894,159,1053,1.310942,103.865653
339417,177,1057,1234,1.310222,103.867366
339418,8,131,139,1.310443,103.866622
339420,8,189,197,1.310738,103.86718
339504,199,90,289,1.311362,103.866805
339505,50,81,131,1.312699,103.866049
339508,522,162,684,1.311413,103.867008
339509,6326,576,6902,1.310828,103.863684
339510,6138,21677,27815,1.310322,103.864261
339511,981,203,1184,1.309576,103.86436
339557,0,111,111,1.315729,103.861862
339558,0,1,1,1.314085,103.867381
339559,0,30,30,1.315658,103.861949
339560,0,1,1,1.315498,103.862094
339561,3,9,12,1.315598,103.862013
339562,0,3,3,1.313955,103.863452
339563,7,11,18,1.315536,103.862136
339564,99,10,109,1.315197,103.862486
339565,2,8,10,1.31537,103.862375
339567,1,6,7,1.315164,103.862637
339568,17,2,19,1.314956,103.862794
339569,1,12,13,1.314838,103.862949
339570,2,11,13,1.314987,103.862848
339571,0,7,7,1.314686,103.863152
339572,7,9,16,1.31491,103.86297
339573,77,409,486,1.314598,103.863274
339626,11,6642,6653,1.324084,103.87089
339627,52,89,141,1.322721,103.872784
339628,19,2342,2361,1.323059,103.872058
339629,8,156,164,1.299509,103.837
339682,14,1,15,1.32109,103.872231
339683,6,85,91,1.320475,103.872783
339684,3,7,10,1.321125,103.873044
339685,6,6,12,1.320599,103.873052
339686,26,56,82,1.320421,103.872659
339687,9,199,208,1.320345,103.872726
339688,8,10,18,1.320566,103.873202
339689,7,3,10,1.320358,103.873837
339690,11,582,593,1.320317,103.872675
339691,5,26,31,1.319475,103.87293
339692,13,8,21,1.320189,103.873945
339693,0,3,3,1.315299,103.862331
339694,0,1,1,1.315373,103.862237
339695,54,112,166,1.320061,103.874184
339696,113,98,211,1.320231,103.874069
339697,12,102,114,1.320549,103.873827
339698,2,81,83,1.320864,103.873774
339699,5,11,16,1.321077,103.873324
339700,4,155,159,1.320976,103.873718
339701,5,18,23,1.318082,103.871947
339702,71,5,76,1.317897,103.871437
339703,95,14,109,1.31727,103.871384
339704,2,1,3,1.320117,103.873991
339705,9,2,11,1.318746,103.869908
339706,11,0,11,1.318217,103.870669
339707,2,0,2,1.314365,103.866672
339708,19,1,20,1.317756,103.869992
339709,31,29,60,1.318723,103.871515
339710,0,1,1,1.320038,103.874052
339711,12,3,15,1.317494,103.869312
339712,11,1,12,1.316519,103.87009
339713,103,1,104,1.316277,103.869741
339714,12,1,13,1.316613,103.869517
339715,4,1,5,1.316909,103.870323
339716,27,1,28,1.317036,103.869423
339717,44,673,717,1.324105,103.869686
339718,7,85,92,1.32476,103.868411
339719,10,365,375,1.299509,103.837
339771,107,287,394,1.31786,103.862294
339772,11,2716,2727,1.317142,103.862515
339773,15,1190,1205,1.316098,103.864197
339774,6,83,89,1.316237,103.863947
339775,14,550,564,1.315644,103.86386
339776,8,406,414,1.316464,103.863663
339777,0,283,283,1.315464,103.864153
339778,8,700,708,1.316944,103.863037
339779,642,834,1476,1.315326,103.865071
339780,3333,36,3369,1.315811,103.863375
339833,5,22,27,1.323762,103.865517
339834,3,64,67,1.323528,103.865337
339835,3,23,26,1.323852,103.865598
339836,9,9,18,1.323438,103.865263
339837,0,10,10,1.323945,103.865678
339839,6,19,25,1.324083,103.86578
339840,1,7,8,1.323228,103.865092
339841,8,14,22,1.324191,103.86586
339842,1,0,1,1.317291,103.870443
339843,1,1,2,1.318314,103.869886
339844,1,5,6,1.323067,103.865089
339846,1,7,8,1.322986,103.865183
339847,6,10,16,1.324113,103.866112
339848,23,47,70,1.322929,103.86527
339849,12,13,25,1.324071,103.86619
339850,0,10,10,1.323003,103.865384
339851,58,1,59,1.323093,103.865471
339852,20,9,29,1.323226,103.865558
339853,8,14,22,1.32334,103.865645
339854,16,27,43,1.323487,103.865762
339855,10,2,12,1.32361,103.865859
339856,22,15,37,1.323714,103.865956
339914,2639,959,3598,1.31437,103.862153
339930,14,10,24,1.315027,103.861852
339932,12,1506,1518,1.315098,103.861523
339933,9,560,569,1.315201,103.861317
339934,4,268,272,1.315317,103.861415
339935,5,314,319,1.315427,103.861518
339936,6,869,875,1.315556,103.861589
339937,26,1335,1361,1.315652,103.861686
339938,2,14,16,1.31593,103.861906
339939,10,1720,1730,1.316034,103.86201
339940,940,2705,3645,1.316459,103.862385
339941,814,574,1388,1.316002,103.862886
339942,790,3276,4066,1.318369,103.864618
339943,316,1665,1981,1.319788,103.865101
339944,494,83,577,1.319083,103.865482
339945,10,59,69,1.319582,103.865965
339946,1518,16446,17964,1.32576,103.86903
339948,482,8720,9202,1.322197,103.865365
339949,2580,101,2681,1.31708,103.863297
347467,53,1,54,1.329524,103.870186
347468,14,0,14,1.329524,103.870186
347469,17,0,17,1.329524,103.870186
347470,6,0,6,1.329631,103.870153
347471,8,0,8,1.329631,103.870153
347472,24,0,24,1.329631,103.870153
347473,2,0,2,1.324261,103.865946
347475,56,1,57,1.329733,103.87013
347476,3,11,14,1.329733,103.87013
347477,13,6,19,1.329733,103.87013
347478,26,2,28,1.329483,103.870275
347479,0,4,4,1.329791,103.870179
347480,4,8,12,1.299509,103.837
347482,7,0,7,1.332001,103.875223
347483,2,0,2,1.329631,103.870153
347484,1,0,1,1.323148,103.865032
347485,0,5,5,1.331897,103.875116
347486,3,197,200,1.320488,103.877241
347487,13,1,14,1.332818,103.877965
347488,0,1,1,1.331959,103.875165
347489,0,2,2,1.332019,103.875266
347490,1,6,7,1.333268,103.878042
347491,44,191,235,1.333254,103.878096
347493,138,22,160,1.323237,103.877622
347494,10,15,25,1.323634,103.877451
347495,121,160,281,1.323076,103.877667
347496,1,7,8,1.333073,103.8749
347497,0,1,1,1.33321,103.877973
347498,1,0,1,1.333118,103.874909
347499,11,1,12,1.333312,103.874955
347500,0,9,9,1.333375,103.874963
347504,1,17,18,1.299509,103.837
347505,1,42,43,1.299509,103.837
347506,3,0,3,1.318701,103.870447
347507,12,0,12,1.299509,103.837
347529,0,107,107,1.332041,103.87037
347530,1,15,16,1.332046,103.870415
347532,0,7,7,1.33207,103.870514
347533,35,1,36,1.332318,103.870558
347534,0,12,12,1.332087,103.870568
347535,1,8,9,1.332225,103.870757
347536,30,11,41,1.332306,103.87065
347537,0,2,2,1.333227,103.877996
347538,5,10,15,1.332394,103.870988
347539,5,2,7,1.33243,103.871099
347540,0,19,19,1.332461,103.871202
347541,0,16,16,1.332166,103.870827
347542,1,2,3,1.299509,103.837
347543,1,7,8,1.332195,103.870914
347544,7,0,7,1.33249,103.871264
347545,1,19,20,1.332256,103.871083
347546,28,0,28,1.332564,103.871232
347547,15,38,53,1.332312,103.871234
347548,2,2,4,1.332635,103.871204
347549,2,5,7,1.332337,103.87137
347550,25,0,25,1.332723,103.871168
347551,133,1,134,1.33236,103.871439
347552,118,1,119,1.332867,103.871102
347553,8,2,10,1.332385,103.871501
347554,25,3,28,1.332915,103.871225
347555,13,0,13,1.332404,103.871568
347556,6,61,67,1.332452,103.871324
347557,5,0,5,1.3325,103.87131
347559,0,1,1,1.33324,103.874937
347560,2,0,2,1.332111,103.87065
347561,2,3,5,1.332689,103.871252
347562,3,2,5,1.332746,103.871233
347563,1,0,1,1.332592,103.871279
347564,8,5,13,1.332858,103.8712
347565,2,2,4,1.332922,103.871179
347566,3,7,10,1.332418,103.871637
347567,0,8,8,1.332605,103.871941
347568,1,2,3,1.332416,103.871286
347569,28,0,28,1.33299,103.871855
347570,3,0,3,1.332491,103.871779
347574,10,14,24,1.33253,103.871927
347575,3,8,11,1.332682,103.872193
347576,17,4,21,1.332578,103.872099
347578,8,12,20,1.332589,103.872174
347579,12,4,16,1.332714,103.872277
347580,2,3,5,1.332629,103.872255
347581,1,0,1,1.332799,103.871212
347582,5,0,5,1.33274,103.872569
347583,13,5,18,1.332746,103.872352
347584,2,0,2,1.332646,103.871264
347585,10,0,10,1.332768,103.872388
347586,0,16,16,1.332765,103.872781
347587,3,11,14,1.332776,103.872446
347588,12,3,15,1.332699,103.873615
347589,42,2,44,1.332698,103.873689
347590,30,156,186,1.332683,103.873754
347591,1,11,12,1.332792,103.872496
347592,81,1,82,1.332602,103.87422
347593,3,8,11,1.332811,103.87256
347594,3,9,12,1.332833,103.872615
347595,13,11,24,1.332849,103.8728
347597,1,9,10,1.332841,103.872972
347598,2,16,18,1.332842,103.873054
347599,4,0,4,1.332841,103.873136
347600,3,9,12,1.332839,103.873206
347601,353,7,360,1.332923,103.873609
347602,1,23,24,1.332758,103.872621
347603,23,23,46,1.332144,103.870934
347604,1,16,17,1.332684,103.872629
347605,4,0,4,1.331985,103.870335
347607,3,0,3,1.332635,103.872021
347608,15,16,31,1.332227,103.870993
347609,1,23,24,1.332293,103.871152
347610,2,0,2,1.332768,103.872723
347611,12,15,27,1.332542,103.871995
347612,0,2,2,1.332501,103.871842
347613,13,11,24,1.299509,103.837
347627,1,6,7,1.328737,103.869341
347628,6,445,451,1.328705,103.869212
347629,5,47,52,1.328763,103.869077
347630,0,46,46,1.328863,103.868994
347632,9,349,358,1.328953,103.86892
347633,0,147,147,1.329397,103.868863
347634,1,252,253,1.329451,103.868876
347636,2,223,225,1.329664,103.868927
347637,4,28,32,1.329771,103.868953
347638,0,2,2,1.332125,103.870692
347639,0,20,20,1.329984,103.869004
347640,0,3,3,1.332007,103.87042
347641,4,234,238,1.331542,103.868902
347642,6,34,40,1.330198,103.869055
347643,0,12,12,1.330305,103.869081
347644,0,14,14,1.330411,103.869106
347645,1,105,106,1.330556,103.869006
347646,2,63,65,1.330587,103.869013
347647,0,71,71,1.330617,103.86902
347648,1,36,37,1.330678,103.869034
347649,1,82,83,1.33074,103.869048
347650,0,2,2,1.329878,103.868978
347651,1,131,132,1.330862,103.869077
347652,1,73,74,1.330923,103.869091
347653,3,218,221,1.330984,103.869105
347654,26,2007,2033,1.331542,103.868902
347655,0,18,18,1.331046,103.869119
347656,8,1,9,1.337177,103.866611
347657,5,237,242,1.331107,103.869133
347658,45,1655,1700,1.331542,103.868902
347659,1,33,34,1.331168,103.869147
347660,0,1,1,1.332733,103.872306
347661,4,322,326,1.33129,103.869176
347662,3,207,210,1.331352,103.86919
347663,0,1,1,1.331229,103.869161
347664,1,197,198,1.331474,103.869218
347665,4,12,16,1.331535,103.869232
347666,2,4,6,1.331597,103.869246
347667,2,1,3,1.330091,103.869029
347668,1,4,5,1.331719,103.869274
347669,0,10,10,1.33178,103.869288
347670,0,44,44,1.331841,103.869303
347671,2,173,175,1.331903,103.869317
347672,6,143,149,1.331964,103.869331
347673,1,87,88,1.332025,103.869345
347674,11,179,190,1.332386,103.869585
347675,1,42,43,1.332439,103.869593
347676,1,99,100,1.332494,103.869612
347677,0,38,38,1.332566,103.86964
347678,1,40,41,1.332638,103.869647
347679,3,43,46,1.332712,103.869679
347680,4,45,49,1.33278,103.869689
347681,2,59,61,1.332839,103.869714
347682,2,0,2,1.330801,103.869062
347683,0,1,1,1.331413,103.869204
347684,5,153,158,1.333017,103.869763
347685,0,5,5,1.333075,103.869784
347686,13,1021,1034,1.333135,103.869821
347688,11,2189,2200,1.336132,103.87011
347689,3,6,9,1.336132,103.87011
347690,37,520,557,1.336132,103.87011
347691,489,663,1152,1.337767,103.868391
347692,69,2270,2339,1.33757,103.870238
347693,17,1587,1604,1.338435,103.870239
347694,645,5098,5743,1.330996,103.868874
347695,297,3574,3871,1.339325,103.870503
347696,7,251,258,1.333443,103.869961
347697,1,0,1,1.332955,103.869737
347719,233,143,376,1.33072,103.878142
347720,42,737,779,1.3305,103.877722
347722,1134,50,1184,1.328936,103.876546
347724,10,419,429,1.328246,103.876376
347725,9,1,10,1.328145,103.876335
347728,0,20,20,1.32799,103.876211
347730,10,21,31,1.32788,103.876128
347731,58,74,132,1.327801,103.876066
347733,110,66,176,1.327571,103.875814
347735,3,23,26,1.327479,103.875739
347737,16,0,16,1.327386,103.875682
347738,5,35,40,1.327307,103.87562
347739,21,952,973,1.327223,103.875559
347740,488,1382,1870,1.326558,103.875078
347768,9,2296,2305,1.329437,103.87505
347769,3,108,111,1.329585,103.875148
347770,0,13,13,1.329299,103.875233
347772,5,4,9,1.329204,103.875372
347773,197,14,211,1.329208,103.875072
347774,11,0,11,1.329131,103.87546
347775,45,15,60,1.329065,103.875255
347776,7,4,11,1.329087,103.87554
347777,1,1,2,1.332887,103.869719
347778,116,312,428,1.328648,103.875825
347779,0,9,9,1.329312,103.875521
347780,240,2,242,1.328456,103.875994
347781,2,8,10,1.328882,103.875825
347783,0,3,3,1.331658,103.86926
347784,0,1,1,1.299509,103.837
347785,7,0,7,1.328751,103.875986
347786,1088,351,1439,1.328692,103.876066
347787,24,102,126,1.328641,103.876154
347788,476,169,645,1.328583,103.876249
347789,202,516,718,1.328378,103.876556
347790,1035,187,1222,1.32811,103.877166
347791,176,83,259,1.328064,103.876636
347792,10,16,26,1.327998,103.876724
347793,9,13,22,1.327925,103.876804
347794,71,30,101,1.327859,103.877477
347795,4,13,17,1.327852,103.876878
347796,133,10,143,1.327567,103.877915
347797,0,2,2,1.329036,103.875613
347798,95,85,180,1.32718,103.878427
347799,6,4,10,1.327735,103.877082
347800,1,2,3,1.328809,103.875913
347801,8,5,13,1.327625,103.877243
347802,0,12,12,1.327567,103.877316
347803,1,24,25,1.327508,103.877396
347804,21,30,51,1.32745,103.87747
347805,717,291,1008,1.326755,103.877357
347807,504,47,551,1.326979,103.879117
347810,118,82,200,1.326148,103.878607
347835,19,386,405,1.329376,103.868888
347836,17,8,25,1.329274,103.869056
347837,3,1,4,1.329358,103.868981
347838,8,77,85,1.329248,103.869143
347839,0,1,1,1.328809,103.875913
347840,52,1,53,1.329222,103.869238
347841,3,1,4,1.329316,103.869166
347842,7,2,9,1.329199,103.869291
347843,0,10,10,1.329287,103.869251
347844,9,44,53,1.329156,103.869348
347845,1,22,23,1.329259,103.869312
347846,16,126,142,1.329115,103.869406
347847,11,64,75,1.329223,103.869391
347848,13,597,610,1.32908,103.869442
347849,31,18,49,1.329192,103.869436
347850,2,63,65,1.329025,103.869503
347851,7,23,30,1.329157,103.86948
347852,9,153,162,1.328956,103.869564
347853,3,15,18,1.329118,103.869526
347854,5,0,5,1.329081,103.869567
347855,7,11,18,1.329036,103.869606
347856,5,2,7,1.328994,103.869635
347857,2,21,23,1.328964,103.869656
347858,9,14,23,1.328941,103.869675
347859,41,100,141,1.328884,103.869709
347860,25,55,80,1.328819,103.869733
347861,6,30,36,1.328749,103.869755
347862,21,37,58,1.328678,103.869779
347863,103,42,145,1.328606,103.869807
347864,13,23,36,1.328529,103.86983
347865,9,30,39,1.328457,103.869859
347866,39,21,60,1.328398,103.869882
347867,24,858,882,1.328344,103.869906
347893,271,1000,1271,1.32743,103.879557
347919,6,1,7,1.328985,103.869856
347920,5,15,20,1.32896,103.869891
347921,1,16,17,1.329018,103.869968
347922,1,4,5,1.328983,103.869962
347923,1,0,1,1.329337,103.869069
347924,17,4,21,1.328997,103.870014
347925,1,10,11,1.32909,103.870177
347926,0,5,5,1.329019,103.870071
347927,1,19,20,1.329125,103.870282
347928,1,1,2,1.327779,103.876994
347929,2,2,4,1.329199,103.870503
347930,0,3,3,1.327669,103.87717
347931,16,0,16,1.329251,103.870656
347932,1,2,3,1.329051,103.870187
347933,5,4,9,1.329295,103.870748
347934,0,1,1,1.329053,103.870069
347935,2,0,2,1.329036,103.870124
347936,5,1,6,1.329612,103.871605
347938,17,1,18,1.329368,103.870957
347939,2,4,6,1.329144,103.870456
347940,9,1,10,1.329402,103.871069
347941,0,2,2,1.329331,103.870862
347943,5,0,5,1.329187,103.870608
347944,5,5,10,1.329475,103.871278
347945,2,2,4,1.329219,103.870697
347946,31,0,31,1.329516,103.871369
347947,5,16,21,1.329245,103.870773
347948,4,2,6,1.329542,103.871464
347949,42,0,42,1.329272,103.870845
347950,5,1,6,1.329582,103.871595
347951,7,1,8,1.329299,103.870933
347952,0,2,2,1.329161,103.870514
347953,2,0,2,1.329633,103.871714
347956,0,6,6,1.329686,103.871909
347957,1,11,12,1.329368,103.871168
347958,6,3,9,1.329716,103.872007
347959,62,0,62,1.329385,103.871241
347960,1,0,1,1.329088,103.870299
347961,115,1,116,1.329781,103.872163
347962,1,3,4,1.329405,103.871317
347963,69,0,69,1.329812,103.872284
347964,1,0,1,1.32976,103.872102
347965,6,0,6,1.329419,103.87136
347966,2,3,5,1.329863,103.87245
347967,166,0,166,1.329897,103.872543
347968,1,1,2,1.329328,103.871021
347970,0,4,4,1.329493,103.871604
347971,132,0,132,1.330029,103.872857
347972,1,2,3,1.329065,103.870243
347974,0,19,19,1.329526,103.871744
347975,71,0,71,1.329536,103.871791
347976,0,1,1,1.329836,103.872354
347977,2,5,7,1.329565,103.871882
347978,0,1,1,1.329552,103.87184
347979,1,0,1,1.329582,103.871924
347980,2,0,2,1.329442,103.871419
347981,2,0,2,1.32961,103.872009
347982,84,2,86,1.329639,103.872094
347983,5,0,5,1.329658,103.872135
347984,4,42,46,1.329727,103.872294
347985,30,0,30,1.329744,103.872343
347987,4,2,6,1.329775,103.872445
347988,5,0,5,1.329792,103.872495
347989,1,1,2,1.329623,103.872047
347990,3,0,3,1.329509,103.871661
347992,14,0,14,1.329852,103.872705
347993,13,10,23,1.329869,103.872759
347995,16,1,17,1.329906,103.872874
347996,1,3,4,1.32993,103.872934
347997,15,1,16,1.329989,103.873083
347998,173,0,173,1.330006,103.873142
347999,0,15,15,1.330023,103.873201
348000,3,6,9,1.330043,103.873265
348002,35,2,37,1.330086,103.873404
348003,0,1,1,1.329597,103.871964
348005,7,1,8,1.330146,103.873612
348006,2,0,2,1.329807,103.872553
348007,2,6,8,1.330206,103.87372
348008,0,1,1,1.330108,103.873468
348009,0,2,2,1.330173,103.873672
348010,0,2,2,1.330239,103.873824
348011,0,4,4,1.330276,103.873912
348013,4,5,9,1.329229,103.870582
348014,0,3,3,1.329823,103.872605
348015,3,0,3,1.33008,103.873002
348037,0,5,5,1.329884,103.8704
348038,4,0,4,1.329897,103.870458
348039,0,6,6,1.329799,103.8704
348040,2,2,4,1.329833,103.870507
348041,3,34,37,1.329922,103.870523
348042,8,14,22,1.329872,103.870644
348043,21,0,21,1.329971,103.870661
348044,2,0,2,1.330259,103.873872
348045,18,2,20,1.329942,103.87086
348046,4,0,4,1.330204,103.871377
348047,14,0,14,1.329973,103.870962
348048,1,1,2,1.329993,103.870721
348049,6,15,21,1.330302,103.871685
348050,64,2,66,1.330061,103.8712
348051,2,0,2,1.330267,103.871596
348052,3,0,3,1.329535,103.871368
348053,11,0,11,1.330104,103.871356
348054,0,2,2,1.330353,103.87181
348055,1,4,5,1.330149,103.871497
348056,41,2,43,1.330451,103.872123
348057,1,3,4,1.33049,103.872236
348058,19,0,19,1.330171,103.871557
348060,2,1,3,1.330384,103.8719
348061,2,3,5,1.330202,103.871661
348063,1,2,3,1.330565,103.87245
348064,1,0,1,1.330226,103.873787
348065,4,0,4,1.33062,103.872606
348066,3,5,8,1.330237,103.871787
348067,0,15,15,1.330648,103.872692
348068,11,5,16,1.330274,103.871912
348070,0,1,1,1.330222,103.871731
348071,14,6,20,1.330368,103.872236
348072,7,0,7,1.330415,103.872346
348073,0,2,2,1.330419,103.872025
348074,2,1,3,1.330553,103.872415
348075,2,1,3,1.330519,103.872662
348076,109,14,123,1.330562,103.872824
348077,7,0,7,1.330589,103.872894
348078,15,1,16,1.33045,103.872451
348079,0,1,1,1.330331,103.872133
348080,5,1,6,1.330004,103.871069
348081,47,0,47,1.330083,103.871276
348082,2,1,3,1.330534,103.872734
348083,6,1,7,1.329897,103.870722
348084,2,13,15,1.329938,103.870582
348085,46,0,46,1.329898,103.870901
348087,27,1,28,1.330294,103.871595
348088,3,0,3,1.33012,103.871413
348089,9,1,10,1.330355,103.871815
348090,3,1,4,1.330382,103.871898
348091,1,0,1,1.329987,103.871017
348092,1,1,2,1.330495,103.87258
348093,17,0,17,1.330487,103.872178
348094,6,0,6,1.299509,103.837
348103,7,1,8,1.329206,103.870286
348104,84,6,90,1.329218,103.870338
348105,10,18,28,1.329524,103.870186
348106,61,1,62,1.329293,103.870328
348107,16,1,17,1.329631,103.870153
348108,35,7,42,1.329483,103.870275
348109,13,0,13,1.329733,103.87013
348110,9,12,21,1.329573,103.870255
348111,2,0,2,1.330465,103.872101
348112,69,0,69,1.330166,103.870287
348113,1,0,1,1.330432,103.871997
348114,27,0,27,1.330015,103.870185
348115,69,12,81,1.330363,103.870355
348116,6,12,18,1.330481,103.870391
348117,1,1,2,1.329841,103.870147
348118,4,3,7,1.330645,103.870444
348119,18,3,21,1.330207,103.870239
348120,8,1,9,1.330741,103.870478
348121,0,5,5,1.330422,103.870303
348122,2,2,4,1.330861,103.870534
348123,14,1,15,1.330523,103.87034
348125,7,2,9,1.330682,103.870393
348126,4,0,4,1.331088,103.870594
348127,0,4,4,1.330835,103.870432
348128,5,0,5,1.331209,103.870633
348129,1,0,1,1.329932,103.870161
348130,44,20,64,1.331358,103.870696
348131,2,1,3,1.330322,103.871727
348132,34,0,34,1.331686,103.871423
348133,1,0,1,1.331029,103.870488
348134,37,0,37,1.331736,103.871596
348135,116,0,116,1.331357,103.870601
348136,7,12,19,1.331792,103.871778
348137,1,0,1,1.331291,103.870569
348138,6,0,6,1.331847,103.871953
348139,3,1,4,1.331426,103.870641
348141,2,9,11,1.331893,103.872127
348142,3,3,6,1.331908,103.872212
348145,31,0,31,1.331987,103.872402
348146,2,13,15,1.331506,103.870758
348147,5,4,9,1.332008,103.872513
348148,70,0,70,1.332039,103.872591
348149,3,0,3,1.331198,103.870536
348150,32,0,32,1.332068,103.872671
348151,8,0,8,1.331569,103.870912
348152,0,2,2,1.330107,103.870207
348154,5,0,5,1.331636,103.871114
348155,17,3,20,1.331668,103.871208
348156,1,4,5,1.331694,103.871288
348158,1,0,1,1.331818,103.871877
348159,0,1,1,1.33175,103.871444
348160,8,0,8,1.331803,103.871625
348161,7,1,8,1.331825,103.871706
348162,3,0,3,1.331543,103.870837
348165,27,0,27,1.331945,103.872078
348166,0,4,4,1.331976,103.872181
348167,2,2,4,1.332008,103.872279
348168,1,0,1,1.331774,103.87154
348169,20,1,21,1.332097,103.872593
348170,2,0,2,1.331591,103.870973
348171,14,2,16,1.33025,103.870321
348172,3,4,7,1.330614,103.87037
348173,84,2,86,1.330762,103.870406
348174,2,0,2,1.332125,103.872685
348175,0,5,5,1.33095,103.870466
348176,6,1,7,1.332156,103.872915
348177,9,0,9,1.331416,103.870752
348178,1,0,1,1.332061,103.872468
348179,1,2,3,1.331849,103.871793
348180,6,2,8,1.329373,103.870231
348181,101,0,101,1.331506,103.870758
348182,11,0,11,1.331543,103.870837
348183,130,0,130,1.331118,103.870511
348184,0,1,1,1.331416,103.870752
348185,1,1,2,1.332097,103.872593
348186,13,0,13,1.331569,103.870912
348187,2,0,2,1.331617,103.871052
348188,21,5,26,1.331712,103.871512
348189,8,0,8,1.331772,103.871703
348190,0,3,3,1.330422,103.870303
348191,19,17,36,1.329674,103.870228
348193,18,1,19,1.330107,103.870207
348194,2,0,2,1.332041,103.872378
348195,25,8,33,1.329524,103.870186
348196,1429,15,1444,1.329372,103.86937
348197,5,3,8,1.329353,103.869427
348198,2,5,7,1.329444,103.869386
348199,0,4,4,1.329424,103.869445
348200,1,13,14,1.329528,103.869404
348201,11,3,14,1.329494,103.869462
348202,2,2,4,1.329626,103.869417
348204,1,31,32,1.329709,103.869442
348205,4,48,52,1.329644,103.869502
348206,1,5,6,1.329791,103.869466
348207,1,12,13,1.329706,103.869519
348208,3,11,14,1.329878,103.869484
348209,6,3,9,1.33036,103.86987
348210,2,30,32,1.329975,103.869499
348211,2,2,4,1.330462,103.869878
348212,1,58,59,1.330054,103.869519
348213,5,0,5,1.330617,103.869935
348214,4,240,244,1.330111,103.869547
348215,2,1,3,1.330307,103.870271
348216,3,127,130,1.330183,103.869572
348217,11,3,14,1.330865,103.869993
348218,0,33,33,1.33026,103.869585
348220,0,2,2,1.330063,103.870196
348221,12,6,18,1.331129,103.870077
348222,0,10,10,1.330443,103.869631
348223,10,5,15,1.331275,103.870073
348224,0,10,10,1.330517,103.869642
348225,4,1,5,1.331368,103.8701
348226,340,12,352,1.330608,103.869675
348227,2,5,7,1.331514,103.870139
348228,253,2,255,1.330687,103.869701
348229,1,2,3,1.330721,103.869958
348230,163,4,167,1.330764,103.869707
348231,110,0,110,1.331795,103.870242
348232,643,8,651,1.33087,103.869734
348233,11,5,16,1.331811,103.870288
348234,45,10,55,1.330936,103.869758
348236,0,9,9,1.331018,103.869784
348237,0,58,58,1.332208,103.870155
348238,2,21,23,1.331107,103.869802
348239,38,10,48,1.332265,103.870175
348240,0,2,2,1.330349,103.869608
348241,0,7,7,1.332315,103.870195
348242,2,2,4,1.331217,103.869835
348243,3,6,9,1.332362,103.87021
348244,4,12,16,1.331276,103.869845
348245,95,6,101,1.332421,103.870228
348246,2,13,15,1.331358,103.869868
348247,1,15,16,1.332473,103.870245
348248,2,54,56,1.331425,103.869883
348249,0,4,4,1.332535,103.870272
348250,0,111,111,1.33149,103.869906
348251,7,0,7,1.3326,103.870302
348252,1,103,104,1.331551,103.869913
348253,2,76,78,1.332657,103.870307
348254,0,74,74,1.331613,103.869931
348256,0,23,23,1.331673,103.869946
348257,2,10,12,1.332768,103.870355
348258,0,28,28,1.331742,103.869958
348259,1,47,48,1.332839,103.870358
348260,0,21,21,1.331806,103.869968
348261,42,0,42,1.332965,103.870374
348262,0,10,10,1.331861,103.869986
348263,0,7,7,1.331913,103.870008
348264,0,21,21,1.331971,103.870018
348265,1,111,112,1.332028,103.870026
348266,0,40,40,1.332232,103.870043
348268,0,63,63,1.332336,103.870071
348269,53,137,190,1.332382,103.870084
348270,515,2,517,1.332429,103.870099
348271,1577,24,1601,1.332469,103.870118
348272,9,161,170,1.332559,103.870152
348273,0,184,184,1.332716,103.870188
348274,1,0,1,1.32939,103.870299
348275,0,54,54,1.332833,103.870222
348276,1,18,19,1.332902,103.870241
348277,0,56,56,1.332976,103.870259
348279,1,0,1,1.33278,103.870204
348280,0,1,1,1.331458,103.870118
348281,2,7,9,1.32957,103.869489
348282,0,2,2,1.331184,103.869812
348283,0,3,3,1.331632,103.870201
348284,0,10,10,1.330181,103.869642
348285,2,2,4,1.331159,103.87009
348287,5,1,6,1.331289,103.87008
348303,5,43,48,1.332608,103.871644
348304,0,41,41,1.332658,103.871745
348305,4,0,4,1.332667,103.871622
348306,2,1,3,1.331557,103.870145
348312,19,1,20,1.332882,103.871683
348313,9,2,11,1.33291,103.871523
348314,0,1,1,1.330885,103.870005
348316,28,0,28,1.332965,103.871508
348317,2,0,2,1.330332,103.869843
348318,0,1,1,1.332969,103.87165
348319,0,3,3,1.332711,103.871732
348321,6,1,7,1.333172,103.871573
348322,0,1,1,1.333014,103.871495
348323,9,0,9,1.333156,103.871446
348349,0,5,5,1.330705,103.874994
348350,2,0,2,1.333065,103.871619
348351,1,3,4,1.33088,103.87541
348352,4,1,5,1.330915,103.875475
348353,33,0,33,1.330942,103.875585
348354,14,0,14,1.330999,103.875713
348356,2,0,2,1.330858,103.875325
348358,7,1,8,1.331156,103.876148
348359,2,4,6,1.331218,103.87631
348360,1,1,2,1.331067,103.875904
348361,4,0,4,1.331243,103.876586
348362,20,23,43,1.330633,103.874975
348364,3,2,5,1.330656,103.875037
348365,4,0,4,1.331295,103.876728
348366,1,6,7,1.330679,103.8751
348368,9,0,9,1.330696,103.875157
348370,0,3,3,1.333118,103.871604
348372,9,0,9,1.330739,103.875309
348374,1,2,3,1.330713,103.875219
348375,0,4,4,1.331403,103.877035
348376,7,0,7,1.330774,103.875434
348377,16,2,18,1.331457,103.877198
348378,1,1,2,1.331222,103.87651
348379,93,13,106,1.331468,103.877234
348381,32,0,32,1.33148,103.877273
348382,4,0,4,1.330837,103.875622
348383,0,4,4,1.33149,103.877307
348384,2,0,2,1.330791,103.875497
348386,3,3,6,1.330883,103.875741
348387,1,0,1,1.333103,103.871461
348390,5,0,5,1.330929,103.875867
348391,6,2,8,1.331521,103.877422
348394,0,1,1,1.331504,103.877367
348396,0,1,1,1.330969,103.87598
348398,53,0,53,1.33102,103.876106
348399,0,1,1,1.330992,103.876043
348400,1,1,2,1.33086,103.875679
348401,11,0,11,1.331562,103.877556
348402,13,0,13,1.331072,103.876231
348403,3,0,3,1.330756,103.875371
348404,1,5,6,1.331118,103.876356
348406,1,0,1,1.331556,103.877528
348407,51,3,54,1.331174,103.87655
348408,2,0,2,1.331049,103.876168
348409,5,0,5,1.33122,103.876675
348410,4,1,5,1.331243,103.876738
348411,8,0,8,1.331266,103.8768
348412,7,0,7,1.331294,103.876863
348414,141,3,144,1.331317,103.876925
348416,2,4,6,1.331363,103.877051
348417,1,0,1,1.331156,103.876487
348418,5,2,7,1.331404,103.877178
348419,1,0,1,1.33138,103.877113
348420,5,3,8,1.331436,103.877276
348421,1,0,1,1.331416,103.877233
348423,1,0,1,1.331453,103.877339
348424,13,1,14,1.331522,103.877526
348425,1,0,1,1.331493,103.877464
348426,0,5,5,1.331562,103.877652
348427,1,3,4,1.331579,103.877714
348428,11,0,11,1.331602,103.877777
348429,3,0,3,1.331095,103.876293
348430,5,0,5,1.331637,103.877902
348431,2,1,3,1.331619,103.877839
348434,4,0,4,1.331711,103.878147
348435,10,3,13,1.331728,103.878209
348436,3,0,3,1.331654,103.877965
348437,0,1,1,1.331539,103.877589
348438,0,3,3,1.331746,103.878272
348439,56,0,56,1.331809,103.87846
348441,4,922,926,1.331849,103.878585
348442,1,3,4,1.331015,103.875123
348444,1,0,1,1.331769,103.878335
348445,1,1,2,1.331197,103.876612
348446,4,2,6,1.331597,103.877663
348447,4,0,4,1.331602,103.877692
348449,3,1,4,1.33162,103.877745
348450,3,3,6,1.331626,103.877773
348452,4,3,7,1.332006,103.878384
348453,1,0,1,1.331576,103.877606
348454,0,113,113,1.332034,103.878457
348456,4,0,4,1.331181,103.875053
348468,16,126,142,1.328436,103.869728
348469,46,664,710,1.328539,103.870237
348470,1,74,75,1.32853,103.870275
348471,124,1090,1214,1.328193,103.870048
348472,2,1108,1110,1.328683,103.870738
348473,13,2553,2566,1.328347,103.870923
348474,9,1522,1531,1.328697,103.870769
348475,39,3249,3288,1.328486,103.871274
348476,5,2,7,1.328714,103.870817
348477,9,76,85,1.328727,103.870861
348479,10,14,24,1.32876,103.870964
348480,6,30,36,1.328784,103.871039
348481,0,24,24,1.3288,103.871086
348482,2,12,14,1.328819,103.871144
348483,0,9,9,1.328832,103.871189
348484,3,0,3,1.331791,103.878397
348485,3,18,21,1.328868,103.871288
348486,4,11,15,1.328886,103.871348
348487,0,4,4,1.32891,103.871406
348488,0,17,17,1.328921,103.871449
348489,2,44,46,1.328932,103.871483
348490,2,263,265,1.328941,103.871516
348491,1,223,224,1.32896,103.871566
348492,7,147,154,1.328982,103.871626
348493,1,202,203,1.329001,103.871684
348494,1,52,53,1.329017,103.871737
348495,0,14,14,1.329041,103.871793
348496,5,77,82,1.329058,103.871851
348497,3,31,34,1.329111,103.871971
348498,1,18,19,1.329121,103.872021
348499,8,0,8,1.329136,103.872071
348500,2,0,2,1.331587,103.877634
348501,66,1979,2045,1.328689,103.871876
348502,15,166,181,1.329171,103.87218
348504,67,977,1044,1.299509,103.837
348505,0,1,1,1.33201,103.878438
348506,16,23,39,1.329222,103.872321
348507,0,8,8,1.32924,103.872384
348508,1,8,9,1.329263,103.872447
348509,4,0,4,1.329289,103.872505
348510,1,0,1,1.329205,103.872259
348511,27,69,96,1.329329,103.872631
348513,239,71,310,1.329373,103.87276
348515,3,120,123,1.329412,103.872885
348516,6,0,6,1.329435,103.872947
348517,1,80,81,1.329458,103.87301
348518,2,0,2,1.329154,103.872123
348519,0,161,161,1.329498,103.873135
348520,1,16,17,1.32951,103.873177
348522,3,12,15,1.329546,103.873261
348523,5,146,151,1.329569,103.873324
348524,80,52,132,1.329276,103.873295
348525,4,0,4,1.329592,103.873387
348526,3,46,49,1.329615,103.873449
348528,191,1512,1703,1.329352,103.873532
348529,5,22,27,1.329655,103.873575
348530,3,37,40,1.329672,103.873614
348531,11,23,34,1.329713,103.873724
348532,54,167,221,1.329736,103.873787
348533,5,701,706,1.329759,103.873855
348534,7,155,162,1.329782,103.873917
348535,34,525,559,1.329805,103.87398
348536,4,108,112,1.329822,103.874043
348537,37,4,41,1.330028,103.874606
348538,6,8,14,1.330216,103.875147
348539,12,934,946,1.330233,103.875209
348540,3,795,798,1.330333,103.875208
348542,2,34,36,1.330279,103.875334
348544,9,810,819,1.330296,103.875408
348545,20,2,22,1.330314,103.875477
348547,0,26,26,1.330351,103.875602
348548,539,783,1322,1.329571,103.874301
348549,2,392,394,1.330368,103.875664
348550,36,0,36,1.330385,103.875727
348551,5,97,102,1.330408,103.875789
348552,4,0,4,1.330426,103.875852
348553,2,61,63,1.330448,103.87592
348554,13,5,18,1.330471,103.875983
348555,1,62,63,1.3305,103.876045
348556,3,135,138,1.330523,103.876108
348557,0,13,13,1.330552,103.876176
348558,4,22,26,1.330562,103.876252
348559,8,3,11,1.330582,103.876306
348561,1,1078,1079,1.330622,103.876431
348562,2,0,2,1.329475,103.873073
348563,0,16,16,1.330659,103.876555
348564,1,25,26,1.330676,103.876618
348565,2,85,87,1.330699,103.87668
348566,1,19,20,1.330716,103.876743
348567,0,14,14,1.330739,103.876805
348568,0,18,18,1.330756,103.876862
348569,6,20,26,1.330773,103.876919
348570,0,11,11,1.330786,103.876975
348571,0,99,99,1.330798,103.877022
348572,8,4,12,1.330815,103.877084
348573,3,82,85,1.330838,103.877147
348574,390,94,484,1.329951,103.87532
348575,0,63,63,1.330861,103.877204
348576,0,61,61,1.330873,103.877261
348577,1,56,57,1.330896,103.877318
348578,371,734,1105,1.330083,103.875672
348579,0,30,30,1.330919,103.877375
348580,1,36,37,1.330936,103.877431
348581,0,31,31,1.330959,103.877483
348582,1,4,5,1.330971,103.87753
348583,17,185,202,1.330983,103.877572
348584,23,458,481,1.33112,103.877698
348585,0,319,319,1.331046,103.878112
348587,3,196,199,1.331071,103.878191
348588,0,111,111,1.331084,103.878231
348591,1,52,53,1.331129,103.878366
348592,0,178,178,1.331134,103.878405
348595,0,132,132,1.331181,103.878541
348597,10,910,920,1.330415,103.876755
348598,1,4,5,1.331218,103.87862
348599,0,48,48,1.330433,103.876815
348600,4,37,41,1.331242,103.878652
348601,0,82,82,1.330453,103.876877
348602,1,32,33,1.331268,103.87868
348603,0,4,4,1.330468,103.876933
348604,0,190,190,1.331303,103.878706
348605,7,86,93,1.330483,103.876989
348606,2,195,197,1.331343,103.878728
348607,1,2,3,1.328857,103.871246
348608,1,101,102,1.330529,103.877119
348610,0,118,118,1.33057,103.877244
348611,4,0,4,1.330592,103.877298
348612,1,359,360,1.330613,103.877358
348615,9430,1076,10506,1.327466,103.870786
348639,594,166,760,1.329012,103.874598
348640,14,0,14,1.328894,103.874494
348666,1,0,1,1.329306,103.872568
348667,3,1,4,1.331169,103.873838
348669,4,1,5,1.331218,103.873973
348670,3,0,3,1.330504,103.877052
348671,2,0,2,1.330636,103.876492
348672,31,0,31,1.331286,103.874186
348673,4,2,6,1.331314,103.874263
348674,0,4,4,1.331342,103.874335
348700,6,10,16,1.331942,103.873798
348701,0,4,4,1.33186,103.873803
348702,24,0,24,1.331925,103.873865
348703,1,2,3,1.331239,103.874041
348704,7,0,7,1.331915,103.873936
348706,7,0,7,1.331902,103.874002
348707,0,3,3,1.331848,103.873866
348708,37,0,37,1.331888,103.874074
348709,19,1,20,1.331814,103.874048
348710,18,0,18,1.33188,103.874144
348712,0,3,3,1.331831,103.873985
348713,31,2,33,1.331797,103.874173
348714,1,5,6,1.331861,103.874281
348715,0,2,2,1.33126,103.87411
348741,158,701,859,1.328296,103.872011
348742,151,425,576,1.327937,103.872438
348743,779,419,1198,1.327982,103.872279
348744,229,443,672,1.327034,103.871378
348745,876,328,1204,1.326337,103.871598
348771,179,9,188,1.33283,103.875305
348772,0,8,8,1.332849,103.875372
348773,1,0,1,1.331147,103.873765
348774,2,3,5,1.332885,103.875506
348775,9,62,71,1.332613,103.874833
348776,2,1,3,1.331873,103.874207
348777,0,2,2,1.331785,103.874236
348779,3,9,12,1.332656,103.875002
348780,1,16,17,1.333052,103.875956
348781,21,0,21,1.332681,103.875091
348782,4,0,4,1.333063,103.876007
348783,0,3,3,1.332902,103.875589
348784,16,4,20,1.332718,103.875219
348785,1,4,5,1.333079,103.87607
348786,0,7,7,1.333087,103.876102
348787,1,0,1,1.332874,103.875455
348788,1,0,1,1.332748,103.875323
348789,0,2,2,1.332631,103.874901
348790,8,67,75,1.332807,103.87552
348791,0,8,8,1.333115,103.876189
348793,1,10,11,1.333126,103.876229
348794,3,0,3,1.333069,103.876032
348795,12,7,19,1.333138,103.876275
348796,3,3,6,1.332951,103.875988
348797,2,0,2,1.333103,103.876144
348798,15,0,15,1.332969,103.87605
348799,13,12,25,1.333161,103.876354
348800,4,0,4,1.332986,103.876107
348801,3,27,30,1.333172,103.8764
348803,0,1,1,1.332783,103.875431
348804,2,0,2,1.333149,103.876314
348806,2,2,4,1.333032,103.876278
348807,0,5,5,1.333226,103.876587
348809,8,4,12,1.333244,103.876644
348810,2,0,2,1.33302,103.876221
348811,35,0,35,1.333265,103.876703
348812,19,6,25,1.333083,103.876466
348813,0,3,3,1.332868,103.875762
348814,5,1,6,1.33318,103.876641
348815,47,6,53,1.333296,103.876807
348816,2,17,19,1.333202,103.876691
348817,114,1,115,1.333313,103.876858
348818,39,12,51,1.33322,103.876746
348821,0,3,3,1.33328,103.876755
348822,8,9,17,1.33325,103.876843
348823,0,6,6,1.333389,103.877098
348826,16,7,23,1.333286,103.876951
348827,3,4,7,1.33346,103.877288
348828,13,0,13,1.333304,103.877002
348829,1,1,2,1.333066,103.876403
348830,0,3,3,1.333367,103.877039
348831,0,11,11,1.333322,103.877057
348832,1,0,1,1.333189,103.87644
348834,0,8,8,1.333567,103.87762
348835,0,9,9,1.333354,103.877159
348837,25,0,25,1.333367,103.877197
348838,0,5,5,1.333631,103.877755
348839,1,11,12,1.33338,103.877235
348840,12,2,14,1.33366,103.877838
348841,29,17,46,1.333684,103.877921
348842,1,0,1,1.333544,103.877554
348843,1,10,11,1.333732,103.878062
348844,3,0,3,1.333518,103.877468
348845,14,4176,4190,1.333779,103.878189
348846,1,7,8,1.333488,103.877373
348847,159,7,166,1.333324,103.876915
348848,0,6,6,1.333412,103.877318
348849,9,3,12,1.333453,103.877434
348850,1,4,5,1.333471,103.877492
348851,0,7,7,1.333488,103.877544
348852,4,4,8,1.333507,103.877597
348853,5,8,13,1.333531,103.877659
348854,3,6,9,1.333549,103.877735
348855,3,8,11,1.333576,103.87782
348856,9,7,16,1.333593,103.877883
348857,0,8,8,1.33361,103.877945
348858,1,4,5,1.333633,103.878002
348859,0,4,4,1.33365,103.878065
348860,3,4,7,1.333673,103.878122
348861,6,4,10,1.33369,103.878173
348862,4,2311,2315,1.333708,103.878224
348863,5,4,9,1.333193,103.876465
348864,13,3,16,1.333296,103.876807
348871,1,3,4,1.330129,103.871024
348872,5,5,10,1.330231,103.870998
348873,12,26,38,1.330147,103.871151
348874,4,0,4,1.330357,103.870955
348875,1,0,1,1.333709,103.877998
348876,9,0,9,1.330205,103.871123
348877,0,1,1,1.330444,103.870946
348878,2,0,2,1.333518,103.877468
348879,4,2,6,1.33026,103.871107
348880,6,0,6,1.330783,103.871023
348882,206,2,208,1.330301,103.871092
348884,1,9,10,1.330774,103.872078
348886,26,10,36,1.330282,103.870979
348888,2,0,2,1.330646,103.870972
348889,50,7,57,1.330954,103.871079
348891,11,7,18,1.331115,103.871139
348892,0,2,2,1.33086,103.87105
348893,14,0,14,1.331303,103.871171
348894,0,3,3,1.333753,103.878117
348895,1,14,15,1.331503,103.871138
348896,3,2,5,1.331396,103.871259
348897,6,2,8,1.331451,103.871247
348898,39,15,54,1.331511,103.87123
348899,0,19,19,1.331579,103.871209
348911,5,0,5,1.332333,103.876082
348912,2,0,2,1.33119,103.871157
348913,3,27,30,1.332973,103.875857
348914,6,0,6,1.33327,103.875769
348915,1,0,1,1.330572,103.870952
348916,11,0,11,1.299509,103.837
348941,4,11,15,1.330231,103.873381
348942,0,19,19,1.330258,103.873494
348946,63,13,76,1.330591,103.873232
348947,0,1,1,1.333556,103.875691
348948,12,12,24,1.330803,103.873174
348949,4,1,5,1.330877,103.873145
348950,1,0,1,1.330458,103.873414
348951,1,0,1,1.330927,103.873127
348952,81,0,81,1.33101,103.873105
348953,1,0,1,1.330521,103.873392
348954,1,3,4,1.330584,103.873374
348955,9,2,11,1.330647,103.873357
348956,6,0,6,1.331268,103.873044
348957,12,4,16,1.331327,103.87303
348958,1,2,3,1.33139,103.871167
348959,2,0,2,1.332963,103.875867
348960,21,1,22,1.330768,103.873312
348961,1,1,2,1.331434,103.87302
348962,4,0,4,1.330825,103.873289
348963,12,1,13,1.331823,103.873042
348964,0,3,3,1.33071,103.873329
348965,16,38,54,1.330877,103.873266
348966,7,0,7,1.331955,103.873053
348967,2,5,7,1.332069,103.873059
348969,6,1,7,1.33236,103.873153
348970,0,1,1,1.331119,103.873077
348971,0,2,2,1.331691,103.873036
348972,1,37,38,1.332585,103.873186
348973,164,1,165,1.3311,103.873198
348974,1,4,5,1.331151,103.873186
348976,1,1,2,1.331043,103.873209
348977,4,7,11,1.331323,103.873152
348978,10,4,14,1.331535,103.873144
348979,1,0,1,1.332434,103.873163
348980,0,2,2,1.331266,103.873164
348981,1,0,1,1.331604,103.873149
348982,4,5,9,1.331799,103.873172
348984,1,0,1,1.331736,103.873166
348985,0,1,1,1.332045,103.8732
348987,0,1,1,1.332103,103.873206
348988,5,3,8,1.332257,103.873234
348989,0,1,1,1.332206,103.873229
348990,1,2,3,1.332233,103.873131
348991,1,12,13,1.332429,103.873263
348992,153,8,161,1.332486,103.873274
348993,5,14,19,1.332544,103.873286
348994,1,2,3,1.332372,103.873257
348995,9,30,39,1.332658,103.87332
348996,2,3,5,1.330476,103.873273
348997,8,2,10,1.331196,103.87306
348998,96,7,103,1.332299,103.873145
348999,8,0,8,1.331584,103.873032
349021,1,404,405,1.323675,103.880408
349022,4,236,240,1.323642,103.880367
349023,0,260,260,1.323593,103.880432
349024,0,35,35,1.323549,103.880409
349025,127,11,138,1.32341,103.880458
349026,0,133,133,1.323299,103.88055
349028,0,103,103,1.323151,103.880601
349029,1,1,2,1.331667,103.873161
349030,2,71,73,1.323007,103.880655
349032,3,8,11,1.322879,103.880659
349033,0,61,61,1.322896,103.880707
349035,2,5620,5622,1.322773,103.880759
349036,0,95,95,1.323432,103.880499
349061,1,29,30,1.323276,103.879494
349062,0,249,249,1.323257,103.879434
349068,2,1,3,1.332601,103.873303
349070,3,0,3,1.322938,103.879557
349075,0,1,1,1.332314,103.873246
349102,1,248,249,1.322984,103.878493
349103,1,0,1,1.322435,103.879747
349105,1,0,1,1.322869,103.87854
349110,0,163,163,1.322976,103.878453
349111,0,1,1,1.322628,103.87863
349113,1,0,1,1.322859,103.878504
349142,1,97,98,1.322493,103.877296
349144,1,0,1,1.32262,103.878599
349146,3,835,838,1.322493,103.877276
349147,0,3,3,1.322749,103.879625
349151,1,1,2,1.323129,103.880564
349181,7,1856,1863,1.322101,103.87626
349182,5,31,36,1.322041,103.876286
349183,0,9,9,1.321919,103.876337
349184,1,18,19,1.321798,103.876388
349185,0,28,28,1.321677,103.87644
349186,1,0,1,1.322024,103.877482
349187,1,0,1,1.321555,103.876492
349188,0,77,77,1.321312,103.876595
349189,0,9,9,1.321201,103.876636
349215,15,36,51,1.32386,103.879922
349216,60,150,210,1.323221,103.878644
349217,1,296,297,1.321212,103.875716
349218,1,0,1,1.321434,103.876543
349219,1,0,1,1.321255,103.875706
349226,2,0,2,1.321649,103.877611
349229,1,0,1,1.321261,103.875717
349230,5,0,5,1.321339,103.875778
349231,1,0,1,1.321659,103.877621
349232,10,0,10,1.321326,103.875829
349233,15,0,15,1.321328,103.875832
349235,1,0,1,1.321351,103.87582
349241,3,87,90,1.327407,103.878823
349242,1,1,2,1.321292,103.875766
349243,4,17,21,1.321431,103.875761
349244,217,18,235,1.321387,103.875901
349245,1631,8,1639,1.322593,103.876758
349246,249,37,286,1.322875,103.875832
349247,709,1334,2043,1.322205,103.874958
349248,16,111,127,1.324004,103.875743
349249,1678,35,1713,1.324421,103.874858
349250,26,1235,1261,1.324247,103.874408
349253,1952,16,1968,1.325297,103.87502
349254,28,269,297,1.322,103.875996
349255,39,747,786,1.299509,103.837
349276,757,265,1022,1.326581,103.873524
349277,2054,721,2775,1.325973,103.87242
349278,604,938,1542,1.326021,103.873187
349279,149,1282,1431,1.326049,103.874203
349280,123,275,398,1.323544,103.873931
349281,189,154,343,1.323618,103.874357
349282,3538,672,4210,1.324625,103.873258
349307,264,250,514,1.330167,103.876698
349308,16,281,297,1.330047,103.87711
349309,109,109,218,1.329721,103.877516
349312,296,655,951,1.329288,103.877898
349313,50,6,56,1.329013,103.878253
349314,487,125,612,1.33,103.878276
349315,502,10,512,1.329394,103.878103
349316,197,264,461,1.329239,103.878503
349317,617,509,1126,1.329015,103.878785
349318,870,2440,3310,1.328694,103.878989
349319,1,32,33,1.299509,103.837
349320,94,17,111,1.327646,103.878597
349321,98,21,119,1.326946,103.878391
349323,54,93,147,1.327084,103.878577
349324,371,28,399,1.327245,103.878976
349325,1,12,13,1.328442,103.879035
349326,133,494,627,1.328699,103.878729
349327,454,84,538,1.328262,103.87938
349328,343,1608,1951,1.328272,103.87937
349329,26,107,133,1.328271,103.879369
349330,30,66,96,1.327604,103.878876
349331,7,221,228,1.329647,103.877441
349350,28,1298,1326,1.329944,103.874267
349351,4,16,20,1.330011,103.874255
349352,1,5,6,1.330098,103.87423
349353,3,7,10,1.330169,103.874204
349354,117,13,130,1.330223,103.87419
349355,0,14,14,1.330434,103.874153
349356,0,4,4,1.330486,103.874142
349359,6,1,7,1.33064,103.874096
349360,53,0,53,1.330692,103.874095
349361,0,2,2,1.321367,103.875873
349362,4,7,11,1.330795,103.874061
349363,0,17,17,1.330846,103.874044
349364,6,17,23,1.330915,103.874033
349365,21,13,34,1.330953,103.874057
349366,0,7,7,1.330963,103.874089
349367,0,2,2,1.330743,103.874078
349368,0,1,1,1.321328,103.875839
349370,21,0,21,1.331006,103.874222
349371,3,4,7,1.331018,103.874259
349373,0,3,3,1.322399,103.877313
349374,0,1,1,1.330984,103.874153
349375,22,4,26,1.331058,103.874425
349376,1,8,9,1.331007,103.874442
349377,2,4,6,1.330953,103.874469
349378,0,1,1,1.331068,103.874383
349381,1,1,2,1.330975,103.874119
349382,0,4,4,1.330681,103.874596
349383,1,1,2,1.330729,103.874572
349384,1,7,8,1.330578,103.874642
349385,3,7,10,1.330468,103.874714
349386,2,4,6,1.330408,103.87474
349387,0,5,5,1.330328,103.874773
349388,7,3,10,1.330242,103.87481
349389,10,1234,1244,1.330174,103.874844
349415,7,15,22,1.330362,103.873882
349416,4,0,4,1.330442,103.873848
349418,2,1,3,1.331051,103.874336
349419,3,0,3,1.330591,103.873791
349420,0,1,1,1.330897,103.874494
349421,37,2,39,1.330809,103.873711
349422,7,7,14,1.330877,103.873688
349423,18,3,21,1.330946,103.873671
349424,4,12,16,1.331026,103.873643
349425,1,2,3,1.330666,103.873757
349426,1,1,2,1.330629,103.874619
349428,0,2,2,1.33117,103.873603
349430,2,1,3,1.331095,103.87362
349431,55,2,57,1.331525,103.873546
349432,21,0,21,1.331599,103.873557
349433,8,0,8,1.331668,103.873563
349434,1,1,2,1.331307,103.873563
349436,2,0,2,1.331725,103.873574
349437,1,0,1,1.330734,103.873734
349439,0,1,1,1.331943,103.873614
349441,1,0,1,1.33208,103.873636
349442,8,0,8,1.332293,103.873665
349443,74,7,81,1.332361,103.873682
349444,132,1,133,1.332419,103.873693
349445,2,0,2,1.331869,103.873597
349471,48,95,143,1.328608,103.874472
349472,164,21,185,1.328519,103.874627
349473,43,15,58,1.328417,103.87476
349474,0,14,14,1.32834,103.87488
349475,2,7,9,1.328247,103.874978
349476,2,6,8,1.328176,103.875067
349477,4,9,13,1.328068,103.875186
349478,31,34,65,1.328609,103.874967
349479,7,3,10,1.327872,103.87543
349480,1,8,9,1.327977,103.875323
349481,159,14,173,1.328402,103.875234
349482,185,20,205,1.328275,103.875402
349483,15,7,22,1.327704,103.87593
349484,0,1,1,1.332224,103.873659
349485,10,5,15,1.327567,103.87612
349486,0,7,7,1.327476,103.876247
349487,1,1,2,1.332482,103.873705
349488,0,1,1,1.327659,103.875993
349489,255,57,312,1.327201,103.876629
349490,4,2,6,1.32711,103.876756
349491,2,0,2,1.327384,103.876374
349492,6,1,7,1.326937,103.877
349493,0,61,61,1.299509,103.837
349518,819,93,912,1.328265,103.873927
349544,110,230,340,1.328813,103.873306
349552,0,6,6,1.328223,103.873719
349553,55,173,228,1.328119,103.873865
349554,132,206,338,1.32806,103.873967
349555,114,205,319,1.328,103.874049
349556,2,0,2,1.327018,103.876883
349557,620,197,817,1.327763,103.874377
349558,315,207,522,1.327842,103.87398
349560,345,74,419,1.326975,103.874689
349561,9,355,364,1.327288,103.875033
349562,669,79,748,1.326844,103.874309
349563,2,13,15,1.327169,103.875197
349564,101,19,120,1.32706,103.875351
349565,380,348,728,1.326544,103.875761
349566,122,308,430,1.326841,103.876101
349567,2824,4578,7402,1.325258,103.8767
349568,155,42,197,1.326559,103.876455
349569,35,858,893,1.326295,103.876861
349570,461,387,848,1.324726,103.878035
349571,5,130,135,1.324168,103.877957
349572,457,740,1197,1.324436,103.878079
349573,2,8,10,1.324065,103.878009
349574,475,421,896,1.323939,103.878229
349575,0,70,70,1.323968,103.878037
349576,4,1,5,1.323871,103.878088
349577,2,0,2,1.327881,103.874213
349578,1,0,1,1.327293,103.876502
349579,0,4,4,1.323555,103.878196
349580,0,39,39,1.323475,103.878231
349581,1,102,103,1.323384,103.878282
349582,2,197,199,1.323275,103.878328
349583,230,371,601,1.328845,103.872841
349584,1450,2178,3628,1.32457,103.877316
349585,1873,535,2408,1.328378,103.873499
349609,1,8,9,1.331377,103.875155
349611,38,1,39,1.331532,103.875401
349612,86,0,86,1.331419,103.875355
349614,1,0,1,1.323659,103.878157
349615,1,0,1,1.331719,103.875872
349616,5,3,8,1.331483,103.875531
349617,1,0,1,1.331742,103.875929
349618,93,7,100,1.331785,103.876093
349619,17,7,24,1.331827,103.876148
349620,6,0,6,1.331543,103.875728
349622,4,2,6,1.331838,103.876366
349623,1,1,2,1.323773,103.878117
349625,4,0,4,1.33166,103.876132
349626,11,0,11,1.331878,103.876503
349627,0,7,7,1.331797,103.876397
349628,7,2,9,1.331896,103.876565
349630,15,0,15,1.331913,103.876633
349631,3,0,3,1.331456,103.87354
349632,5,1,6,1.331943,103.876691
349634,3,1,4,1.33196,103.876745
349635,25,0,25,1.331866,103.87663
349636,0,3,3,1.331832,103.876511
349637,31,0,31,1.331889,103.876693
349638,0,4,4,1.331995,103.876853
349639,18,1,19,1.331912,103.876761
349640,2,2,4,1.33201,103.876972
349641,20,0,20,1.331925,103.87681
349645,9,6,15,1.331981,103.876986
349646,7,0,7,1.332033,103.877062
349647,6,0,6,1.331988,103.877017
349648,47,0,47,1.332045,103.87709
349649,6,16,22,1.331995,103.877045
349650,7,1,8,1.332057,103.877136
349651,5,0,5,1.332006,103.877073
349654,25,0,25,1.332074,103.877193
349655,23,17,40,1.332023,103.877127
349657,1,0,1,1.331496,103.875604
349658,3,0,3,1.33198,103.876799
349659,1,5,6,1.332038,103.877188
349661,53,0,53,1.332049,103.877216
349662,2,0,2,1.331624,103.875991
349664,3,0,3,1.332096,103.877264
349665,1,0,1,1.332029,103.877156
349666,0,2,2,1.332119,103.877326
349667,0,2,2,1.332069,103.877306
349668,6,1,7,1.332135,103.877408
349669,5,1,6,1.332142,103.877436
349670,5,2,7,1.332147,103.877466
349671,0,1,1,1.33206,103.877277
349672,0,2,2,1.332125,103.877382
349673,3,1,4,1.332168,103.877556
349674,8,0,8,1.332176,103.877585
349675,9,4,13,1.332592,103.878109
349676,2,12,14,1.332583,103.878164
349678,2,24,26,1.332637,103.878285
349679,1,2,3,1.332121,103.877355
349680,62,2,64,1.332088,103.877364
349681,1,2,3,1.332077,103.877334
349682,2,0,2,1.332164,103.877525
349683,17,2,19,1.332111,103.877458
349684,1,0,1,1.332155,103.877496
349685,0,1,1,1.332122,103.877492
349686,2,2,4,1.332209,103.878177
349687,1,17,18,1.332197,103.878255
349688,14,7,21,1.332244,103.878278
349689,13,2,15,1.332235,103.87836
349690,0,33,33,1.332286,103.87839
349692,1316,6,1322,1.333751,103.874242
349693,14,295,309,1.334722,103.875121
349694,21,14,35,1.334755,103.875221
349695,3,1,4,1.33481,103.87535
349696,4,9,13,1.334827,103.875407
349697,10,14,24,1.334844,103.875464
349698,0,8,8,1.334861,103.875521
349699,1,3,4,1.334879,103.875572
349700,492,6,498,1.335578,103.876669
349701,20,37,57,1.334902,103.875629
349702,1,0,1,1.332164,103.878125
349703,3,0,3,1.332094,103.877393
349704,30,46,76,1.334973,103.875868
349706,0,21,21,1.335002,103.875976
349707,4,17,21,1.335025,103.876028
349708,4,12,16,1.335075,103.87617
349709,1,0,1,1.334939,103.875766
349710,3,20,23,1.335115,103.876289
349711,1,2,3,1.334956,103.875817
349712,0,6,6,1.335156,103.87642
349713,3,3,6,1.335173,103.876477
349714,2,4,6,1.335228,103.876594
349715,17,5,22,1.335245,103.876657
349716,0,4,4,1.335268,103.876714
349717,2,0,2,1.332105,103.877427
349718,8,4,12,1.335308,103.876839
349719,3,7,10,1.335331,103.876902
349721,0,7,7,1.335422,103.877207
349722,0,13,13,1.335442,103.877281
349723,0,21,21,1.33545,103.877359
349724,13,240,253,1.335447,103.877418
349726,1,0,1,1.335098,103.876227
349727,7,28,35,1.33539,103.877718
349728,4,0,4,1.335366,103.877795
349729,5,2111,2116,1.335345,103.877868
349730,4,3,7,1.299509,103.837
349756,5,1,6,1.333484,103.875279
349757,2,1,3,1.335138,103.876358
349758,6,1,7,1.33351,103.875523
349759,3,2,5,1.33372,103.875958
349760,18,0,18,1.333566,103.875793
349762,7,1,8,1.333788,103.876164
349763,3,2,5,1.333634,103.875984
349764,7,0,7,1.333661,103.876063
349765,21,5,26,1.333928,103.876518
349766,1,11,12,1.333867,103.876368
349767,1,0,1,1.335405,103.877648
349768,1,2,3,1.333651,103.875757
349769,2,1,3,1.333728,103.876256
349770,2,4,6,1.333958,103.876568
349771,0,1,1,1.333706,103.876183
349772,34,7,41,1.333773,103.876357
349774,2,2,4,1.334065,103.876953
349775,0,10,10,1.334015,103.876784
349776,0,4,4,1.333831,103.876541
349778,4,2,6,1.334106,103.877079
349779,1,11,12,1.33409,103.876989
349780,1,0,1,1.334144,103.877196
349781,1,0,1,1.333912,103.876717
349782,3,1,4,1.33467,103.877047
349783,41,3,44,1.333967,103.876861
349784,2,0,2,1.335285,103.876777
349785,1,2,3,1.333996,103.876742
349786,1,1,2,1.333993,103.876937
349788,2,0,2,1.334044,103.877072
349791,130,1,131,1.334608,103.876843
349792,2,3,5,1.334574,103.876745
349793,13,0,13,1.334558,103.876648
349794,12,4,16,1.334515,103.876559
349796,0,2,2,1.334642,103.876949
349797,22,0,22,1.334422,103.87627
349798,0,1,1,1.33394,103.87679
349801,1,0,1,1.299509,103.837
349803,16,0,16,1.334347,103.876013
349804,3,1,4,1.33425,103.877513
349805,10,0,10,1.334335,103.87593
349811,3,3,6,1.334226,103.875659
349812,8,0,8,1.334509,103.877603
349813,4,0,4,1.334178,103.875549
349814,14,4,18,1.334582,103.877592
349816,1,0,1,1.334375,103.876091
349817,62,0,62,1.334734,103.877481
349818,8,2,10,1.334775,103.87741
349819,0,1,1,1.33465,103.87756
349823,32,1,33,1.334798,103.877
349825,31,0,31,1.334752,103.876898
349826,2,0,2,1.334459,103.876358
349828,16,29,45,1.3347,103.876727
349830,6,0,6,1.334637,103.876551
349831,6,1,7,1.33462,103.876488
349833,8,0,8,1.334585,103.876363
349834,7,0,7,1.334568,103.876306
349835,2,1,3,1.334571,103.877151
349836,214,0,214,1.334494,103.876124
349837,2,0,2,1.334735,103.876841
349838,8,4,12,1.334454,103.87601
349839,10,0,10,1.334436,103.875953
349840,0,1,1,1.334796,103.877342
349841,2,1,3,1.334517,103.876181
349843,1,2,3,1.334358,103.875742
349844,18,5,23,1.334297,103.875516
349845,54,5,59,1.334214,103.875282
349846,17,35,52,1.33357,103.875562
349847,2,0,2,1.334471,103.876067
349848,1,0,1,1.334419,103.875896
349849,1,0,1,1.33357,103.875562
349850,3,0,3,1.334314,103.875585
349852,1,1,2,1.33357,103.875562
349853,0,3,3,1.33467,103.877047
349854,4,0,4,1.333515,103.875565
349855,9,23,32,1.33357,103.875562
349856,1,5,6,1.33357,103.875562
349857,1,12,13,1.33357,103.875562
349858,0,1,1,1.33357,103.875562
349860,30,9,39,1.33357,103.875562
349862,7,7,14,1.333502,103.875427
349863,1,0,1,1.33357,103.875562
349865,3,0,3,1.334144,103.877196
349866,12,0,12,1.334137,103.877386
349867,171,31,202,1.299509,103.837
349868,4,1,5,1.299509,103.837
349873,1,3,4,1.330958,103.875147
349874,4,0,4,1.332166,103.875747
349876,2,0,2,1.334144,103.877196
349877,2,0,2,1.331305,103.875023
349878,3,1,4,1.332261,103.875998
349879,0,1,1,1.334104,103.877316
349880,4,0,4,1.332323,103.876195
349882,1,0,1,1.331403,103.874996
349884,0,5,5,1.332363,103.87632
349887,8,0,8,1.331882,103.875021
349889,1,0,1,1.332346,103.876258
349890,0,6,6,1.332421,103.876502
349891,15,0,15,1.332046,103.875176
349892,4,0,4,1.332444,103.876565
349893,7,0,7,1.332089,103.875279
349894,0,2,2,1.332241,103.875912
349895,1,0,1,1.332003,103.875089
349896,1,0,1,1.332114,103.875382
349898,2,0,2,1.332461,103.876622
349901,4,0,4,1.332237,103.875699
349902,0,1,1,1.332478,103.876679
349903,0,1,1,1.332633,103.876848
349904,6,0,6,1.332645,103.876876
349905,32,1,33,1.3323,103.875912
349906,1,1,2,1.33261,103.87678
349907,0,3,3,1.334123,103.877362
349908,5,0,5,1.332668,103.876933
349909,2,5,7,1.332431,103.876179
349916,2,0,2,1.332656,103.876905
349917,4,0,4,1.332504,103.876428
349918,2,0,2,1.332719,103.877059
349919,7,0,7,1.332522,103.87649
349922,2,0,2,1.332725,103.877087
349923,1,0,1,1.332265,103.875813
349924,0,10,10,1.332696,103.876764
349925,6,0,6,1.332705,103.876791
349926,2,0,2,1.332558,103.876614
349927,0,7,7,1.332722,103.876846
349928,3,0,3,1.33233,103.875985
349929,11,5,16,1.332739,103.8769
349930,1,0,1,1.332576,103.876676
349931,2,4,6,1.332756,103.876954
349932,7,0,7,1.332765,103.876981
349933,0,1,1,1.332748,103.876927
349935,10,5,15,1.33279,103.877063
349936,16,13,29,1.331652,103.875065
349937,3,1,4,1.331724,103.875066
349938,2,3,5,1.331779,103.875075
349939,36,0,36,1.331833,103.875085
349940,21,5,26,1.332742,103.87715
349941,5,0,5,1.332754,103.877178
349942,0,1,1,1.332773,103.877008
349943,1,0,1,1.332765,103.877206
349944,0,1,1,1.332777,103.877235
349946,96,1,97,1.3328,103.87732
349948,2,0,2,1.332713,103.876818
349949,28,2,30,1.332892,103.878148
349950,36,1,37,1.332908,103.878205
349951,1,106,107,1.332927,103.878225
349952,7,0,7,1.332799,103.87709
349953,4,1,5,1.332808,103.877117
349954,3,1,4,1.332816,103.877144
349955,5,0,5,1.332825,103.877172
349956,1,1,2,1.332885,103.878092
349957,10,1,11,1.332842,103.877226
349958,2,0,2,1.332833,103.877199
349959,12,2,14,1.333208,103.877839
349960,1,0,1,1.332782,103.877263
349961,1,3,4,1.331415,103.874434
349962,88,0,88,1.331462,103.874437
349963,75,0,75,1.331639,103.874394
349965,11,0,11,1.331733,103.874397
349967,1,0,1,1.333201,103.877892
349968,0,1,1,1.331842,103.87439
349970,27,0,27,1.331952,103.874421
349971,79,1,80,1.331996,103.874428
349972,25,2,27,1.332054,103.874438
349973,1,7,8,1.332113,103.87446
349974,2,62,64,1.332365,103.874414
349977,2,0,2,1.333161,103.877796
349979,129,0,129,1.331253,103.874465
350101,382,10315,10697,1.3332,103.868354
350102,484,381,865,1.333736,103.868753
350103,567,727,1294,1.334085,103.869407
350104,562,231,793,1.334383,103.869056
350105,637,345,982,1.334412,103.868558
350106,391,7897,8288,1.334154,103.868122
350107,354,496,850,1.334656,103.868221
350108,403,127,530,1.334998,103.867619
350109,321,4648,4969,1.334921,103.867376
350110,452,3634,4086,1.336442,103.865121
350111,149,125,274,1.336882,103.864843
350112,478,86,564,1.337514,103.864517
350113,406,3330,3736,1.33606,103.863384
350114,830,502,1332,1.336758,103.863212
350115,1265,211,1476,1.337282,103.862784
350116,264,404,668,1.336827,103.86262
350117,453,379,832,1.335998,103.86281
350118,178,510,688,1.3355,103.862635
350119,346,151,497,1.334991,103.862913
350120,1801,15328,17129,1.335157,103.863514
350121,664,1380,2044,1.335916,103.865614
350122,862,2934,3796,1.334928,103.86605
350123,37,155,192,1.335317,103.865721
350124,217,56,273,1.335364,103.865427
350125,52,119,171,1.335462,103.865169
350126,8,65,73,1.334924,103.865255
350127,38,37,75,1.335004,103.865448
350128,32,81,113,1.334899,103.865756
350129,66,19,85,1.334775,103.86548
350130,12,24,36,1.334426,103.865501
350131,55,125,180,1.334328,103.865301
350132,12,196,208,1.334194,103.865547
350133,36,71,107,1.334368,103.865817
350134,302,156,458,1.334612,103.866351
350135,326,2857,3183,1.334654,103.86679
350136,444,259,703,1.334079,103.866477
350137,565,275,840,1.333803,103.865877
350138,405,507,912,1.33357,103.865419
350139,522,84,606,1.33333,103.865883
350140,559,227,786,1.333785,103.866748
350141,109,3911,4020,1.334039,103.867366
350142,742,391,1133,1.33341,103.867023
350143,1227,336,1563,1.332865,103.865965
350144,113,293,406,1.332628,103.865474
350145,692,947,1639,1.332421,103.865997
350146,409,220,629,1.332062,103.867199
350147,304,441,745,1.33182,103.867954
350148,646,5477,6123,1.332627,103.867766
357674,1,70,71,1.299509,103.837
357679,1,6,7,1.299509,103.837
357680,69,7,76,1.299509,103.837
357684,12794,138,12932,1.33721,103.8689
357689,247,47,294,1.334188,103.863582
357690,67,170,237,1.333604,103.863514
357691,474,1529,2003,1.333201,103.863195
357694,17,0,17,1.299509,103.837
357695,6,0,6,1.299509,103.837
357697,16,2,18,1.299509,103.837
357698,0,41,41,1.299509,103.837
357699,150,10,160,1.299509,103.837
357704,13,0,13,1.347487,103.861349
357705,9,0,9,1.347487,103.861349
357706,19,48,67,1.347487,103.861349
357709,1,0,1,1.331872,103.874401
357710,12,31,43,1.344274,103.861265
357711,28,1,29,1.346004,103.861248
357712,10,40,50,1.299509,103.837
357713,42,2,44,1.299509,103.837
357714,1,0,1,1.344248,103.861268
357715,2,4,6,1.345518,103.861036
357716,2,0,2,1.332395,103.874511
357718,3,298,301,1.344149,103.861286
357719,52,2,54,1.347531,103.861795
357720,81,0,81,1.347487,103.861349
357721,18,0,18,1.347487,103.861349
357722,6,0,6,1.347487,103.861349
357723,14,0,14,1.347487,103.861349
357724,33,6,39,1.34727,103.860733
357725,7,12,19,1.34727,103.860733
357726,28,0,28,1.347968,103.860745
357727,11,0,11,1.345518,103.861036
357728,1,17,18,1.345518,103.861036
357734,72,1,73,1.347486,103.861585
357735,24,12,36,1.34549,103.862178
357736,30,4,34,1.347048,103.862107
357737,35,2,37,1.347048,103.862107
357738,20,6,26,1.345933,103.862338
357739,1,2,3,1.33273,103.876873
357741,2393,628,3021,1.339603,103.869405
357768,64,268,332,1.329249,103.867879
357769,2,274,276,1.329379,103.867921
357774,748,146,894,1.330239,103.868068
357775,31,304,335,1.32882,103.867699
357776,398,81,479,1.330414,103.868109
357777,2,23,25,1.328841,103.867705
357779,0,47,47,1.32961,103.867853
357781,0,13,13,1.328922,103.867727
357782,0,15,15,1.328962,103.867737
357783,0,70,70,1.329871,103.8678
357784,1,5,6,1.329922,103.867811
357785,43,1,44,1.329997,103.867823
357786,92,0,92,1.330037,103.867842
357787,1,9,10,1.33009,103.867862
357788,6,8,14,1.330136,103.867867
357789,3,16,19,1.330185,103.8679
357790,0,16,16,1.330242,103.867881
357791,28,7,35,1.330263,103.867891
357792,3,100,103,1.33037,103.867961
357793,37,57,94,1.330396,103.867981
357794,55,0,55,1.330494,103.867995
357795,2,35,37,1.330464,103.867987
357796,16,51,67,1.330539,103.867972
357797,0,23,23,1.330616,103.868016
357798,13,110,123,1.330664,103.868027
357799,770,28,798,1.329641,103.868131
357826,5,6,11,1.343662,103.865398
357827,30,5,35,1.343549,103.865498
357828,2,4,6,1.343427,103.865614
357829,8,0,8,1.343303,103.865713
357830,74,58,132,1.343167,103.865852
357831,3,13,16,1.343083,103.865968
357832,3,1,4,1.34299,103.866036
357834,0,1,1,1.345518,103.861036
357835,8,1,9,1.342727,103.866347
357836,1,0,1,1.342784,103.866266
357837,9,1,10,1.342597,103.866571
357839,5,18,23,1.342535,103.866659
357840,37,1,38,1.34004,103.867144
357841,0,1,1,1.342649,103.866474
357842,92,0,92,1.340018,103.866482
357843,38,26,64,1.342439,103.866864
357844,2541,684,3225,1.342257,103.867493
357845,11,148,159,1.341656,103.86755
357846,28,4,32,1.341479,103.867343
357847,69,2,71,1.341334,103.867177
357848,2,2,4,1.341325,103.86673
357849,47,8,55,1.341233,103.866343
357850,12,7,19,1.341569,103.865945
357851,1,0,1,1.342501,103.866754
357852,28,1,29,1.342493,103.865286
357853,16,0,16,1.343093,103.864781
357854,59,1,60,1.341483,103.865792
357855,130,6,136,1.34111,103.866024
357856,131,3,134,1.341025,103.866428
357857,20,6,26,1.341066,103.866968
357858,39,1,40,1.341227,103.867253
357859,155,11,166,1.340373,103.867263
357860,80,5,85,1.34021,103.866525
357861,36,2,38,1.340365,103.865887
357862,75,0,75,1.340545,103.865575
357863,10,23,33,1.335545,103.868844
357864,7,366,373,1.335467,103.869336
357865,16,12,28,1.335443,103.86936
357866,13,7,20,1.335206,103.869576
357867,15,5,20,1.335216,103.869546
357869,13,2,15,1.335188,103.869715
357870,5,6,11,1.335072,103.869509
357871,55,439,494,1.334973,103.869753
357872,9,13,22,1.334914,103.869916
357874,230,456,686,1.341999,103.869198
357875,85,0,85,1.341947,103.867666
357876,3,0,3,1.347436,103.862017
357877,14,1,15,1.299509,103.837
357900,1183,25,1208,1.335766,103.869953
357901,264,1565,1829,1.335741,103.8698
357902,810,652,1462,1.335727,103.869705
357903,1659,9,1668,1.335738,103.869506
357905,1497,11,1508,1.336437,103.868569
357906,7,10,17,1.336567,103.867961
357907,1106,24,1130,1.335752,103.869116
357909,107,440,547,1.335775,103.868998
357910,3,17,20,1.336197,103.86814
357911,7,9,16,1.335831,103.868876
357913,5,260,265,1.335873,103.868653
357915,14,19,33,1.336591,103.866751
357916,938,262,1200,1.33589,103.868392
357917,5,120,125,1.336035,103.868509
357919,4,34,38,1.336099,103.868453
357920,2153,19,2172,1.336046,103.86743
357922,270,306,576,1.336684,103.867614
357958,155,282,437,1.346442,103.871332
357959,11,22,33,1.346427,103.871257
357960,1,0,1,1.342135,103.865622
357962,3,0,3,1.341173,103.867472
357963,29,0,29,1.346402,103.870476
357964,8,10,18,1.346465,103.870351
357965,20,0,20,1.346543,103.870187
357966,7,0,7,1.346628,103.870076
357968,7,6,13,1.346877,103.86987
357969,1,3,4,1.346828,103.869991
357970,1,3,4,1.34693,103.869761
357971,18,0,18,1.346997,103.869774
357972,4,0,4,1.347036,103.869543
357973,0,9,9,1.347046,103.869692
357975,1,0,1,1.346223,103.870944
357976,12,6,18,1.34702,103.86917
357977,12,0,12,1.34702,103.86917
357978,2,2,4,1.347006,103.86892
357979,5,4,9,1.347005,103.868919
357980,16,1,17,1.347073,103.868813
357981,1,1,2,1.344188,103.861283
357982,13,3,16,1.346936,103.868594
357983,12,0,12,1.346912,103.868468
357984,2,1,3,1.34634,103.870655
357985,11,0,11,1.346882,103.868374
357986,8,0,8,1.346867,103.868337
357987,1,0,1,1.347021,103.869171
357988,1,0,1,1.346344,103.868431
357991,30,0,30,1.346777,103.868121
357993,2,1,3,1.346897,103.868431
357994,11,0,11,1.346862,103.868296
357995,3,1,4,1.347227,103.869089
357996,1,2,3,1.346845,103.868264
357997,4,5,9,1.347206,103.868954
357998,2,6,8,1.347195,103.868881
357999,26,6,32,1.347129,103.868715
358000,1,0,1,1.346287,103.868436
358001,0,2,2,1.34695,103.868667
358002,0,1,1,1.347107,103.868654
358003,0,7,7,1.347051,103.86847
358004,6,5,11,1.34703,103.8684
358005,49,0,49,1.347022,103.86834
358007,3,22,25,1.347003,103.868296
358008,9,4,13,1.346823,103.868131
358009,2,11,13,1.346924,103.868103
358010,16,4,20,1.346792,103.868032
358011,4,0,4,1.346905,103.868055
358013,6,16,22,1.346891,103.86802
358014,1,0,1,1.34707,103.868536
358015,10,0,10,1.346878,103.867974
358016,6,2,8,1.346698,103.867738
358017,0,2,2,1.347085,103.868601
358019,7,0,7,1.346832,103.867847
358020,7,0,7,1.346636,103.867541
358021,1,0,1,1.346729,103.867836
358022,10,0,10,1.346604,103.867443
358023,0,2,2,1.346846,103.867876
358024,8,5,13,1.346573,103.867345
358025,9,1,10,1.346767,103.86766
358026,5,33,38,1.346542,103.867247
358028,69,0,69,1.346511,103.867148
358029,2,4,6,1.346709,103.867502
358030,12,4,16,1.34648,103.86705
358031,2,1,3,1.347218,103.869053
358032,18,19,37,1.346449,103.866952
358033,144,12,156,1.346684,103.867414
358034,0,3,3,1.3467,103.867443
358035,3,9,12,1.346651,103.86734
358036,3,11,14,1.346388,103.86683
358037,145,0,145,1.346641,103.867291
358038,9,11,20,1.346364,103.866754
358039,0,23,23,1.346612,103.867221
358040,17,3,20,1.346593,103.86715
358041,3,6,9,1.346577,103.867093
358043,41,6,47,1.346536,103.866993
358044,7,0,7,1.346519,103.866936
358045,2,0,2,1.34678,103.867694
358046,13,85,98,1.346485,103.866821
358047,38,3,41,1.346464,103.86675
358048,0,8,8,1.346368,103.870615
358049,7,0,7,1.34664,103.870042
358051,2,0,2,1.346498,103.866874
358052,25,18,43,1.347128,103.869562
358053,1,0,1,1.346815,103.867791
358054,8,3,11,1.347035,103.869542
358055,1,12,13,1.34711,103.869382
358074,0,26,26,1.346724,103.870873
358076,29,44,73,1.346661,103.870958
358077,2,4,6,1.34678,103.870934
358078,0,2,2,1.347073,103.869629
358079,9,1,10,1.346783,103.871054
358080,0,3,3,1.346425,103.866905
358081,3,0,3,1.346879,103.870979
358082,0,2,2,1.34678,103.870934
358083,1,1,2,1.3469,103.871131
358084,41,1,42,1.347087,103.871024
358087,16,9,25,1.347017,103.871148
358088,4,0,4,1.347017,103.871148
358089,8,1,9,1.347216,103.871027
358090,7,1,8,1.347333,103.871018
358091,6,1,7,1.347391,103.871003
358092,0,1,1,1.347147,103.869514
358093,1,1,2,1.3469,103.871131
358095,4,8,12,1.34758,103.870978
358096,5,0,5,1.34762,103.870982
358097,1,0,1,1.34744,103.871009
358098,2,52,54,1.347518,103.871117
358099,18,2,20,1.347689,103.870967
358100,2,6,8,1.347749,103.870969
358101,11,0,11,1.347724,103.871108
358102,3,1,4,1.347724,103.871108
358104,45,4,49,1.34788,103.870978
358105,30,1,31,1.347973,103.871069
358106,10,2,12,1.347987,103.870945
358107,0,4,4,1.348039,103.870948
358108,0,1,1,1.34734,103.87113
358109,0,2,2,1.34716,103.871146
358134,5,8,13,1.346622,103.864372
358135,3,0,3,1.346879,103.870979
358136,3,1,4,1.346765,103.864349
358137,21,0,21,1.347012,103.864496
358139,33,0,33,1.347245,103.864451
358140,19,6,25,1.347143,103.864317
358141,11,0,11,1.347389,103.864283
358142,0,1,1,1.299509,103.837
358143,0,1,1,1.347785,103.864392
358144,1,0,1,1.348025,103.864377
358145,0,3,3,1.346788,103.864511
358146,5,1,6,1.348124,103.864195
358147,3,0,3,1.348262,103.864349
358148,5,2,7,1.348616,103.864171
358149,7,0,7,1.348473,103.864336
358150,8,0,8,1.346701,103.864528
358151,12,16,28,1.347117,103.86448
358175,2,4,6,1.343783,103.870073
358176,21,1,22,1.343825,103.870074
358177,0,1,1,1.347872,103.864242
358178,206,18,224,1.343602,103.869978
358179,3,0,3,1.348364,103.864196
358180,1,12,13,1.344584,103.870101
358181,2,0,2,1.299509,103.837
358182,8,23,31,1.344766,103.870148
358183,2,0,2,1.344118,103.869812
358184,1,14,15,1.344592,103.869863
358185,284,11,295,1.345204,103.870348
358186,4,0,4,1.344939,103.869912
358187,30,75,105,1.345322,103.870395
358188,4,1,5,1.345188,103.869976
358189,33,38,71,1.345592,103.870515
358190,63,5,68,1.345354,103.870018
358191,7,4,11,1.345755,103.870539
358192,9,0,9,1.345426,103.870034
358193,3,32,35,1.345925,103.870919
358194,19,22,41,1.3456,103.870066
358195,33,0,33,1.345692,103.870142
358196,21,0,21,1.345858,103.870177
358197,32,10,42,1.345938,103.870212
358198,0,2,2,1.345018,103.870263
358199,2,4,6,1.343985,103.870061
358200,7,0,7,1.344133,103.870047
358202,0,19,19,1.344302,103.870061
358203,15,1,16,1.343931,103.869941
358204,2,2,4,1.343813,103.869941
358205,12,0,12,1.344999,103.869918
358206,2,3,5,1.345032,103.869918
358208,2,0,2,1.346016,103.870358
358209,1,0,1,1.343906,103.87008
358210,65,0,65,1.345793,103.870425
358211,2,0,2,1.345821,103.870426
358213,2,0,2,1.345843,103.870429
358214,2,0,2,1.345901,103.870444
358215,1,0,1,1.345743,103.870406
358216,3,0,3,1.344055,103.870065
358217,1,0,1,1.345959,103.870479
358218,0,1,1,1.345959,103.870479
358219,12,0,12,1.344687,103.869911
358220,11,8,19,1.344755,103.869932
358221,2,15,17,1.34482,103.869951
358222,4,0,4,1.299509,103.837
358223,5,14,19,1.299509,103.837
358225,5,0,5,1.34432,103.8703
358226,5,396,401,1.344431,103.870439
358227,67,34,101,1.34417,103.870063
358228,4,14,18,1.344462,103.870306
358230,10,0,10,1.344631,103.869735
358231,9,3,12,1.344462,103.869877
358232,7,0,7,1.344643,103.869657
358234,1,19,20,1.34468,103.869502
358235,0,3,3,1.345959,103.870479
358236,5,16,21,1.344889,103.86936
358238,0,4,4,1.344856,103.86906
358239,2,0,2,1.345959,103.870479
358240,12,1,13,1.344583,103.869463
358241,18,16,34,1.344921,103.868899
358242,2,10,12,1.344935,103.868835
358243,5,0,5,1.344417,103.869176
358244,2,2,4,1.344447,103.869184
358246,499,11,510,1.344522,103.869146
358247,300,33,333,1.344843,103.868693
358249,300,6,306,1.344881,103.868612
358250,0,2,2,1.344841,103.869106
358251,16,19,35,1.344909,103.86854
358252,4,1,5,1.344908,103.868539
358254,4,0,4,1.344964,103.868397
358255,8,3,11,1.344963,103.868396
358256,0,12,12,1.345138,103.86811
358257,66,0,66,1.345158,103.868065
358258,2,42,44,1.34502,103.868254
358259,1,0,1,1.345959,103.870479
358260,21,2,23,1.345178,103.868017
358261,17,1,18,1.3452,103.867969
358262,113,1,114,1.345099,103.867998
358263,1,0,1,1.345019,103.868253
358264,26,3,29,1.34524,103.867883
358265,122,0,122,1.345045,103.868127
358268,17,5,22,1.345294,103.867792
358270,0,1,1,1.299509,103.837
358271,4,10,14,1.345349,103.86765
358272,22,0,22,1.345155,103.867846
358273,8,0,8,1.345382,103.867499
358274,1,1,2,1.34504,103.868389
358275,51,0,51,1.345431,103.867384
358276,1,4,5,1.345141,103.867455
358277,11,2,13,1.345488,103.867256
358278,2,7,9,1.345371,103.867326
358279,2,0,2,1.345247,103.867624
358280,1,1,2,1.345502,103.867149
358281,11,0,11,1.345521,103.867021
358282,3,1,4,1.345425,103.867112
358283,2,8,10,1.345441,103.867014
358284,145,0,145,1.345589,103.866879
358285,9,0,9,1.345451,103.866874
358286,3,2,5,1.345451,103.866744
358287,21,44,65,1.345465,103.86666
358288,2,0,2,1.345389,103.867254
358289,15,8,23,1.345459,103.866575
358291,15,0,15,1.345447,103.866407
358292,1,0,1,1.345388,103.866472
358293,81,0,81,1.345435,103.866238
358294,3,0,3,1.344536,103.869598
358295,13,17,30,1.345423,103.86607
358296,2,1,3,1.345386,103.866404
358297,9,0,9,1.34541,103.865901
358299,0,6,6,1.345398,103.865732
358301,10,3,13,1.345415,103.865636
358302,2,0,2,1.345447,103.866683
358303,9,24,33,1.345414,103.865517
358304,12,41,53,1.345333,103.865799
358305,6,2,8,1.345353,103.86568
358306,0,5,5,1.345344,103.865605
358307,0,3,3,1.345369,103.866224
358308,167,0,167,1.345372,103.86759
358309,2,0,2,1.345344,103.865922
358310,12,0,12,1.345207,103.867747
358311,1,0,1,1.345388,103.866472
358361,531,5172,5703,1.332691,103.867251
358362,624,2899,3523,1.331576,103.866614
358389,39,442,481,1.333079,103.863594
358390,59,1,60,1.333563,103.863534
358416,7,6,13,1.344661,103.862646
358417,10,2,12,1.344757,103.862612
358418,10,0,10,1.344628,103.862445
358419,13,11,24,1.3447,103.862254
358420,24,4,28,1.344563,103.862087
358421,49,0,49,1.344646,103.862001
358422,3,0,3,1.345343,103.865486
358423,41,5,46,1.344614,103.861732
358424,5,3,8,1.344471,103.861512
358425,113,36,149,1.344613,103.86159
358426,8,0,8,1.3446,103.86229
358427,39,4,43,1.344691,103.862386
358428,16,0,16,1.344608,103.861471
358429,20,9,29,1.344538,103.86133
358430,8,0,8,1.344376,103.862226
358431,6,0,6,1.344251,103.862221
358432,12,0,12,1.344251,103.86212
358433,15,0,15,1.344321,103.862105
358434,84,0,84,1.344374,103.86209
358435,16,0,16,1.344445,103.862071
358436,4,16,20,1.299509,103.837
358453,3,70,73,1.330698,103.868491
358454,3,4,7,1.330723,103.86841
358455,5,80,85,1.330774,103.868202
358456,9,0,9,1.330801,103.868096
358457,1,0,1,1.299509,103.837
358458,53,107,160,1.330934,103.867663
358459,59,1,60,1.33104,103.867318
358460,1,2,3,1.344516,103.861782
358461,82,176,258,1.331094,103.867145
358462,2,13,15,1.330836,103.868
358463,204,3,207,1.331147,103.866972
358464,138,42,180,1.331237,103.866792
358465,1,15,16,1.33096,103.867597
358467,1,0,1,1.330827,103.868009
358468,1,3,4,1.331367,103.866533
358469,2,41,43,1.33119,103.866902
358470,0,46,46,1.331284,103.866723
358471,5,378,383,1.331377,103.866543
358472,5,579,584,1.299509,103.837
358473,3,2,5,1.299509,103.837
358474,10,0,10,1.299509,103.837
358498,24,17,41,1.347702,103.864543
358500,16,1,17,1.347964,103.864875
358501,17,4,21,1.347705,103.864697
358502,3,1,4,1.348209,103.865249
358503,1,0,1,1.331023,103.867395
358504,16,4,20,1.348282,103.865337
358506,9,1,10,1.348339,103.865433
358507,8,0,8,1.348113,103.865452
358508,50,0,50,1.348202,103.865755
358509,15,0,15,1.3483,103.86588
358510,11,2,13,1.348499,103.866098
358511,6,0,6,1.348589,103.866263
358512,6,2,8,1.348644,103.866363
358513,6,1,7,1.348685,103.866441
358514,1,0,1,1.3479,103.865124
358516,0,4,4,1.347767,103.864584
358517,4,1,5,1.34838,103.865952
358518,14,0,14,1.299509,103.837
358539,3,0,3,1.330805,103.868101
358540,3,5,8,1.346469,103.863816
358541,219,1,220,1.3466,103.863685
358542,1,2,3,1.346454,103.863693
358544,0,7,7,1.34674,103.863791
358545,1,0,1,1.348418,103.865521
358546,1,0,1,1.346906,103.863639
358547,70,13,83,1.347018,103.86363
358548,8,0,8,1.347033,103.863753
358549,6,0,6,1.347184,103.863737
358550,10,0,10,1.347388,103.863593
358551,12,0,12,1.347403,103.863716
358552,7,2,9,1.347603,103.863536
358553,27,5,32,1.347614,103.863699
358554,83,1,84,1.34781,103.863542
358555,18,1,19,1.347863,103.863678
358556,9,1,10,1.347982,103.863525
358557,4,0,4,1.348651,103.863735
358558,4,1,5,1.348172,103.863513
358559,1,4,5,1.347458,103.863749
358560,5,0,5,1.347906,103.86373
358561,9,1,10,1.346304,103.863706
358562,0,1,1,1.346921,103.863762
358563,7,0,7,1.348374,103.863479
358564,35,0,35,1.347033,103.863834
358565,128,0,128,1.34702,103.863563
358566,2,0,2,1.344454,103.870234
358567,9,0,9,1.347097,103.863544
358569,25,35,60,1.347177,103.863625
358585,1,11,12,1.345371,103.865312
358587,7,0,7,1.345326,103.865015
358588,1,0,1,1.346788,103.863838
358589,8,0,8,1.34524,103.865012
358590,53,5,58,1.34524,103.865012
358591,2,0,2,1.347097,103.863611
358592,2,9,11,1.345219,103.864892
358593,11,0,11,1.345208,103.864843
358594,9,1,10,1.345266,103.864661
358595,1,0,1,1.345325,103.864873
358596,41,11,52,1.345165,103.864715
358597,2,2,4,1.345237,103.864573
358598,2,0,2,1.345316,103.864739
358599,6,4,10,1.345116,103.864546
358600,41,0,41,1.345213,103.864482
358601,39,1,40,1.345089,103.864471
358602,18,3,21,1.345089,103.864471
358603,0,10,10,1.345173,103.864359
358604,9,3,12,1.345063,103.86434
358605,13,6,19,1.345063,103.86434
358606,42,0,42,1.345159,103.864243
358607,2,0,2,1.345116,103.864546
358608,1,0,1,1.345165,103.864715
358610,19,0,19,1.34495,103.863815
358613,31,0,31,1.344977,103.863568
358614,17,0,17,1.344863,103.863462
358615,6,0,6,1.34493,103.863434
358616,1,0,1,1.345025,103.864171
358617,0,1,1,1.344799,103.863315
358618,137,3,140,1.344759,103.863174
358619,1,0,1,1.299509,103.837
358620,16,9,25,1.344741,103.863055
358621,36,1,37,1.345352,103.865162
358623,2,13,15,1.345291,103.865264
358624,8,8,16,1.345245,103.865101
358625,0,1,1,1.299509,103.837
358626,0,6,6,1.345038,103.8638
358627,12,2,14,1.345008,103.863701
358628,32,0,32,1.344759,103.863174
358647,44,1,45,1.344226,103.862883
358649,1,12,13,1.344323,103.863031
358650,39,20,59,1.34517,103.862722
358651,8,14,22,1.344737,103.862914
358652,13,0,13,1.345788,103.862839
358653,23,16,39,1.345038,103.862968
358654,71,5,76,1.345914,103.862901
358655,10,0,10,1.345423,103.862863
358656,3,11,14,1.34678,103.862872
358657,102,1,103,1.345652,103.862926
358658,1,3,4,1.345907,103.862962
358659,42,0,42,1.347118,103.862831
358660,3,1,4,1.346066,103.862987
358661,13,2,15,1.347342,103.862804
358662,2,1,3,1.346615,103.863808
358663,1,0,1,1.345025,103.864171
358665,14,2,16,1.346848,103.862884
358666,201,3,204,1.347028,103.862862
358667,6,20,26,1.347387,103.862818
358668,7,0,7,1.347747,103.862774
358669,5,1,6,1.348106,103.86273
358670,36,2,38,1.348466,103.862686
358671,14,437,451,1.344133,103.863103
358673,8,2,10,1.344814,103.862668
358674,18,1,19,1.348241,103.862693
358675,19,15,34,1.348388,103.862665
358676,58,0,58,1.344226,103.862883
358677,6,0,6,1.344226,103.862883
358678,3,0,3,1.346269,103.862955
358679,5,0,5,1.344226,103.862883
358680,3,0,3,1.344226,103.862883
358681,71,0,71,1.344226,103.862883
358682,23,2,25,1.344226,103.862883
358683,18,0,18,1.345331,103.862717
358684,42,0,42,1.345414,103.862721
358686,9,2,11,1.345038,103.862968
358687,2,0,2,1.345143,103.864151
358688,1,9,10,1.345038,103.862968
358689,3,1,4,1.345038,103.862968
358690,12,28,40,1.344226,103.862883
358691,3,0,3,1.344226,103.862883
358692,21,0,21,1.345038,103.862968
358693,129,6,135,1.345038,103.862968
358694,39,0,39,1.345038,103.862968
358695,10,0,10,1.345038,103.862968
358697,24,43,67,1.3451,103.868704
358698,0,1,1,1.347567,103.862776
358699,4,5,9,1.345228,103.868725
358700,0,1,1,1.345156,103.868714
358701,1,4,5,1.34532,103.868795
358702,11,0,11,1.345586,103.868654
358703,7,7,14,1.345608,103.868603
358704,85,4,89,1.345422,103.868816
358705,2,0,2,1.345038,103.862968
358706,3,4,7,1.345675,103.868451
358708,143,11,154,1.345708,103.868388
358709,261,4,265,1.345726,103.868796
358711,4,1,5,1.345702,103.868573
358712,31,0,31,1.345743,103.868476
358713,0,3,3,1.345038,103.862968
358714,10,8,18,1.34581,103.868342
358715,1,3,4,1.345831,103.868149
358716,6,42,48,1.346056,103.868174
358717,9,12,21,1.345865,103.868082
358718,1,2,3,1.345805,103.868203
358719,98,8,106,1.346084,103.867647
358721,108,1,109,1.346084,103.867647
358722,2,0,2,1.345647,103.868521
358723,2,21,23,1.346131,103.867723
358724,8,0,8,1.346084,103.867647
358725,96,0,96,1.346084,103.867647
358726,8,0,8,1.346084,103.867647
358727,14,0,14,1.346084,103.867647
358728,58,0,58,1.346084,103.867658
358730,112,0,112,1.346096,103.867812
358731,4,4,8,1.346056,103.868174
358732,1,0,1,1.345549,103.868724
358733,1,1,2,1.346084,103.867647
358734,1,0,1,1.346056,103.868174
358735,4,0,4,1.346056,103.868174
358736,1,0,1,1.346056,103.868174
358738,87,0,87,1.346056,103.868174
358739,31,1,32,1.346056,103.868174
358740,5,0,5,1.346056,103.868174
358741,133,0,133,1.346056,103.868174
358742,4,0,4,1.346056,103.868174
358743,5,0,5,1.346056,103.868174
358744,15,42,57,1.346056,103.868174
358745,15,1,16,1.345726,103.868796
358746,8,4,12,1.345726,103.868796
358747,52,0,52,1.345726,103.868796
358748,67,17,84,1.345726,103.868796
358749,5,0,5,1.345726,103.868796
358750,1,0,1,1.346056,103.868174
358751,6,0,6,1.345726,103.868796
358752,3,0,3,1.345928,103.868085
358754,2,0,2,1.346056,103.868174
358756,2,12,14,1.347351,103.870055
358762,3,0,3,1.345726,103.868796
358764,7,0,7,1.347457,103.870275
358765,7,6,13,1.347474,103.87018
358766,2,7,9,1.34757,103.870294
358767,2,4,6,1.347569,103.870293
358768,14,1,15,1.34764,103.870579
358769,26,0,26,1.347835,103.870613
358770,52,0,52,1.347903,103.870615
358771,12,2,14,1.347978,103.870612
358773,7,13,20,1.347866,103.870319
358774,13,1,14,1.347689,103.87015
358775,6,0,6,1.347853,103.870181
358776,5,9,14,1.34799,103.870301
358777,14,2,16,1.347969,103.870165
358780,7,0,7,1.348081,103.870118
358782,1,0,1,1.345726,103.868796
358783,5,6,11,1.348192,103.870092
358784,9,50,59,1.34824,103.870069
358789,1,5,6,1.34842,103.870015
358790,0,1,1,1.347853,103.870078
358791,35,0,35,1.348426,103.869926
358792,0,1,1,1.34837,103.870045
358793,1,1,2,1.345726,103.868796
358794,3,0,3,1.347457,103.870275
358795,1,2,3,1.348425,103.869925
358796,0,2,2,1.348425,103.869925
358797,5,4,9,1.348425,103.869925
358798,3,2,5,1.348486,103.869982
358799,5,2,7,1.348518,103.869971
358801,2,4,6,1.348552,103.869954
358828,3009,6,3015,1.329792,103.867656
358829,22,215,237,1.329792,103.867656
358830,5,14,19,1.329792,103.867656
358831,109,29,138,1.329757,103.867877
358832,4,19,23,1.329864,103.867519
358833,0,11,11,1.329864,103.867519
358834,3,0,3,1.348425,103.869925
358836,0,1,1,1.348425,103.869925
358838,1,70,71,1.329924,103.867354
358839,0,1,1,1.32979,103.867799
358840,2,157,159,1.329961,103.86719
358841,657,34,691,1.329925,103.867492
358842,1,2,3,1.329791,103.8678
358843,78,110,188,1.330029,103.867007
358844,392,39,431,1.329992,103.867338
358845,1,2,3,1.329924,103.867491
358846,0,50,50,1.330125,103.867031
358847,539,49,588,1.330259,103.866723
358877,0,10,10,1.348074,103.86731
358878,0,9,9,1.348106,103.867225
358879,3,6,9,1.348034,103.867263
358881,46,0,46,1.347995,103.867212
358882,30,1,31,1.348052,103.867156
358884,1,0,1,1.329858,103.867646
358886,1,4,5,1.34796,103.867029
358892,17,2,19,1.347873,103.866896
358894,24,1,25,1.34784,103.866861
358897,1,2,3,1.330058,103.867185
358898,133,0,133,1.347764,103.866742
358899,4,0,4,1.347616,103.866689
358900,7,2,9,1.347718,103.866694
358901,0,1,1,1.348006,103.867093
358905,4,0,4,1.347509,103.866557
358906,4,1,5,1.347594,103.866535
358907,4,2,6,1.347487,103.866527
358908,17,3,20,1.34755,103.866467
358909,6,0,6,1.34745,103.866466
358910,2,17,19,1.347505,103.866408
358911,1,0,1,1.347568,103.86663
358912,5,0,5,1.347456,103.866355
358913,16,0,16,1.347364,103.866363
358914,2,1,3,1.347656,103.866745
358915,0,23,23,1.347323,103.866322
358916,5,1,6,1.347389,103.86626
358917,12,1,13,1.347295,103.86628
358918,0,1,1,1.347397,103.86642
358919,14,0,14,1.347269,103.866232
358920,1,1,2,1.348425,103.869925
358921,3,0,3,1.347422,103.866299
358922,10,3,13,1.347269,103.866094
358923,4,0,4,1.347197,103.866137
358924,2,1,3,1.347238,103.866188
358926,2,2,4,1.347186,103.865979
358928,2,0,2,1.347306,103.866146
358929,35,0,35,1.347084,103.865988
358930,3,4,7,1.347092,103.865863
358931,0,5,5,1.347042,103.865933
358932,4,0,4,1.347051,103.865799
358933,19,1,20,1.346996,103.865873
358934,3,0,3,1.34723,103.866033
358935,3,0,3,1.347009,103.865747
358936,4,0,4,1.346969,103.865688
358937,3,0,3,1.346975,103.865846
358938,0,7,7,1.346933,103.865631
358939,1,0,1,1.347356,103.866208
358940,1,2,3,1.346952,103.865813
358941,0,7,7,1.346853,103.86567
358968,8,16,24,1.347902,103.867683
358969,1,2,3,1.346885,103.865719
358971,2,3,5,1.347745,103.867564
358972,12,57,69,1.347645,103.867654
358973,3,4,7,1.347597,103.867699
358974,3,4,7,1.347559,103.867763
358975,2,4,6,1.347525,103.867792
358976,1,13,14,1.299509,103.837
358978,0,5,5,1.347427,103.867949
358980,1,15,16,1.34736,103.868054
358981,5,0,5,1.347311,103.868093
358983,2,8,10,1.347695,103.867525
358984,25,7,32,1.347634,103.867467
358986,2,0,2,1.34714,103.865917
358987,431,105,536,1.347525,103.867568
358988,6,8,14,1.347542,103.867318
358990,2,0,2,1.347587,103.867404
358991,2,3,5,1.347377,103.867092
358992,1,0,1,1.346919,103.865761
358993,1,1,2,1.347449,103.867177
358995,3,2,5,1.347305,103.866984
358996,25,0,25,1.347237,103.867003
358997,1,2,3,1.347852,103.867647
358999,1,6,7,1.347219,103.866856
359001,0,5,5,1.347181,103.866793
359002,5,1,6,1.347098,103.866815
359003,6,1,7,1.34715,103.866732
359004,43,0,43,1.347055,103.866749
359005,3,0,3,1.347275,103.866919
359006,24,0,24,1.347018,103.866695
359007,0,29,29,1.347092,103.86666
359008,6,4,10,1.346982,103.866645
359009,21,10,31,1.347057,103.866608
359011,20,4,24,1.347026,103.866569
359012,3,5,8,1.346925,103.866566
359015,1,1,2,1.347347,103.867031
359016,0,1,1,1.347301,103.867121
359017,13,0,13,1.346844,103.866309
359018,2,2,4,1.346774,103.866398
359020,1,5,6,1.346736,103.866365
359021,0,2,2,1.346935,103.866406
359022,11,0,11,1.3467,103.866317
359023,116,3,119,1.346717,103.866156
359024,23,2,25,1.346652,103.866258
359025,0,3,3,1.347116,103.866703
359027,0,1,1,1.346874,103.866356
359028,2,0,2,1.346753,103.86621
359029,1,0,1,1.346638,103.866079
359030,1,0,1,1.346608,103.866047
359031,4,0,4,1.346583,103.866011
359032,1,9,10,1.346512,103.866056
359033,0,2,2,1.346578,103.866169
359034,1,1,2,1.346556,103.865976
359035,4,9,13,1.346523,103.865911
359036,2,0,2,1.346465,103.866
359038,2,0,2,1.346433,103.865929
359039,16,0,16,1.346341,103.865671
359041,2,2,4,1.347472,103.867904
359042,6,0,6,1.347503,103.867869
359066,1,0,1,1.34656,103.866115
359067,13,0,13,1.346416,103.866589
359068,33,8,41,1.34627,103.866613
359069,0,3,3,1.346679,103.866119
359070,46,0,46,1.34602,103.866371
359071,30,0,30,1.346018,103.866371
359072,6,1,7,1.346018,103.866371
359073,3,2,5,1.346018,103.866371
359074,6,0,6,1.346018,103.866371
359075,1,0,1,1.346507,103.866551
359076,24,14,38,1.345841,103.866781
359078,0,1,1,1.346018,103.866371
359104,10,0,10,1.346383,103.869918
359105,3,0,3,1.346166,103.866623
359106,50,9,59,1.345975,103.869764
359108,76,7,83,1.345844,103.869714
359109,7,4,11,1.345736,103.869655
359111,76,16,92,1.346065,103.868853
359112,33,10,43,1.345541,103.869612
359113,6,10,16,1.346103,103.869679
359114,2,0,2,1.346367,103.865739
359115,10,12,22,1.346015,103.86966
359116,40,0,40,1.345139,103.869427
359117,2,2,4,1.345895,103.869613
359118,4,4,8,1.345758,103.869554
359119,28,3,31,1.345656,103.869508
359120,17,0,17,1.34418,103.869104
359121,5,18,23,1.344206,103.869111
359122,2,0,2,1.345274,103.869484
359123,4,8,12,1.345544,103.869459
359124,5,0,5,1.344253,103.869118
359126,1,0,1,1.299509,103.837
359127,2,0,2,1.344227,103.869118
359128,9,0,9,1.345404,103.869362
359130,321,10,331,1.345304,103.869339
359132,76,6,82,1.345222,103.869308
359133,2,12,14,1.343944,103.869249
359134,11,1,12,1.344087,103.869035
359135,6,1,7,1.344055,103.869029
359137,0,1,1,1.34546,103.869403
359138,1,1,2,1.343855,103.86972
359139,0,1,1,1.34364,103.869115
359145,1,11,12,1.34331,103.86905
359149,10,0,10,1.344381,103.86908
359150,1,0,1,1.344084,103.868985
359152,2,0,2,1.343663,103.869134
359153,2,7,9,1.344141,103.869051
359154,6,3,9,1.344112,103.869041
359155,69,5,74,1.34661,103.870008
359156,2,0,2,1.344178,103.869059
359157,11,0,11,1.346609,103.870007
359158,1,0,1,1.34428,103.869052
359159,11,3,14,1.346383,103.869918
359160,83,10,93,1.345423,103.869565
359161,19,2,21,1.345451,103.869596
359162,271,4,275,1.299509,103.837
359177,0,2,2,1.346609,103.870007
359178,1,0,1,1.346609,103.870007
359179,1,0,1,1.347454,103.868644
359180,1,3,4,1.347495,103.86858
359181,0,2,2,1.34745,103.868754
359182,7,0,7,1.347557,103.868509
359184,73,4,77,1.347593,103.868463
359185,5,6,11,1.347744,103.86838
359186,2,18,20,1.347622,103.868384
359187,1,3,4,1.347796,103.868309
359188,44,0,44,1.347683,103.868323
359189,21,0,21,1.347893,103.868224
359190,1,74,75,1.347745,103.868219
359191,10,0,10,1.347949,103.868114
359192,7,0,7,1.347802,103.868159
359193,3,3,6,1.347973,103.868054
359195,73,2,75,1.348099,103.867886
359196,4,0,4,1.347894,103.868033
359197,86,1,87,1.348119,103.867837
359199,1,2,3,1.346176,103.869812
359201,4,0,4,1.348201,103.867585
359202,6,5,11,1.34799,103.867845
359203,1,1,2,1.347603,103.868584
359204,29,6,35,1.348258,103.867318
359205,1,0,1,1.347555,103.868641
359206,1,0,1,1.348236,103.867217
359207,6,21,27,1.348359,103.86679
359208,17,2,19,1.348307,103.867253
359209,0,3,3,1.348177,103.867687
359210,2,13,15,1.348564,103.866993
359211,8,0,8,1.348319,103.866721
359212,15,3,18,1.348398,103.86683
359213,14,26,40,1.348435,103.866817
359214,0,1,1,1.348347,103.867117
359218,2,26,28,1.348191,103.866548
359220,5,2,7,1.348148,103.86649
359221,109,7,116,1.348181,103.866508
359222,5,9,14,1.348105,103.866432
359223,10,1,11,1.348122,103.866427
359224,0,3,3,1.34834,103.86675
359225,10,0,10,1.348062,103.866347
359227,2,0,2,1.348247,103.867441
359228,0,3,3,1.348063,103.866374
359229,1,0,1,1.348276,103.866663
359230,0,3,3,1.347977,103.866258
359231,32,1,33,1.347884,103.866105
359232,41,0,41,1.347892,103.866143
359234,1,4,5,1.347849,103.866085
359236,3,0,3,1.347935,103.8662
359237,54,0,54,1.347705,103.865862
359238,1,1,2,1.348003,103.866266
359239,0,2,2,1.347764,103.865969
359240,1,0,1,1.347943,103.866185
359241,1,3,4,1.347586,103.865701
359242,3,1,4,1.347678,103.865853
359243,5,0,5,1.347527,103.86562
359244,0,2,2,1.347646,103.865782
359245,40,0,40,1.347467,103.86554
359246,4,0,4,1.347593,103.865738
359248,0,2,2,1.347636,103.865795
359249,4,1,5,1.347348,103.865378
359250,4,0,4,1.347508,103.865622
359251,2,3,5,1.347289,103.865298
359253,12,2,14,1.347229,103.865217
359254,0,1,1,1.347721,103.865911
359255,4,0,4,1.347219,103.865207
359256,8,2,10,1.34738,103.865448
359257,1,1,2,1.34755,103.86568
359258,3,3,6,1.347337,103.865391
359259,4,3,7,1.347164,103.865244
359262,202,0,202,1.347252,103.865275
359263,7,1,8,1.347,103.865356
359264,2,16,18,1.347219,103.865227
359265,39,0,39,1.34689,103.865431
359266,14,2,16,1.346781,103.865506
359267,1,0,1,1.347422,103.865506
359268,5,0,5,1.346601,103.865652
359269,9,5,14,1.346411,103.865646
359296,0,78,78,1.32923,103.866729
359297,0,1,1,1.346771,103.865516
359299,2,1,3,1.347807,103.866027
359300,2,1,3,1.329343,103.866706
359301,1,4,5,1.329434,103.866687
359302,2,129,131,1.329479,103.866678
359304,2,95,97,1.32957,103.866659
359305,4,19,23,1.329615,103.86665
359306,1,82,83,1.329661,103.86664
359307,8,373,381,1.329696,103.866641
359334,9,4,13,1.331273,103.86572
359337,366,109,475,1.331468,103.865209
359338,112,17,129,1.330083,103.866549
359339,20,5,25,1.330278,103.865687
359340,59,91,150,1.329609,103.865741
359341,5,184,189,1.329573,103.865765
359342,463,12,475,1.331368,103.865853
359363,73,5,78,1.34393,103.86129
359364,8,935,943,1.34374,103.86135
359366,2,8,10,1.344174,103.861286
359367,2,8,10,1.344936,103.861336
359368,37,0,37,1.344381,103.861166
359369,11,6,17,1.345131,103.861191
359370,14,8,22,1.344624,103.861137
359371,19,0,19,1.345386,103.861147
359372,20,28,48,1.344876,103.861108
359373,12,0,12,1.345694,103.861022
359374,5,99,104,1.345012,103.861094
359375,12,6,18,1.346308,103.8609
359376,49,0,49,1.346549,103.860858
359377,8,81,89,1.345359,103.861043
359378,21,14,35,1.34679,103.860817
359379,2,9,11,1.345519,103.861037
359380,19,4,23,1.347271,103.860734
359381,20,60,80,1.345782,103.860985
359382,70,0,70,1.34757,103.860721
359383,10,2,12,1.346045,103.860932
359384,12,3,15,1.347969,103.860746
359385,14,6,20,1.346298,103.86089
359386,24,137,161,1.348465,103.860805
359387,44,62,106,1.346428,103.860859
359388,92,1,93,1.346549,103.860838
359389,0,57,57,1.34679,103.860797
359390,55,86,141,1.34703,103.860756
359391,5,240,245,1.347271,103.860714
359392,3,12,15,1.34737,103.860708
359393,4,4,8,1.34757,103.860701
359394,132,202,334,1.34787,103.860716
359395,1,0,1,1.329252,103.866725
359396,40,328,368,1.348349,103.860778
359397,16,0,16,1.348475,103.860795
359398,29,83,112,1.345781,103.860984
359399,6,163,169,1.346297,103.860889
359400,26,776,802,1.346427,103.860858
359401,4,7,11,1.345208,103.861061
359402,1,3,4,1.346789,103.860816
359403,2,0,2,1.347117,103.865066
359404,48,18,66,1.346548,103.860838
359405,4,7,11,1.344513,103.861138
359406,29,10,39,1.344733,103.861102
359407,3,2,5,1.346789,103.860796
359408,5,1,6,1.348348,103.860777
359409,2,36,38,1.348348,103.860777
359410,29,122,151,1.348348,103.860777
359411,9,9,18,1.348348,103.860777
359412,19,508,527,1.348348,103.860777
359413,14,178,192,1.348348,103.860777
359414,7,102,109,1.348348,103.860777
359415,37,104,141,1.348348,103.860777
359416,1,0,1,1.348096,103.860743
359417,87,0,87,1.348474,103.860794
359418,31,2,33,1.348474,103.860794
359419,3,0,3,1.329388,103.866697
359420,15,0,15,1.348474,103.860794
359421,34,8,42,1.348474,103.860794
359422,12,15,27,1.348474,103.860794
359423,4,73,77,1.348474,103.860794
359424,19,41,60,1.344395,103.867073
359425,229,77,306,1.344418,103.866735
359426,327,23,350,1.344107,103.8676
359427,8,7,15,1.344088,103.86765
359428,23,0,23,1.34406,103.867706
359430,5,1,6,1.34405,103.867764
359431,23,57,80,1.344107,103.866987
359432,32,12,44,1.344037,103.867788
359433,18,0,18,1.344103,103.867021
359434,14,0,14,1.344025,103.867822
359435,168,0,168,1.344104,103.867092
359436,85,0,85,1.344003,103.867875
359437,2,9,11,1.344098,103.867144
359438,2,0,2,1.346789,103.860816
359439,1,53,54,1.344014,103.867269
359440,2,7,9,1.343781,103.86817
359441,44,45,89,1.343996,103.867322
359442,0,19,19,1.344264,103.868097
359443,11,49,60,1.344,103.867384
359444,1,2,3,1.348474,103.860794
359445,22,4,26,1.344398,103.868061
359446,12,0,12,1.344486,103.868052
359447,15,0,15,1.344547,103.867935
359448,3,2,5,1.34429,103.868206
359449,4,0,4,1.344132,103.868213
359450,13,74,87,1.343853,103.86823
359455,435,1,436,1.299509,103.837
359480,0,1,1,1.348474,103.860794
359481,7,0,7,1.345068,103.867365
359482,1,0,1,1.345005,103.867364
359483,1,0,1,1.344935,103.867439
359484,2,1,3,1.344358,103.868118
359485,53,0,53,1.34498,103.867363
359486,3,0,3,1.344821,103.867339
359487,0,4,4,1.344894,103.867125
359488,4,0,4,1.344811,103.867279
359489,4,0,4,1.344891,103.867056
359490,19,0,19,1.344889,103.866977
359492,27,0,27,1.344882,103.86692
359493,12,2,14,1.344808,103.867146
359494,0,2,2,1.343965,103.867913
359495,7,0,7,1.344811,103.867064
359496,1,0,1,1.345029,103.867367
359497,2,2,4,1.344791,103.866989
359498,62,4,66,1.34488,103.866779
359499,8,1,9,1.344781,103.866937
359501,6,14,20,1.34476,103.866852
359502,1,1,2,1.344883,103.866846
359503,9,7,16,1.344748,103.866677
359504,9,0,9,1.344871,103.866577
359505,1,1,2,1.344874,103.866644
359506,29,2,31,1.344868,103.866509
359508,4,0,4,1.344864,103.866442
359509,10,1,11,1.344739,103.866505
359510,29,1,30,1.344861,103.866375
359512,0,2,2,1.344741,103.866637
359514,3,4,7,1.344855,103.86624
359516,13,0,13,1.344852,103.866172
359517,4,6,10,1.344733,103.86628
359518,4,3,7,1.344849,103.866105
359521,21,3,24,1.344719,103.866186
359522,1,1,2,1.344858,103.866307
359523,2,1,3,1.344813,103.867302
359525,13,3,16,1.344712,103.866037
359526,13,4,17,1.344836,103.865836
359529,4,2,6,1.344701,103.865899
359530,11,0,11,1.34483,103.865701
359531,4,0,4,1.344698,103.865864
359532,1,0,1,1.344881,103.866812
359533,6,2,8,1.344698,103.865773
359534,1,17,18,1.344824,103.865566
359535,5,67,72,1.344698,103.865719
359536,85,18,103,1.344821,103.865499
359538,8,1,9,1.344706,103.865642
359539,2,0,2,1.344843,103.86597
359542,3,0,3,1.344712,103.866077
359543,1,0,1,1.344827,103.865634
359544,7,3,10,1.344934,103.867438
359545,7,113,120,1.299509,103.837
359565,135,228,363,1.344632,103.865368
359566,0,5,5,1.34487,103.865294
359567,2,6,8,1.345768,103.86547
359568,0,3,3,1.344934,103.867438
359569,16,0,16,1.345768,103.86547
359570,3,1,4,1.345768,103.86547
359571,18,0,18,1.345768,103.86547
359574,7,2,9,1.345794,103.865419
359600,18,0,18,1.346658,103.862896
359601,12,7,19,1.346138,103.862234
359602,0,11,11,1.346278,103.862289
359603,27,24,51,1.345967,103.862254
359604,311,0,311,1.346132,103.862302
359605,0,4,4,1.345494,103.862204
359606,30,5,35,1.345747,103.862373
359607,6,5,11,1.345566,103.861832
359608,8,0,8,1.345463,103.8623
359609,7,2,9,1.345867,103.861712
359610,20,0,20,1.345449,103.862225
359611,64,4,68,1.346445,103.861586
359612,2,3,5,1.346455,103.861576
359613,10,0,10,1.345394,103.861922
359614,2,1,3,1.345768,103.86547
359615,12,0,12,1.345366,103.861771
359616,16,12,28,1.347437,103.862018
359617,1,13,14,1.345376,103.861761
359619,5,6,11,1.345756,103.861584
359620,6,1,7,1.346435,103.861576
359621,13,0,13,1.346298,103.86089
359622,29,15,44,1.346318,103.86089
359623,49,9,58,1.346455,103.861576
359624,0,1,1,1.344934,103.867438
359625,9,38,47,1.347423,103.861377
359626,55,0,55,1.347465,103.861482
359627,21,0,21,1.347487,103.861586
359628,130,5,135,1.347532,103.861796
359629,13,0,13,1.347576,103.862005
359630,1,0,1,1.346445,103.861566
359631,36,9,45,1.347049,103.862108
359632,7,1,8,1.347281,103.862307
359633,0,1,1,1.347566,103.862015
359634,3,0,3,1.347433,103.861387
359635,59,9,68,1.346454,103.861575
359636,2,0,2,1.344934,103.867438
359637,20,9,29,1.346454,103.861575
359638,3,2,5,1.347049,103.862088
359640,1,0,1,1.346565,103.862308
359641,6,5,11,1.346539,103.862147
359642,1,0,1,1.346676,103.862115
359643,10,6,16,1.345558,103.862408
359644,1,0,1,1.346365,103.862211
359645,10,13,23,1.346678,103.862896
359646,1,3,4,1.346444,103.861585
359647,0,6,6,1.346444,103.861585
359648,8,2,10,1.346434,103.861575
359649,20,3,23,1.346564,103.862308
359650,4,7,11,1.346564,103.862308
359651,20,2,22,1.346054,103.861695
359652,7,1,8,1.346201,103.861673
359653,20,1,21,1.346297,103.860889
359654,16,25,41,1.346297,103.860889
359655,4,8,12,1.345671,103.861797
359656,18,3,21,1.345777,103.861764
359657,3,0,3,1.346587,103.862426
359658,21,1,22,1.346541,103.86219
359659,23,5,28,1.34625,103.862213
359661,342,7,349,1.346094,103.86347
359662,20,1,21,1.345775,103.863682
359663,7,103,110,1.345954,103.863653
359664,10,5,15,1.345818,103.863683
359665,20,6,26,1.346246,103.864015
359667,0,6,6,1.34564,103.863723
359670,20,1,21,1.345353,103.863814
359672,3,6,9,1.346281,103.864251
359673,38,0,38,1.345774,103.864142
359674,59,7,66,1.345367,103.863919
359675,6,11,17,1.345249,103.863964
359676,197,87,284,1.346331,103.864691
359677,41,2,43,1.345643,103.863878
359678,5,1,6,1.345693,103.863875
359679,115,5,120,1.345731,103.86386
359680,41,7,48,1.345897,103.863832
359681,0,38,38,1.346339,103.864928
359682,4,0,4,1.346124,103.864059
359684,1,1,2,1.346454,103.861575
359686,14,0,14,1.346158,103.864237
359687,33,0,33,1.346216,103.864416
359688,4,6,10,1.346254,103.864783
359689,161,2,163,1.346245,103.864969
359690,6,3,9,1.346247,103.865114
359692,2,7,9,1.345611,103.863899
359694,7,6,13,1.346354,103.865344
359695,2,0,2,1.346172,103.864281
359696,0,13,13,1.345829,103.863013
359697,2,0,2,1.346247,103.865253
359698,24,0,24,1.345858,103.863681
359718,5,0,5,1.348478,103.860973
359719,335,5,340,1.348454,103.861057
359720,17,0,17,1.34847,103.861141
359721,1,0,1,1.346633,103.862661
359722,46,11,57,1.348463,103.861309
359723,3,0,3,1.346541,103.86219
359724,41,4,45,1.348416,103.861639
359725,31,15,46,1.348416,103.861639
359726,19,2,21,1.34837,103.861904
359727,2,1,3,1.348408,103.861556
359728,5,6,11,1.348393,103.862104
359729,40,0,40,1.348456,103.862676
359730,1,1,2,1.345834,103.86318
359732,5,0,5,1.348644,103.862643
359733,2,5,7,1.348476,103.862676
359734,0,1,1,1.348443,103.861309
359735,12,2,14,1.349087,103.86347
359736,6,0,6,1.348676,103.862751
359737,2,1,3,1.348401,103.862295
359738,10,0,10,1.348686,103.862858
359739,7,6,13,1.348983,103.864438
359740,27,1,28,1.348708,103.863072
359741,14,1,15,1.348959,103.864689
359742,5,0,5,1.348729,103.863285
359744,37,1,38,1.349358,103.863196
359745,11,0,11,1.348864,103.865691
359746,42,1,43,1.349082,103.863601
359747,5,12,17,1.348761,103.866066
359748,25,3,28,1.349067,103.863723
359749,14,8,22,1.349037,103.863965
359750,7,6,13,1.349017,103.864198
359751,51,17,68,1.348994,103.864345
359752,2,3,5,1.348981,103.864481
359753,3,15,18,1.348955,103.864755
359754,9,5,14,1.348929,103.865028
359755,42,2,44,1.348903,103.865301
359756,15,5,20,1.348877,103.865574
359757,8,345,353,1.34884,103.865807
359758,5,93,98,1.348771,103.866076
359759,2,0,2,1.348645,103.862644
359760,9,2,11,1.349066,103.863722
359761,8,3,11,1.348958,103.864688
359762,0,2,2,1.348455,103.862675
359763,8,2,10,1.34837,103.861904
359764,16,52,68,1.349016,103.864197
359765,16,4,20,1.34898,103.86448
359766,1,0,1,1.348475,103.862675
359767,7,0,7,1.348477,103.860972
359768,4,0,4,1.348477,103.860972
359769,8,0,8,1.348477,103.860972
359770,1,13,14,1.348477,103.860972
359771,37,44,81,1.348993,103.864344
359772,156,6,162,1.348435,103.86239
359773,19,12,31,1.349081,103.8636
359774,22,118,140,1.348878,103.865659
359775,55,0,55,1.348457,103.86138
359776,25,1,26,1.348457,103.86138
359777,31,1,32,1.348457,103.86138
359778,6,0,6,1.348457,103.86138
359779,49,84,133,1.348457,103.86138
359781,5,0,5,1.299509,103.837
359782,17,1,18,1.299509,103.837
359783,0,13,13,1.299509,103.837
359784,0,4,4,1.299509,103.837
359785,18,16,34,1.343917,103.86416
359786,1,52,53,1.343807,103.864113
359788,0,2,2,1.348954,103.864754
359789,25,0,25,1.343604,103.864214
359790,5,0,5,1.343328,103.863634
359791,63,0,63,1.343553,103.864005
359792,4,9,13,1.343124,103.863561
359793,11,0,11,1.343046,103.863532
359795,78,0,78,1.343406,103.863929
359797,18,0,18,1.343012,103.863375
359798,1,0,1,1.348477,103.860972
359799,11,2,13,1.34298,103.863251
359800,6,0,6,1.343077,103.863785
359801,2,0,2,1.343071,103.863698
359802,4,0,4,1.342916,103.863674
359803,8,0,8,1.342812,103.863594
359804,238,36,274,1.342691,103.863513
359805,2,4,6,1.342574,103.863464
359806,3,6,9,1.342867,103.862925
359807,7,20,27,1.342993,103.862787
359808,8,0,8,1.34236,103.863469
359810,2,4,6,1.342806,103.862742
359811,7,11,18,1.342415,103.863238
359812,0,2,2,1.342934,103.863097
359813,170,0,170,1.342329,103.86317
359814,28,0,28,1.342289,103.863093
359815,6,4,10,1.342274,103.863035
359816,14,2,16,1.342792,103.862468
359817,2,3,5,1.342792,103.862558
359818,10,1,11,1.342896,103.862982
359819,9,3,12,1.342335,103.862907
359820,0,8,8,1.342905,103.86229
359821,23,2,25,1.342421,103.862766
359822,5,41,46,1.342494,103.862668
359824,1,51,52,1.342581,103.862578
359825,5,3,8,1.342546,103.862336
359826,56,17,73,1.342633,103.862519
359827,9,85,94,1.342737,103.86238
359828,7,5,12,1.342842,103.862238
359829,0,58,58,1.342939,103.862131
359830,10,1,11,1.343041,103.862027
359831,3,10,13,1.343117,103.861933
359832,14,44,58,1.343188,103.861866
359833,14,791,805,1.343286,103.861712
359834,1,62,63,1.343247,103.861946
359835,5,20,25,1.342291,103.862991
359862,0,2,2,1.342789,103.862654
359863,1,0,1,1.343175,103.863826
359864,3,2,5,1.347041,103.870522
359865,18,0,18,1.347041,103.870522
359866,2,8,10,1.347041,103.870522
359868,3,1,4,1.347041,103.870522
359869,0,11,11,1.347237,103.870283
359870,2,21,23,1.346862,103.870455
359871,5,6,11,1.346934,103.870342
359872,7,7,14,1.346981,103.870275
359873,5,5,10,1.347002,103.870258
359874,3,0,3,1.348997,103.864198
359895,22,755,777,1.343178,103.870398
359896,1,0,1,1.347041,103.870522
359897,7,105,112,1.343172,103.870348
359898,13,1,14,1.343157,103.87031
359899,1,100,101,1.343137,103.870264
359900,4,50,54,1.343123,103.870219
359901,4,494,498,1.343065,103.869721
359902,3,432,435,1.342464,103.869276
359903,5,369,374,1.343349,103.867216
359904,14,368,382,1.3433,103.868496
359905,235,169,404,1.343538,103.868226
359906,7,163,170,1.343759,103.86803
359907,0,1,1,1.343176,103.870382
359908,1,14,15,1.34388,103.867795
359909,1,36,37,1.343916,103.867716
359910,2,28,30,1.343983,103.867585
359911,6,225,231,1.344018,103.867503
359912,2,0,2,1.347041,103.870522
359913,0,26,26,1.344432,103.864896
359914,19,135,154,1.344383,103.864467
359915,11,18,29,1.344296,103.864131
359916,26,6,32,1.344252,103.864012
359917,1,37,38,1.344205,103.863848
359918,3,0,3,1.34709,103.87001
359919,32,163,195,1.344109,103.863543
359920,0,9,9,1.34351,103.863235
359922,4,16,20,1.343633,103.863155
359923,13,204,217,1.343608,103.863026
359924,9,0,9,1.343568,103.862879
359925,1,22,23,1.343934,103.862417
359926,2,104,106,1.343533,103.86274
359927,1,0,1,1.343829,103.867916
359928,4,29,33,1.343489,103.86262
359929,34,44,78,1.343756,103.862157
359930,1,12,13,1.343465,103.862493
359931,0,2,2,1.344425,103.865161
359932,1,12,13,1.343437,103.86233
359933,33,46,79,1.343718,103.861773
359934,26,15,41,1.3434,103.862192
359935,2,63,65,1.343675,103.861525
359938,4,33,37,1.34406,103.864533
359939,0,39,39,1.343879,103.86365
359940,12,31,43,1.343726,103.863332
359942,0,8,8,1.344326,103.864309
359943,7,40,47,1.344534,103.864236
359944,63,0,63,1.34318,103.868984
359945,3,67,70,1.343209,103.868731
359946,155,74,229,1.343036,103.869425
359947,21,17,38,1.344222,103.863797
359948,2,130,132,1.344165,103.863737
359949,2,0,2,1.34374,103.861966
359951,5,0,5,1.343934,103.862417
359953,0,1,1,1.343926,103.862935
359954,1,0,1,1.343934,103.862417
359956,51,0,51,1.343934,103.862417
359958,3,0,3,1.344396,103.86382
359959,11,17,28,1.343934,103.862417
359960,42,1,43,1.343934,103.862417
359961,0,2,2,1.343934,103.862417
359962,12,7,19,1.343934,103.862417
359963,21,11,32,1.343759,103.862199
359964,15,1,16,1.343716,103.861659
359965,186,1,187,1.343223,103.868759
359966,374,47,421,1.343056,103.869723
359967,92,146,238,1.299509,103.837
360001,21,1813,1834,1.334274,103.878807
360002,209,102,311,1.334167,103.87922
360003,215,111,326,1.334408,103.87975
360004,164,37,201,1.333527,103.879065
360005,473,53,526,1.334119,103.879544
360007,32,53,85,1.33448,103.879687
360008,957,2417,3374,1.335219,103.878805
360009,666,3353,4019,1.334632,103.879703
360010,398,216,614,1.334836,103.880879
360011,293,2468,2761,1.334836,103.880879
360012,404,515,919,1.335843,103.878954
360013,372,598,970,1.335499,103.879478
360014,419,393,812,1.33583,103.879775
360015,484,1869,2353,1.335674,103.879989
360016,459,197,656,1.336497,103.880341
360017,411,1390,1801,1.336244,103.881127
360018,620,176,796,1.336834,103.881167
360019,313,499,812,1.334836,103.880879
360020,988,130,1118,1.334836,103.880879
360021,290,104,394,1.334836,103.880879
360081,286,1,287,1.332396,103.885867
360082,799,127,926,1.332396,103.885867
360083,266,57,323,1.331427,103.885237
360084,4,28,32,1.329123,103.871348
361002,4,104,108,1.334549,103.879475
361004,5,105,110,1.334586,103.879799
361009,11,1345,1356,1.299509,103.837
361081,47,3371,3418,1.332396,103.885867
361082,41,34,75,1.331893,103.885685
361083,53,121,174,1.331078,103.885163
367815,1,0,1,1.343934,103.862417
367819,24,51,75,1.338891,103.882084
367820,25,6,31,1.339194,103.881887
367822,140,1,141,1.338294,103.87941
367823,2,0,2,1.343934,103.862417
367824,1,6,7,1.337192,103.880496
367825,5,0,5,1.337626,103.880915
367826,15,170,185,1.337141,103.881548
367827,7,1,8,1.338029,103.881475
367828,369,15,384,1.338263,103.880365
367829,16,1,17,1.339183,103.881322
367830,5,0,5,1.338487,103.881911
367831,125,288,413,1.338615,103.878843
367832,11,132,143,1.336568,103.878642
367833,2,11,13,1.336612,103.87941
367834,0,2,2,1.337561,103.880024
367835,0,6,6,1.340062,103.880577
367844,1,0,1,1.338436,103.879588
367845,4,217,221,1.333905,103.878347
367846,3,0,3,1.343934,103.862417
367847,5,0,5,1.334086,103.878306
367849,2,69,71,1.334267,103.878264
367850,1,31,32,1.334357,103.878243
367851,1,1,2,1.336299,103.879262
367852,1,569,570,1.334538,103.878201
367853,7,869,876,1.334629,103.878181
367854,3,10,13,1.334719,103.87816
367855,5,2,7,1.33669,103.876656
367858,1,39,40,1.338347,103.876052
367859,89,1201,1290,1.332456,103.878813
367860,7,1213,1220,1.332704,103.878682
367861,0,8,8,1.332735,103.878727
367862,3,0,3,1.333995,103.878326
367863,1,324,325,1.33279,103.878715
367864,12,249,261,1.332884,103.878882
367865,0,358,358,1.332841,103.878707
367866,2,0,2,1.334448,103.878222
367867,52,184,236,1.3329,103.878695
367868,2,332,334,1.332943,103.87862
367869,1,0,1,1.333859,103.878358
367870,1,0,1,1.332966,103.878682
367871,1,217,218,1.333037,103.87867
367872,3,782,785,1.333028,103.878608
367874,3,0,3,1.332763,103.878671
367875,0,350,350,1.333123,103.878652
367876,11,0,11,1.333178,103.878561
367877,15,2554,2569,1.333194,103.878642
367878,510,372,882,1.340365,103.877293
367879,1,751,752,1.334356,103.878242
367880,1,0,1,1.332984,103.878615
367881,1,43,44,1.336368,103.877644
367882,1,781,782,1.336368,103.877644
367883,3,663,666,1.337073,103.876846
367885,242,517,759,1.299509,103.837
367886,9,1444,1453,1.299509,103.837
367901,183,1448,1631,1.334989,103.881565
367902,256,239,495,1.335248,103.881764
367903,558,466,1024,1.334707,103.882054
367904,960,161,1121,1.333818,103.88248
367950,62,112,174,1.336913,103.884642
367951,63,11,74,1.33682,103.884588
367952,1,4,5,1.336752,103.884415
367953,231,4,235,1.336799,103.884818
367954,34,20,54,1.336531,103.883801
367955,33,37,70,1.336154,103.884487
367956,41,56,97,1.336368,103.884349
367957,89,286,375,1.335777,103.88364
367981,25,2750,2775,1.333322,103.886853
367982,1,57,58,1.333479,103.886805
367983,4,1,5,1.333609,103.886742
367984,0,45,45,1.333752,103.886694
367985,12,43,55,1.33388,103.886672
367986,26,45,71,1.333996,103.886617
367987,58,35,93,1.334084,103.88658
367988,4,9,13,1.334278,103.886512
367989,10,17,27,1.334386,103.886481
367990,37,85,122,1.334522,103.886441
367991,117,255,372,1.334616,103.88641
367992,58,21,79,1.33471,103.886385
367993,81,13,94,1.334772,103.88635
367995,339,204,543,1.334263,103.886718
367996,1005,40,1045,1.336474,103.8866
367997,14,295,309,1.336554,103.885899
367998,529,71,600,1.337029,103.886432
367999,22,173,195,1.336888,103.885332
368000,1222,357,1579,1.337118,103.885209
368001,467,155,622,1.337221,103.885315
368024,10,357,367,1.337844,103.886326
368025,1118,125,1243,1.337562,103.886159
368026,84,58,142,1.337561,103.885559
368051,538,87,625,1.341737,103.878284
368052,15,113,128,1.340956,103.878539
368054,69,229,298,1.341567,103.880953
368055,463,617,1080,1.340909,103.881129
368056,145,9,154,1.299509,103.837
368057,291,8,299,1.299509,103.837
368058,415,13,428,1.299509,103.837
368059,170,59,229,1.340909,103.881129
368060,190,34,224,1.299509,103.837
368061,158,93,251,1.299509,103.837
368062,570,119,689,1.299509,103.837
368063,438,78,516,1.299509,103.837
368078,30,320,350,1.334929,103.885898
368079,51,670,721,1.334798,103.885318
368080,0,34,34,1.334385,103.884407
368082,117,69,186,1.334167,103.883722
368083,613,23,636,1.334054,103.883506
368084,35,197,232,1.333954,103.883185
368085,13,52,65,1.334692,103.885
368086,199,27,226,1.334833,103.884686
368088,260,260,520,1.334177,103.883297
368089,112,165,277,1.334793,103.886079
368112,4,550,554,1.331273,103.87964
368113,10,82,92,1.331293,103.879841
368114,1,14,15,1.33131,103.879904
368116,5,372,377,1.331333,103.880029
368117,0,2,2,1.332883,103.878636
368118,1,11,12,1.331374,103.880211
368119,0,79,79,1.331385,103.880274
368121,7,69,76,1.331414,103.88041
368122,0,73,73,1.331425,103.880473
368123,0,109,109,1.331443,103.880536
368124,0,198,198,1.331454,103.880598
368125,8307,301,8608,1.331732,103.879124
368126,0,131,131,1.331465,103.880667
368127,0,52,52,1.331483,103.880729
368128,6,353,359,1.331494,103.880792
368130,0,162,162,1.331528,103.880928
368131,8,0,8,1.331543,103.880986
368132,8,584,592,1.331555,103.881036
368133,1,0,1,1.336466,103.876695
368135,0,161,161,1.331588,103.881185
368136,1,66,67,1.331607,103.881243
368137,175,19,194,1.331622,103.881299
368138,0,152,152,1.331633,103.881353
368139,3,1,4,1.331645,103.88141
368140,20,615,635,1.331888,103.880302
368141,3,262,265,1.331655,103.881471
368142,5,561,566,1.331903,103.880797
368143,3,85,88,1.331668,103.88152
368144,1,145,146,1.331923,103.880902
368145,1,2,3,1.33312,103.878583
368146,3,18,21,1.331954,103.881013
368147,11,100,111,1.331724,103.881719
368148,11,0,11,1.331967,103.881084
368149,0,149,149,1.331729,103.881785
368150,5,441,446,1.331973,103.881129
368152,2,0,2,1.331345,103.880086
368153,5,108,113,1.331755,103.88191
368154,8,341,349,1.332006,103.881184
368155,0,1,1,1.331564,103.881064
368156,17,0,17,1.33202,103.881367
368157,3,611,614,1.332014,103.881255
368158,5,1,6,1.332037,103.881472
368159,12,57,69,1.332045,103.881516
368160,0,36,36,1.332058,103.881573
368161,1,57,58,1.332065,103.881626
368162,0,28,28,1.332076,103.881683
368163,0,46,46,1.332086,103.881738
368164,0,6,6,1.332096,103.881779
368165,1,12,13,1.332102,103.881817
368166,0,24,24,1.332111,103.881852
368167,0,56,56,1.332119,103.881888
368168,2,83,85,1.332127,103.881918
368169,1,225,226,1.332134,103.88195
368170,15,701,716,1.331887,103.882123
368171,3,2,5,1.331899,103.882184
368172,10,980,990,1.331906,103.88225
368173,274,95,369,1.332297,103.882743
368174,23,10,33,1.331902,103.882318
368175,28,344,372,1.332324,103.882907
368176,13,89,102,1.331961,103.882487
368177,131,233,364,1.332346,103.883056
368178,13,711,724,1.33197,103.882539
368179,5,98,103,1.332367,103.883241
368181,30,236,266,1.332401,103.883411
368182,3,509,512,1.331993,103.882657
368183,18,253,271,1.332639,103.883693
368185,7,482,489,1.332016,103.882776
368186,145,336,481,1.33252,103.884007
368188,14,0,14,1.33203,103.882826
368189,15,414,429,1.332042,103.882874
368191,9,332,341,1.332057,103.882957
368192,0,2,2,1.331985,103.881178
368193,2,533,535,1.332079,103.883061
368195,2,458,460,1.3321,103.88315
368196,13,1,14,1.332109,103.883193
368197,3,426,429,1.332118,103.883235
368198,2,0,2,1.332067,103.883006
368199,1,331,332,1.332138,103.883321
368201,0,276,276,1.332153,103.883425
368202,3,2,5,1.332165,103.883482
368203,17,408,425,1.332171,103.883549
368204,2,2,4,1.332193,103.883593
368205,10,557,567,1.332199,103.883638
368206,10,540,550,1.332212,103.883713
368207,6,345,351,1.332242,103.883866
368208,1,5,6,1.332252,103.883919
368209,2,647,649,1.332264,103.883982
368210,8,0,8,1.332272,103.884039
368211,13,445,458,1.332286,103.884095
368212,8,0,8,1.332298,103.884156
368213,4,277,281,1.33232,103.884214
368215,21,287,308,1.332344,103.884325
368216,8,0,8,1.332353,103.884379
368217,8,453,461,1.33236,103.884421
368218,0,1,1,1.33177,103.881954
368219,10,500,510,1.332381,103.884519
368220,14,3,17,1.332395,103.884576
368221,9,526,535,1.332401,103.88463
368222,7,0,7,1.33241,103.884681
368223,25,601,626,1.332427,103.884732
368224,0,2,2,1.332126,103.883278
368225,2,696,698,1.332453,103.884834
368226,2,0,2,1.332445,103.884783
368227,18,256,274,1.33247,103.884937
368228,1,0,1,1.332373,103.884469
368229,42,1310,1352,1.332496,103.885056
368230,1,2,3,1.331702,103.881631
368231,12,147,159,1.332515,103.88516
368232,1,0,1,1.332479,103.884997
368233,23,1901,1924,1.332535,103.885257
368234,35,902,937,1.332822,103.884998
368235,0,4,4,1.332838,103.88506
368236,864,1710,2574,1.332604,103.886324
368237,857,847,1704,1.332724,103.886657
368238,15,584,599,1.333006,103.886036
368239,203,763,966,1.333529,103.887734
368240,111,0,111,1.333533,103.887855
368241,61,2607,2668,1.333568,103.888087
368314,360,139,499,1.332328,103.882357
368315,1,31,32,1.332711,103.882932
368316,10,161,171,1.333152,103.882633
368317,1,32,33,1.333218,103.882653
368318,21,25,46,1.333352,103.882694
368319,6,48,54,1.333485,103.882735
368320,3,104,107,1.333608,103.882766
368324,5420,321,5741,1.335079,103.883514
368326,237,100,337,1.334283,103.882758
368328,1472,1173,2645,1.334806,103.883051
368329,170,273,443,1.335468,103.883013
368330,1185,104,1289,1.335829,103.88268
368354,5,98,103,1.334586,103.879799
368355,256,2349,2605,1.336572,103.882292
368356,76,130,206,1.33724,103.882321
368357,541,433,974,1.337389,103.882417
368358,246,1087,1333,1.337001,103.883365
368359,122,51,173,1.337494,103.883722
368360,447,658,1105,1.337719,103.884101
368361,1082,147,1229,1.337768,103.884673
368362,115,46,161,1.338455,103.884239
368363,546,48,594,1.337829,103.882821
368386,3,0,3,1.332502,103.885103
368388,2,0,2,1.332462,103.884886
368389,1,0,1,1.332524,103.885204
368391,33,7,40,1.329969,103.882832
368393,14,2,16,1.329981,103.882697
368394,22,2,24,1.32982,103.882724
368395,12,0,12,1.329844,103.88263
368419,0,5,5,1.333159,103.878983
368420,0,2,2,1.329789,103.88301
368422,4,0,4,1.333112,103.879064
368423,0,9,9,1.333172,103.879058
368424,0,3,3,1.329792,103.883071
368425,0,3,3,1.333123,103.879104
368429,0,1,1,1.32996,103.882921
368430,0,4,4,1.333146,103.879223
368434,2,2,4,1.333158,103.879309
368435,2,0,2,1.333106,103.879024
368437,3,8,11,1.333229,103.879329
368439,0,6,6,1.333247,103.879424
368440,2,4,6,1.333186,103.879428
368441,10,0,10,1.333264,103.879487
368442,2,0,2,1.333225,103.879293
368443,3,6,9,1.333281,103.879529
368444,11,2,13,1.333198,103.879519
368445,0,2,2,1.333192,103.879474
368448,0,2,2,1.333286,103.879561
368449,0,3,3,1.333184,103.879092
368450,8,0,8,1.333232,103.879645
368451,0,2,2,1.333221,103.879605
368453,0,3,3,1.333308,103.879656
368454,25,0,25,1.333244,103.879736
368457,12,1,13,1.33335,103.879819
368460,2,9,11,1.333267,103.879867
368461,18,5,23,1.333378,103.879917
368462,1,1,2,1.333319,103.8797
368463,2,0,2,1.333278,103.879912
368465,0,5,5,1.333393,103.880021
368468,0,1,1,1.333201,103.879166
368469,0,1,1,1.333301,103.880037
368471,15,0,15,1.333412,103.880123
368472,0,2,2,1.333384,103.879961
368473,2,14,16,1.333423,103.880164
368474,1,0,1,1.3334,103.880089
368475,1,0,1,1.333324,103.880162
368476,1,3,4,1.333341,103.880202
368477,1,7,8,1.333426,103.880259
368478,1,2,3,1.333327,103.879726
368479,0,8,8,1.333426,103.880365
368480,25,15,40,1.333372,103.880403
368482,2,0,2,1.333319,103.880117
368484,7,0,7,1.333389,103.880483
368485,1,0,1,1.333426,103.880195
368486,4,2,6,1.333395,103.880522
368487,0,4,4,1.333468,103.880604
368491,8,0,8,1.333486,103.880694
368493,1,0,1,1.333457,103.880535
368494,22,0,22,1.333429,103.880687
368497,8,1,9,1.333511,103.880827
368498,6,0,6,1.333446,103.880773
368499,3,0,3,1.333347,103.880236
368500,3,1,4,1.333456,103.88083
368504,15,0,15,1.333475,103.880931
368505,1,0,1,1.333496,103.880726
368507,0,2,2,1.333377,103.880437
368511,3,7,10,1.333579,103.881153
368512,1,1,2,1.333563,103.881072
368513,1,16,17,1.333585,103.881192
368514,2,0,2,1.333517,103.881141
368516,0,4,4,1.333532,103.881216
368517,5,11,16,1.333596,103.881254
368518,1,0,1,1.333554,103.881046
368519,1,0,1,1.333537,103.88126
368520,12,7,19,1.33355,103.881302
368521,2,4,6,1.33361,103.881321
368522,0,5,5,1.333555,103.881347
368548,30,1,31,1.328539,103.882416
368549,0,2,2,1.333521,103.881165
368550,11,17,28,1.328536,103.882583
368551,1,0,1,1.333598,103.88129
368552,0,1,1,1.328522,103.882651
368553,8,0,8,1.328449,103.882681
368554,11,0,11,1.328444,103.882774
368556,9,0,9,1.328519,103.88276
368557,3,0,3,1.333526,103.880891
368558,1,1,2,1.328534,103.882497
368559,6,2,8,1.328513,103.882941
368560,3,0,3,1.328519,103.882841
368561,2,0,2,1.328429,103.882946
368562,19,1,20,1.328502,103.883087
368564,2,0,2,1.328427,103.883023
368565,18,0,18,1.328425,103.883178
368566,5,4,9,1.32849,103.883237
368567,12,2,14,1.328488,103.883302
368569,7,12,19,1.328483,103.88352
368570,1,2,3,1.328507,103.88301
368573,7,0,7,1.328483,103.883712
368574,2,0,2,1.328427,103.883109
368575,7,0,7,1.328414,103.883511
368576,4,1,5,1.328486,103.883803
368577,12,0,12,1.328403,103.883632
368579,1,0,1,1.328454,103.882603
368580,1,0,1,1.3284,103.883793
368581,5,7,12,1.328485,103.883899
368582,1,0,1,1.328396,103.883894
368585,9,9,18,1.328485,103.884104
368586,3,2,5,1.32841,103.884139
368587,1,8,9,1.328473,103.884275
368588,1,1,2,1.328421,103.883427
368589,3,0,3,1.328422,103.883274
368590,3,0,3,1.328415,103.88428
368591,1,5,6,1.328473,103.884378
368592,389,1,390,1.328408,103.884416
368594,3,3,6,1.328473,103.88448
368595,6,0,6,1.328403,103.884545
368596,0,5,5,1.328473,103.884591
368597,0,1,1,1.328399,103.884004
368598,2,8,10,1.328396,103.884669
368622,1,3,4,1.332743,103.879082
368623,0,1,1,1.328403,103.884609
368625,0,13,13,1.332776,103.87923
368626,3,0,3,1.328413,103.884342
368627,1,11,12,1.332859,103.879307
368628,12,0,12,1.332771,103.879334
368629,1,7,8,1.332776,103.879354
368630,1,0,1,1.332756,103.879153
368631,0,1,1,1.332785,103.879396
368632,0,1,1,1.332794,103.879437
368633,1,3,4,1.332812,103.87952
368636,3,0,3,1.332787,103.879266
368637,0,3,3,1.332838,103.879645
368639,2,5,7,1.332865,103.879769
368641,0,3,3,1.332847,103.879686
368642,2,0,2,1.328417,103.884216
368643,7,3,10,1.332895,103.879918
368646,1,5,6,1.332933,103.880115
368649,0,1,1,1.332803,103.879479
368650,2,0,2,1.332889,103.879885
368651,36,21,57,1.33299,103.880336
368652,39,10,49,1.332999,103.880467
368653,1,4,5,1.33298,103.880472
368654,2,0,2,1.332983,103.880377
368656,2,3,5,1.333012,103.880538
368657,5,0,5,1.332995,103.880559
368659,1,0,1,1.33297,103.880312
368662,29,1,30,1.333036,103.88068
368663,55,4,59,1.333026,103.880732
368664,1,5,6,1.333045,103.880727
368666,5,0,5,1.333053,103.880775
368668,3,4,7,1.333061,103.880822
368670,0,8,8,1.333069,103.880869
368672,170,0,170,1.333078,103.880917
368674,0,4,4,1.333086,103.880964
368675,0,1,1,1.333005,103.880617
368677,1,0,1,1.333096,103.881085
368678,1,1,2,1.333003,103.88049
368680,1,0,1,1.333125,103.881206
368681,2,3,5,1.333184,103.881447
368682,1,1,2,1.333102,103.881031
368683,2,0,2,1.333135,103.881165
368684,8,2,10,1.333152,103.881232
368685,0,1,1,1.333119,103.881098
368687,0,13,13,1.333201,103.881434
368688,34,0,34,1.333218,103.881501
368689,7,12,19,1.333234,103.881568
368713,73,3,76,1.33232,103.88049
368714,13,20,33,1.33248,103.880579
368715,1,0,1,1.333168,103.8813
368716,1,0,1,1.332368,103.880481
368719,107,0,107,1.332465,103.880464
368720,79,0,79,1.332623,103.880549
368721,4,1,5,1.3325,103.880457
368722,1,6,7,1.332664,103.880539
368724,2,1,3,1.332883,103.879852
368725,2,0,2,1.333214,103.881568
368726,16,0,16,1.332749,103.880511
368727,0,2,2,1.332581,103.880438
368728,0,11,11,1.332792,103.880501
368730,0,1,1,1.332537,103.880569
368733,3,3,6,1.332821,103.88039
368734,0,35,35,1.332861,103.880385
368758,14,76,90,1.332274,103.879947
368759,1,11,12,1.33227,103.880054
368760,1,7,8,1.332323,103.879931
368761,0,1,1,1.332718,103.880409
368762,0,14,14,1.332361,103.879922
368763,0,2,2,1.332623,103.880431
368764,0,4,4,1.332391,103.879906
368765,4,1,5,1.332389,103.880038
368766,39,7,46,1.332423,103.879892
368767,0,1,1,1.33232,103.880047
368768,3,1,4,1.332454,103.879883
368770,1,3,4,1.332479,103.879872
368772,0,3,3,1.332706,103.880528
368773,0,1,1,1.332418,103.880029
368774,0,2,2,1.332356,103.880043
368775,0,3,3,1.332511,103.879865
368776,1,0,1,1.332511,103.880015
368778,1,3,4,1.332616,103.879835
368779,1,1,2,1.332543,103.879861
368780,2,0,2,1.332637,103.87999
368782,0,1,1,1.332577,103.879852
368784,0,12,12,1.332714,103.879811
368785,0,10,10,1.332764,103.879952
368810,29,70,99,1.333039,103.883117
368811,1,154,155,1.333092,103.883255
368812,3,79,82,1.333218,103.883295
368813,102,4,106,1.333317,103.883697
368814,94,139,233,1.33315,103.883525
368815,655,3,658,1.333306,103.883907
368816,34,7,41,1.333361,103.883893
368817,54,0,54,1.333372,103.884059
368818,2,30,32,1.33343,103.884039
368819,143,1,144,1.333323,103.884203
368842,0,8,8,1.331589,103.883993
368843,0,7,7,1.331607,103.884106
368844,1,12,13,1.331699,103.883956
368845,2,0,2,1.332654,103.879829
368846,16,0,16,1.331722,103.88407
368847,0,2,2,1.331709,103.884015
368848,6,0,6,1.331749,103.884184
368849,3,1,4,1.331758,103.884257
368851,3,2,5,1.331778,103.88437
368852,9,0,9,1.331791,103.884421
368853,15,4,19,1.331805,103.884476
368854,1,0,1,1.332686,103.879815
368855,0,2,2,1.331732,103.884126
368856,0,2,2,1.331818,103.884588
368858,2,0,2,1.331832,103.884647
368859,0,5,5,1.33186,103.884814
368861,34,9,43,1.331885,103.884932
368862,2,0,2,1.331852,103.88476
368863,2,0,2,1.331893,103.885
368864,6,131,137,1.331904,103.885128
368888,8,5,13,1.329,103.883255
368889,1,7,8,1.32906,103.883267
368891,0,1,1,1.331811,103.884534
368892,2,2,4,1.329028,103.883086
368893,2,1,3,1.332552,103.880002
368895,28,5,33,1.329038,103.882919
368896,3,0,3,1.329088,103.88312
368897,2,0,2,1.331903,103.885059
368898,4,3,7,1.329052,103.882834
368899,37,20,57,1.329146,103.882748
368900,46,4,50,1.329082,103.882682
368901,68,13,81,1.329173,103.882647
368902,90,0,90,1.329189,103.882555
368903,8,0,8,1.329091,103.882578
368904,20,4,24,1.329215,103.882408
368905,0,2,2,1.329128,103.882857
368906,11,0,11,1.329123,103.882376
368907,1,0,1,1.329078,103.883178
368931,3,16,19,1.33132,103.883609
368932,0,2,2,1.329108,103.882468
368933,3,0,3,1.329116,103.882966
368935,1,0,1,1.329153,103.882257
368936,12,1,13,1.331362,103.883245
368937,1,4,5,1.331471,103.883144
368938,6,1,7,1.331395,103.883112
368939,77,0,77,1.33148,103.883061
368941,1,0,1,1.331462,103.883227
368942,1,0,1,1.331492,103.882928
368943,0,3,3,1.331456,103.883305
368944,21,3,24,1.331441,103.883419
368945,0,1,1,1.331421,103.882882
368946,1,7,8,1.331412,103.883577
368947,24,12,36,1.331401,103.883653
368967,2,2,4,1.332784,103.881609
368968,0,2,2,1.331329,103.883495
368969,2,0,2,1.332644,103.88172
368970,10,2,12,1.332693,103.881714
368971,2,0,2,1.332838,103.881593
368972,9,0,9,1.332728,103.881703
368973,3,1,4,1.332934,103.881571
368976,2,1,3,1.331498,103.882842
368979,20,0,20,1.333063,103.881542
368980,2,2,4,1.332914,103.881676
368981,2,1,3,1.332813,103.881705
368982,1,1,2,1.332886,103.881584
368983,0,1,1,1.331428,103.883498
368984,0,1,1,1.333011,103.881659
368985,0,1,1,1.333045,103.881648
368986,5,1,6,1.333168,103.881608
368987,0,3,3,1.333108,103.881531
368988,4,3,7,1.333266,103.881596
368991,26,0,26,1.333407,103.881549
368992,4,0,4,1.333464,103.881537
368995,0,2,2,1.332965,103.881665
368996,0,4,4,1.333724,103.881494
368997,5,2,7,1.333783,103.881483
368998,1,4,5,1.333847,103.881474
368999,0,1,1,1.333091,103.881642
369000,1,11,12,1.333957,103.881455
369001,0,11,11,1.334015,103.881448
369002,0,16,16,1.334064,103.881445
369026,7,3,10,1.330509,103.883525
369027,16,69,85,1.330562,103.883498
369028,19,1,20,1.330515,103.883441
369029,12,8,20,1.330579,103.883379
369032,31,0,31,1.330532,103.883302
369033,12,1,13,1.330607,103.883169
369034,28,0,28,1.330545,103.883207
369035,97,0,97,1.330621,103.883061
369036,4,7,11,1.330554,103.883141
369037,6,10,16,1.330633,103.882966
369039,2,0,2,1.33366,103.8815
369040,1,0,1,1.3339,103.881466
369041,5,0,5,1.330586,103.882832
369042,1,0,1,1.330581,103.882895
369043,4,0,4,1.330645,103.882801
369044,39,0,39,1.330641,103.88287
369068,13,5,18,1.332579,103.881035
369069,0,6,6,1.332591,103.881102
369070,8,0,8,1.332627,103.881021
369072,5,0,5,1.332674,103.88101
369074,1,1,2,1.330573,103.882979
369075,1,1,2,1.332721,103.881
369076,81,0,81,1.332761,103.880991
369077,2,4,6,1.332779,103.881064
369078,9,0,9,1.332803,103.880983
369080,1,0,1,1.330592,103.88278
369081,7,0,7,1.332857,103.881038
369082,3,0,3,1.333214,103.881602
369083,5,1,6,1.332901,103.881031
369107,0,15,15,1.332641,103.879393
369108,1,24,25,1.332617,103.879317
369111,2,2,4,1.332555,103.879416
369112,1,2,3,1.332887,103.880965
369113,1,0,1,1.332846,103.880972
369115,48,0,48,1.332469,103.879439
369116,0,1,1,1.332509,103.879428
369117,0,4,4,1.332429,103.87945
369118,1,1,2,1.332738,103.881069
369119,2,1,3,1.332531,103.87934
369120,2,0,2,1.332399,103.879374
369121,0,1,1,1.332445,103.879362
369123,3,3,6,1.332316,103.879484
369125,19,3,22,1.332277,103.879492
369127,0,4,4,1.332237,103.879504
369128,31,17,48,1.332216,103.879414
369129,0,11,11,1.332202,103.879512
369130,1,0,1,1.332349,103.879474
369131,5,29,34,1.33216,103.879527
369132,0,3,3,1.332393,103.879459
369133,1,238,239,1.332107,103.879534
369134,7,47,54,1.332113,103.879442
369135,0,418,418,1.33203,103.879543
369136,0,61,61,1.332045,103.879603
369137,2,77,79,1.33205,103.87964
369138,0,53,53,1.33206,103.879684
369139,4,21,25,1.33207,103.879724
369140,0,341,341,1.332076,103.87975
369141,4,19,23,1.332086,103.879793
369142,1,258,259,1.332097,103.879849
369143,0,22,22,1.332102,103.879886
369144,0,165,165,1.332113,103.879925
369145,1,0,1,1.332182,103.879419
369146,0,119,119,1.332122,103.879981
369147,0,2,2,1.332359,103.87938
369148,0,2,2,1.332336,103.880761
369149,0,4,4,1.332359,103.880844
369150,0,48,48,1.332139,103.880099
369151,0,1,1,1.332349,103.880792
369154,0,3,3,1.332142,103.879431
369155,20,5,25,1.33239,103.880993
369158,0,2,2,1.332133,103.880047
369160,5,2,7,1.33219,103.880323
369162,0,4,4,1.332199,103.88037
369165,1,2,3,1.332159,103.88017
369166,18,5,23,1.33222,103.880464
369168,2,13,15,1.332261,103.880621
369169,2,0,2,1.332184,103.880277
369171,0,5,5,1.332493,103.881422
369172,2,2,4,1.332271,103.880688
369174,1,0,1,1.332378,103.880896
369175,17,16,33,1.332514,103.881561
369176,1,5,6,1.332287,103.880747
369178,0,1,1,1.332278,103.880711
369180,3,23,26,1.332325,103.88091
369181,3,0,3,1.332445,103.881249
369182,17,2,19,1.332337,103.880984
369183,1,0,1,1.332302,103.88083
369184,3,2,5,1.332356,103.88106
369187,3,1,4,1.332379,103.881224
369188,1,0,1,1.332346,103.881027
369190,155,17,172,1.332405,103.881351
369193,0,1,1,1.332393,103.881334
369196,0,4,4,1.332469,103.88167
369197,5,0,5,1.332475,103.881719
369198,1,0,1,1.332433,103.881565
369200,4,0,4,1.332504,103.881865
369230,0,10,10,1.331617,103.884526
369231,0,1,1,1.332492,103.881779
369232,20,0,20,1.331466,103.884506
369233,79,0,79,1.331406,103.884497
369234,2,19,21,1.331541,103.884593
369235,3,4,7,1.331339,103.884481
369236,2,0,2,1.332478,103.881353
369237,3,0,3,1.332331,103.880948
369238,22,1,23,1.331428,103.884588
369239,3,1,4,1.331185,103.884451
369240,3,11,14,1.331366,103.884579
369241,5,0,5,1.331112,103.884443
369242,119,2,121,1.331312,103.884576
369243,84,0,84,1.331261,103.884568
369244,7,0,7,1.331039,103.88444
369245,1,3,4,1.331193,103.884573
369246,0,3,3,1.331263,103.884468
369247,2,0,2,1.331498,103.884593
369248,0,1,1,1.331539,103.884514
369249,6,0,6,1.331004,103.884538
369250,23,5,28,1.33087,103.884424
369251,0,4,4,1.330939,103.884543
369252,0,4,4,1.330856,103.884526
369253,1,2,3,1.331137,103.884554
369254,0,3,3,1.330732,103.884373
369255,1,5,6,1.330672,103.884365
369256,0,1,1,1.331066,103.884543
369259,2,0,2,1.330961,103.884421
369260,10,0,10,1.330578,103.884495
369261,44,5,49,1.330466,103.884339
369262,2,1,3,1.330784,103.884529
369263,1,0,1,1.330715,103.884512
369265,1,0,1,1.330397,103.884331
369266,3,5,8,1.330371,103.884478
369267,1,1,2,1.330526,103.884348
369268,6,0,6,1.330305,103.884467
369269,4,1,5,1.330191,103.884297
369270,0,1,1,1.330329,103.884322
369273,0,4,4,1.330054,103.884288
369274,4,0,4,1.330105,103.884438
369275,1,2,3,1.330509,103.884495
369276,13,3,16,1.330042,103.884427
369277,4,2,6,1.329916,103.884263
369278,2,1,3,1.329985,103.88428
369279,1,0,1,1.330237,103.884455
369280,0,4,4,1.329905,103.884398
369282,3,0,3,1.329973,103.88441
369283,0,1,1,1.329859,103.884251
369284,21,1,22,1.329772,103.884401
369285,0,2,2,1.33026,103.884305
369286,17,14,31,1.329698,103.88439
369287,5,0,5,1.329612,103.884212
369288,3,4,7,1.329629,103.884379
369289,1,0,1,1.329727,103.884234
369290,1,25,26,1.329555,103.884373
369291,2,5,7,1.329486,103.884195
369292,5,4,9,1.329486,103.884367
369294,111,20,131,1.329417,103.884356
369295,1,0,1,1.329549,103.884206
369296,0,47,47,1.32936,103.884345
369297,2,0,2,1.32967,103.884223
369298,0,28,28,1.329291,103.884339
369299,11,0,11,1.329274,103.884161
369300,10,18,28,1.329222,103.884327
369301,2,0,2,1.329326,103.884166
369302,0,6,6,1.329159,103.884322
369304,2,10,12,1.329096,103.884316
369306,2,4,6,1.329028,103.884305
369307,10,0,10,1.329057,103.884121
369308,3,13,16,1.328959,103.884305
369309,33,0,33,1.329011,103.88411
369311,2,0,2,1.329223,103.884149
369312,0,1,1,1.329383,103.884172
369313,2,4,6,1.328898,103.884115
369361,9,2,11,1.331851,103.883749
369362,7,0,7,1.331254,103.883809
369363,1,0,1,1.328856,103.884288
369365,7,0,7,1.331163,103.883794
369367,8,0,8,1.331066,103.883789
369368,52,0,52,1.330992,103.88377
369369,2,0,2,1.328971,103.884104
369370,9,0,9,1.33084,103.883743
369371,0,4,4,1.330773,103.883724
369373,14,3,17,1.330681,103.883724
369374,2,2,4,1.330614,103.883714
369375,1,2,3,1.329841,103.884413
369376,5,0,5,1.330528,103.883701
369381,4,0,4,1.330118,103.883515
369382,3,1,4,1.330146,103.883638
369383,4,0,4,1.330037,103.883637
369384,7,3,10,1.330062,103.883507
369385,8,0,8,1.329973,103.883632
369386,2,6,8,1.329885,103.883615
369387,0,3,3,1.330799,103.883599
369388,5,9,14,1.329896,103.883479
369389,11,0,11,1.329817,103.883605
369390,10,1,11,1.329728,103.883595
369391,5,7,12,1.329672,103.883466
369392,15,0,15,1.329546,103.883549
369393,1,4,5,1.329538,103.883425
369394,12,15,27,1.329471,103.883538
369395,0,12,12,1.329462,103.883412
369396,3,1,4,1.329381,103.883528
369397,0,2,2,1.331004,103.883624
369398,105,0,105,1.329293,103.883517
369399,4,3,7,1.329283,103.883389
369400,4,2,6,1.329209,103.883512
369401,3,0,3,1.329976,103.883491
369402,14,1,15,1.329123,103.883494
369403,185,0,185,1.329034,103.883466
369404,2,1,3,1.329188,103.883373
369428,297,0,297,1.331581,103.882308
369429,5,1,6,1.331681,103.882489
369430,0,2,2,1.329362,103.883404
369433,0,1,1,1.33176,103.883755
369434,26,0,26,1.331348,103.882287
369435,15,0,15,1.331394,103.882472
369436,88,0,88,1.331322,103.882459
369438,1,1,2,1.331607,103.882493
369440,0,1,1,1.331404,103.882293
369441,10,0,10,1.331021,103.882433
369442,0,2,2,1.331199,103.882447
369444,17,0,17,1.330819,103.882407
369445,2,6,8,1.331222,103.882271
369446,3,1,4,1.330706,103.882395
369447,9,6,15,1.331159,103.882265
369448,2,2,4,1.330648,103.882398
369449,6,3,9,1.331119,103.882265
369451,0,3,3,1.328949,103.883448
369452,2,3,5,1.330493,103.882377
369453,60,3,63,1.33099,103.882275
369454,2,1,3,1.331047,103.882286
369455,90,5,95,1.330915,103.882264
369456,16,6,22,1.33033,103.882373
369457,12,7,19,1.330846,103.882252
369458,2,0,2,1.330967,103.882429
369459,26,0,26,1.330772,103.882241
369460,1,0,1,1.331253,103.882274
369461,1,11,12,1.330709,103.88223
369462,8,0,8,1.33008,103.88233
369463,16,3,19,1.330646,103.882224
369464,19,1,20,1.330021,103.882302
369465,2,1,3,1.330384,103.882373
369468,0,1,1,1.330177,103.882339
369470,0,1,1,1.329875,103.882231
369473,5,2,7,1.330221,103.882167
369474,4,0,4,1.329744,103.882125
369475,9,1,10,1.330042,103.882136
369476,0,2,2,1.330246,103.882352
369477,16,5,21,1.329957,103.882095
369480,0,6,6,1.329542,103.881947
369483,44,8,52,1.329668,103.881915
369484,62,0,62,1.329482,103.881906
369485,6,0,6,1.329583,103.88187
369486,1,0,1,1.330379,103.882203
369487,1,1,2,1.329666,103.882053
369488,2,1,3,1.330577,103.882213
369490,15,3,18,1.329395,103.881831
369491,4,0,4,1.329359,103.881808
369492,1,0,1,1.329538,103.881824
369493,1,0,1,1.329277,103.881624
369494,0,7,7,1.329222,103.881702
369495,1,16,17,1.327835,103.880699
369496,0,474,474,1.327779,103.880659
369497,1,3,4,1.330154,103.882153
369498,5,9,14,1.331557,103.882491
369499,0,9,9,1.331487,103.882486
369520,481,507,988,1.335478,103.8863
369521,54,199,253,1.335349,103.886462
369522,5,149,154,1.335643,103.886951
369546,1277,5,1282,1.336047,103.886073
369547,33,136,169,1.336067,103.886183
369548,11,48,59,1.336075,103.886299
369549,7,40,47,1.336098,103.886406
369550,0,65,65,1.336109,103.886501
369551,14,68,82,1.336132,103.8866
369552,4,144,148,1.336172,103.886765
369553,1,100,101,1.336189,103.886867
369577,11,0,11,1.333467,103.885722
369581,0,7,7,1.333431,103.885736
369582,7,73,80,1.333448,103.885863
369583,1,0,1,1.329268,103.881744
369585,1341,318,1659,1.334053,103.885683
369586,2,122,124,1.334052,103.885565
369587,3,3,6,1.334367,103.885515
369588,2,0,2,1.32946,103.881766
369589,0,4,4,1.334727,103.885472
369610,47,775,822,1.332797,103.884601
369611,0,7,7,1.333032,103.884637
369612,1,1439,1440,1.332846,103.884682
369613,1,28,29,1.333232,103.884497
369614,0,16,16,1.333533,103.884521
369615,0,11,11,1.333385,103.884464
369616,92,7,99,1.333587,103.884399
369617,0,4,4,1.333804,103.884347
369618,5,15,20,1.333937,103.884422
369619,5,5,10,1.334166,103.883954
369621,1,14,15,1.334319,103.884236
369645,65,3,68,1.334822,103.8844
369646,95,125,220,1.335888,103.884903
369647,74,105,179,1.336135,103.885044
369648,444,24,468,1.336303,103.885177
369649,856,102,958,1.336531,103.885261
369650,367,209,576,1.335329,103.884664
369651,87,55,142,1.33547,103.88467
369652,67,51,118,1.334729,103.884367
369673,103,1992,2095,1.334311,103.887995
369674,1200,29,1229,1.335282,103.887532
369675,7,29,36,1.334424,103.887843
369676,2,3,5,1.334517,103.887792
369677,556,41,597,1.334722,103.886781
369678,1,1,2,1.334428,103.885498
369679,11,111,122,1.334775,103.887624
369680,0,18,18,1.334759,103.887488
369681,0,9,9,1.33475,103.887368
369682,1,8,9,1.334721,103.887264
369683,5,111,116,1.334692,103.887024
369707,1,3,4,1.329247,103.880649
369708,1,0,1,1.333489,103.885722
369710,16,0,16,1.329427,103.880478
369711,2,2,4,1.329472,103.880445
369712,27,1,28,1.329533,103.880393
369736,5,662,667,1.330519,103.879928
369738,3,0,3,1.329404,103.881724
369740,57,0,57,1.330518,103.879927
369741,4,0,4,1.330517,103.879926
369744,4,0,4,1.330519,103.879928
369745,2,0,2,1.334482,103.887676
369746,5,0,5,1.330518,103.879927
369747,1,0,1,1.329296,103.880611
369748,5,2,7,1.33085,103.880103
369749,0,2,2,1.330518,103.879927
369750,1,0,1,1.330518,103.879927
369754,0,15,15,1.330518,103.879927
369756,9,0,9,1.330901,103.880178
369761,14,4,18,1.331089,103.880245
369762,2,0,2,1.330849,103.880102
369764,1,0,1,1.330849,103.880102
369768,0,1,1,1.330518,103.879927
369769,6,2,8,1.330917,103.880383
369771,171,0,171,1.330955,103.880564
369772,23,0,23,1.330974,103.880654
369773,19,4,23,1.330993,103.880744
369774,0,1,1,1.330898,103.880293
369775,0,2,2,1.330519,103.879928
369776,54,9,63,1.33105,103.881014
369777,0,10,10,1.331059,103.881057
369778,4,0,4,1.331068,103.881101
369779,0,2,2,1.331031,103.880924
369780,1,2,3,1.330518,103.879927
369781,34,0,34,1.331124,103.88136
369782,1,4,5,1.331142,103.881447
369784,1,5,6,1.331179,103.88162
369785,0,2,2,1.331087,103.881187
369811,1,5,6,1.331136,103.881626
369812,4,14,18,1.331169,103.88161
369814,0,1,1,1.331012,103.880834
369817,0,1,1,1.331089,103.881601
369818,4,0,4,1.330768,103.881566
369819,8,1,9,1.330902,103.881601
369822,4,0,4,1.330448,103.881531
369823,28,0,28,1.33031,103.881507
369824,0,4,4,1.330702,103.881579
369825,3,0,3,1.331105,103.881274
369827,35,0,35,1.330054,103.881318
369829,2,2,4,1.329931,103.881228
369830,27,11,38,1.330502,103.881557
369832,12,0,12,1.330435,103.881549
369833,4,0,4,1.329687,103.881047
369834,2,0,2,1.331179,103.88162
369835,0,1,1,1.330969,103.881608
369836,1,0,1,1.329565,103.880957
369837,3,0,3,1.330176,103.881408
369839,12,0,12,1.32932,103.880777
369841,6,3,9,1.329363,103.880753
369842,3,0,3,1.329442,103.880867
369843,2,0,2,1.330368,103.881542
369844,1,0,1,1.33031,103.881527
369845,0,3,3,1.330157,103.881414
369846,6,1,7,1.330051,103.881336
369847,2,879,881,1.328812,103.88043
369848,1,0,1,1.330104,103.881375
369849,0,1,1,1.329997,103.881296
369850,5,0,5,1.329891,103.881218
369853,2,1,3,1.329,103.880553
369854,7,0,7,1.329678,103.881061
369855,2,0,2,1.329077,103.880555
369856,22,0,22,1.329571,103.880982
369859,2,1,3,1.329731,103.8811
369861,0,1,1,1.329944,103.881257
369863,1,0,1,1.329305,103.880786
369864,10,9,19,1.329165,103.880685
369865,1,0,1,1.329198,103.880707
369866,0,1,1,1.329132,103.880662
369867,0,8,8,1.329,103.880574
369868,26,20,46,1.328934,103.880529
369869,1,4,5,1.328868,103.880485
369870,1,51,52,1.328802,103.88044
369894,11,11,22,1.330994,103.881025
369895,1,16,17,1.330915,103.880985
369896,0,1,1,1.329066,103.880618
369897,0,1,1,1.330915,103.881016
369898,3,0,3,1.329411,103.880864
369899,113,2,115,1.330746,103.880967
369901,0,7,7,1.33055,103.880943
369902,26,0,26,1.330611,103.880971
369903,5,0,5,1.330418,103.880873
369904,41,5,46,1.33055,103.880963
369905,10,2,12,1.330272,103.880759
369906,181,8,189,1.330126,103.880646
369907,0,1,1,1.330788,103.880963
369908,0,1,1,1.330327,103.880822
369909,12,2,14,1.330236,103.880751
369910,1,1,2,1.329624,103.881021
369911,8,4,12,1.330144,103.88068
369912,19,4,23,1.329698,103.880315
369913,3,3,6,1.330053,103.880609
369914,1,0,1,1.32998,103.880532
369915,5,0,5,1.32987,103.880467
369917,89,4,93,1.329688,103.880325
369941,94,1513,1607,1.333014,103.885281
369942,1,0,1,1.329962,103.880538
369943,1,2,3,1.330792,103.881001
369945,0,1,1,1.333544,103.885173
369946,4,0,4,1.334235,103.884888
369947,0,28,28,1.334455,103.884827
369972,212,247,459,1.335487,103.885048
369974,200,17,217,1.335704,103.884213
369976,19,61,80,1.335781,103.884431
369977,2434,359,2793,1.335497,103.885304
370012,47,2393,2440,1.327464,103.88445
370013,86,3064,3150,1.327481,103.883686
370014,58,950,1008,1.327537,103.883214
370017,68,7,75,1.329902,103.8886
370018,50,1735,1785,1.299509,103.837
370019,798,20,818,1.331402,103.887461
370020,377,141,518,1.330886,103.887498
370021,314,105,419,1.331171,103.887015
370022,6,37,43,1.330142,103.88773
370023,373,60,433,1.330922,103.886753
370024,727,227,954,1.330222,103.8875
370027,260,97,357,1.330429,103.886163
370028,126,151,277,1.330653,103.886648
370029,593,510,1103,1.330088,103.88705
370030,112,97,209,1.329614,103.887126
370031,646,85,731,1.329751,103.885782
370032,177,303,480,1.329432,103.886652
370033,369,467,836,1.329924,103.886029
370034,116,799,915,1.329061,103.887484
370035,224,5859,6083,1.329166,103.886
370036,462,20405,20867,1.328989,103.886929
370037,569,473,1042,1.328302,103.887176
370038,193,149,342,1.327932,103.886171
370039,218,3046,3264,1.327478,103.885705
370040,12,2,14,1.327655,103.886083
370041,160,313,473,1.327157,103.886273
370042,150,0,150,1.326973,103.886492
370043,140,3344,3484,1.326515,103.885547
370044,145,125,270,1.326617,103.886115
370045,421,138,559,1.326376,103.886013
370046,276,58,334,1.326172,103.885974
370047,813,4382,5195,1.325774,103.885642
370048,228,101,329,1.325422,103.885575
370049,78,2,80,1.325142,103.88555
370050,151,203,354,1.32491,103.88549
370051,154,1476,1630,1.324486,103.885551
370052,215,2330,2545,1.324225,103.885492
370053,583,256,839,1.323995,103.886777
370054,346,4371,4717,1.323921,103.88747
370055,204,1578,1782,1.323709,103.888424
370056,215,798,1013,1.324079,103.888439
370057,167,172,339,1.324687,103.886723
370058,111,10,121,1.324988,103.886504
370059,366,79,445,1.325575,103.886332
370060,68,0,68,1.32551,103.886638
370061,434,106,540,1.325805,103.886771
370062,9,0,9,1.326197,103.88711
370063,50,1,51,1.326461,103.886613
370064,216,190,406,1.326993,103.887178
370065,195,1278,1473,1.327428,103.887166
370066,84,5308,5392,1.326483,103.887665
370067,235,425,660,1.325816,103.887931
370068,115,556,671,1.325435,103.888052
370069,470,410,880,1.325004,103.887431
370070,22,5,27,1.325172,103.888017
370071,295,289,584,1.324878,103.88796
370072,155,519,674,1.32456,103.887928
370077,31,6971,7002,1.32849,103.885399
370078,42,8139,8181,1.327882,103.885268
370079,44,5296,5340,1.326412,103.885064
370080,20,9556,9576,1.327638,103.887098
370081,2,6169,6171,1.299509,103.837
370082,2,111,113,1.299509,103.837
370083,0,802,802,1.299509,103.837
370085,210,215,425,1.322662,103.885739
370086,6,113,119,1.322941,103.885348
370087,144,91,235,1.323212,103.885612
370088,36,6033,6069,1.323564,103.88585
370089,16,461,477,1.32362,103.885383
370090,117,1925,2042,1.323317,103.886605
370091,141,257,398,1.322683,103.886683
370092,201,3505,3706,1.323254,103.887287
370093,176,331,507,1.322724,103.888003
370094,198,1837,2035,1.323156,103.888175
371017,562,413,975,1.329521,103.888616
371018,733,186,919,1.329521,103.888616
371027,13,104,117,1.330419,103.885766
371028,14,226,240,1.330551,103.887275
371042,5,15,20,1.327,103.88591
371052,7,14,21,1.324668,103.885815
371064,7,2,9,1.327183,103.887218
371065,11,0,11,1.327202,103.88708
371066,63,805,868,1.326748,103.887858
371079,40,10446,10486,1.325608,103.88493
371083,0,111,111,1.299509,103.837
371092,299,903,1202,1.322973,103.887513
372017,308,1309,1617,1.329818,103.88864
372018,82,39,121,1.329301,103.888446
372052,6,267,273,1.323868,103.885912
372082,0,465,465,1.299509,103.837
372083,0,267,267,1.299509,103.837
373017,8,19,27,1.299509,103.837
373018,242,181,423,1.329385,103.889059
374018,510,41,551,1.329521,103.888616
378956,53,2663,2716,1.299509,103.837
379131,114,477,591,1.323438,103.88467
379299,0,99,99,1.327657,103.881121
379300,0,4,4,1.327643,103.881238
379301,2,26,28,1.32764,103.881339
379302,0,10,10,1.327634,103.88144
379303,0,2,2,1.329834,103.880419
379304,0,7,7,1.327623,103.881693
379305,0,121,121,1.327618,103.881759
379307,0,4,4,1.327621,103.881934
379309,1,16,17,1.327605,103.882021
379310,1,8,9,1.327613,103.882075
379311,0,12,12,1.327608,103.882171
379312,0,46,46,1.327599,103.882314
379313,0,147,147,1.299509,103.837
379397,23,0,23,1.299509,103.837
379480,1,1,2,1.327626,103.881572
379481,1,15,16,1.32808,103.88807
379483,4,5357,5361,1.325543,103.88882
379484,0,28,28,1.325552,103.88866
379485,0,29,29,1.325552,103.88866
379486,0,33,33,1.325552,103.88866
379487,0,31,31,1.325704,103.889206
379488,1,77,78,1.325725,103.889296
379489,1,227,228,1.325801,103.889386
379490,0,234,234,1.325847,103.889498
379491,4,195,199,1.325884,103.889601
379492,1,251,252,1.325933,103.889663
379493,0,4,4,1.325967,103.889746
379494,1,481,482,1.325977,103.889853
379495,4,674,678,1.326041,103.889992
379496,49,4786,4835,1.324159,103.884697
379497,14,333,347,1.329162,103.885575
379498,1,0,1,1.333972,103.884943
379499,19,3484,3503,1.327133,103.888668
379500,3,463,466,1.299509,103.837
380002,35,71,106,1.313456,103.872125
380003,19,8,27,1.313731,103.872663
380005,88,7408,7496,1.31265,103.87257
380006,4,63,67,1.314135,103.871853
380008,70,2436,2506,1.314219,103.872059
380009,9,1466,1475,1.314391,103.870066
380010,4,30,34,1.299509,103.837
380011,581,2708,3289,1.314321,103.870795
380012,455,304,759,1.31437,103.869949
380013,441,244,685,1.31448,103.870399
380014,323,24,347,1.315089,103.870285
380015,736,407,1143,1.315908,103.871257
380016,428,459,887,1.315498,103.87148
380017,72,2697,2769,1.315038,103.871636
380018,197,13169,13366,1.314735,103.871939
380019,899,1050,1949,1.315138,103.873633
380020,3,385,388,1.314265,103.873764
380038,833,167,1000,1.317928,103.87424
380039,1061,513,1574,1.318635,103.874252
380040,734,133,867,1.317458,103.876279
380041,1332,530,1862,1.316956,103.875494
380042,186,453,639,1.317039,103.87589
380043,319,123,442,1.317207,103.87649
380044,833,701,1534,1.316375,103.877098
380045,613,92,705,1.317386,103.87832
380046,39,349,388,1.317513,103.878913
380047,38,2448,2486,1.317817,103.879045
380048,55,4715,4770,1.317613,103.879359
380049,165,1261,1426,1.316995,103.879252
380050,228,3713,3941,1.316616,103.878436
380051,409,162,571,1.316319,103.878761
380052,1071,1150,2221,1.316652,103.880308
380053,586,1508,2094,1.317801,103.880004
380054,43,829,872,1.318487,103.878807
380055,147,1,148,1.318974,103.87883
380056,3,199,202,1.319412,103.878954
380057,1,148,149,1.319523,103.879407
380059,7,4805,4812,1.318747,103.879654
380060,8,11,19,1.319583,103.881268
380061,35,99,134,1.316634,103.878559
380062,12,305,317,1.319249,103.876683
380063,785,542,1327,1.316613,103.879371
380095,360,488,848,1.321563,103.886362
380096,140,90,230,1.321634,103.88549
380097,382,167,549,1.321334,103.885756
380098,422,5177,5599,1.320833,103.885768
380099,485,199,684,1.321364,103.884467
380100,300,1005,1305,1.320944,103.883992
380101,250,342,592,1.320902,103.883273
380102,1009,494,1503,1.320099,103.882241
380103,155,2057,2212,1.320541,103.883268
380104,669,419,1088,1.320063,103.882846
380105,423,719,1142,1.319488,103.882735
380106,307,3942,4249,1.319083,103.88276
380107,205,5758,5963,1.318994,103.884242
380108,283,1977,2260,1.31901,103.884983
380109,268,1312,1580,1.31942,103.88437
380110,375,1286,1661,1.319943,103.884262
380111,337,3375,3712,1.320398,103.883918
380112,369,2497,2866,1.320455,103.885443
380113,271,8427,8698,1.320532,103.886013
380114,46,60,106,1.321746,103.886822
380115,24,119,143,1.321292,103.887252
380116,13,115,128,1.321236,103.886721
380117,63,2066,2129,1.320653,103.886925
380118,89,372,461,1.320126,103.887252
380119,128,18257,18385,1.31953,103.886657
380120,363,1497,1860,1.318199,103.884718
380121,17,609,626,1.317996,103.885654
380122,431,167,598,1.317705,103.884907
380123,155,3083,3238,1.318158,103.885275
380124,457,1298,1755,1.318363,103.886648
380125,375,1695,2070,1.322892,103.88146
380126,175,94,269,1.322892,103.88146
380127,207,350,557,1.318081,103.887418
380128,618,688,1306,1.318508,103.887583
380129,90,781,871,1.316696,103.888139
380130,738,101,839,1.316754,103.887749
380131,253,58,311,1.31677,103.886855
380132,263,246,509,1.316467,103.885941
380133,428,712,1140,1.316381,103.885554
380134,181,142,323,1.316062,103.886013
381002,545,4757,5302,1.313919,103.871896
381003,354,437,791,1.314097,103.872342
381005,857,453,1310,1.313261,103.873483
381008,566,448,1014,1.312948,103.870325
381013,13,813,826,1.314591,103.871042
381014,948,471,1419,1.315183,103.870498
381042,59,1980,2039,1.316635,103.875993
381043,83,1265,1348,1.316793,103.876606
381045,14,7017,7031,1.316943,103.878223
381050,15,520,535,1.316276,103.878429
381052,8,156,164,1.316808,103.880062
381063,10,267,277,1.299509,103.837
381097,39,517,556,1.321107,103.886127
381098,11,469,480,1.321074,103.884874
381111,40,3740,3780,1.312248,103.873458
381112,72,83,155,1.312023,103.873475
381113,459,106,565,1.311808,103.873849
381114,494,108,602,1.311576,103.873992
381120,781,242,1023,1.322692,103.884196
381121,459,406,865,1.321968,103.882748
381122,402,1345,1747,1.322584,103.88237
381123,766,293,1059,1.322694,103.883113
381124,900,546,1446,1.323058,103.883598
381125,649,229,878,1.31773,103.886644
381126,513,257,770,1.317816,103.886973
382002,386,12535,12921,1.313672,103.871488
382003,738,13901,14639,1.314313,103.872805
382008,702,102,804,1.312612,103.870673
382114,6,726,732,1.312448,103.874431
383002,1311,11369,12680,1.313153,103.871757
383003,649,159,808,1.313973,103.873035
383008,427,753,1180,1.312948,103.870325
384002,814,498,1312,1.313056,103.872271
384003,907,595,1502,1.313276,103.872764
387298,176,7,183,1.315867,103.877448
387299,125,74,199,1.315784,103.877073
387310,4,8,12,1.315289,103.870009
387311,42,173,215,1.31554,103.872887
387312,390,2182,2572,1.316409,103.873481
387313,30,0,30,1.316046,103.872675
387355,2036,10,2046,1.317208,103.880848
387358,7,191,198,1.317339,103.880464
387379,16,3803,3819,1.318492,103.877885
387380,2131,3466,5597,1.315557,103.876122
387381,138,133,271,1.31876,103.876024
387382,193,270,463,1.317931,103.87756
387383,334,134,468,1.318597,103.877201
387384,688,81,769,1.318036,103.87631
387385,314,107,421,1.31834,103.88087
387386,63,1301,1364,1.299509,103.837
387387,0,185,185,1.31897,103.881357
387389,1,0,1,1.323617,103.889561
387390,1,53,54,1.299509,103.837
387391,14,200,214,1.299509,103.837
387392,3,3452,3455,1.299509,103.837
387393,1,43,44,1.299509,103.837
387405,451,5364,5815,1.311472,103.871353
387412,13,46,59,1.313628,103.875647
387413,3,1010,1013,1.31352,103.875777
387414,11,1895,1906,1.313692,103.875902
387415,8,452,460,1.299509,103.837
387416,102,125,227,1.31327,103.875885
387418,139,43,182,1.31377,103.876253
387419,8,291,299,1.313813,103.877
387420,2,530,532,1.313834,103.877051
387421,0,15,15,1.313858,103.877098
387422,5,1626,1631,1.313881,103.877157
387423,13,452,465,1.313906,103.877211
387424,1,920,921,1.31378,103.877428
387425,5,399,404,1.313821,103.877501
387426,2,119,121,1.31382,103.877518
387427,0,417,417,1.313859,103.877569
387428,6,140,146,1.313838,103.877655
387429,121,27,148,1.314513,103.877245
387430,3,149,152,1.313884,103.877714
387431,60,579,639,1.313953,103.877333
387432,1,263,264,1.313908,103.877752
387433,5,809,814,1.313962,103.877382
387434,2,215,217,1.3139,103.877833
387435,1,5,6,1.313975,103.877424
387436,87,258,345,1.31394,103.877888
387437,0,436,436,1.313993,103.877468
387438,5,437,442,1.313929,103.87794
387439,0,95,95,1.314008,103.87751
387440,5,402,407,1.314007,103.878127
387441,9,197,206,1.31403,103.877561
387442,3,959,962,1.314079,103.878147
387443,0,872,872,1.314103,103.878234
387444,5,1179,1184,1.314055,103.877618
387445,5,10,15,1.314107,103.878252
387446,0,5,5,1.314072,103.877651
387447,1,506,507,1.314126,103.878312
387448,1,6,7,1.31409,103.877702
387449,59,5668,5727,1.314143,103.878356
387450,4,3248,3252,1.314102,103.877749
387451,4,708,712,1.314152,103.878444
387452,0,117,117,1.314121,103.87779
387453,5,25,30,1.314159,103.878502
387454,2,1,3,1.333211,103.885161
387455,1,672,673,1.314146,103.877902
387456,13,663,676,1.314167,103.87869
387457,1,691,692,1.314199,103.877981
387458,0,152,152,1.314199,103.878712
387459,1,193,194,1.314217,103.878081
387460,0,84,84,1.314209,103.878807
387461,0,534,534,1.314226,103.878134
387462,0,2,2,1.328686,103.888349
387463,2,293,295,1.314245,103.878187
387464,8,392,400,1.314231,103.87891
387465,1,1175,1176,1.31426,103.878253
387466,0,1,1,1.299509,103.837
387467,7,1494,1501,1.314276,103.878303
387468,3,394,397,1.314261,103.879018
387469,13,1820,1833,1.314341,103.878581
387470,3,133,136,1.314256,103.879214
387471,1,296,297,1.314366,103.878674
387472,4,1551,1555,1.314336,103.879235
387473,0,1146,1146,1.314381,103.878744
387474,2,2,4,1.314288,103.879301
387475,0,5,5,1.314391,103.878806
387476,3,385,388,1.314327,103.879346
387477,2,509,511,1.3144,103.878875
387479,1,15,16,1.314411,103.878926
387480,0,242,242,1.314338,103.87944
387481,3,1796,1799,1.314428,103.87897
387482,0,1,1,1.314216,103.878964
387483,0,190,190,1.314364,103.879509
387485,0,249,249,1.314383,103.879605
387487,1,0,1,1.314347,103.879447
387488,3,819,822,1.31454,103.879483
387489,3,251,254,1.314395,103.879697
387491,3,332,335,1.314437,103.879812
387492,1,1,2,1.314219,103.878851
387493,38,495,533,1.31456,103.87959
387494,11,929,940,1.314432,103.879918
387495,5,1281,1286,1.314627,103.879998
387496,0,5,5,1.314636,103.880038
387497,1,1099,1100,1.314642,103.88007
387498,1,0,1,1.314381,103.879664
387499,1,593,594,1.31466,103.880123
387500,0,1,1,1.314648,103.880095
387501,1,446,447,1.314673,103.880217
387502,2,1,3,1.314134,103.877839
387503,2,454,456,1.314679,103.880277
387504,9,1,10,1.314688,103.880305
387505,0,671,671,1.314697,103.880324
387506,8,1951,1959,1.314703,103.880374
387507,5,1206,1211,1.314685,103.881436
387508,3,1193,1196,1.314705,103.881456
387510,2,888,890,1.314726,103.881596
387511,12,0,12,1.314703,103.881633
387512,1,1099,1100,1.314761,103.881699
387513,232,6338,6570,1.314907,103.882633
387514,29,4594,4623,1.31509,103.883163
387515,28,592,620,1.315111,103.883569
387516,180,1,181,1.315149,103.88382
387517,4,3774,3778,1.315168,103.883877
387518,1,3,4,1.315142,103.883887
387519,3,1167,1170,1.315213,103.883944
387520,0,1,1,1.314667,103.880155
387521,1,518,519,1.315228,103.884059
387522,0,1,1,1.315154,103.88401
387523,0,311,311,1.315238,103.884127
387524,0,1,1,1.31517,103.884075
387525,9,343,352,1.315265,103.884219
387527,2,159,161,1.315257,103.884392
387528,2,337,339,1.315279,103.884438
387529,1,0,1,1.315195,103.884174
387530,1,443,444,1.315319,103.884579
387531,7,3,10,1.315314,103.885223
387538,0,1085,1085,1.315625,103.885592
387540,17,852,869,1.315507,103.885779
387541,10,170,180,1.315997,103.887076
387542,3,454,457,1.315732,103.887116
387543,1,1,2,1.314378,103.879828
387544,92,227,319,1.315747,103.887216
387545,5,99,104,1.315739,103.887275
387546,0,80,80,1.315823,103.887462
387547,0,122,122,1.315846,103.887517
387549,0,63,63,1.315995,103.887496
387550,1,38,39,1.315885,103.887585
387551,6,193,199,1.316009,103.887534
387552,1,0,1,1.315266,103.884539
387553,0,5,5,1.316012,103.887573
387554,2,77,79,1.315911,103.88771
387555,3,96,99,1.316021,103.887615
387556,5,13,18,1.315851,103.887718
387557,0,11,11,1.316026,103.887643
387558,8,312,320,1.315873,103.887822
387559,7,291,298,1.316032,103.887688
387560,12,290,302,1.31595,103.888049
387561,15,8,23,1.315965,103.888107
387562,0,21,21,1.315962,103.888136
387563,14,467,481,1.315982,103.888195
387564,2,0,2,1.31571,103.88718
387565,0,230,230,1.315994,103.888311
387566,0,2,2,1.315956,103.888226
387567,3,245,248,1.31604,103.888399
387568,0,17,17,1.315994,103.888439
387569,3,494,497,1.316031,103.888482
387570,0,76,76,1.316032,103.888518
387571,0,497,497,1.316071,103.88855
387572,31,955,986,1.316047,103.888651
387573,2,0,2,1.315965,103.888345
387574,1,198,199,1.316078,103.888854
387575,9,249,258,1.316327,103.88902
387576,0,973,973,1.31611,103.888921
387577,1,139,140,1.316331,103.889049
387578,1,75,76,1.316091,103.888942
387580,16,40,56,1.316122,103.88899
387581,1,70,71,1.316336,103.889108
387582,0,27,27,1.316133,103.889067
387583,0,1,1,1.315835,103.887661
387584,0,12,12,1.316135,103.88908
387585,0,161,161,1.316349,103.889164
387586,0,16,16,1.316107,103.889134
387587,1,0,1,1.316346,103.889144
387589,7,563,570,1.316364,103.889226
387590,0,48,48,1.31617,103.889261
387592,1,183,184,1.316331,103.890166
387593,0,684,684,1.316344,103.890219
387594,5,0,5,1.316346,103.890299
387595,3,328,331,1.31639,103.89035
387596,1,644,645,1.316374,103.890395
387597,2,2,4,1.316359,103.890458
387598,24,2941,2965,1.316369,103.890497
387599,6,7,13,1.316813,103.891366
387600,103,2899,3002,1.316856,103.891686
387601,1,2373,2374,1.315669,103.886917
387602,0,36,36,1.315674,103.886946
387603,39,70,109,1.316163,103.889567
387604,44,3336,3380,1.314882,103.882927
387605,10,220,230,1.315906,103.888017
387606,71,4,75,1.314514,103.879375
387607,279,123,402,1.315869,103.886505
387621,283,14,297,1.326166,103.882253
387622,4,499,503,1.326208,103.880989
387623,0,24,24,1.326208,103.881142
387624,2,2,4,1.326208,103.881241
387625,1,32,33,1.326198,103.88132
387626,18,12,30,1.326173,103.881428
387627,0,1,1,1.316353,103.889193
387628,285,0,285,1.326124,103.881759
387629,1,3,4,1.326099,103.881892
387630,1,4,5,1.32609,103.881937
387632,4,0,4,1.325841,103.882257
387633,27,22,49,1.325849,103.882317
387634,3,1,4,1.326028,103.882403
387635,63,45,108,1.325761,103.882643
387637,20,46,66,1.325799,103.883137
387639,195,264,459,1.326021,103.882815
387640,7,3,10,1.326174,103.881429
387713,25,230,255,1.325678,103.881521
387714,23,108,131,1.325091,103.882209
387715,134,268,402,1.325034,103.882299
387716,4,142,146,1.325656,103.881727
387717,2,65,67,1.325645,103.881766
387718,5,3,8,1.325608,103.881884
387720,22,0,22,1.32557,103.882054
387721,10,8,18,1.325367,103.883524
387722,6,27,33,1.325488,103.882537
387723,5,14,19,1.325591,103.881912
387724,390,706,1096,1.324557,103.881618
387725,28,611,639,1.325559,103.881193
387726,10,271,281,1.299509,103.837
387727,527,178,705,1.324688,103.883025
387749,0,1,1,1.326173,103.881428
387750,1,2,3,1.314682,103.880245
387751,8,352,360,1.312569,103.875745
387757,40,34,74,1.312591,103.875767
387780,1,157,158,1.313838,103.879222
387781,0,1,1,1.312556,103.875698
387782,0,15,15,1.313862,103.879316
387783,0,1,1,1.313846,103.879254
387784,1,17,18,1.313893,103.879441
387785,10,2,12,1.313909,103.879504
387786,3,0,3,1.312555,103.875697
387787,0,11,11,1.313957,103.879692
387788,15,20,35,1.313973,103.879754
387789,1,0,1,1.313878,103.879379
387790,6,88,94,1.314036,103.880004
387791,42,218,260,1.314042,103.880057
387812,75,57,132,1.315053,103.891362
387813,5,14,19,1.315037,103.891385
387814,9,30,39,1.315115,103.891351
387815,2,3,5,1.315083,103.891377
387816,21,12,33,1.315238,103.89133
387817,6,6,12,1.315173,103.891361
387818,7,12,19,1.315361,103.891308
387819,2,8,10,1.315264,103.891345
387820,19,11,30,1.315484,103.891286
387821,31,11,42,1.315355,103.891329
387822,53,16,69,1.315607,103.891265
387823,62,7,69,1.315445,103.891313
387824,9,19,28,1.31573,103.891243
387825,58,11,69,1.315536,103.891297
387826,15,12,27,1.315853,103.891222
387827,23,7,30,1.315626,103.891281
387828,45,15,60,1.315976,103.8912
387829,8,12,20,1.315717,103.891265
387830,4,18,22,1.316099,103.891178
387831,14,10,24,1.315808,103.891249
387832,25,15,40,1.316222,103.891157
387833,14,15,29,1.315898,103.891234
387834,6,4,10,1.316345,103.891135
387835,3,2,5,1.315989,103.891218
387836,13,38,51,1.316468,103.891113
387837,7,13,20,1.31608,103.891202
387838,43,4,47,1.31617,103.891186
387839,5,6,11,1.31575,103.891113
387840,7,6,13,1.316261,103.89117
387841,12,4,16,1.316351,103.891154
387842,1,143,144,1.316442,103.891138
387843,38,862,900,1.316714,103.89109
387844,58,4,62,1.31542,103.891195
387865,50,86,136,1.314975,103.890746
387866,314,35,349,1.315091,103.890727
387867,16,13,29,1.315207,103.890707
387869,55,115,170,1.31544,103.890667
387874,4,7,11,1.316136,103.890549
387875,1,0,1,1.31402,103.879942
387876,0,22,22,1.316369,103.890509
387877,6,3,9,1.316485,103.89049
387878,60,377,437,1.316601,103.89047
387882,634,293,927,1.315402,103.89071
387901,174,167,341,1.314844,103.889623
387902,85,18,103,1.314786,103.889649
387903,32,12,44,1.315048,103.889601
387904,108,189,297,1.314932,103.889633
387905,3,28,31,1.315455,103.889556
387906,94,28,122,1.315807,103.889967
387907,73,149,222,1.315982,103.890011
387908,18,9,27,1.316273,103.889771
387909,2,0,2,1.316325,103.888994
387911,0,39,39,1.315977,103.889657
387912,28,1411,1439,1.316231,103.889772
387913,6,1,7,1.316475,103.889876
387914,180,100,280,1.315127,103.889577
387934,4,98,102,1.314505,103.888646
387935,210,1,211,1.314496,103.888644
387937,1,37,38,1.314608,103.888628
387938,1,80,81,1.314807,103.888602
387939,15,7,22,1.314832,103.888596
387940,130,5,135,1.315009,103.888573
387941,16,53,69,1.315056,103.888563
387942,0,54,54,1.31521,103.888544
387943,12,26,38,1.31528,103.888531
387944,12,60,72,1.315476,103.888513
387945,440,13,453,1.315645,103.888581
387946,7,45,52,1.315705,103.888616
387949,0,8,8,1.316076,103.888781
387951,68,1,69,1.316262,103.888863
387972,10,35,45,1.314285,103.887929
387973,1,36,37,1.314327,103.88792
387975,1,36,37,1.314412,103.887901
387976,2,25,27,1.314498,103.887882
387977,164,48,212,1.314288,103.887949
387978,2,24,26,1.314583,103.887863
387980,30,22,52,1.314668,103.887843
387981,10,53,63,1.314838,103.887805
387982,33,59,92,1.314612,103.887876
387983,3,20,23,1.315094,103.887748
387985,14,25,39,1.315264,103.88771
387986,29,23,52,1.315075,103.887772
387987,24,31,55,1.315261,103.88773
387988,24,45,69,1.315501,103.887737
387989,21,35,56,1.315407,103.887723
387990,14,39,53,1.315658,103.887817
387991,44,10,54,1.315585,103.8878
387992,1,1166,1167,1.315814,103.887898
387993,3,55,58,1.316049,103.888018
387994,0,159,159,1.31592,103.887972
387995,0,2,2,1.315756,103.889568
387997,3,457,460,1.316078,103.888048
388018,7,313,320,1.314119,103.887094
388021,550,0,550,1.314381,103.887049
388022,3,0,3,1.313941,103.879629
388023,3,0,3,1.314485,103.887031
388024,3,167,170,1.314595,103.887015
388025,4,0,4,1.314694,103.886994
388026,1,6,7,1.314722,103.886993
388028,1,0,1,1.316253,103.890529
388029,69,346,415,1.315321,103.886886
388030,118,6,124,1.315426,103.886867
388031,17,20,37,1.31561,103.886839
388034,31,22,53,1.315828,103.886807
388035,5,819,824,1.315828,103.886789
388038,65,20,85,1.315356,103.886883
388039,418,1,419,1.314214,103.887081
388040,0,1,1,1.315112,103.886922
388058,9,28,37,1.313807,103.885555
388059,1,421,422,1.313848,103.885567
388060,11,52,63,1.313824,103.88554
388061,3,1,4,1.314399,103.886325
388062,8,9,17,1.314391,103.886318
388063,2,34,36,1.313882,103.885557
388064,110,32,142,1.314012,103.885616
388065,38,259,297,1.313998,103.885592
388066,9,6,15,1.314579,103.886292
388067,204,3,207,1.314601,103.886257
388068,7,1,8,1.314794,103.886113
388069,17,9,26,1.314346,103.885694
388070,14,171,185,1.314578,103.885763
388071,1,15,16,1.315065,103.886137
388072,46,145,191,1.31481,103.885832
388073,14,169,183,1.31467,103.88581
388074,107,47,154,1.314926,103.885866
388078,2,9,11,1.315158,103.885935
388080,2,303,305,1.315506,103.886037
388081,23,3837,3860,1.31569,103.886091
388082,6,399,405,1.316262,103.886487
388083,1,6,7,1.316342,103.886561
388084,2,125,127,1.316403,103.886611
388105,39,73,112,1.314148,103.884989
388106,144,45,189,1.314419,103.885075
388107,50,148,198,1.314663,103.885055
388112,50,3,53,1.314708,103.884792
388114,4,400,404,1.314844,103.884813
388115,1,3,4,1.315195,103.884883
388116,9,2,11,1.314983,103.884839
388117,13,1,14,1.315358,103.884914
388121,1,11,12,1.315123,103.884866
388124,0,4,4,1.315519,103.884943
388125,0,44,44,1.315262,103.884892
388126,1,38,39,1.315401,103.884918
388127,5,1619,1624,1.31553,103.884934
388133,844,983,1827,1.314408,103.884624
388134,209,29,238,1.313731,103.884604
388153,89,43,132,1.31348,103.883756
388154,8,30,38,1.313479,103.883755
388155,3,51,54,1.313479,103.883755
388156,1,48,49,1.313529,103.883755
388157,1,52,53,1.313528,103.883754
388158,223,106,329,1.313627,103.883753
388159,5,258,263,1.314327,103.883587
388160,3,30,33,1.314413,103.883736
388161,0,11,11,1.314511,103.883734
388162,1,29,30,1.31461,103.883732
388163,1,6,7,1.314708,103.88373
388164,32,3,35,1.314468,103.883755
388165,3,11,14,1.314904,103.883725
388170,21,1,22,1.315101,103.883721
388174,4,14,18,1.314986,103.883744
388175,0,52,52,1.31509,103.883741
388176,17,5702,5719,1.315333,103.883724
388177,6,1,7,1.31537,103.883731
388178,3,85,88,1.315297,103.883737
388180,3,184,187,1.315516,103.88376
388181,45,47,92,1.315588,103.883775
388182,3,15,18,1.315661,103.883789
388183,17,16,33,1.315734,103.883804
388184,11,1,12,1.315807,103.883818
388185,2,7,9,1.31588,103.883833
388186,0,3,3,1.31459,103.887012
388187,8,12,20,1.316026,103.883862
388188,3,5,8,1.316099,103.883876
388189,23,16,39,1.316171,103.883891
388190,0,5,5,1.316244,103.883905
388191,25,18,43,1.316317,103.88392
388192,6,25,31,1.31639,103.883934
388193,3,218,221,1.315347,103.883747
388194,2,31,33,1.315396,103.883757
388195,10,12,22,1.316092,103.883895
388196,3,26,29,1.316191,103.883915
388197,5,18,23,1.316291,103.883934
388198,6,46,52,1.31638,103.883944
388199,896,30,926,1.313483,103.883776
388219,2,48,50,1.313336,103.8831
388220,31,38,69,1.313377,103.883099
388221,28,15,43,1.313459,103.883098
388222,29,53,82,1.313961,103.883281
388224,20,96,116,1.314258,103.883248
388225,2,0,2,1.316088,103.888038
388227,2,9,11,1.313788,103.883095
388228,0,7,7,1.31387,103.883094
388229,8,13,21,1.313952,103.883093
388230,32,16,48,1.314199,103.88309
388232,2,8,10,1.314281,103.883089
388233,43,28,71,1.314389,103.883278
388234,1,2,3,1.315953,103.883847
388235,4,16,20,1.314466,103.883289
388236,1,2,3,1.314363,103.883088
388237,0,14,14,1.314486,103.883281
388238,0,15,15,1.314528,103.883086
388239,13,56,69,1.314534,103.883284
388240,13,69,82,1.31461,103.883085
388241,7,2,9,1.314692,103.883084
388242,238,76,314,1.3147,103.883247
388243,3,14,17,1.314774,103.883084
388244,72,102,174,1.314853,103.883288
388247,6,52,58,1.315063,103.883281
388248,17,7055,7072,1.315356,103.88325
388249,1,180,181,1.315419,103.883278
388250,5,232,237,1.315458,103.883257
388251,2,96,98,1.315478,103.883292
388252,3,230,233,1.315558,103.883272
388253,7,39,46,1.31559,103.883327
388255,5,64,69,1.315695,103.883318
388256,6,57,63,1.315751,103.883319
388257,8,47,55,1.31583,103.883331
388258,23,75,98,1.315875,103.883363
388259,9,81,90,1.315918,103.883347
388260,10,164,174,1.315987,103.88338
388261,8,175,183,1.316124,103.883388
388262,0,112,112,1.316178,103.883368
388263,8,93,101,1.316238,103.883376
388264,13,38,51,1.316291,103.883383
388265,4,1,5,1.316328,103.883401
388266,3,0,3,1.314445,103.883087
388286,11,0,11,1.313297,103.882906
388287,2,28,30,1.313324,103.882915
388288,5,70,75,1.313372,103.882894
388289,1,85,86,1.313469,103.882853
388290,0,8,8,1.313566,103.882812
388291,3,7,10,1.313451,103.882841
388292,1,14,15,1.313664,103.882772
388293,7,12,19,1.314099,103.8824
388294,0,8,8,1.313761,103.882731
388295,2,9,11,1.313858,103.88269
388296,0,10,10,1.313955,103.882649
388297,0,3,3,1.314939,103.883261
388298,0,7,7,1.314149,103.882567
388299,9,29,38,1.314254,103.882348
388300,13,4,17,1.314294,103.882525
388301,0,3,3,1.314052,103.882608
388302,211,86,297,1.314385,103.882301
388304,2,110,112,1.314767,103.882491
388305,46,2,48,1.314873,103.882484
388306,0,20,20,1.314066,103.882582
388307,12,31,43,1.315083,103.882469
388308,9,70,79,1.31411,103.882564
388309,18,4830,4848,1.314934,103.88231
388310,304,23,327,1.316169,103.882721
388352,190,46,236,1.313191,103.881407
388353,11,71,82,1.313043,103.881463
388354,15,69,84,1.31309,103.881458
388355,0,34,34,1.313184,103.88145
388356,19,74,93,1.313371,103.881433
388357,0,38,38,1.313465,103.881424
388358,1,58,59,1.313559,103.881416
388359,0,20,20,1.313653,103.881407
388360,0,18,18,1.313747,103.881399
388361,0,18,18,1.313841,103.88139
388362,2,29,31,1.313934,103.881382
388363,1,16,17,1.314028,103.881373
388364,9,27,36,1.314122,103.881364
388365,0,26,26,1.314216,103.881356
388366,1,15,16,1.31431,103.881347
388367,1,49,50,1.314404,103.881339
388368,30,25,55,1.314498,103.88133
388369,28,3058,3086,1.314887,103.881284
388371,196,57,253,1.314912,103.881283
388372,6,23,29,1.314685,103.881313
388373,0,39,39,1.314779,103.881305
388374,3,48,51,1.314863,103.881306
388375,29,491,520,1.314964,103.881302
388376,14,224,238,1.315054,103.881301
388377,1,330,331,1.315137,103.881291
388378,2,84,86,1.315253,103.881261
388379,0,5,5,1.315302,103.881257
388380,10,24,34,1.315266,103.88128
388381,83,1937,2020,1.3154,103.881271
388383,3,5,8,1.315448,103.881248
388384,1,20,21,1.315668,103.881254
388385,4,601,605,1.315802,103.881245
388386,85,62,147,1.315741,103.881229
388387,32,3787,3819,1.316473,103.881201
388390,4,137,141,1.316483,103.881191
388391,1,23,24,1.316873,103.881178
388392,1,33,34,1.317272,103.881156
388393,5,49,54,1.317337,103.881151
388394,0,63,63,1.317531,103.881136
388396,0,96,96,1.317661,103.881125
388397,7,81,88,1.31779,103.881115
388398,432,145,577,1.31792,103.881105
388399,60,455,515,1.317447,103.88109
388401,2,64,66,1.317919,103.880982
388402,13,77,90,1.317918,103.880778
388403,0,20,20,1.317918,103.880778
388404,12,10,22,1.317917,103.880572
388405,58,679,737,1.317926,103.88048
388407,7,54,61,1.317906,103.88048
388409,168,88,256,1.316721,103.881455
388410,195,281,476,1.317572,103.881411
388428,2,17,19,1.315214,103.880435
388429,10,4,14,1.315454,103.880303
388430,16,16,32,1.31553,103.880424
388431,32,11,43,1.315688,103.880384
388432,4,21,25,1.315596,103.880267
388452,10,219,229,1.313182,103.880697
388453,0,40,40,1.312907,103.880168
388455,0,31,31,1.312974,103.880161
388456,1,0,1,1.31415,103.887092
388457,5,0,5,1.313108,103.880148
388459,0,41,41,1.313174,103.880142
388460,1,32,33,1.313241,103.880135
388461,2,12,14,1.313308,103.880129
388462,2,110,112,1.313375,103.880122
388463,1,48,49,1.314991,103.879711
388464,54,13,67,1.315422,103.879961
388465,0,38,38,1.315659,103.879751
388466,11,68,79,1.315605,103.879486
388467,3,19,22,1.315212,103.879688
388487,8,249,257,1.312977,103.879286
388488,1,105,106,1.313008,103.879283
388489,84,342,426,1.31297,103.879292
388491,0,4,4,1.313005,103.879286
388492,23,73,96,1.313045,103.879281
388493,5,14,19,1.313485,103.879758
388496,0,47,47,1.313563,103.879219
388497,0,49,49,1.313625,103.879212
388498,0,52,52,1.313687,103.879205
388499,0,124,124,1.313748,103.879198
388500,6,44,50,1.31381,103.879191
388501,3,99,102,1.313823,103.879188
388502,111,2,113,1.313836,103.879185
388503,0,7,7,1.313862,103.87918
388504,0,52,52,1.313888,103.879174
388507,3,4,7,1.31483,103.878972
388508,2,2,4,1.31496,103.878928
388509,1,4,5,1.314994,103.878941
388510,0,1,1,1.313041,103.880155
388511,1,9,10,1.315252,103.878843
388512,4,24,28,1.31551,103.878767
388513,39,17,56,1.315217,103.878641
388514,20,18,38,1.314562,103.879046
388534,7,30,37,1.312904,103.878828
388535,1,11,12,1.312925,103.878823
388536,1,92,93,1.312908,103.878807
388537,0,11,11,1.312967,103.878815
388538,1,41,42,1.312932,103.878802
388539,1,5,6,1.313009,103.878806
388540,2,20,22,1.312982,103.878792
388541,6,6,12,1.313051,103.878797
388542,1,19,20,1.313031,103.878781
388543,0,11,11,1.313093,103.878789
388544,0,15,15,1.313081,103.878771
388545,1,15,16,1.313135,103.87878
388546,3,38,41,1.31313,103.878761
388547,21,20,41,1.31318,103.878751
388549,0,21,21,1.313229,103.878741
388550,10,6,16,1.313279,103.878731
388551,0,9,9,1.313328,103.87872
388552,1,59,60,1.313378,103.87871
388553,1,33,34,1.313427,103.8787
388554,1,53,54,1.313477,103.87869
388555,0,2,2,1.313624,103.883096
388557,3,5,8,1.313576,103.87867
388559,2,7,9,1.313625,103.878659
388560,10,6,16,1.313675,103.878649
388561,3,127,130,1.31364,103.878676
388563,0,9,9,1.313682,103.878668
388564,2,24,26,1.313753,103.878633
388565,0,15,15,1.313724,103.878659
388566,6,31,37,1.314852,103.877989
388567,2,22,24,1.313822,103.878639
388568,21,7,28,1.314827,103.878669
388570,12,753,765,1.315197,103.878425
388571,168,885,1053,1.315261,103.877889
388572,3,1399,1402,1.315903,103.877732
388573,10,11,21,1.315668,103.877448
388575,956,143,1099,1.313261,103.878754
388576,4,566,570,1.314852,103.878427
388577,2,0,2,1.313526,103.87868
388595,3,1,4,1.312853,103.878292
388596,5,160,165,1.312862,103.878337
388597,0,7,7,1.312893,103.878282
388598,52,1,53,1.312953,103.878272
388599,2,68,70,1.313017,103.87829
388600,14,4,18,1.313001,103.878255
388601,1,67,68,1.31312,103.878258
388603,6,35,41,1.313223,103.878227
388604,1,1,2,1.299509,103.837
388605,0,72,72,1.313327,103.878195
388606,10,97,107,1.31343,103.878163
388607,286,16,302,1.313192,103.878186
388608,26,25,51,1.31331,103.878153
388609,0,106,106,1.313636,103.8781
388611,0,163,163,1.31374,103.878068
388612,2,0,2,1.313114,103.878207
388613,2,72,74,1.31405,103.877974
388614,1,2,3,1.314347,103.882521
388615,8,57,65,1.314143,103.877952
388616,6,0,6,1.313619,103.878073
388617,0,1,1,1.315005,103.878909
388618,5,186,191,1.313774,103.878018
388619,266,112,378,1.313843,103.878037
388639,32,90,122,1.312423,103.877715
388640,3,5,8,1.312427,103.877734
388641,0,9,9,1.312478,103.877699
388642,2,25,27,1.312486,103.877716
388643,0,31,31,1.312588,103.877666
388644,3,1,4,1.312638,103.877694
388645,0,12,12,1.312698,103.877633
388647,0,51,51,1.312807,103.8776
388648,2,15,17,1.312909,103.877628
388649,0,24,24,1.312917,103.877567
388651,11,29,40,1.313027,103.877534
388653,1,1,2,1.313493,103.87812
388654,4,23,27,1.313145,103.877493
388656,1,4,5,1.313145,103.877493
388657,0,21,21,1.313145,103.877493
388659,4,46,50,1.313196,103.877503
388660,54,21,75,1.313247,103.877467
388661,0,14,14,1.313314,103.877467
388662,1,22,23,1.313357,103.877434
388663,0,33,33,1.313433,103.877431
388664,0,25,25,1.313467,103.877401
388665,4,30,34,1.313551,103.877396
388666,25,23,48,1.313576,103.877368
388667,0,19,19,1.313669,103.87736
388668,10,3,13,1.313686,103.877335
388669,0,41,41,1.313788,103.877325
388670,201,21,222,1.313796,103.877302
388671,0,30,30,1.313906,103.877289
388672,309,1793,2102,1.313896,103.877279
388674,2,0,2,1.313145,103.877493
388693,6,6,12,1.312287,103.877168
388694,1,18,19,1.312294,103.877184
388695,0,19,19,1.3123,103.87717
388696,1,24,25,1.31232,103.87717
388697,13,3,16,1.312343,103.877156
388698,0,16,16,1.312363,103.877156
388699,0,1,1,1.313684,103.878048
388700,8,3,11,1.312448,103.87713
388701,1,59,60,1.312512,103.877103
388702,1,1,2,1.299509,103.837
388703,56,0,56,1.312597,103.877076
388704,7,4,11,1.312617,103.877076
388705,1,32,33,1.312682,103.87705
388706,0,1,1,1.312428,103.87713
388708,0,12,12,1.312787,103.877023
388709,1,3,4,1.312852,103.876996
388710,1,10,11,1.312872,103.876996
388711,0,6,6,1.312937,103.87697
388712,2,6,8,1.312957,103.87697
388713,1,8,9,1.313021,103.876943
388714,1,19,20,1.313041,103.876943
388715,0,7,7,1.313106,103.876917
388716,2,29,31,1.313126,103.876917
388717,4,11,15,1.313191,103.87689
388718,16,1,17,1.313211,103.87689
388719,3,11,14,1.313276,103.876863
388720,2,44,46,1.313296,103.876863
388721,2,9,11,1.313361,103.876837
388723,10,19,29,1.313446,103.87681
388724,2,15,17,1.313466,103.87681
388725,6,15,21,1.31353,103.876783
388726,12,44,56,1.31355,103.876783
388727,30,1532,1562,1.313615,103.876757
388728,2,18,20,1.313635,103.876757
388730,12,2399,2411,1.31371,103.87674
388751,1,316,317,1.312156,103.876533
388752,6,110,116,1.312265,103.876523
388753,8,0,8,1.312229,103.876513
388754,2,10,12,1.312446,103.876473
388755,10,79,89,1.312374,103.876473
388756,1,4,5,1.312808,103.876374
388757,0,9,9,1.312518,103.876433
388758,43,83,126,1.31317,103.876274
388759,55,93,148,1.312663,103.876393
388760,11,73,84,1.312879,103.876598
388761,13,82,95,1.313098,103.876274
388763,70,45,115,1.313387,103.876194
388764,5,290,295,1.313522,103.876164
388785,3,6,9,1.311914,103.876011
388787,6,53,59,1.311966,103.875994
388789,35,14,49,1.312422,103.875794
388790,68,28,96,1.312446,103.875872
388791,2,40,42,1.312172,103.875927
388792,862,21,883,1.312548,103.875828
388793,3,0,3,1.313556,103.878095
388794,0,26,26,1.312377,103.875859
388795,0,52,52,1.312794,103.875736
388796,0,5,5,1.312986,103.875681
388798,5,146,151,1.313117,103.875659
388799,2,72,74,1.31271,103.875755
388800,0,245,245,1.313297,103.875611
388802,8,49,57,1.313093,103.875644
388803,7,101,108,1.313287,103.875572
388829,9,89,98,1.312356,103.875031
388831,7,55,62,1.312414,103.875038
388832,1,624,625,1.312953,103.875266
388833,0,233,233,1.312917,103.875259
388837,1,800,801,1.312703,103.875361
388838,3,146,149,1.312794,103.875339
388859,9,508,517,1.311478,103.874496
388860,3,4,7,1.311645,103.874432
388861,34,370,404,1.311884,103.874354
388862,13,272,285,1.312025,103.874277
388868,2,140,142,1.313627,103.873721
388869,500,584,1084,1.314252,103.873428
388871,0,43,43,1.317244,103.873157
388872,3,461,464,1.318234,103.873896
388874,0,19,19,1.318239,103.873912
388876,0,25,25,1.318249,103.873944
388877,1,0,1,1.312702,103.87705
388878,0,21,21,1.318259,103.873976
388880,0,57,57,1.318269,103.874008
388882,0,101,101,1.318281,103.874021
388884,0,74,74,1.318305,103.874047
388886,0,32,32,1.318327,103.87407
388888,0,41,41,1.318357,103.874065
388889,0,1,1,1.31726,103.873258
388890,0,38,38,1.318387,103.87406
388891,1,0,1,1.317299,103.8735
388892,0,21,21,1.318417,103.874054
388894,0,35,35,1.318447,103.874049
388895,1,0,1,1.317305,103.873541
388896,0,55,55,1.318477,103.874044
388898,0,112,112,1.318506,103.874039
388900,0,124,124,1.318536,103.874034
388902,0,110,110,1.318566,103.874029
388903,0,1,1,1.317318,103.873621
388904,0,236,236,1.318596,103.874023
388906,0,97,97,1.318626,103.874018
388908,0,52,52,1.318656,103.874013
388910,0,40,40,1.318686,103.874008
388912,0,42,42,1.318716,103.874003
388914,0,29,29,1.318746,103.873997
388916,1,34,35,1.318776,103.873992
388918,0,48,48,1.318806,103.873987
388919,0,5,5,1.317395,103.874106
388920,0,74,74,1.318835,103.873982
388921,0,14,14,1.317401,103.874146
388922,0,104,104,1.318865,103.873977
388923,0,7,7,1.317408,103.874187
388924,0,117,117,1.318895,103.873972
388925,2,112,114,1.317414,103.874227
388926,1,557,558,1.318925,103.873966
388927,0,6,6,1.317431,103.874205
388931,0,1,1,1.317344,103.873783
388935,2,1,3,1.312699,103.875764
388939,0,1,1,1.31742,103.87414
388940,0,1,1,1.317365,103.873791
388942,0,2,2,1.312532,103.877103
388943,0,1,1,1.317358,103.873747
388944,0,2,2,1.317344,103.87366
388946,0,1,1,1.317337,103.873617
388949,0,1,1,1.317316,103.873486
388952,0,2,2,1.31733,103.873573
388953,1,1,2,1.317275,103.873224
388954,1,89,90,1.317261,103.873137
388955,3,94,97,1.317629,103.873013
388958,2,0,2,1.317268,103.873181
388959,1,0,1,1.317296,103.873355
388960,0,1,1,1.317652,103.873156
388961,0,1,1,1.317659,103.873197
388962,1,0,1,1.317665,103.873238
388965,1,0,1,1.317672,103.873279
388967,0,1,1,1.317691,103.873402
388968,2,1,3,1.317392,103.873965
388969,0,1,1,1.317704,103.873484
388977,0,1,1,1.317717,103.873567
388978,0,4,4,1.317776,103.873936
388979,0,1,1,1.317769,103.873895
388981,0,1,1,1.317782,103.873977
388983,0,1,1,1.317805,103.873996
388988,1,2,3,1.317711,103.873526
388989,0,1,1,1.317795,103.873929
388990,0,1,1,1.317752,103.873661
388992,1,1,2,1.317646,103.873115
388993,1,2,3,1.317759,103.873706
388997,1,0,1,1.317745,103.873617
389000,0,1,1,1.317696,103.873304
389004,0,53,53,1.317646,103.872992
389005,0,211,211,1.318056,103.872868
389006,0,2,2,1.317731,103.873527
389007,1,1,2,1.31806,103.87289
389008,1,7,8,1.318075,103.872977
389010,0,1,1,1.317674,103.87317
389011,0,2,2,1.318068,103.872933
389012,0,1,1,1.318091,103.873064
389013,0,3,3,1.317724,103.873483
389015,0,2,2,1.318099,103.873107
389016,0,1,1,1.318107,103.873151
389017,0,1,1,1.318138,103.873325
389018,0,2,2,1.31813,103.873281
389019,0,1,1,1.318146,103.873368
389020,0,1,1,1.318161,103.873455
389021,0,1,1,1.318169,103.873499
389024,0,1,1,1.318177,103.873542
389025,0,3,3,1.318114,103.873194
389026,0,5,5,1.318216,103.87376
389027,0,11,11,1.318223,103.873803
389028,0,5,5,1.318231,103.873846
389029,0,198,198,1.318229,103.87388
389030,0,24,24,1.318235,103.873845
389031,0,1,1,1.3182,103.873672
389032,0,1,1,1.31823,103.87382
389033,0,3,3,1.318208,103.873716
389034,0,2,2,1.318153,103.873412
389035,2,0,2,1.318203,103.873671
389036,0,2,2,1.318194,103.873621
389038,0,1,1,1.318221,103.873771
389039,0,1,1,1.318168,103.873472
389040,0,1,1,1.318159,103.873423
389041,0,3,3,1.318212,103.873721
389042,1,2,3,1.318141,103.873323
389044,0,1,1,1.31815,103.873373
389045,0,1,1,1.318114,103.873174
389046,0,2,2,1.318186,103.873572
389047,1,3,4,1.318088,103.873025
389048,0,2,2,1.318097,103.873075
389050,0,1,1,1.318105,103.873124
389051,0,259,259,1.318062,103.872836
389052,0,4,4,1.318331,103.872781
389054,2,0,2,1.318079,103.872975
389056,4,5,9,1.318476,103.872943
389057,0,4,4,1.318502,103.873004
389060,0,1,1,1.318061,103.872876
389061,0,1,1,1.31854,103.873162
389062,1,2,3,1.318132,103.873273
389071,1,14,15,1.318644,103.873825
389072,0,34,34,1.318664,103.873825
389074,0,1,1,1.318549,103.873222
389075,4,0,4,1.318643,103.873692
389076,0,1,1,1.318651,103.873745
389078,1,0,1,1.318635,103.873638
389080,1,0,1,1.318618,103.873532
389082,0,2,2,1.318393,103.87285
389084,0,1,1,1.318601,103.873425
389087,0,2,2,1.318584,103.873319
389089,1,0,1,1.318568,103.873212
389090,21,1,22,1.318478,103.872922
389092,5,82,87,1.318404,103.87284
389115,13,189,202,1.310584,103.872617
389116,36,127,163,1.310654,103.872592
389117,63,196,259,1.310793,103.872541
389118,14,181,195,1.310933,103.87249
389119,23,128,151,1.311072,103.872439
389120,31,1260,1291,1.311202,103.872398
389141,7,5,12,1.311226,103.872684
389142,7,28,35,1.31123,103.87275
389143,30,8,38,1.31123,103.872831
389144,146,0,146,1.311229,103.872901
389145,1,48,49,1.311229,103.872967
389146,0,2,2,1.318542,103.873067
389192,3,1063,1066,1.30936,103.871157
389193,5,420,425,1.30936,103.871152
389194,13,1160,1173,1.310586,103.872686
389195,1,365,366,1.310607,103.872731
389196,5,361,366,1.310622,103.87277
389197,44,315,359,1.31064,103.872812
389198,3,300,303,1.310661,103.872858
389199,6,306,312,1.310679,103.872907
389200,2,343,345,1.310698,103.872965
389201,0,286,286,1.310714,103.873013
389202,1,184,185,1.310726,103.873055
389203,139,387,526,1.310741,103.873095
389204,8,322,330,1.310757,103.873134
389205,11,389,400,1.310774,103.873187
389206,3,176,179,1.310789,103.873229
389207,1,249,250,1.310807,103.873269
389208,3,184,187,1.310826,103.873313
389211,0,197,197,1.310845,103.873347
389212,0,259,259,1.31086,103.873394
389213,3,253,256,1.310876,103.87344
389214,2,287,289,1.310888,103.873477
389215,0,49,49,1.310912,103.873517
389216,2,62,64,1.310931,103.873559
389217,1,5,6,1.310944,103.873602
389218,13,717,730,1.31096,103.873643
389220,3,238,241,1.310983,103.873694
389221,0,253,253,1.311004,103.873742
389223,89,357,446,1.311025,103.873795
389224,1,18,19,1.311045,103.873841
389225,1,2,3,1.318559,103.873283
389226,19,1,20,1.311077,103.873936
389227,3,277,280,1.311096,103.87398
389228,2,465,467,1.311114,103.874027
389229,1,813,814,1.31113,103.874072
389230,1,39,40,1.31115,103.874117
389231,0,12,12,1.311169,103.874162
389232,0,80,80,1.311187,103.874207
389233,4,8,12,1.311205,103.874251
389237,3,548,551,1.311263,103.87444
389238,4,2430,2434,1.311271,103.874469
389239,29,171,200,1.311287,103.874505
389240,34,166,200,1.311308,103.874563
389242,16,1,17,1.311327,103.874608
389243,5,2811,2816,1.311337,103.874629
389245,9,0,9,1.311348,103.874655
389247,23,348,371,1.311358,103.874671
389252,8,2230,2238,1.311752,103.875823
389253,3,741,744,1.311771,103.875879
389254,5,1162,1167,1.311795,103.875939
389255,0,1092,1092,1.311833,103.876025
389257,10,4353,4363,1.311865,103.876109
389259,0,5,5,1.311884,103.876173
389261,0,3,3,1.311063,103.873889
389263,4,6,10,1.311938,103.876283
389265,2,0,2,1.311229,103.873073
389266,6,1166,1172,1.311759,103.87568
389267,0,323,323,1.311982,103.876409
389268,1,1039,1040,1.311993,103.876433
389269,33,4578,4611,1.312015,103.876472
389270,8,6837,6845,1.312037,103.876507
389271,9,3348,3357,1.311821,103.87584
389272,8,16,24,1.31207,103.876601
389273,6,2234,2240,1.31186,103.875943
389274,16,2710,2726,1.312112,103.87672
389276,1,4645,4646,1.312149,103.876816
389277,7,2430,2437,1.311971,103.876213
389278,12,5928,5940,1.312183,103.876937
389279,0,56,56,1.311959,103.876178
389280,2,4628,4630,1.312188,103.876988
389281,1,0,1,1.318496,103.872943
389282,1,1,2,1.311974,103.876381
389283,2,1050,1052,1.311918,103.876089
389284,2,2426,2428,1.312218,103.877094
389285,0,2813,2813,1.312017,103.876343
389286,0,3,3,1.311906,103.876225
389287,2,11,13,1.311999,103.876307
389288,3,4128,4131,1.312251,103.877218
389289,8,1451,1459,1.312033,103.876393
389290,1,12,13,1.312261,103.877286
389291,2,261,263,1.312055,103.876431
389292,7,6307,6314,1.312277,103.877348
389293,12,1955,1967,1.312062,103.876452
389294,50,3937,3987,1.312086,103.876513
389295,7,2302,2309,1.312298,103.877441
389296,30,3790,3820,1.312142,103.876591
389297,0,824,824,1.3123,103.877527
389298,1,1,2,1.312206,103.87704
389299,0,1393,1393,1.312308,103.877582
389300,1,567,568,1.312316,103.877637
389301,1,1179,1180,1.312322,103.877682
389302,0,2070,2070,1.312327,103.87773
389303,3,639,642,1.312334,103.877782
389304,12,1317,1329,1.312233,103.876855
389305,3,326,329,1.312343,103.877836
389306,6,6349,6355,1.312349,103.877886
389307,76,175,251,1.312251,103.876944
389308,8,11,19,1.312356,103.877934
389309,8,2784,2792,1.312323,103.87722
389310,5,6884,6889,1.312365,103.877983
389311,21,13,34,1.31233,103.87729
389312,2,1196,1198,1.312337,103.877342
389313,4,2,6,1.312354,103.877416
389314,3,1574,1577,1.312406,103.878188
389315,37,844,881,1.312416,103.877772
389316,0,2234,2234,1.312411,103.878243
389317,0,347,347,1.31237,103.87748
389318,0,796,796,1.312422,103.878293
389319,5,587,592,1.312378,103.877552
389320,1,530,531,1.312428,103.878342
389321,0,25,25,1.312436,103.878393
389322,1,6732,6733,1.312447,103.878448
389323,6,270,276,1.312474,103.87775
389324,5,953,958,1.312421,103.877816
389325,4,2002,2006,1.312426,103.877863
389327,0,3,3,1.312229,103.877141
389328,2,113,115,1.312446,103.878007
389329,1,927,928,1.312454,103.878055
389331,15,5491,5506,1.312518,103.878949
389332,29,1153,1182,1.312471,103.878177
389333,1,4830,4831,1.312528,103.878997
389334,1,1,2,1.312191,103.876574
389335,2,3,5,1.312539,103.879054
389336,1,2174,2175,1.312497,103.878323
389337,0,206,206,1.312549,103.879106
389338,5,2423,2428,1.312503,103.878388
389339,1,1170,1171,1.312557,103.879165
389340,1,373,374,1.312567,103.879223
389341,1,956,957,1.31258,103.879283
389342,1,2593,2594,1.312588,103.879335
389343,1,2,3,1.312438,103.877955
389344,50,7634,7684,1.312545,103.878641
389345,7,3506,3513,1.312605,103.879422
389346,0,2,2,1.312486,103.878256
389347,4,3895,3899,1.312621,103.879507
389348,0,2,2,1.312611,103.87946
389349,16,4586,4602,1.312639,103.879604
389350,56,4405,4461,1.312589,103.878931
389351,1,23,24,1.312648,103.879651
389352,11,871,882,1.312602,103.879009
389353,9,16982,16991,1.312655,103.87971
389354,4,400,404,1.312614,103.879075
389356,3,347,350,1.312631,103.87916
389357,2,372,374,1.312647,103.879235
389358,1,2318,2319,1.312808,103.879192
389359,15,863,878,1.312659,103.879296
389360,17,2692,2709,1.312748,103.879409
389361,7,184,191,1.312669,103.879361
389362,1,9,10,1.312678,103.879413
389363,1,8,9,1.312688,103.879464
389364,5,7538,7543,1.312697,103.879513
389365,93,14753,14846,1.312545,103.880207
389366,0,2,2,1.312629,103.879555
389367,20,25103,25123,1.312782,103.880621
389368,2,320,322,1.312777,103.879889
389369,3,1125,1128,1.312782,103.880621
389370,8,3174,3182,1.312789,103.879983
389371,4,3661,3665,1.312792,103.880694
389372,14,1518,1532,1.312804,103.880069
389373,5,4144,4149,1.312803,103.880768
389374,3,13,16,1.312813,103.880845
389375,1,3091,3092,1.312826,103.880914
389376,2,5,7,1.312836,103.880985
389377,0,5790,5790,1.312849,103.881052
389378,0,900,900,1.312862,103.881116
389379,4,4771,4775,1.312874,103.88118
389380,8,5253,5261,1.312892,103.881272
389381,4,8306,8310,1.31291,103.88136
389382,4,3636,3640,1.312926,103.881433
389383,4,16,20,1.312939,103.88151
389384,0,1112,1112,1.312953,103.881581
389385,1,4478,4479,1.312967,103.881662
389386,4,25,29,1.312983,103.881744
389387,0,2,2,1.312761,103.879787
389388,3,2125,2128,1.313017,103.881922
389389,4,3335,3339,1.313036,103.88202
389390,8,3514,3522,1.313083,103.882231
389391,4,41,45,1.313129,103.882443
389392,82,1,83,1.313163,103.882635
389393,2,1449,1451,1.313204,103.882822
389395,125,148,273,1.313243,103.88309
389396,17,3801,3818,1.313281,103.883268
389397,6,2240,2246,1.313051,103.88151
389398,0,433,433,1.313071,103.88164
389399,9,1616,1625,1.313205,103.881864
389400,4,9739,9743,1.313296,103.883367
389402,0,95,95,1.313304,103.88342
389403,12,0,12,1.31312,103.881887
389404,2,5097,5099,1.313315,103.883486
389405,0,10,10,1.313328,103.883555
389406,20,721,741,1.313187,103.882242
389407,1,15,16,1.31334,103.883626
389408,1,145,146,1.3132,103.882321
389409,0,439,439,1.313354,103.883695
389410,1,623,624,1.313215,103.882397
389411,4,806,810,1.313368,103.883756
389413,4,1109,1113,1.313382,103.883818
389414,3,655,658,1.313249,103.882554
389415,9,3283,3292,1.313396,103.883877
389417,35,2332,2367,1.313412,103.883962
389418,5,2311,2316,1.31328,103.882701
389419,7,881,888,1.313417,103.884031
389420,1,13,14,1.313297,103.882765
389421,1,164,165,1.313431,103.884102
389422,7,4184,4191,1.31331,103.882838
389423,2,3,5,1.313441,103.88415
389424,0,125,125,1.313326,103.882957
389425,6,2069,2075,1.313448,103.884194
389426,12,2528,2540,1.313336,103.883022
389427,0,2,2,1.313,103.881827
389428,1,2228,2229,1.313356,103.883142
389430,19,39,58,1.313435,103.883143
389431,23,0,23,1.313479,103.884342
389432,2,6,8,1.313511,103.883148
389433,0,11,11,1.313483,103.884377
389434,0,132,132,1.313576,103.883151
389435,3,791,794,1.313497,103.884445
389436,3,5,8,1.313645,103.883154
389437,4,380,384,1.313509,103.884505
389438,4,301,305,1.313688,103.883156
389439,6,392,398,1.313523,103.884567
389440,2,98,100,1.313775,103.883715
389441,0,535,535,1.313535,103.884625
389442,0,345,345,1.313708,103.883714
389443,1,538,539,1.313549,103.88468
389444,1,623,624,1.313639,103.883717
389445,2,2287,2289,1.313561,103.884727
389446,8,1840,1848,1.313576,103.88372
389447,9,76,85,1.31349,103.884743
389448,10,1447,1457,1.31372,103.883814
389449,1,1045,1046,1.313518,103.883723
389450,19,794,813,1.313588,103.884884
389451,0,281,281,1.313465,103.883724
389452,0,136,136,1.313612,103.884985
389453,1,867,868,1.313627,103.883814
389454,2,17,19,1.313634,103.885085
389455,1,55,56,1.313558,103.883815
389456,3,5,8,1.313652,103.885185
389457,1,5,6,1.313522,103.883917
389458,10,11,21,1.313674,103.88529
389459,1,1395,1396,1.313538,103.884004
389460,0,1,1,1.311945,103.876145
389463,3,377,380,1.31356,103.884135
389465,6,705,711,1.313573,103.884184
389466,48,7569,7617,1.313692,103.885384
389468,14,1049,1063,1.313727,103.885572
389469,6,1935,1941,1.313593,103.884311
389470,16,4143,4159,1.313737,103.885627
389471,4,0,4,1.313603,103.884391
389472,6,1605,1611,1.313751,103.885698
389473,10,3171,3181,1.313617,103.884461
389474,3,1199,1202,1.313762,103.885766
389476,2,1014,1016,1.313777,103.88583
389477,3,1356,1359,1.31365,103.884684
389478,0,1018,1018,1.313784,103.885894
389480,5,910,915,1.313799,103.88595
389481,1,80,81,1.313665,103.884754
389482,5,1021,1026,1.313808,103.886017
389483,16,3678,3694,1.313685,103.884851
389484,1,1059,1060,1.313821,103.886074
389485,0,19,19,1.313698,103.884923
389486,4,1318,1322,1.313834,103.886137
389487,7,764,771,1.313706,103.884982
389488,1,2008,2009,1.313847,103.886179
389489,1,4,5,1.313717,103.885041
389490,16,4060,4076,1.313857,103.886228
389491,10,2968,2978,1.313726,103.885098
389492,261,20,281,1.313736,103.885155
389493,26,3682,3708,1.313874,103.886315
389494,0,478,478,1.313744,103.8852
389496,24,382,406,1.313753,103.885242
389498,2,450,452,1.313766,103.885297
389500,4,306,310,1.31378,103.885356
389502,4,1253,1257,1.313796,103.885418
389504,16,163,179,1.313813,103.885479
389509,8,41,49,1.313983,103.886947
389510,9,2803,2812,1.313992,103.887001
389513,0,1,1,1.313546,103.884084
389514,1,2503,2504,1.314033,103.887189
389516,0,1,1,1.314022,103.887139
389517,0,6,6,1.314065,103.887341
389518,5,1117,1122,1.314074,103.887387
389519,0,1,1,1.314055,103.887294
389520,0,484,484,1.314091,103.88748
389521,0,2033,2033,1.314099,103.887522
389522,38,451,489,1.313947,103.886238
389523,0,3,3,1.312598,103.879384
389524,0,1,1,1.314084,103.887437
389525,5,2411,2416,1.314117,103.887603
389526,4,2233,2237,1.313975,103.886377
389527,3,1028,1031,1.314141,103.887697
389529,0,334,334,1.314154,103.887754
389530,1,495,496,1.313992,103.886437
389531,7,269,276,1.314163,103.887818
389532,5,0,5,1.314009,103.886509
389533,3,490,493,1.314176,103.887879
389534,2,314,316,1.31403,103.886592
389535,0,375,375,1.314191,103.887943
389537,0,286,286,1.314196,103.887998
389538,1,307,308,1.314061,103.886775
389539,0,277,277,1.314208,103.888052
389541,0,266,266,1.31422,103.888106
389542,0,29,29,1.314088,103.886886
389543,3,595,598,1.314226,103.888164
389544,3,0,3,1.314106,103.887566
389545,0,1794,1794,1.314235,103.888217
389546,0,1025,1025,1.314107,103.886974
389547,18,5034,5052,1.314261,103.888297
389548,4,461,465,1.314116,103.88703
389549,6,0,6,1.314271,103.888347
389550,5,414,419,1.314137,103.88714
389551,14,0,14,1.31428,103.888392
389552,3,10,13,1.314148,103.887192
389553,1,0,1,1.313965,103.886318
389554,4,1405,1409,1.31416,103.887242
389555,0,153,153,1.314305,103.888479
389558,3,305,308,1.314183,103.887351
389561,1,996,997,1.314199,103.887446
389562,2,0,2,1.313458,103.884233
389563,1,245,246,1.314216,103.887564
389565,1,0,1,1.31429,103.888436
389566,3,975,978,1.314254,103.887752
389568,4,1224,1228,1.314273,103.887866
389569,34,1411,1445,1.31437,103.888845
389570,2,368,370,1.314283,103.887907
389571,2,607,609,1.314298,103.887975
389572,3,453,456,1.314458,103.889113
389573,0,1,1,1.314241,103.887693
389574,3,1498,1501,1.314476,103.889174
389575,1,935,936,1.314314,103.888075
389576,54,0,54,1.314487,103.889239
389577,1,0,1,1.314304,103.888024
389578,71,1420,1491,1.314507,103.889302
389579,0,447,447,1.314335,103.888175
389580,1,2,3,1.314097,103.886928
389582,3,1992,1995,1.314529,103.88943
389583,1,1318,1319,1.314353,103.888278
389584,3,1053,1056,1.314565,103.889592
389585,5,865,870,1.314363,103.888333
389586,7,167,174,1.314579,103.889635
389589,7,0,7,1.314393,103.888438
389590,0,17,17,1.314606,103.889719
389591,0,1,1,1.314326,103.888125
389592,1,483,484,1.314617,103.889758
389593,2,0,2,1.314206,103.887497
389594,1,1103,1104,1.314637,103.889841
389595,2,0,2,1.314626,103.889796
389596,9,3568,3577,1.314467,103.888713
389597,5,493,498,1.314652,103.889938
389598,1,10,11,1.314487,103.888784
389599,3,1163,1166,1.31467,103.890099
389600,1,563,564,1.314498,103.888858
389601,5,2972,2977,1.314685,103.890167
389602,3,387,390,1.314514,103.888928
389603,1,5,6,1.314704,103.890225
389604,0,29,29,1.314712,103.890283
389605,0,7,7,1.314724,103.890336
389606,1,8,9,1.314546,103.889069
389607,5,2366,2371,1.314737,103.890391
389608,0,5,5,1.314752,103.890446
389609,1,1014,1015,1.314764,103.890512
389610,1,1,2,1.314647,103.889888
389611,0,842,842,1.314777,103.890571
389612,0,7,7,1.314787,103.890633
389613,4,53,57,1.314619,103.889393
389614,4,1697,1701,1.3148,103.890697
389615,0,4,4,1.314815,103.890755
389616,4,1589,1593,1.314827,103.890803
389617,1,10,11,1.314635,103.890646
389618,3,1320,1323,1.314834,103.890857
389620,8,27,35,1.314843,103.890895
389621,0,653,653,1.314845,103.890939
389623,0,27,27,1.314855,103.890989
389624,6,2340,2346,1.314647,103.889673
389625,8,697,705,1.314865,103.891031
389626,21,282,303,1.314653,103.889701
389627,0,38,38,1.314871,103.891077
389628,4,1660,1664,1.314882,103.891133
389629,8,697,705,1.314947,103.891211
389630,7,2345,2352,1.314974,103.891307
389631,5,0,5,1.314982,103.891383
389632,4,248,252,1.314712,103.889982
389633,1,236,237,1.315003,103.891455
389634,1,105,106,1.314734,103.890048
389635,4,83,87,1.315015,103.891517
389636,0,108,108,1.31473,103.890066
389637,2,6,8,1.315038,103.891641
389638,1,99,100,1.314735,103.890093
389639,0,2022,2022,1.315061,103.891765
389640,0,147,147,1.314746,103.890148
389641,7,3182,3189,1.315083,103.89189
389642,13,101,114,1.314757,103.890204
389643,1,1307,1308,1.315106,103.892014
389644,1,99,100,1.314769,103.890259
389645,4,565,569,1.315129,103.892138
389646,1,110,111,1.31478,103.890314
389647,5,1428,1433,1.315142,103.892252
389648,0,84,84,1.314791,103.890369
389649,0,146,146,1.314802,103.890425
389650,1,406,407,1.314801,103.890424
389651,2,62,64,1.314813,103.89048
389652,0,193,193,1.314824,103.890535
389653,6,355,361,1.314836,103.89059
389654,0,217,217,1.314847,103.890646
389655,4,606,610,1.314858,103.890701
389656,13,1352,1365,1.314879,103.890766
389657,14,3026,3040,1.314873,103.890778
389658,1,762,763,1.314878,103.8908
389659,43,5,48,1.314887,103.890845
389660,0,594,594,1.314895,103.89089
389661,3,331,334,1.314904,103.890934
389662,0,196,196,1.314913,103.890978
389663,3,390,393,1.314922,103.891023
389665,1,484,485,1.314939,103.891112
389666,1,0,1,1.314406,103.888531
389668,3,56,59,1.314967,103.891211
389669,3,237,240,1.314974,103.891287
389670,9,421,430,1.315002,103.891383
389671,2,105,107,1.314999,103.891409
389672,4,955,959,1.315005,103.891445
389673,1,462,463,1.315019,103.891518
389674,0,516,516,1.315032,103.89159
389675,1,0,1,1.314948,103.891156
389676,4,3950,3954,1.315059,103.891735
389678,5,2,7,1.315085,103.89188
389679,1,508,509,1.315099,103.891952
389680,90,6,96,1.315112,103.892025
389681,8,84,92,1.315125,103.892097
389682,0,2,2,1.314576,103.890665
389683,7,2426,2433,1.315162,103.892252
389684,7,278,285,1.314602,103.889315
389685,16,440,456,1.314561,103.889137
389686,13,8,21,1.314574,103.889195
389687,76,1807,1883,1.314641,103.889519
389688,14,2266,2280,1.312461,103.877664
389689,2,696,698,1.314534,103.889006
389705,361,58,419,1.318124,103.8829
389706,206,2485,2691,1.318207,103.88336
389707,579,20902,21481,1.319476,103.887157
389708,15,2601,2616,1.319482,103.887961
389728,186,219,405,1.318756,103.890619
389729,367,209,576,1.318639,103.890658
389730,152,2228,2380,1.319309,103.890522
389731,112,2430,2542,1.318871,103.891226
389752,487,79,566,1.318404,103.888924
389753,89,2002,2091,1.317958,103.888882
389754,1334,334,1668,1.316675,103.890226
389755,8,333,341,1.316675,103.890226
389756,1351,316,1667,1.316675,103.890226
389757,1288,560,1848,1.316906,103.889416
389758,962,733,1695,1.316771,103.888958
389759,53,4713,4766,1.318484,103.888359
389760,174,61,235,1.316388,103.887937
389774,2,25,27,1.316064,103.885397
389775,0,31,31,1.316044,103.885489
389776,0,98,98,1.316164,103.885526
389777,208,1359,1567,1.317336,103.885764
389778,1431,163,1594,1.315908,103.884886
389779,1220,342,1562,1.315993,103.884896
389780,8,2100,2108,1.315897,103.885042
389781,30,630,660,1.316103,103.885257
389782,1,25,26,1.317226,103.885652
389783,1,443,444,1.299509,103.837
389797,5,727,732,1.313482,103.882012
389798,2,2,4,1.313584,103.881999
389799,37,1021,1058,1.313541,103.882141
389800,0,32,32,1.313677,103.881989
389801,74,1020,1094,1.313702,103.88211
389802,7,336,343,1.31378,103.881977
389804,2,410,412,1.313948,103.881948
389805,31,906,937,1.313993,103.882068
389806,1,111,112,1.314063,103.881932
389808,9,67,76,1.314165,103.881921
389810,0,124,124,1.31427,103.881907
389812,4,165,169,1.31436,103.881894
389814,0,281,281,1.314455,103.881882
389816,1,278,279,1.314549,103.881868
389817,4,1689,1693,1.314776,103.881941
389818,2,0,2,1.315139,103.89217
389819,6,494,500,1.314658,103.881852
389820,35,3272,3307,1.315272,103.8819
389821,5,687,692,1.317064,103.882133
389822,11,1044,1055,1.3166,103.881798
389823,3,254,257,1.316961,103.881833
389824,11,2801,2812,1.31702,103.881838
389825,2,131,133,1.317082,103.881842
389826,2,892,894,1.317909,103.881592
389827,10,37,47,1.321019,103.880109
389830,37,663,700,1.324255,103.880989
389831,7,454,461,1.324688,103.880887
389834,80,78,158,1.325283,103.880244
389835,583,107,690,1.324926,103.879401
389836,526,539,1065,1.325061,103.878886
389837,218,17,235,1.325654,103.87896
389838,593,82,675,1.3255,103.879628
389839,39,1112,1151,1.3272,103.880575
389840,5,1329,1334,1.325442,103.879835
389841,20,1028,1048,1.326704,103.88032
389842,1436,157,1593,1.325648,103.879166
389862,227,448,675,1.321271,103.888049
389886,145,102,247,1.321783,103.889359
389887,23,85,108,1.321779,103.889313
389908,216,28,244,1.321317,103.88934
389909,48,10,58,1.321316,103.889363
389910,89,19,108,1.321238,103.889375
389911,2,17,19,1.321236,103.889338
389932,190,882,1072,1.320117,103.890053
389933,255,831,1086,1.32023,103.890137
389934,6,264,270,1.320771,103.889375
389935,101,73,174,1.320935,103.890001
389957,48,73,121,1.321816,103.887214
389977,218,846,1064,1.32008,103.888775
389978,249,638,887,1.320336,103.888758
390000,75,59,134,1.307355,103.871774
390001,412,80,492,1.308084,103.883069
390002,31,981,1012,1.305517,103.883577
390004,0,2,2,1.314891,103.881921
390006,82,2445,2527,1.30623,103.883552
390009,615,765,1380,1.309487,103.882372
390010,4,17,21,1.306384,103.884369
390012,3,11,14,1.305819,103.884629
390013,154,8844,8998,1.307053,103.883466
390014,5,1408,1413,1.306884,103.884494
390016,3,5,8,1.306164,103.88483
390018,7,6,13,1.306,103.885113
390020,8,0,8,1.306241,103.885188
390021,74,2703,2777,1.307519,103.884504
390022,82,2955,3037,1.307162,103.885075
390024,5,2,7,1.306471,103.885501
390026,7,5,12,1.306315,103.88559
390028,1,1,2,1.305918,103.883965
390030,6,48,54,1.306898,103.885577
390032,398,461,859,1.30926,103.883932
390034,450,638,1088,1.309599,103.884447
390036,493,631,1124,1.309829,103.884861
390039,103,13131,13234,1.307846,103.884919
390041,49,730,779,1.307978,103.88465
390042,334,526,860,1.310415,103.886421
390043,714,311,1025,1.308184,103.884676
390045,360,959,1319,1.308664,103.88435
390047,383,429,812,1.308844,103.884809
390049,514,665,1179,1.308985,103.885188
390051,250,6518,6768,1.308248,103.885894
390052,267,1181,1448,1.310808,103.88537
390054,726,271,997,1.310057,103.884573
390058,643,73,716,1.307313,103.889415
390060,899,543,1442,1.307443,103.88844
390062,281,298,579,1.307642,103.889057
390093,491,1425,1916,1.308683,103.887038
390095,167,3194,3361,1.308456,103.887374
390097,319,108,427,1.308969,103.888297
390099,103,861,964,1.308567,103.887961
391005,404,119,523,1.30711,103.882603
391007,589,215,804,1.307763,103.882306
391010,493,239,732,1.309023,103.882324
391011,1109,330,1439,1.308115,103.882681
391012,408,218,626,1.308494,103.882283
391028,1172,313,1485,1.309052,103.883532
391030,1159,415,1574,1.309498,103.883285
391032,9,26,35,1.306308,103.886053
391043,11,25,36,1.308491,103.884821
391049,31,171,202,1.308626,103.885612
391052,4,1287,1291,1.299509,103.837
391056,651,1765,2416,1.310266,103.883246
391093,8,58,66,1.308781,103.887704
391095,26,1755,1781,1.299509,103.837
392003,239,350,589,1.30699,103.882987
392011,20,283,303,1.308903,103.88276
392030,27,621,648,1.309675,103.8835
392052,19,1084,1103,1.299509,103.837
392056,9,249,258,1.310053,103.883643
393003,38,438,476,1.306783,103.882931
393052,9,797,806,1.299509,103.837
397628,379,7,386,1.303184,103.872863
397629,229,2,231,1.30433,103.874338
397630,258,0,258,1.303084,103.875145
397631,297,1100,1397,1.304707,103.876151
397632,1293,7375,8668,1.305413,103.872721
397639,120,16,136,1.304197,103.880924
397643,59,987,1046,1.310866,103.880059
397644,49,1,50,1.310881,103.88012
397645,68,166,234,1.310909,103.880242
397646,4,0,4,1.310938,103.880364
397647,4,296,300,1.310967,103.880487
397648,27,4,31,1.310995,103.880609
397649,2,177,179,1.311024,103.880731
397650,9,866,875,1.310876,103.880015
397651,23,112,135,1.31088,103.880031
397652,1,90,91,1.310888,103.880065
397653,64,16,80,1.310981,103.880464
397655,17,55,72,1.310989,103.880498
397656,9,2005,2014,1.31112,103.881242
397657,4,137,141,1.311028,103.880664
397659,30,50,80,1.311137,103.881312
397660,11,3066,3077,1.311036,103.880698
397662,9,98,107,1.311056,103.880792
397664,3,49,52,1.311136,103.881221
397665,5,1033,1038,1.311148,103.881312
397688,559,2760,3319,1.301545,103.875855
397691,1711,61,1772,1.300506,103.874585
397692,277,14,291,1.302812,103.875334
397693,7044,9369,16413,1.302358,103.876445
397694,39,527,566,1.301967,103.876766
397696,17,8,25,1.300938,103.872181
397697,142,11,153,1.301888,103.874206
397698,25,0,25,1.301511,103.873436
397699,123,2,125,1.300738,103.873152
397718,211,1,212,1.303242,103.874757
397722,3,26,29,1.305096,103.870578
397724,245,713,958,1.305706,103.879476
397726,283,673,956,1.305215,103.881873
397727,0,271,271,1.305289,103.882274
397728,17,172,189,1.305235,103.87084
397729,11,20,31,1.304495,103.881188
397730,5,4,9,1.304574,103.881165
397731,20,123,143,1.304699,103.881134
397732,60,50,110,1.305867,103.86991
397750,3,157,160,1.307435,103.873604
397751,7,257,264,1.306883,103.87067
397753,1,33,34,1.309073,103.873839
397773,55,540,595,1.305128,103.871598
397774,58,127,185,1.304382,103.869931
397775,0,6,6,1.299509,103.837
397776,1,126,127,1.299509,103.837
397777,3,46,49,1.299509,103.837
397796,0,1,1,1.315045,103.891663
397797,201,47,248,1.305978,103.87968
397799,2,23,25,1.304273,103.882381
397800,276,782,1058,1.305356,103.881085
397801,43,293,336,1.305581,103.88157
397802,0,677,677,1.305289,103.882274
397803,714,1001,1715,1.304991,103.882516
397804,243,14,257,1.305919,103.878809
397805,29,262,291,1.299509,103.837
397971,614,11606,12220,1.308771,103.889172
397972,75,4868,4943,1.307274,103.883998
397994,8,768,776,1.308332,103.876352
397997,35,370,405,1.307718,103.879349
397998,192,227,419,1.307531,103.879755
397999,913,799,1712,1.308095,103.880885
398000,14,61,75,1.308097,103.880915
398001,0,12,12,1.309191,103.87417
398002,0,33,33,1.308677,103.874485
398004,16,624,640,1.307518,103.875608
398006,134,1465,1599,1.306659,103.883084
398007,3132,1700,4832,1.307532,103.881287
398008,1336,419,1755,1.308035,103.879544
398022,5,22,27,1.314354,103.890117
398023,9,3,12,1.314298,103.890129
398024,3,22,25,1.314187,103.890152
398025,18,62,80,1.314076,103.890176
398026,515,195,710,1.314409,103.890125
398027,103,19,122,1.313973,103.890965
398028,487,164,651,1.314086,103.890186
398047,4,10,14,1.314262,103.889568
398048,3,123,126,1.314023,103.889586
398049,0,2,2,1.306058,103.885695
398050,4,13,17,1.31402,103.889572
398051,1,0,1,1.301199,103.872035
398052,2,0,2,1.314201,103.889584
398053,2,3,5,1.314105,103.889599
398054,2,3,5,1.314011,103.889517
398055,0,1,1,1.314153,103.889587
398056,0,1,1,1.314063,103.889608
398057,0,16,16,1.313992,103.889615
398058,2,1,3,1.314517,103.88937
398061,9,15,24,1.313925,103.889629
398062,3,11,14,1.313992,103.889406
398063,0,24,24,1.31388,103.889638
398064,1,0,1,1.314006,103.889489
398065,0,18,18,1.313834,103.889647
398066,2,9,11,1.313983,103.88935
398067,0,47,47,1.313789,103.889656
398068,0,2,2,1.314016,103.889545
398069,12,99,111,1.313744,103.889666
398071,5,158,163,1.313973,103.889295
398074,1873,1326,3199,1.312215,103.889486
398075,889,939,1828,1.313112,103.889796
398076,230,345,575,1.312381,103.889373
398077,398,200,598,1.313067,103.889805
398079,741,2,743,1.313022,103.889814
398081,306,2,308,1.31323,103.890605
398082,347,4,351,1.313304,103.89087
398083,106,0,106,1.313344,103.8911
398084,139,0,139,1.313144,103.891103
398085,415,36,451,1.312778,103.891236
398086,374,189,563,1.312536,103.89109
398087,414,57,471,1.312529,103.890802
398088,108,105,213,1.312391,103.890559
398089,440,2583,3023,1.312626,103.889888
398103,3,71,74,1.313866,103.888845
398104,2,5,7,1.313844,103.888849
398105,1,19,20,1.3138,103.888856
398106,425,16,441,1.313756,103.888864
398107,3,29,32,1.313712,103.888872
398108,0,1,1,1.313987,103.889378
398110,1,1,2,1.313978,103.889323
398111,0,3,3,1.314001,103.889461
398112,0,1,1,1.313668,103.88888
398113,1,1,2,1.313581,103.888895
398114,4,3,7,1.313405,103.888926
398136,0,4,4,1.313957,103.888314
398138,3,7,10,1.313924,103.888319
398139,0,2,2,1.313449,103.888918
398140,0,2,2,1.313904,103.888319
398141,1,2,3,1.313537,103.888903
398142,1,2,3,1.313839,103.888331
398143,0,6,6,1.313774,103.888342
398144,18,0,18,1.313729,103.888353
398145,2,2,4,1.313709,103.888353
398146,1,1,2,1.313859,103.888331
398147,7,23,30,1.313644,103.888364
398148,2,3,5,1.3136,103.888376
398150,235,48,283,1.313535,103.888387
398152,0,7,7,1.31347,103.888398
398153,1,0,1,1.313493,103.888911
398154,0,1,1,1.31345,103.888398
398155,2,8,10,1.313385,103.888409
398156,0,8,8,1.31334,103.888421
398157,1,1,2,1.313664,103.888364
398158,2,17,19,1.313275,103.888432
398159,8,18,26,1.313265,103.888422
398160,10,41,51,1.313214,103.888439
398161,20,7,27,1.313172,103.888447
398162,124,29,153,1.31309,103.888462
398169,3,9,12,1.312512,103.888566
398170,0,3,3,1.313794,103.888342
398171,4,4,8,1.312347,103.888596
398172,1,9,10,1.312265,103.888611
398173,0,1,1,1.313405,103.888409
398174,4,2,6,1.3121,103.88864
398175,0,1,1,1.312182,103.888625
398176,0,3,3,1.31243,103.888581
398177,0,4,4,1.311879,103.888677
398199,0,37,37,1.314134,103.887663
398200,0,12,12,1.31413,103.887644
398201,2,43,45,1.314092,103.887672
398202,0,3,3,1.311935,103.88867
398204,1,5,6,1.313993,103.887672
398206,5,3,8,1.313902,103.88769
398207,6,88,94,1.313841,103.887723
398208,2,18,20,1.31381,103.887709
398209,3,22,25,1.313757,103.88774
398210,9,8,17,1.313719,103.887727
398211,86,0,86,1.313627,103.887746
398212,1,25,26,1.313589,103.887773
398213,7,38,45,1.313536,103.887764
398216,1,17,18,1.313422,103.887807
398218,1,10,11,1.313338,103.887824
398219,10,14,24,1.313261,103.88782
398220,0,32,32,1.313254,103.887841
398221,0,8,8,1.31317,103.887838
398222,0,89,89,1.31318,103.887848
398223,7,74,81,1.31311,103.887848
398224,1,139,140,1.31311,103.887868
398225,2,3,5,1.313051,103.887859
398227,63,5,68,1.312932,103.88788
398228,5,73,78,1.312932,103.8879
398229,19,29,48,1.312813,103.8879
398230,2,2,4,1.312813,103.88792
398231,21,15,36,1.312694,103.887921
398232,2,58,60,1.312694,103.887941
398233,0,27,27,1.312456,103.887982
398234,1,27,28,1.312337,103.888003
398235,5,34,39,1.312218,103.888024
398236,143,0,143,1.312099,103.888045
398237,2,50,52,1.31198,103.888066
398239,20,1,21,1.311762,103.888087
398240,138,90,228,1.311764,103.888097
398265,73,5,78,1.314,103.886885
398269,14,20,34,1.313534,103.886876
398273,3,10,13,1.313409,103.886875
398277,1,6,7,1.313284,103.886897
398280,63,21,84,1.313207,103.886901
398282,4,0,4,1.31311,103.886929
398283,7,27,34,1.313025,103.886933
398284,2,9,11,1.313079,103.886907
398285,4,2,6,1.312941,103.886938
398286,0,3,3,1.314085,103.887653
398288,0,1,1,1.312017,103.888655
398290,0,15,15,1.312975,103.886901
398291,2,0,2,1.31332,103.888421
398292,0,14,14,1.31286,103.886915
398293,88,0,88,1.312686,103.88695
398294,1,26,27,1.312792,103.886916
398295,1,2,3,1.312856,103.886942
398296,1,44,45,1.312745,103.886916
398297,2,16,18,1.312517,103.886959
398298,131,2,133,1.312676,103.886919
398299,270,14,284,1.312432,103.886963
398300,5,41,46,1.312611,103.886925
398301,1,2,3,1.312602,103.886954
398302,36,11,47,1.312553,103.886929
398304,15,12,27,1.312493,103.886931
398305,75,41,116,1.312178,103.886975
398306,22,9,31,1.312446,103.886929
398307,2,1,3,1.312348,103.886967
398308,3,17,20,1.312389,103.886932
398309,3,1,4,1.312009,103.886984
398310,0,2,2,1.312771,103.886946
398311,62,5,67,1.311924,103.886988
398312,1,18,19,1.312246,103.886947
398314,0,19,19,1.312178,103.886933
398316,1,11,12,1.312105,103.886934
398318,0,8,8,1.312037,103.886937
398320,1,10,11,1.311957,103.88695
398342,30,4,34,1.313861,103.886292
398343,2,97,99,1.313809,103.886294
398344,2,20,22,1.313704,103.886298
398345,2,26,28,1.313599,103.886301
398346,1,28,29,1.313844,103.886273
398347,8,1,9,1.313494,103.886305
398348,11,40,51,1.313389,103.886309
398349,4,13,17,1.313179,103.886317
398350,9,36,45,1.313074,103.88632
398351,4,348,352,1.312969,103.886324
398352,100,23,123,1.313074,103.8863
398353,655,10,665,1.312864,103.886328
398354,5,117,122,1.312934,103.886305
398355,19,143,162,1.312759,103.886332
398356,2,38,40,1.312654,103.886336
398357,1,3,4,1.312654,103.886336
398358,3,157,160,1.312654,103.886336
398359,388,63,451,1.312654,103.886316
398360,1,2,3,1.312093,103.88698
398361,391,1,392,1.312513,103.886321
398362,441,2,443,1.312443,103.886343
398363,19,19,38,1.312373,103.886326
398364,0,16,16,1.312338,103.886347
398365,4,6,10,1.312233,103.886331
398366,58,21,79,1.312233,103.886351
398367,17,0,17,1.312093,103.886336
398368,6,47,53,1.312128,103.886354
398369,14,38,52,1.311953,103.886341
398370,3,79,82,1.312023,103.886358
398371,1942,0,1942,1.311813,103.886346
398372,13,49,62,1.311812,103.886345
398373,6,1315,1321,1.311918,103.886362
398374,2,7,9,1.311673,103.886351
398375,6,94,100,1.311672,103.88635
398376,2,181,183,1.311813,103.886366
398377,1,11,12,1.311533,103.886356
398378,0,8,8,1.311533,103.886356
398379,1,92,93,1.311708,103.88637
398380,0,321,321,1.311401,103.886366
398381,0,108,108,1.311401,103.886366
398382,0,129,129,1.311603,103.886373
398383,0,6,6,1.311498,103.886377
398384,3,561,564,1.311407,103.886373
398406,207,2,209,1.31307,103.885728
398408,201,151,352,1.313667,103.885538
398410,176,45,221,1.313557,103.885542
398412,48,45,93,1.313448,103.885547
398414,36,8,44,1.313339,103.885552
398415,10,114,124,1.313701,103.885535
398416,246,58,304,1.31323,103.885556
398417,5,118,123,1.313647,103.885538
398418,2,69,71,1.313537,103.885542
398419,12,0,12,1.313011,103.885566
398420,0,41,41,1.313428,103.885547
398421,1,73,74,1.299509,103.837
398422,0,15,15,1.313319,103.885552
398423,0,30,30,1.312792,103.885575
398424,0,25,25,1.31321,103.885556
398425,300,31,331,1.312683,103.88558
398426,1,24,25,1.3131,103.885561
398427,2,30,32,1.312574,103.885584
398428,1,31,32,1.312991,103.885566
398429,4,29,33,1.312465,103.885589
398430,44,53,97,1.312882,103.88557
398431,13,53,66,1.312355,103.885594
398432,227,60,287,1.312772,103.885575
398433,6,6,12,1.312246,103.885598
398434,1,1,2,1.312305,103.886933
398435,107,37,144,1.312137,103.885603
398436,7,99,106,1.312554,103.885584
398437,136,8,144,1.312027,103.885608
398438,15,0,15,1.312445,103.885589
398439,9,8,17,1.311918,103.885612
398440,60,4,64,1.312335,103.885594
398441,2,5,7,1.311809,103.885617
398442,3,56,59,1.312226,103.885598
398443,0,12,12,1.3117,103.885622
398444,1,2,3,1.312548,103.886339
398445,1,19,20,1.31159,103.885626
398446,0,2,2,1.312663,103.88558
398447,1,55,56,1.311481,103.885631
398449,2,50,52,1.31135,103.885678
398451,1,18,19,1.31128,103.885707
398452,1,2,3,1.312117,103.885603
398453,565,107,672,1.31157,103.885626
398454,1,4,5,1.311461,103.885631
398455,1,4,5,1.31133,103.885678
398456,6,1,7,1.31127,103.885697
398457,66,2,68,1.31312,103.885561
398478,7,28,35,1.312951,103.884513
398479,7,42,49,1.312693,103.884552
398480,88,72,160,1.312971,103.885148
398481,10,81,91,1.312593,103.884571
398482,7,66,73,1.312484,103.885158
398483,376,95,471,1.312433,103.884533
398484,497,109,606,1.312381,103.885124
398485,292,1,293,1.31215,103.8846
398486,3,2,5,1.312222,103.885168
398487,1,4,5,1.312023,103.884532
398489,44,222,266,1.312082,103.885079
398490,0,64,64,1.312513,103.884843
398491,1,1,2,1.312007,103.885608
398492,2,2,4,1.312198,103.884861
398495,140,32,172,1.311796,103.884863
398497,50,22,72,1.311656,103.884871
398498,173,149,322,1.311568,103.884896
398504,307,193,500,1.312971,103.885148
398505,510,198,708,1.299509,103.837
398525,27,34,61,1.313417,103.883914
398526,3,49,52,1.313418,103.883894
398527,1,37,38,1.313377,103.883918
398528,0,2,2,1.312356,103.884852
398529,13,38,51,1.313296,103.883926
398530,0,12,12,1.313301,103.883905
398532,2,9,11,1.313223,103.883913
398533,14,0,14,1.313135,103.883942
398534,1,1,2,1.313379,103.883898
398535,33,234,267,1.313055,103.883949
398536,0,1,1,1.312855,103.886941
398537,1,1,2,1.313145,103.883921
398538,0,3,3,1.31168,103.885622
398539,14,0,14,1.312894,103.883965
398540,4,2,6,1.312911,103.883944
398541,17,0,17,1.312814,103.883973
398542,0,25,25,1.312833,103.883951
398543,169,1,170,1.312733,103.883981
398544,0,10,10,1.312754,103.883959
398545,13,0,13,1.312653,103.883989
398546,0,34,34,1.312676,103.883966
398547,24,12,36,1.312572,103.883997
398548,0,4,4,1.312598,103.883974
398549,1,25,26,1.312492,103.884005
398550,0,14,14,1.31252,103.883982
398551,0,1,1,1.313067,103.883928
398552,2,6,8,1.312442,103.883989
398553,1,17,18,1.312331,103.88402
398554,2,8,10,1.312364,103.883997
398555,6,4,10,1.312251,103.884028
398556,1,4,5,1.312286,103.884005
398557,2,24,26,1.31217,103.884036
398558,4,13,17,1.312208,103.884012
398559,14,3,17,1.31213,103.88404
398560,3,29,32,1.31213,103.88402
398561,0,7,7,1.312049,103.88404
398562,1,21,22,1.312091,103.88402
398563,26,10,36,1.311967,103.884041
398564,0,1,1,1.312411,103.884012
398565,7,6,13,1.311886,103.884041
398566,0,68,68,1.311933,103.884021
398567,0,18,18,1.311804,103.884041
398568,5,28,33,1.311854,103.884021
398569,1,5,6,1.311723,103.884042
398570,2,18,20,1.311775,103.884021
398571,0,6,6,1.311641,103.884042
398572,0,19,19,1.311696,103.884022
398574,0,12,12,1.311618,103.884022
398575,0,5,5,1.311478,103.884043
398576,0,21,21,1.311539,103.884022
398577,0,8,8,1.311397,103.884043
398578,0,2,2,1.312974,103.883957
398579,1,0,1,1.312012,103.88402
398580,2,13,15,1.311381,103.884023
398581,0,14,14,1.311234,103.884044
398582,0,5,5,1.311302,103.884023
398583,0,10,10,1.311152,103.884044
398584,1,23,24,1.311223,103.884024
398585,1,9,10,1.311071,103.884044
398586,3,7,10,1.311145,103.884024
398587,0,3,3,1.312989,103.883936
398588,0,36,36,1.311066,103.884024
398589,5,102,107,1.310918,103.884035
398590,0,32,32,1.310987,103.884025
398592,0,2,2,1.31146,103.884023
398614,421,1,422,1.313277,103.883335
398615,3,130,133,1.313194,103.883338
398616,3,74,77,1.313205,103.883332
398617,0,104,104,1.313027,103.883343
398618,0,12,12,1.313049,103.883342
398620,0,29,29,1.312758,103.88335
398621,2,81,83,1.312694,103.883352
398623,120,24,144,1.312528,103.883357
398624,2,80,82,1.312205,103.883356
398625,2,175,177,1.312195,103.883367
398626,2,81,83,1.312145,103.883367
398627,1,23,24,1.312115,103.883367
398628,9,0,9,1.312055,103.883366
398629,0,46,46,1.311994,103.883366
398630,11,0,11,1.311934,103.883366
398631,2,17,19,1.311874,103.883365
398632,1,10,11,1.311814,103.883365
398633,0,1,1,1.311315,103.884043
398636,0,1,1,1.311754,103.883364
398637,0,39,39,1.311523,103.883373
398638,0,57,57,1.311439,103.883364
398639,0,22,22,1.311346,103.883365
398640,0,5,5,1.311159,103.883366
398641,0,3,3,1.310989,103.884045
398642,0,16,16,1.310784,103.88337
398664,139,1290,1429,1.312698,103.882399
398665,0,227,227,1.31303,103.882077
398666,0,120,120,1.312959,103.88208
398667,0,148,148,1.312816,103.882086
398668,0,376,376,1.312673,103.882091
398669,3,2,5,1.31253,103.882097
398670,6,142,148,1.31255,103.882206
398671,3,0,3,1.310971,103.883368
398672,1,125,126,1.312244,103.882109
398673,21,1383,1404,1.312316,103.882217
398674,0,3,3,1.312387,103.882103
398675,1,202,203,1.311958,103.88212
398676,487,165,652,1.312082,103.882227
398677,0,98,98,1.311815,103.882126
398678,64,675,739,1.311965,103.882232
398679,0,86,86,1.311672,103.882132
398681,0,68,68,1.311529,103.882138
398682,11,635,646,1.31173,103.882242
398683,3,38,41,1.311386,103.882143
398684,6,167,173,1.311826,103.882465
398685,0,131,131,1.311243,103.882149
398686,15,90,105,1.311496,103.882252
398687,1,230,231,1.3111,103.882155
398688,0,2,2,1.310908,103.884025
398689,2,946,948,1.310957,103.882161
398690,0,146,146,1.311262,103.882262
398691,220,16,236,1.310814,103.882166
398692,3,105,108,1.311145,103.882268
398693,596,1201,1797,1.310671,103.882172
398694,12,7,19,1.311028,103.882273
398695,11,547,558,1.310528,103.882178
398696,1,140,141,1.31091,103.882278
398697,229,499,728,1.310793,103.882283
398698,242,578,820,1.310676,103.882288
398699,5,3873,3878,1.310563,103.882295
398721,46,533,579,1.312888,103.881229
398722,0,58,58,1.312891,103.881208
398723,1,6,7,1.312839,103.881232
398724,12,266,278,1.312844,103.881212
398725,1,0,1,1.311573,103.883363
398727,1,1,2,1.311379,103.882257
398729,0,6,6,1.31254,103.881254
398730,733,998,1731,1.312561,103.881232
398731,2,15,17,1.312441,103.881261
398735,2,41,43,1.312143,103.881282
398737,3,32,35,1.312044,103.88129
398738,898,1204,2102,1.312091,103.881266
398739,1,21,22,1.311944,103.881297
398741,524,299,823,1.311845,103.881304
398745,1,387,388,1.311714,103.881293
398746,0,104,104,1.31162,103.8813
398747,5,98,103,1.311447,103.881332
398748,5,236,241,1.311526,103.881307
398749,123,42,165,1.311348,103.88134
398750,4,4,8,1.311431,103.881314
398751,152,63,215,1.311248,103.881347
398752,48,515,563,1.311337,103.88132
398753,173,48,221,1.311159,103.881344
398754,21,62,83,1.311243,103.881327
398755,4,33,37,1.311051,103.88136
398756,61,7,68,1.311149,103.881334
398757,138,20,158,1.310954,103.881366
398758,15,65,80,1.310759,103.881377
398759,53,19,72,1.310564,103.881388
398760,70,2,72,1.310379,103.88139
398761,1,241,242,1.311051,103.88134
398762,0,81,81,1.310954,103.881346
398763,90,59,149,1.310759,103.881357
398764,28,154,182,1.310564,103.881368
398765,220,1874,2094,1.310369,103.88138
398787,21,113,134,1.312794,103.880581
398788,1,119,120,1.312762,103.880584
398789,1,272,273,1.312698,103.88059
398791,0,85,85,1.312634,103.880595
398792,0,257,257,1.31257,103.880601
398793,70,1802,1872,1.312677,103.880572
398794,1,194,195,1.312506,103.880607
398796,1,451,452,1.312442,103.880613
398797,5,493,498,1.312527,103.880585
398798,2,186,188,1.312378,103.880619
398799,1,710,711,1.312453,103.880592
398800,0,171,171,1.312314,103.880625
398801,23,390,413,1.312378,103.880599
398802,1,9,10,1.31225,103.88063
398803,322,108,430,1.312303,103.880606
398804,0,254,254,1.312229,103.880612
398805,0,10,10,1.312154,103.880619
398806,19,1094,1113,1.312058,103.880648
398807,0,698,698,1.312079,103.880626
398809,0,440,440,1.312005,103.880633
398811,20,526,546,1.31193,103.88064
398812,40,493,533,1.311855,103.880646
398813,2,1146,1148,1.311781,103.880653
398815,7,1,8,1.311706,103.88066
398817,6,525,531,1.311631,103.880667
398819,2,344,346,1.311557,103.880673
398821,1,145,146,1.311482,103.88068
398823,51,978,1029,1.311407,103.880687
398824,854,668,1522,1.311183,103.880707
398825,0,28,28,1.310467,103.880594
398826,16,2027,2043,1.310428,103.880602
398827,33,140,173,1.311044,103.880731
398828,1940,2273,4213,1.311866,103.880665
398829,5,1375,1380,1.299509,103.837
398849,14,4,18,1.312686,103.879796
398850,0,1,1,1.312739,103.881239
398851,0,6,6,1.312606,103.879805
398852,14,5,19,1.311919,103.879815
398853,0,1401,1401,1.312553,103.879811
398854,163,11,174,1.31181,103.879834
398855,5,10,15,1.312501,103.879818
398856,25,2,27,1.312002,103.879512
398857,1,0,1,1.312659,103.879799
398858,76,0,76,1.312031,103.879506
398860,25,3,28,1.312342,103.879836
398861,16,3,19,1.312289,103.879842
398862,1,7,8,1.312236,103.879848
398863,673,2342,3015,1.311806,103.879577
398864,1,8,9,1.312183,103.879854
398866,7,123,130,1.311609,103.8796
398867,698,110,808,1.312078,103.879867
398870,88,615,703,1.311424,103.879655
398874,0,65,65,1.311813,103.879897
398875,1,119,120,1.311761,103.879904
398876,21,41,62,1.311708,103.87991
398877,9,12,21,1.311655,103.879916
398878,0,26,26,1.311602,103.879922
398879,1,1,2,1.31264,103.881246
398880,0,55,55,1.311496,103.879934
398881,31,0,31,1.311443,103.87994
398882,0,16,16,1.311436,103.879921
398883,71,2,73,1.311391,103.879947
398884,12,27,39,1.311309,103.879936
398885,1,59,60,1.311245,103.879944
398886,28,2,30,1.311181,103.879951
398887,8,46,54,1.311117,103.879958
398888,14,18,32,1.310862,103.880008
398889,50,3645,3695,1.310862,103.879988
398890,72,2,74,1.310476,103.880063
398891,25,3758,3783,1.310099,103.880107
398913,31,99,130,1.312542,103.878902
398915,266,142,408,1.312525,103.878906
398917,1,133,134,1.312491,103.878913
398919,3,97,100,1.312458,103.878921
398921,1,169,170,1.311857,103.879248
398922,76,506,582,1.311298,103.879171
398923,8,208,216,1.311805,103.879269
398924,194,0,194,1.310267,103.879072
398934,14,258,272,1.311257,103.879194
398936,2,139,141,1.311206,103.879207
398938,43,128,171,1.311154,103.87922
398940,36,0,36,1.311103,103.879233
398944,3,747,750,1.311001,103.879259
398950,0,702,702,1.310796,103.879311
398951,0,5,5,1.310643,103.87935
398952,4,332,336,1.310591,103.879362
398953,10,204,214,1.310335,103.879427
398954,0,38,38,1.310284,103.87944
398955,0,8,8,1.310233,103.879453
398956,1,110,111,1.310182,103.879466
398957,0,61,61,1.310131,103.879479
398958,1,24,25,1.310079,103.879492
398959,7,5067,5074,1.310028,103.879505
398960,1,311,312,1.309977,103.879518
398961,932,528,1460,1.311582,103.879278
398982,6,42,48,1.312023,103.878234
398983,0,326,326,1.312019,103.878206
398985,0,42,42,1.311936,103.87822
398986,10,1223,1233,1.311792,103.878278
398987,0,145,145,1.311855,103.878238
398988,1,8,9,1.311719,103.878286
398989,0,6,6,1.311786,103.87825
398990,2,1,3,1.312101,103.882114
398991,17,101,118,1.311716,103.878267
398992,3,24,27,1.311567,103.878315
398993,489,680,1169,1.311398,103.87832
398995,0,69,69,1.311513,103.878329
398997,10,456,466,1.311454,103.878337
398999,2,1531,1533,1.3114,103.878343
399001,970,389,1359,1.311019,103.878418
399003,0,130,130,1.310808,103.878458
399004,2,31,33,1.310668,103.878486
399005,14,3,17,1.310975,103.878373
399006,96,254,350,1.310387,103.87854
399007,11,1,12,1.310247,103.878567
399009,0,50,50,1.310212,103.878832
399011,2,0,2,1.311549,103.879928
399012,23,1380,1403,1.309825,103.878649
399013,3,1372,1375,1.309695,103.878666
399014,106,157,263,1.311857,103.878266
399035,10,248,258,1.31193,103.877588
399036,8,48,56,1.31194,103.877548
399037,206,357,563,1.312145,103.877625
399038,4,66,70,1.31183,103.877563
399039,4,190,194,1.311721,103.87758
399041,252,58,310,1.311549,103.87748
399042,377,119,496,1.31155,103.877658
399043,131,367,498,1.311213,103.877548
399044,17,196,213,1.311451,103.87768
399045,162,78,240,1.311229,103.877696
399046,1,67,68,1.311352,103.877695
399047,176,72,248,1.311128,103.877679
399048,5,1,6,1.311246,103.877716
399049,22,422,444,1.311054,103.877703
399050,38,227,265,1.311162,103.877732
399051,1,520,521,1.311054,103.877743
399073,27,130,157,1.311787,103.876976
399077,3,175,178,1.312011,103.876892
399078,14,139,153,1.311675,103.877007
399080,0,37,37,1.311568,103.87703
399082,0,73,73,1.31146,103.877044
399083,0,104,104,1.31175,103.876944
399084,2,30,32,1.311663,103.876961
399085,2,68,70,1.311576,103.876978
399086,1,34,35,1.311354,103.877071
399087,0,23,23,1.311488,103.876995
399088,8,281,289,1.31121,103.877108
399089,0,77,77,1.311401,103.877012
399090,1343,344,1687,1.311081,103.877149
399091,1,183,184,1.311314,103.877029
399094,3,309,312,1.31114,103.877064
399095,109,1009,1118,1.310764,103.877178
399096,308,1905,2213,1.310879,103.877115
399098,1,520,521,1.310769,103.877133
399099,7,4,11,1.310636,103.877196
399100,5,38,43,1.310659,103.87715
399101,0,324,324,1.310549,103.877168
399102,0,171,171,1.31058,103.877207
399104,19,22,41,1.310508,103.877213
399105,10,65,75,1.310439,103.877239
399107,0,1,1,1.312448,103.879824
399108,24,182,206,1.310109,103.877238
399109,0,112,112,1.310309,103.877249
399110,24,329,353,1.309999,103.877255
399111,2,92,94,1.310218,103.877269
399112,1,0,1,1.310368,103.877244
399113,0,161,161,1.31017,103.877279
399114,1,113,114,1.309779,103.87729
399116,1,306,307,1.309669,103.877308
399120,69,2,71,1.309449,103.877343
399121,1539,961,2500,1.309772,103.877366
399122,1,61,62,1.309946,103.877081
399124,0,96,96,1.309922,103.877103
399125,5,49,54,1.309567,103.877367
399126,23,403,426,1.309835,103.877158
399130,1,64,65,1.309009,103.877413
399131,8,390,398,1.309419,103.877392
399132,1,74,75,1.308892,103.877428
399133,0,35,35,1.308891,103.877427
399134,0,58,58,1.308891,103.877427
399135,0,76,76,1.308891,103.877427
399136,1,11,12,1.308827,103.877473
399137,0,15,15,1.308826,103.877472
399138,14,70,84,1.308759,103.877586
399142,0,103,103,1.309347,103.877402
399143,0,1,1,1.309889,103.877273
399165,11,103,114,1.311548,103.876438
399166,136,39,175,1.311489,103.876375
399167,597,145,742,1.311486,103.87645
399168,5,46,51,1.311361,103.876407
399170,1,2,3,1.311653,103.8783
399171,0,59,59,1.311163,103.876433
399174,578,240,818,1.31091,103.876476
399182,62,113,175,1.310703,103.876506
399187,8,57,65,1.310627,103.876571
399189,1,8,9,1.310545,103.876585
399190,52,82,134,1.310519,103.876543
399191,1,13,14,1.310519,103.876543
399192,33,36,69,1.310462,103.876598
399193,3,18,21,1.31042,103.876564
399194,1,84,85,1.31042,103.876564
399195,0,26,26,1.310379,103.876611
399198,44,118,162,1.310296,103.876624
399199,354,55,409,1.310231,103.87659
399200,1,68,69,1.310214,103.876638
399201,28,19,47,1.310123,103.876597
399202,41,38,79,1.310131,103.876651
399203,0,12,12,1.310054,103.876612
399205,1,0,1,1.309242,103.877415
399206,0,9,9,1.309971,103.876631
399208,0,14,14,1.309885,103.876646
399211,1,14,15,1.30982,103.876661
399213,13,22,35,1.30976,103.876678
399216,0,2,2,1.309966,103.878622
399218,7,10,17,1.309579,103.876693
399220,3,14,17,1.309491,103.876717
399221,101,99,200,1.30922,103.876797
399222,55,7,62,1.309401,103.87673
399223,2,35,37,1.309138,103.87681
399224,102,5,107,1.309321,103.876736
399226,0,3,3,1.311241,103.876423
399228,0,12,12,1.309165,103.87676
399230,0,4,4,1.309087,103.876777
399232,19,55,74,1.30893,103.876849
399234,2,31,33,1.308804,103.876859
399235,21,38,59,1.308934,103.876799
399236,0,8,8,1.308727,103.876839
399237,15,85,100,1.308868,103.87681
399242,71,63,134,1.311306,103.876454
399264,24,59,83,1.31161,103.875775
399266,14,85,99,1.311537,103.875788
399267,1,94,95,1.311463,103.875802
399268,145,19,164,1.310831,103.87609
399270,4,143,147,1.310716,103.876104
399272,5,191,196,1.310616,103.876153
399273,67,0,67,1.310493,103.876157
399275,245,308,553,1.310419,103.876207
399276,2,514,516,1.310336,103.876204
399277,92,475,567,1.310246,103.876212
399281,202,667,869,1.310188,103.876201
399283,8,1576,1584,1.310084,103.876203
399284,4,765,769,1.309941,103.876239
399285,1,525,526,1.309913,103.876273
399286,4,1081,1085,1.30982,103.876256
399287,3,255,258,1.309821,103.876292
399288,8,176,184,1.309702,103.876296
399289,3,16,19,1.31022,103.876036
399290,2,75,77,1.310147,103.87605
399291,1,67,68,1.310074,103.876064
399292,0,32,32,1.310001,103.876078
399293,4,95,99,1.309928,103.876091
399296,222,17,239,1.309708,103.876133
399297,0,9,9,1.309635,103.876146
399298,4,2,6,1.309562,103.87616
399300,28,176,204,1.309499,103.876164
399408,0,157,157,1.312176,103.883239
399409,0,68,68,1.312175,103.883238
399410,0,158,158,1.312196,103.883239
399411,2,1,3,1.309238,103.876749
399412,0,17,17,1.312195,103.883238
399413,0,105,105,1.312176,103.883197
399418,1,0,1,1.309971,103.876631
399429,0,4,4,1.31218,103.882952
399430,0,2,2,1.309687,103.876687
399433,1,3,4,1.312185,103.882903
399437,0,2,2,1.312201,103.882953
399438,1,0,1,1.312177,103.883108
399439,0,4,4,1.312179,103.88279
399442,2,5,7,1.312199,103.88279
399443,11,13,24,1.312187,103.882738
399446,0,2,2,1.312204,103.882902
399449,0,3,3,1.312195,103.883238
399450,0,3,3,1.312182,103.882678
399453,0,6,6,1.312185,103.882622
399455,0,2,2,1.312206,103.882737
399479,136,203,339,1.310175,103.887194
399501,1,295,296,1.311513,103.883324
399502,0,149,149,1.311512,103.883323
399503,0,4,4,1.311533,103.883324
399504,0,437,437,1.311532,103.883323
399506,1,2,3,1.312203,103.882679
399507,2,14,16,1.311533,103.883285
399509,1,1,2,1.312205,103.882622
399511,0,2,2,1.311514,103.883207
399512,0,3,3,1.311512,103.883284
399514,0,1,1,1.31218,103.882791
399523,0,27,27,1.311534,103.882972
399525,1,1,2,1.311534,103.883207
399527,9,0,9,1.311535,103.882894
399530,0,3,3,1.311533,103.883206
399531,3,0,3,1.311514,103.882815
399532,0,7,7,1.311534,103.882815
399533,0,5,5,1.311515,103.882737
399535,127,7,134,1.311535,103.882737
399536,0,1,1,1.311513,103.883127
399537,0,7,7,1.311515,103.882658
399539,0,9,9,1.311516,103.882581
399541,67,3,70,1.311536,103.882581
399629,64,20,84,1.30253,103.880543
399630,47,20,67,1.302347,103.880398
399631,17,12,29,1.302179,103.88027
399632,25,35,60,1.302065,103.880186
399633,35,29,64,1.301876,103.880019
399634,118,298,416,1.301753,103.879903
399635,806,33,839,1.301581,103.87977
399636,33,64,97,1.301487,103.879695
399637,21,86,107,1.301236,103.879299
399638,1,0,1,1.311516,103.882659
399639,1,38,39,1.301236,103.879299
399642,15,3,18,1.301236,103.879299
399643,0,4,4,1.301236,103.879299
399644,1,2,3,1.311535,103.882816
399645,4,4,8,1.301236,103.879299
399646,16,330,346,1.300879,103.878986
399653,5,212,217,1.300555,103.877345
399654,1,22,23,1.300555,103.877345
399655,0,23,23,1.300555,103.877345
399657,1,11,12,1.300555,103.877345
399658,0,10,10,1.300555,103.877345
399659,2,8,10,1.300147,103.876854
399660,3,9,12,1.300102,103.876748
399661,12,358,370,1.300055,103.87664
399663,11,16,27,1.302704,103.880821
399664,26,42,68,1.302704,103.880821
399683,7,1345,1352,1.308642,103.87695
399684,4,840,844,1.308675,103.877145
399685,26,1515,1541,1.308714,103.877315
399688,3,3298,3301,1.308817,103.877624
399689,3,32,35,1.308874,103.877661
399690,2,166,168,1.308932,103.877699
399691,0,114,114,1.30899,103.877742
399692,1,49,50,1.309049,103.877791
399693,2,39,41,1.309078,103.877815
399694,0,24,24,1.309131,103.877863
399695,3,56,59,1.309184,103.877912
399696,0,7,7,1.309242,103.877965
399697,12,46,58,1.309299,103.878018
399698,0,1,1,1.301236,103.879299
399699,3,93,96,1.309381,103.878112
399700,0,30,30,1.309424,103.878169
399701,1,599,600,1.309467,103.878227
399702,3,338,341,1.309616,103.878508
399703,3,332,335,1.309647,103.878571
399704,3,269,272,1.309679,103.878634
399705,17,1743,1760,1.309685,103.878656
399710,175,2816,2991,1.309767,103.879672
399711,57,291,348,1.309935,103.880336
399712,5,196,201,1.310126,103.88093
399713,0,71,71,1.310141,103.880995
399714,1,154,155,1.310156,103.881075
399715,2,184,186,1.310187,103.881196
399716,6,302,308,1.310197,103.881248
399717,14,2671,2685,1.310156,103.881343
399718,404,197,601,1.310077,103.881833
399719,655,1365,2020,1.310402,103.882267
399720,39,1388,1427,1.310577,103.883834
399721,1,1984,1985,1.310266,103.880903
399722,1,626,627,1.310289,103.881001
399723,0,3,3,1.301236,103.879299
399724,4,696,700,1.310364,103.881325
399725,3,628,631,1.310406,103.881523
399726,9,1188,1197,1.310432,103.881656
399727,3,24,27,1.310485,103.881922
399728,4,1859,1863,1.310538,103.882188
399729,0,1,1,1.309299,103.878018
399730,0,21,21,1.31064,103.882679
399731,0,64,64,1.31063,103.882631
399732,2,143,145,1.31062,103.882582
399733,4,154,158,1.31061,103.882534
399734,0,166,166,1.31104,103.882989
399735,0,197,197,1.311021,103.883069
399736,0,279,279,1.311013,103.883091
399737,2,459,461,1.311023,103.883178
399738,1,2821,2822,1.311022,103.883225
399739,40,1928,1968,1.311042,103.883611
399740,1,1984,1985,1.310925,103.883803
399741,2,566,568,1.310933,103.883882
399742,1,425,426,1.310945,103.883977
399746,689,1019,1708,1.311067,103.886538
399748,1,397,398,1.310949,103.884181
399750,0,271,271,1.310981,103.884327
399752,0,114,114,1.311043,103.88462
399754,28,887,915,1.311105,103.884877
399756,1,596,597,1.311128,103.885011
399757,3,24,27,1.311362,103.887184
399758,0,165,165,1.31115,103.885111
399759,63,202,265,1.311193,103.88531
399760,0,108,108,1.311237,103.885508
399761,1,1306,1307,1.31128,103.885707
399762,9,475,484,1.311295,103.88579
399763,0,9,9,1.311294,103.885789
399764,287,65,352,1.311311,103.885873
399765,18,511,529,1.31131,103.885872
399766,6,144,150,1.311342,103.886039
399767,0,4,4,1.311341,103.886038
399768,1,17,18,1.311372,103.886205
399769,7,652,659,1.311371,103.886204
399770,0,3,3,1.310334,103.881195
399771,2,1324,1326,1.311396,103.88638
399772,216,364,580,1.311292,103.888386
399773,3,1012,1015,1.31154,103.887048
399774,0,12,12,1.311548,103.887087
399776,3,1155,1158,1.311579,103.887242
399777,1,2,3,1.311396,103.88638
399779,11,570,581,1.311626,103.887475
399780,0,2,2,1.311515,103.882894
399781,1,325,326,1.311658,103.887631
399783,3,304,307,1.311689,103.887786
399784,0,1,1,1.310645,103.882703
399785,8,883,891,1.311721,103.887942
399786,3,13,16,1.311736,103.888019
399787,7,565,572,1.311752,103.888097
399788,6,1137,1143,1.311761,103.888139
399789,2,3,5,1.311769,103.888181
399790,17,474,491,1.311786,103.888265
399792,10,238,248,1.311821,103.888433
399794,8,211,219,1.311855,103.888601
399795,64,1127,1191,1.311867,103.888695
399806,12,3140,3152,1.312027,103.889458
399830,1,22,23,1.313774,103.892111
399832,0,2,2,1.311642,103.887553
399838,3,102,105,1.312827,103.891411
399839,1088,6,1094,1.314167,103.89319
399840,67,120,187,1.313437,103.891744
399841,2,16,18,1.314159,103.89315
399845,26,0,26,1.314085,103.892826
399846,0,6889,6889,1.314066,103.892789
399849,397,1643,2040,1.31445,103.891474
399850,22,1619,1641,1.311105,103.884877
399871,4,281,285,1.310009,103.880788
399872,0,1,1,1.311705,103.887864
399874,2,0,2,1.313888,103.892345
399875,0,14,14,1.309758,103.880861
399876,1,0,1,1.309886,103.880876
399878,212,10,222,1.309646,103.880797
399879,2,15,17,1.309513,103.880809
399880,2,42,44,1.309493,103.880881
399881,4,428,432,1.309926,103.880767
399903,4,5,9,1.309982,103.881368
399904,5,5,10,1.30993,103.881367
399905,0,5,5,1.309823,103.881378
399906,1,3,4,1.309785,103.881386
399907,6,3,9,1.309719,103.881387
399908,7,4,11,1.309667,103.881395
399909,0,8,8,1.309618,103.881411
399910,96,3,99,1.308431,103.881606
399911,145,34,179,1.309564,103.881405
399912,28,182,210,1.309214,103.88048
399913,127,42,169,1.309443,103.880216
399914,219,5,224,1.309526,103.881092
399935,449,360,809,1.307522,103.886698
399936,1486,387,1873,1.306352,103.887079
399937,1818,0,1818,1.306639,103.886616
399938,1715,13,1728,1.306679,103.886785
399939,1524,998,2522,1.30671,103.886929
399940,1364,0,1364,1.306744,103.88709
399941,1562,1229,2791,1.306822,103.888064
399942,1549,35,1584,1.306797,103.888028
399943,57,5,62,1.299509,103.837
399944,1280,787,2067,1.306797,103.888028
399945,974,15,989,1.306927,103.888994
399946,880,18,898,1.306797,103.888028
399947,1364,149,1513,1.306797,103.888028
399948,1375,473,1848,1.306797,103.888028
399949,126,68,194,1.299509,103.837
400001,574,4625,5199,1.32077,103.902368
400002,497,215,712,1.320763,103.902739
400003,4,5,9,1.320662,103.903156
400005,102,818,920,1.32128,103.903556
400006,70,253,323,1.321343,103.904369
400007,215,2528,2743,1.320777,103.9045
400008,149,1693,1842,1.321346,103.904463
400009,677,5451,6128,1.321957,103.902155
400010,611,1505,2116,1.322234,103.902571
400011,359,5774,6133,1.321789,103.904275
400012,1164,655,1819,1.322245,103.904103
400013,223,415,638,1.322681,103.903659
400014,532,997,1529,1.323153,103.903624
400015,618,3240,3858,1.323889,103.903248
400016,1305,1402,2707,1.322938,103.904061
400017,722,208,930,1.323327,103.90403
400018,865,368,1233,1.323685,103.903964
400019,2513,1989,4502,1.324298,103.903213
400020,128,2,130,1.324636,103.903214
400021,55,172,227,1.32501,103.903199
400022,154,89,243,1.324795,103.902021
400023,1360,342,1702,1.324299,103.902048
400024,738,520,1258,1.323745,103.902224
400025,506,1298,1804,1.323422,103.902286
400030,59,508,567,1.319407,103.896176
400031,754,3888,4642,1.320364,103.90185
400032,507,218,725,1.320279,103.90139
400033,577,168,745,1.320131,103.900794
400034,508,103,611,1.321038,103.900845
400035,387,162,549,1.321118,103.901257
400036,604,2437,3041,1.321188,103.901666
400301,415,6447,6862,1.330744,103.902125
400302,636,3477,4113,1.329951,103.900986
400304,397,1240,1637,1.329443,103.901257
400305,266,3278,3544,1.329438,103.902291
400306,24,25,49,1.329438,103.902291
400311,742,586,1328,1.329858,103.903085
400312,36,1798,1834,1.329641,103.903752
400313,746,138,884,1.329089,103.903791
400314,497,562,1059,1.329095,103.903317
400315,415,659,1074,1.329339,103.903084
400316,417,454,871,1.329194,103.902427
400317,80,1929,2009,1.328616,103.902782
400318,247,92,339,1.328551,103.903249
400319,260,430,690,1.328268,103.903558
400320,441,181,622,1.328732,103.904145
400321,366,2117,2483,1.328475,103.904683
400322,573,555,1128,1.327948,103.904743
400323,523,498,1021,1.32808,103.904318
400324,784,577,1361,1.328325,103.904114
400325,66,1597,1663,1.327689,103.903984
400326,489,203,692,1.327184,103.903717
400327,672,324,996,1.326892,103.903883
400328,21,202,223,1.327566,103.904744
400329,469,285,754,1.327036,103.904734
400330,403,179,582,1.326548,103.904005
400331,35,73,108,1.32665,103.903487
400332,123,5281,5404,1.326896,103.90255
400333,221,196,417,1.326688,103.902856
400334,513,85,598,1.326382,103.90297
400335,31,122,153,1.326011,103.902749
400336,340,117,457,1.325793,103.902028
400337,8,23,31,1.325965,103.901536
400338,400,357,757,1.326104,103.901949
400339,293,421,714,1.326419,103.901844
400340,24,55,79,1.32643,103.901434
400341,316,4992,5308,1.326765,103.901742
400342,69,6119,6188,1.326417,103.901084
400343,449,11317,11766,1.326499,103.900399
400344,346,9390,9736,1.326296,103.899516
400345,43,459,502,1.326303,103.898778
400346,139,320,459,1.325973,103.899642
400347,236,363,599,1.325674,103.899637
400348,162,529,691,1.326179,103.900398
400349,359,571,930,1.325829,103.900429
400350,257,522,779,1.325864,103.901879
400351,217,229,446,1.325479,103.900546
400352,377,319,696,1.325308,103.899668
400410,16,1898,1914,1.318443,103.899686
400411,737,603,1340,1.318804,103.899354
400412,40,2256,2296,1.318327,103.898824
400413,230,349,579,1.318601,103.898922
400414,183,1164,1347,1.318286,103.898241
400415,382,478,860,1.318427,103.897532
400416,31,3254,3285,1.317992,103.897344
400417,679,2905,3584,1.318389,103.897005
400822,222,980,1202,1.318282,103.903595
400824,336,140,476,1.318015,103.903685
400826,31,1402,1433,1.317569,103.903408
400828,20,144,164,1.317458,103.902731
400830,265,54,319,1.317665,103.902322
400832,188,35,223,1.317769,103.903003
400834,188,45,233,1.318296,103.902902
400836,63,5847,5910,1.318581,103.903214
400838,93,6450,6543,1.318437,103.902552
400840,171,351,522,1.318131,103.902237
400842,255,114,369,1.317905,103.901575
400844,159,2125,2284,1.318157,103.901563
400845,932,7279,8211,1.316442,103.894357
400846,310,193,503,1.317614,103.901592
400848,115,196,311,1.317213,103.901376
401001,50,5162,5212,1.321389,103.902556
401002,206,274,480,1.320158,103.902757
401003,0,240,240,1.317421,103.898725
401011,10,3094,3104,1.299509,103.837
401031,38,142,180,1.320225,103.901761
401032,24,34,58,1.320315,103.901108
401319,23,11190,11213,1.328538,103.902982
402001,1431,44056,45487,1.316716,103.898214
402002,5,217,222,1.317194,103.898319
402003,84,815,899,1.317559,103.898851
402004,46,53,99,1.320065,103.903711
403002,38,1156,1194,1.317066,103.89777
404002,115,1830,1945,1.317688,103.897566
405002,90,332,422,1.317465,103.898082
406002,258,355,613,1.317546,103.898527
408538,1985,122,2107,1.333947,103.894921
408543,66,612,678,1.332084,103.89648
408544,19,59,78,1.318886,103.910094
408548,52,306,358,1.33277,103.893044
408549,127,895,1022,1.333163,103.892778
408553,213,580,793,1.332051,103.893355
408554,175,877,1052,1.33225,103.896886
408555,423,36,459,1.332129,103.897083
408556,3,727,730,1.332491,103.897409
408557,10,35,45,1.332411,103.89713
408558,87,1007,1094,1.325996,103.894021
408559,274,155,429,1.32834,103.898034
408560,567,243,810,1.32794,103.898087
408561,584,199,783,1.327482,103.89817
408562,0,75,75,1.32756,103.897631
408563,282,2249,2531,1.325647,103.894133
408564,3871,1607,5478,1.326293,103.896145
408565,168,199,367,1.32742,103.89762
408566,100,14,114,1.327707,103.897509
408567,225,67,292,1.327014,103.896443
408568,504,72,576,1.327437,103.896165
408569,230,94,324,1.327061,103.895211
408570,411,98,509,1.326911,103.894764
408571,405,1832,2237,1.326862,103.898324
408572,138,8,146,1.326725,103.893992
408573,46,138,184,1.326759,103.894076
408574,252,4,256,1.326836,103.894246
408575,12,16,28,1.326881,103.894374
408576,5,39,44,1.326923,103.894505
408577,11,25,36,1.326969,103.894611
408578,5,35,40,1.327031,103.894757
408579,338,39,377,1.327063,103.894868
408580,60,37,97,1.327122,103.895016
408581,16,7,23,1.327152,103.89511
408582,5,70,75,1.327209,103.895246
408583,19,68,87,1.327271,103.895397
408584,20,54,74,1.327317,103.895508
408585,155,68,223,1.32735,103.895624
408586,7,77,84,1.327436,103.895853
408587,83,37,120,1.327478,103.895964
408588,47,34,81,1.327512,103.896068
408589,1,4,5,1.327574,103.896221
408590,5,16,21,1.327606,103.896302
408591,3,13,16,1.32766,103.896421
408592,10,20,30,1.32771,103.896588
408593,11,33,44,1.327737,103.89667
408594,284,50,334,1.327873,103.896998
408595,4,10,14,1.32792,103.897089
408596,83,9,92,1.327954,103.897223
408597,24,21,45,1.327986,103.897324
408598,6,22,28,1.328021,103.897442
408599,5,8,13,1.328033,103.897514
408600,317,8,325,1.319291,103.894819
408601,1098,2895,3993,1.319657,103.892519
408604,426,1148,1574,1.334593,103.898614
408605,523,1989,2512,1.335058,103.898601
408606,21,146,167,1.322762,103.897384
408607,91,329,420,1.334066,103.899315
408608,30,57,87,1.333575,103.899662
408609,121,182,303,1.332092,103.899134
408610,48,1197,1245,1.333234,103.900032
408611,394,132,526,1.332881,103.900288
408612,54,51,105,1.331129,103.899443
408613,123,24,147,1.331141,103.898981
408614,5,27,32,1.331019,103.898658
408615,53,865,918,1.330766,103.89864
408616,208,16,224,1.332437,103.89981
408617,47,60,107,1.331507,103.900054
408618,462,109,571,1.330873,103.899156
408619,36,1099,1135,1.330632,103.898623
408620,40,354,394,1.331124,103.899829
408621,427,116,543,1.331,103.899468
408622,123,101,224,1.332143,103.899945
408623,452,2392,2844,1.33205,103.900122
408624,21,23,44,1.332667,103.899343
408649,29,4651,4680,1.331599,103.897983
408650,622,255,877,1.333735,103.897599
408651,275,1404,1679,1.335211,103.897253
408652,162,1688,1850,1.328858,103.897421
408653,41,1135,1176,1.328277,103.895996
408654,14,27,41,1.330837,103.896278
408655,2,34,36,1.331123,103.896994
408656,21,18,39,1.330032,103.896195
408657,60,15,75,1.330604,103.896886
408658,7,37,44,1.32984,103.896646
408659,24,71,95,1.33007,103.897255
408660,11,598,609,1.330608,103.897626
408661,229,26,255,1.330156,103.897078
408662,19,506,525,1.329056,103.895751
408663,93,430,523,1.329617,103.897066
408664,494,364,858,1.33448,103.897081
408665,2,66,68,1.332838,103.89837
408666,1,573,574,1.299509,103.837
408694,1130,3543,4673,1.327066,103.892701
408695,279,322,601,1.329422,103.892128
408696,1261,909,2170,1.32982,103.891911
408698,37,2107,2144,1.331221,103.891322
408699,4173,3738,7911,1.331597,103.89117
408700,96,207,303,1.330695,103.892502
408701,149,147,296,1.331101,103.893512
408702,151,103,254,1.330023,103.893894
408703,508,135,643,1.329692,103.893437
408704,283,194,477,1.329612,103.892889
408705,940,848,1788,1.328827,103.892948
408706,62,419,481,1.328748,103.891756
408707,27,79,106,1.330138,103.894508
408708,189,90,279,1.328632,103.891832
408709,24,65,89,1.330454,103.895341
408710,38,195,233,1.327937,103.892038
408711,17,3,20,1.330011,103.89535
408712,34,1642,1676,1.327806,103.892109
408713,20,10,30,1.329926,103.895116
408714,7,1,8,1.32976,103.89472
408715,40,21,61,1.329665,103.894451
408716,31,7,38,1.329055,103.894997
408717,28,16,44,1.329336,103.895698
408718,18,8,26,1.329904,103.89613
408719,255,2716,2971,1.327842,103.894829
408720,51,690,741,1.3274,103.893711
408722,47,86,133,1.328956,103.89415
408723,1174,10218,11392,1.325862,103.892819
408724,972,1355,2327,1.326622,103.893059
408725,3,39,42,1.326098,103.892407
408726,482,2331,2813,1.32642,103.893332
408727,908,52,960,1.332758,103.890369
408728,244,70,314,1.332059,103.890477
408729,851,725,1576,1.332442,103.890944
408730,1024,3213,4237,1.332071,103.891085
408731,966,97,1063,1.332729,103.890081
408732,766,2171,2937,1.332198,103.88995
408733,942,1602,2544,1.332671,103.8902
408734,2117,187,2304,1.331393,103.891938
408754,300,752,1052,1.334228,103.89417
408755,30,2260,2290,1.334618,103.89505
408757,1,503,504,1.334791,103.894959
408758,6,2,8,1.334887,103.894918
408759,0,7,7,1.334998,103.894884
408760,1,52,53,1.335092,103.894841
408761,1,1,2,1.309794,103.880786
408762,0,46,46,1.335269,103.894763
408763,0,54,54,1.335356,103.894713
408764,120,280,400,1.33466,103.895153
408765,1,0,1,1.309686,103.880849
408766,8,1,9,1.334987,103.895021
408767,6,2,8,1.335122,103.894957
408768,9,1,10,1.335241,103.894902
408769,17,1,18,1.335344,103.89486
408770,1,1,2,1.335197,103.8948
408771,47,2,49,1.335661,103.895162
408774,1,0,1,1.334827,103.895088
408775,3,0,3,1.311595,103.88732
408777,1,0,1,1.335373,103.895291
408778,9,0,9,1.334767,103.895491
408779,0,1,1,1.334755,103.895463
408780,5,391,396,1.33479,103.895545
408781,0,1,1,1.334778,103.895518
408784,1,8,9,1.335667,103.895438
408785,1,0,1,1.335813,103.895252
408786,0,3,3,1.335283,103.895327
408787,1,0,1,1.335583,103.895473
408788,0,3,3,1.335497,103.895516
408789,2,7,9,1.335192,103.895649
408790,2,8,10,1.335095,103.895695
408791,18,8,26,1.335014,103.895732
408792,18,479,497,1.334888,103.895772
408793,14,1964,1978,1.335179,103.896297
408794,1,4,5,1.335302,103.896215
408795,3,1,4,1.335415,103.896173
408796,2,1,3,1.335319,103.895592
408797,0,1,1,1.335408,103.895554
408798,0,1,1,1.335617,103.896107
408799,3,3,6,1.335785,103.895974
408801,0,1,1,1.335684,103.896009
408802,30,0,30,1.336065,103.895877
408803,0,1,1,1.335987,103.895908
408804,12,1,13,1.336232,103.89583
408805,2124,1856,3980,1.33562,103.896641
408806,1,147,148,1.33642,103.895632
408807,7,0,7,1.336365,103.895551
408808,3,159,162,1.336301,103.895484
408809,0,1,1,1.336154,103.895854
408810,2,0,2,1.335466,103.894809
408811,1,37,38,1.336167,103.895314
408812,3,12,15,1.336129,103.895263
408813,2,180,182,1.336089,103.895204
408814,1,18,19,1.336044,103.895135
408815,2,250,252,1.335997,103.895073
408816,1,161,162,1.335955,103.895019
408817,9,213,222,1.335912,103.89496
408818,4,53,57,1.335865,103.894905
408819,2,200,202,1.335824,103.894856
408820,1,14,15,1.335779,103.894803
408821,25,151,176,1.335724,103.89474
408822,0,42,42,1.335677,103.89467
408823,4,767,771,1.33562,103.894596
408825,730,103,833,1.334799,103.896027
408826,432,4080,4512,1.334849,103.896952
408827,1223,3557,4780,1.334208,103.89376
408828,38,1696,1734,1.333703,103.891087
408829,8,527,535,1.333827,103.8913
408830,2907,1294,4201,1.333546,103.891785
408831,1276,1832,3108,1.332697,103.891668
408832,1587,2022,3609,1.333139,103.89204
408857,392,143,535,1.331046,103.890475
408858,180,1829,2009,1.332749,103.896042
408859,31,1657,1688,1.333632,103.898605
408860,160,7205,7365,1.331525,103.893382
408861,122,1793,1915,1.331139,103.892412
408863,226,1355,1581,1.333019,103.896646
408864,299,933,1232,1.333402,103.89702
408865,472,501,973,1.33035,103.891074
408866,1050,13808,14858,1.332302,103.895468
408867,310,92,402,1.330996,103.895816
408868,7732,3523,11255,1.33295,103.894131
408896,117,399,516,1.328141,103.893581
408897,123,625,748,1.328606,103.894811
408898,706,6836,7542,1.332273,103.901286
408899,22,422,444,1.299509,103.837
408900,20,0,20,1.299509,103.837
408901,11,2777,2788,1.299509,103.837
408902,5,925,930,1.299509,103.837
408931,240,3776,4016,1.329011,103.901381
408932,2,196,198,1.328971,103.901487
408933,429,11468,11897,1.325096,103.898223
408934,551,9713,10264,1.325723,103.896444
408935,514,129,643,1.324918,103.895577
408936,351,3303,3654,1.325303,103.894861
408937,225,125,350,1.325077,103.893758
408938,288,1756,2044,1.325319,103.894541
408939,535,2320,2855,1.324893,103.893258
408940,266,2279,2545,1.327215,103.901803
408941,788,455,1243,1.325133,103.894161
408942,6360,537,6897,1.324713,103.892629
408943,4,1242,1246,1.329047,103.901347
409004,35,610,645,1.317351,103.892259
409005,41,1297,1338,1.317482,103.892187
409007,15,395,410,1.318523,103.891952
409008,215,12444,12659,1.321772,103.891484
409009,832,297,1129,1.323929,103.891709
409010,5,769,774,1.324476,103.89082
409011,1,666,667,1.32495,103.890932
409012,13,1374,1387,1.325153,103.890881
409013,84,4993,5077,1.325413,103.89083
409014,37,1035,1072,1.32634,103.890991
409015,2567,2107,4674,1.327334,103.89092
409016,6,1248,1254,1.327782,103.890397
409017,84,41,125,1.327884,103.890802
409018,4,12,16,1.328465,103.890948
409019,5,0,5,1.328367,103.890579
409020,652,668,1320,1.328782,103.890577
409022,1383,1735,3118,1.32932,103.890342
409029,2,101,103,1.327616,103.889906
409030,696,3414,4110,1.32982,103.890266
409031,3,17,20,1.327725,103.889896
409032,271,929,1200,1.330885,103.890011
409033,1,36,37,1.328027,103.889873
409034,1,19,20,1.328135,103.889819
409035,4,454,458,1.328247,103.889768
409036,89,9,98,1.331612,103.887961
409037,172,3306,3478,1.331744,103.888823
409038,1,28,29,1.327626,103.890176
409040,12,8,20,1.328012,103.891098
409041,11,8,19,1.32803,103.891092
409042,1815,1912,3727,1.317536,103.891466
409044,1999,736,2735,1.330586,103.888641
409045,675,2690,3365,1.331672,103.889121
409046,76,82,158,1.331215,103.888305
409047,29,1160,1189,1.331734,103.888356
409048,146,4101,4247,1.325922,103.890268
409049,197,1496,1693,1.317163,103.892408
409050,19,13,32,1.299509,103.837
409051,2344,3994,6338,1.318938,103.892611
409052,15,669,684,1.328518,103.891041
409070,8,0,8,1.3237735,103.876213
409074,239,218,457,1.317079,103.899168
409075,142,1491,1633,1.317871,103.900624
409179,12747,2497,15244,1.322415,103.892082
409180,4609,4187,8796,1.322226,103.891795
409215,1,46,47,1.316843,103.896801
409236,0,5,5,1.31689,103.897116
409242,0,3,3,1.335516,103.896142
409286,991,32040,33031,1.315287,103.89325
409294,1,0,1,1.336257,103.895428
409352,65,573,638,1.319681,103.896127
409354,13,1,14,1.318383,103.896336
409386,2,50,52,1.322947,103.899266
409387,36,511,547,1.320742,103.899572
409388,38,34,72,1.319399,103.901834
409389,1,1146,1147,1.319058,103.901504
409423,1885,5295,7180,1.319782,103.902892
409457,23,133,156,1.324139,103.898697
409458,50,14,64,1.324078,103.898306
409459,90,73,163,1.323965,103.897848
409460,119,21,140,1.323898,103.897479
409461,37,177,214,1.323843,103.897171
409496,90,74,164,1.324227,103.900907
409497,65,64,129,1.32398,103.89979
409498,68,12,80,1.323884,103.8998
409499,7,34,41,1.324098,103.900934
409533,2,34,36,1.322873,103.894132
409534,7,35,42,1.323056,103.895048
409535,176,122,298,1.323113,103.894665
409569,72,119,191,1.323296,103.898945
409570,431,75,506,1.323188,103.898516
409571,278,11,289,1.323075,103.898043
409572,183,0,183,1.322982,103.897561
409573,481,103,584,1.322916,103.897275
409574,64,90,154,1.3227,103.896002
409575,535,111,646,1.323342,103.896252
409576,41,16,57,1.323581,103.901011
409577,22,5,27,1.323366,103.899927
409578,66,4,70,1.323278,103.899958
409579,0,6,6,1.323474,103.901055
409580,1,107,108,1.322999,103.898448
409581,25,81,106,1.322595,103.896331
409582,48,3,51,1.322374,103.894242
409583,34,20,54,1.322494,103.89516
409584,5,40,45,1.322684,103.895123
409585,6,14,20,1.322534,103.894229
409619,20,304,324,1.321494,103.895604
409620,5,26,31,1.322158,103.893168
409621,4,0,4,1.322886,103.901123
409622,4,4,8,1.322689,103.900065
409623,16,4,20,1.322601,103.900094
409625,14,4,18,1.322672,103.898535
409626,7,2,9,1.322497,103.898571
409627,49,7,56,1.321909,103.896487
409628,7,6,13,1.32207,103.896449
409630,13,1231,1244,1.321091,103.893276
409631,7,18,25,1.321307,103.894321
409632,2,14,16,1.32148,103.895151
409633,83,32,115,1.321622,103.895242
409634,14,27,41,1.321496,103.89434
409668,36,4,40,1.32136,103.896528
409702,5,10,15,1.322166,103.898842
409703,29,27,56,1.322001,103.898889
409740,17,257,274,1.321799,103.900262
409743,67,18,85,1.321617,103.89896
409744,20,55,75,1.321399,103.898983
409745,25,20,45,1.321241,103.897805
409746,21,19,40,1.321006,103.896661
409747,3,292,295,1.320365,103.893413
409748,4,32,36,1.320553,103.894386
409749,3,33,36,1.320764,103.895478
409750,10,27,37,1.320887,103.895273
409751,40,24,64,1.320747,103.894358
409752,9,169,178,1.320573,103.893389
409790,10,21,31,1.32104,103.899058
409791,6,7,13,1.320865,103.898867
409792,1,2,3,1.316813,103.896802
409793,58,7,65,1.32081,103.897866
409794,4,4,8,1.320485,103.89675
409795,9,14,23,1.320608,103.896726
409796,4,539,543,1.31988,103.893521
409797,0,2,2,1.336209,103.895369
409798,0,34,34,1.32026,103.895591
409799,2,41,43,1.320397,103.895567
409801,1,347,348,1.320003,103.893498
409835,71,39,110,1.320184,103.898436
409836,612,8,620,1.320142,103.898102
409837,169,23,192,1.319409,103.897992
409838,272,462,734,1.319896,103.896867
409839,744,270,1014,1.319419,103.897543
409845,14,14,28,1.320481,103.898985
409846,8,317,325,1.320313,103.89806
409847,1,22,23,1.320092,103.896868
409848,43,97,140,1.320372,103.899138
409849,4,100,104,1.319843,103.895676
409850,8,430,438,1.319623,103.894622
409851,12,1075,1087,1.319435,103.89362
409923,9,490,499,1.317129,103.895747
409957,285,1639,1924,1.325346,103.891157
409958,485,174,659,1.325004,103.89123
409959,250,420,670,1.324639,103.891715
409960,156,292,448,1.326303,103.891803
409961,194,182,376,1.325694,103.891235
409962,88,595,683,1.325858,103.891371
409963,25,346,371,1.325935,103.891848
409965,0,64,64,1.326053,103.892117
409966,23,158,181,1.325983,103.891927
410101,352,307,659,1.325131,103.910841
410102,681,273,954,1.325614,103.910492
410103,1142,226,1368,1.325855,103.910504
410104,737,115,852,1.325854,103.909917
410105,87,164,251,1.325676,103.910086
410106,692,49,741,1.325133,103.909952
410107,29,97,126,1.324953,103.910195
410108,516,34,550,1.324574,103.910072
410109,742,71,813,1.324709,103.910671
410110,279,112,391,1.323791,103.910782
410111,906,258,1164,1.324146,103.911093
410112,320,370,690,1.323646,103.91112
410113,261,332,593,1.323557,103.911833
410114,974,174,1148,1.323151,103.911832
410115,213,32,245,1.322969,103.911233
410116,414,70,484,1.32282,103.911733
410633,329,393,722,1.330431,103.905144
410634,258,1066,1324,1.330239,103.904976
410635,469,374,843,1.33074,103.904784
410636,387,354,741,1.331022,103.904516
410637,959,1811,2770,1.33109,103.903885
410638,694,75,769,1.331431,103.904227
410639,354,125,479,1.331808,103.904602
410640,492,20,512,1.332034,103.904959
410641,376,84,460,1.331692,103.905256
410642,958,165,1123,1.331306,103.905512
410643,493,692,1185,1.330875,103.905716
410644,418,844,1262,1.330783,103.905378
410645,360,4972,5332,1.332131,103.905875
410646,572,1090,1662,1.332131,103.905875
410647,212,85,297,1.332131,103.905875
410648,417,270,687,1.332131,103.905875
410649,438,2249,2687,1.332131,103.905875
410650,225,448,673,1.331914,103.907542
410651,273,532,805,1.332189,103.907342
410652,336,273,609,1.332596,103.907832
410653,415,196,611,1.332979,103.907506
410654,298,1573,1871,1.332998,103.9069
410655,242,91,333,1.333385,103.90684
410656,569,86,655,1.333657,103.907435
410657,268,220,488,1.33398,103.907287
410658,123,6454,6577,1.333604,103.906529
410659,205,5442,5647,1.334275,103.906161
410660,185,362,547,1.334371,103.906615
410661,336,205,541,1.334481,103.907917
410662,246,336,582,1.334555,103.908262
410663,442,638,1080,1.334644,103.908776
410664,876,663,1539,1.334157,103.908898
410665,392,205,597,1.334158,103.908095
410666,442,132,574,1.333789,103.908175
410667,658,428,1086,1.333717,103.90881
410668,262,680,942,1.333328,103.908832
410669,369,224,593,1.333107,103.908427
410670,543,187,730,1.332751,103.908382
410671,324,1104,1428,1.332457,103.908765
410672,208,3892,4100,1.332101,103.908679
411002,18,17,35,1.33644,103.900785
411145,6,76,82,1.299509,103.837
411637,24,585,609,1.330568,103.904321
411647,5,78,83,1.332131,103.905875
411649,13,1367,1380,1.332214,103.90614
411651,19,4271,4290,1.332318,103.907139
411660,28,830,858,1.334396,103.907403
411671,16,2330,2346,1.333163,103.908977
412002,5,15,20,1.336533,103.900857
413002,4,7,11,1.337058,103.900356
415804,4,286,290,1.299509,103.837
415805,64,30,94,1.299509,103.837
415806,102,9,111,1.340886,103.910064
415808,494,29,523,1.341692,103.911319
415809,8,109,117,1.299509,103.837
415810,10,35,45,1.299509,103.837
415811,8,346,354,1.299509,103.837
415812,37,392,429,1.336781,103.904041
415813,5,2,7,1.299509,103.837
415814,406,688,1094,1.337205,103.906637
415815,95,164,259,1.338337,103.908763
415816,165,366,531,1.299509,103.837
415817,6,3,9,1.299509,103.837
415818,3,2,5,1.299509,103.837
415819,11,2,13,1.299509,103.837
415820,41,0,41,1.299509,103.837
415821,20,3,23,1.299509,103.837
415822,7,2,9,1.299509,103.837
415823,1,0,1,1.316837,103.896821
415824,6,2,8,1.299509,103.837
415825,27,3,30,1.299509,103.837
415826,60,4,64,1.299509,103.837
415827,5,1,6,1.299509,103.837
415828,4,3,7,1.299509,103.837
415829,11,1,12,1.299509,103.837
415830,50,2,52,1.299509,103.837
415831,5,0,5,1.299509,103.837
415832,16,3,19,1.299509,103.837
415833,32,0,32,1.299509,103.837
415834,8,1,9,1.299509,103.837
415835,2,1,3,1.320696,103.897894
415836,13,0,13,1.299509,103.837
415837,1,0,1,1.299509,103.837
415838,1,0,1,1.299509,103.837
415839,28,19,47,1.299509,103.837
415840,97,35,132,1.299509,103.837
415841,1,1,2,1.320072,103.894527
415842,2,1,3,1.299509,103.837
415843,16,1,17,1.299509,103.837
415844,53,7,60,1.299509,103.837
415845,9,11,20,1.299509,103.837
415846,43,0,43,1.299509,103.837
415847,0,16,16,1.299509,103.837
415848,1,4,5,1.299509,103.837
415849,17,6,23,1.299509,103.837
415850,3,2,5,1.299509,103.837
415851,14,0,14,1.299509,103.837
415852,79,0,79,1.299509,103.837
415853,4,1,5,1.299509,103.837
415854,7,0,7,1.299509,103.837
415855,12,0,12,1.299509,103.837
415856,0,2,2,1.299509,103.837
415857,4,1,5,1.299509,103.837
415859,8,1,9,1.299509,103.837
415860,2,0,2,1.305033,103.830774
415861,3,1,4,1.299509,103.837
415862,18,0,18,1.299509,103.837
415863,29,2,31,1.299509,103.837
415864,7,2,9,1.299509,103.837
415865,3,2,5,1.299509,103.837
415866,6,7,13,1.299509,103.837
415867,419,30,449,1.299509,103.837
415868,128,2263,2391,1.299509,103.837
415869,502,262,764,1.299509,103.837
415870,332,275,607,1.327913,103.906548
415871,426,40,466,1.327913,103.906548
415872,183,6,189,1.327913,103.906548
415873,252,2,254,1.299509,103.837
415874,356,967,1323,1.338854,103.906119
415875,2652,539,3191,1.338402,103.905945
415876,2,0,2,1.299509,103.837
415877,0,1,1,1.299509,103.837
415878,13,82,95,1.337851,103.902661
415879,0,2,2,1.329783,103.907592
415880,9,115,124,1.337851,103.902661
415881,27,60,87,1.337851,103.902661
415882,99,0,99,1.337847,103.902708
415883,7,0,7,1.337851,103.902661
415884,10,0,10,1.337851,103.902661
415885,0,20,20,1.337851,103.902661
415886,5,0,5,1.337829,103.902734
415887,26,5,31,1.323721,103.908577
415888,3,0,3,1.299509,103.837
415889,4,0,4,1.323359,103.908904
415890,62,1,63,1.323359,103.908904
415891,6,4,10,1.323359,103.908904
415892,1,63,64,1.323314,103.908821
415893,6,0,6,1.323189,103.908897
415894,57,0,57,1.323189,103.908897
415895,13,1,14,1.323189,103.908897
415896,3,1,4,1.323189,103.908897
415897,14,0,14,1.322356,103.908441
415898,10,5,15,1.32316,103.908597
415899,181,15,196,1.318266,103.911348
415900,5,0,5,1.329804,103.907443
415901,15,22,37,1.325721,103.908438
415902,8,0,8,1.32565,103.908446
415903,5,0,5,1.325584,103.908464
415904,2,0,2,1.337851,103.902661
415905,0,1,1,1.323238,103.908825
415906,0,20,20,1.325318,103.908509
415907,3,4,7,1.32504,103.908527
415908,2,0,2,1.325485,103.90848
415909,3,0,3,1.323359,103.908904
415910,1,2,3,1.324914,103.908555
415911,2,1,3,1.322931,103.908408
415912,0,4,4,1.325108,103.90769
415913,2,3,5,1.325108,103.90769
415914,6,2,8,1.325108,103.90769
415915,0,5,5,1.3297,103.907636
415916,54,667,721,1.337961,103.909962
415917,3,3,6,1.338,103.909931
415918,0,10,10,1.338055,103.909946
415919,5,56,61,1.338013,103.909977
415920,140,127,267,1.338125,103.909958
415921,12,67,79,1.337864,103.908795
415923,3,2,5,1.338332,103.908749
415925,5,182,187,1.337906,103.909741
415926,627,1231,1858,1.333543,103.903467
415927,74,1,75,1.339815,103.907413
415928,165,42,207,1.334655,103.900732
415929,2,3,5,1.321553,103.908613
415930,10,0,10,1.329655,103.908291
415931,7,3,10,1.322588,103.908235
415932,3,2,5,1.322727,103.908178
415933,165,158,323,1.338383,103.90776
415934,3518,349,3867,1.33251,103.902292
415935,134,92,226,1.334673,103.901678
415936,259,261,520,1.334486,103.901876
415937,1328,1445,2773,1.333953,103.900879
415938,533,538,1071,1.335527,103.900826
415939,124,21,145,1.335102,103.901265
415940,84,971,1055,1.335031,103.904794
415941,7358,502,7860,1.336483,103.909071
415942,74,92,166,1.33661,103.908909
415943,9,38,47,1.336523,103.908929
415944,43,234,277,1.336391,103.908958
415945,5,8,13,1.336291,103.908989
415946,1,13,14,1.336185,103.909038
415947,58,1192,1250,1.33573,103.908862
415948,46,29,75,1.336112,103.90905
415949,1,33,34,1.335707,103.908807
415950,27,15,42,1.335791,103.908266
415951,19,27,46,1.335692,103.908737
415952,2,52,54,1.335957,103.908227
415953,4,18,22,1.33569,103.908659
415954,1,13,14,1.336072,103.908192
415955,1,3,4,1.335667,103.908556
415956,19,7,26,1.336209,103.90817
415957,11,1,12,1.335638,103.908437
415958,2,13,15,1.336335,103.908133
415959,3,11,14,1.335615,103.908312
415960,23,26,49,1.336467,103.908107
415961,9,11,20,1.33558,103.908186
415962,35,51,86,1.335552,103.908055
415963,100,77,177,1.33552,103.907921
415964,27,32,59,1.335817,103.908195
415965,18,13,31,1.335978,103.908149
415966,129,4,133,1.336127,103.90812
415967,152,5,157,1.336287,103.908092
415968,29,31,60,1.336423,103.908057
415969,71,13,84,1.336621,103.907752
415970,24,129,153,1.336642,103.90785
415971,29,75,104,1.336655,103.907942
415972,15,71,86,1.336682,103.908094
415973,16,64,80,1.336703,103.908169
415974,4,56,60,1.336733,103.908307
415975,42,70,112,1.336762,103.90841
415976,36,74,110,1.336786,103.908532
415977,19,324,343,1.33681,103.908667
415978,2422,139,2561,1.337556,103.902894
415979,1959,5823,7782,1.334635,103.904271
415980,3,16,19,1.336964,103.913119
415981,3,106,109,1.33696,103.913109
415982,10,51,61,1.33695,103.913091
415983,14,144,158,1.336941,103.913072
415984,2,138,140,1.336932,103.913053
415985,25,890,915,1.336922,103.913034
415986,11,148,159,1.337404,103.912918
415987,2,6,8,1.337395,103.912899
415988,1,3,4,1.337385,103.91288
415989,7,11,18,1.337376,103.912862
415990,3,1,4,1.337367,103.912843
415991,1,8,9,1.337358,103.912824
415992,3,1,4,1.337348,103.912806
415993,0,6,6,1.337339,103.912787
415994,1,4,5,1.33733,103.912768
415995,0,7,7,1.33732,103.912749
415996,0,5,5,1.336929,103.91211
415997,4,9,13,1.336698,103.911425
415998,2,3,5,1.336688,103.911406
415999,1,6,7,1.336679,103.911388
416000,1,2,3,1.323093,103.908271
416003,2,1,3,1.33667,103.911369
416004,29,1,30,1.336633,103.911298
416005,9,253,262,1.336624,103.911279
416006,18,196,214,1.336837,103.911381
416007,0,2,2,1.324964,103.908545
416008,2,0,2,1.336828,103.911362
416009,0,1,1,1.325405,103.908493
416010,12,0,12,1.3368,103.911306
416011,6,2,8,1.33679,103.911287
416012,10,0,10,1.336782,103.911273
416013,1,1,2,1.336818,103.911343
416014,0,3,3,1.336642,103.911313
416015,5,5,10,1.337199,103.911974
416016,1,3,4,1.33731,103.912129
416017,10,0,10,1.33733,103.912212
416018,3,2,5,1.337505,103.91278
416019,25,4,29,1.337496,103.912762
416020,66,0,66,1.337486,103.912743
416021,2,3,5,1.337477,103.912724
416022,33,3,36,1.337468,103.912705
416023,2,3,5,1.337458,103.912687
416024,1,1,2,1.337152,103.911791
416025,9,126,135,1.33744,103.912649
416026,39,160,199,1.337913,103.912653
416027,0,2,2,1.337449,103.912668
416028,1,1,2,1.337903,103.912634
416029,1,0,1,1.336809,103.911325
416030,1,1,2,1.337894,103.912615
416031,22,2,24,1.337866,103.912559
416032,2,0,2,1.337875,103.912578
416033,1,1,2,1.337857,103.91254
416034,1,5,6,1.337838,103.912503
416035,0,12,12,1.337829,103.912484
416036,1,4,5,1.337493,103.91185
416037,80,2,82,1.337223,103.911175
416038,1,2,3,1.337163,103.911874
416040,4,3,7,1.337195,103.911119
416041,214,15,229,1.337186,103.9111
416042,65,2,67,1.337177,103.911081
416043,0,3,3,1.337214,103.911156
416044,9,0,9,1.337158,103.911044
416045,24,106,130,1.337149,103.911025
416046,13,16,29,1.337332,103.911143
416047,6,1,7,1.337323,103.911125
416049,5,3,8,1.337304,103.911087
416050,3,11,14,1.337295,103.911069
416051,0,8,8,1.337286,103.91105
416053,3,0,3,1.337167,103.911063
416054,7,0,7,1.337705,103.911611
416055,0,4,4,1.337769,103.911698
416056,17,3,20,1.337804,103.911837
416057,13,2,15,1.337869,103.911944
416058,1,0,1,1.337885,103.912596
416059,2,1,3,1.337667,103.911567
416060,0,5,5,1.337971,103.912536
416061,2,3,5,1.337962,103.912517
416063,14,2,16,1.337943,103.91248
416064,2,0,2,1.337847,103.912522
416065,16,170,186,1.337924,103.912442
416066,0,621,621,1.338373,103.912469
416067,2,35,37,1.338364,103.912451
416068,1,8,9,1.338354,103.912432
416069,2,15,17,1.338345,103.912413
416070,6,7,13,1.338336,103.912395
416071,3,9,12,1.338326,103.912376
416072,34,13,47,1.338317,103.912357
416073,8,8,16,1.338308,103.912338
416074,0,9,9,1.338298,103.91232
416075,0,27,27,1.338287,103.912305
416076,5,16,21,1.338003,103.911585
416077,6,27,33,1.337646,103.910977
416078,0,6,6,1.337636,103.910958
416079,3,19,22,1.337627,103.910939
416080,0,8,8,1.337618,103.910921
416081,2,22,24,1.337608,103.910902
416082,0,6,6,1.337599,103.910883
416083,2,12,14,1.33759,103.910864
416084,0,16,16,1.33758,103.910846
416085,7,52,59,1.337571,103.910827
416086,0,7,7,1.320789,103.9086
416087,876,430,1306,1.336766,103.905363
416088,21,238,259,1.338613,103.907366
416089,8,104,112,1.339165,103.907014
416090,7,860,867,1.337046,103.90343
416091,19,550,569,1.336989,103.903409
416092,0,1,1,1.337989,103.912573
416093,1,0,1,1.336926,103.903335
416094,0,36,36,1.336789,103.903199
416095,1,2,3,1.33798,103.912554
416096,16,23,39,1.336663,103.903068
416097,14,4,18,1.336594,103.903005
416098,6,8,14,1.336531,103.902948
416099,9,1,10,1.336473,103.902891
416100,8,51,59,1.336624,103.902894
416101,13,5,18,1.33641,103.902823
416102,6,5,11,1.336567,103.902852
416103,0,1,1,1.336863,103.903261
416105,3,1,4,1.33629,103.902715
416106,5,1,6,1.336476,103.902743
416107,5,11,16,1.336238,103.902658
416108,0,3,3,1.336731,103.903136
416109,0,1,1,1.336353,103.902766
416110,3,2,5,1.336384,103.902664
416111,0,2,2,1.337934,103.912461
416112,1,0,1,1.336187,103.902607
416113,0,4,4,1.336078,103.902516
416114,18,0,18,1.33631,103.902573
416115,6,4,10,1.336021,103.902465
416116,2,7,9,1.336269,103.902527
416117,8,5,13,1.335969,103.902419
416118,7,3,10,1.336224,103.902482
416119,1,12,13,1.335917,103.902368
416120,16,0,16,1.33593,103.902058
416121,1,2,3,1.33643,103.902704
416122,0,9,9,1.335988,103.90201
416123,0,3,3,1.335872,103.902317
416124,0,3,3,1.33582,103.902265
416125,55,11,66,1.335768,103.90222
416127,4,12,16,1.335717,103.902169
416129,0,3,3,1.336034,103.901959
416130,9,6,15,1.336248,103.901723
416131,4,0,4,1.335614,103.902072
416132,8,5,13,1.336326,103.901655
416133,1,2,3,1.335671,103.902118
416134,11,1,12,1.336445,103.90155
416135,57,26,83,1.335522,103.901975
416136,10,3,13,1.33651,103.901484
416137,0,6,6,1.335482,103.90195
416138,15,4,19,1.336548,103.901423
416139,29,9,38,1.335397,103.901867
416140,4,14,18,1.33661,103.901371
416141,10,313,323,1.335287,103.901766
416142,3,71,74,1.336636,103.901302
416143,0,38,38,1.335325,103.901723
416144,59,7,66,1.336316,103.901325
416145,1,1,2,1.336135,103.902561
416146,2,2,4,1.336255,103.901289
416147,2,162,164,1.335383,103.901656
416148,0,2,2,1.335349,103.901688
416149,0,12,12,1.335429,103.901599
416150,1,102,103,1.336107,103.901172
416151,4,14,18,1.335493,103.901534
416152,1,0,1,1.33635,103.902624
416153,0,15,15,1.335556,103.901469
416154,0,1,1,1.336306,103.901601
416155,8,59,67,1.335618,103.901391
416156,2,0,2,1.33619,103.901244
416157,8,12,20,1.335667,103.901358
416159,0,2,2,1.336156,103.90172
416160,5,7,12,1.336037,103.901836
416162,2,11,13,1.335941,103.9019
416163,3,72,75,1.335821,103.901153
416164,115,0,115,1.335905,103.901955
416165,0,1,1,1.336258,103.901637
416166,37,10,47,1.335537,103.901689
416167,1,36,37,1.335934,103.901038
416168,0,1,1,1.335879,103.901093
416169,10,283,293,1.335976,103.900992
416170,0,5,5,1.335655,103.901541
416171,24,0,24,1.335713,103.901485
416172,41,0,41,1.335775,103.901414
416173,4,0,4,1.335832,103.901352
416175,681,5,686,1.335361,103.902725
416179,33,815,848,1.336049,103.904606
416180,257,1254,1511,1.335921,103.90434
416181,67,29,96,1.335986,103.904547
416182,4,16,20,1.335833,103.904259
416183,18,20,38,1.335862,103.90443
416184,44,15,59,1.335722,103.904145
416185,7,16,23,1.335737,103.904312
416186,37,13,50,1.335631,103.904079
416187,63,7,70,1.335613,103.904195
416188,145,9,154,1.335534,103.903979
416189,27,4,31,1.335488,103.904077
416190,9,8,17,1.335455,103.903914
416191,2,9,11,1.335363,103.90396
416192,24,8,32,1.335373,103.90382
416193,4,22,26,1.335239,103.903842
416194,2,5,7,1.335247,103.903711
416195,381,37,418,1.335114,103.903725
416196,113,16,129,1.335128,103.903614
416197,6,4,10,1.33499,103.903607
416198,50,51,101,1.335017,103.903508
416199,31,4,35,1.334865,103.90349
416200,12,8,20,1.334939,103.903428
416201,39,6,45,1.33474,103.903372
416202,21,6,27,1.334832,103.903315
416203,20,6,26,1.334616,103.903255
416204,244,4,248,1.334749,103.903257
416205,3,3,6,1.334491,103.903137
416206,6,3,9,1.334653,103.903168
416207,5,6,11,1.334367,103.90302
416208,17,2,19,1.334573,103.903089
416209,135,39,174,1.334252,103.902912
416210,6,1,7,1.334474,103.90297
416211,164,61,225,1.334012,103.903423
416212,12,18,30,1.334224,103.902886
416213,7,35,42,1.334082,103.9035
416214,63,545,608,1.334173,103.902922
416215,45,12,57,1.334142,103.903572
416216,265,89,354,1.334109,103.90299
416217,1,17,18,1.334214,103.903636
416218,30,23,53,1.334049,103.903046
416219,6,36,42,1.334294,103.903746
416220,22,20,42,1.334013,103.90308
416221,7,67,74,1.334366,103.903836
416222,0,28,28,1.33396,103.903145
416223,6,48,54,1.334455,103.903938
416224,2,39,41,1.333907,103.903218
416225,27,16,43,1.33454,103.904027
416226,11,366,377,1.333856,103.903295
416227,16,55,71,1.334637,103.90413
416228,15,161,176,1.334735,103.904227
416229,6,112,118,1.334862,103.904355
416230,11,30,41,1.334972,103.904462
416231,260,5,265,1.335044,103.904534
416232,1,23,24,1.335133,103.904619
416233,8,121,129,1.335226,103.904704
416234,326,1493,1819,1.335315,103.904802
416236,288,1083,1371,1.336451,103.906038
416237,154,14,168,1.336313,103.906076
416238,27,2,29,1.336109,103.906141
416239,199,53,252,1.33593,103.906167
416240,811,94,905,1.335649,103.906246
416241,361,79,440,1.335511,103.906287
416242,1,4,5,1.337865,103.903639
416243,370,510,880,1.335305,103.906258
416244,775,85,860,1.335695,103.907245
416245,4,17,21,1.335272,103.906376
416246,14,10,24,1.335789,103.907212
416247,6,16,22,1.335268,103.906498
416248,117,22,139,1.335945,103.907177
416249,0,12,12,1.335292,103.906603
416250,40,12,52,1.336048,103.907139
416251,25,43,68,1.3353,103.906733
416252,4,0,4,1.336191,103.907144
416253,199,38,237,1.33532,103.906867
416254,2,16,18,1.336295,103.907119
416255,97,24,121,1.335344,103.90698
416256,19,9,28,1.336436,103.90707
416257,10,85,95,1.335372,103.90711
416258,17,6,23,1.336542,103.907058
416259,103,50,153,1.3354,103.907236
416260,44,1360,1404,1.336691,103.907021
416261,73,386,459,1.335432,103.907353
416262,4,29,33,1.335686,103.907376
416263,74,11,85,1.335833,103.907345
416264,4,17,21,1.335926,103.907309
416265,57,5,62,1.336035,103.907297
416266,4,5,9,1.336169,103.907281
416267,122,14,136,1.336262,103.90726
416268,1,9,10,1.336396,103.90724
416269,9,2,11,1.336542,103.907212
416270,18,522,540,1.336707,103.907188
416271,2,5,7,1.336658,103.905448
416273,5,285,290,1.336689,103.905438
416274,1,12,13,1.322196,103.918378
416275,0,2,2,1.335711,103.901262
416278,2,0,2,1.322126,103.918421
416279,0,12,12,1.321717,103.918624
416280,2,3,5,1.321732,103.918871
416281,11,0,11,1.32177,103.918975
416282,21,0,21,1.321892,103.919147
416283,2,0,2,1.321814,103.918574
416284,0,106,106,1.321874,103.91918
416285,1,65,66,1.321851,103.919172
416286,8,122,130,1.321835,103.919153
416287,1,19,20,1.321786,103.919105
416288,2,11,13,1.32176,103.919063
416289,9,21,30,1.32172,103.919003
416290,2,22,24,1.321693,103.918935
416291,2,6,8,1.321656,103.918767
416292,7,6,13,1.321635,103.918676
416293,6,6,12,1.32161,103.918578
416294,0,27,27,1.321601,103.918513
416295,20,91,111,1.321556,103.918406
416296,0,27,27,1.321527,103.91826
416315,1,13,14,1.322303,103.918411
416316,26,50,76,1.322107,103.918189
416317,22,1,23,1.322357,103.918462
416318,70,11,81,1.322051,103.918147
416320,0,2,2,1.321874,103.91918
416322,5,0,5,1.321929,103.918031
416323,24,9,33,1.322489,103.918591
416324,1,0,1,1.33559,103.901615
416326,2,1,3,1.335568,103.902021
416327,1,0,1,1.321881,103.917968
416328,2,5,7,1.32258,103.918683
416329,6,2,8,1.321727,103.917807
416331,5,3,8,1.321685,103.917763
416332,1,10,11,1.322689,103.91878
416333,26,8,34,1.321642,103.917718
416334,5,0,5,1.322724,103.918837
416335,8,766,774,1.321595,103.917782
416336,2,3,5,1.322782,103.918879
416337,40,1,41,1.321647,103.917839
416338,8,1,9,1.322847,103.918944
416339,3,0,3,1.321834,103.917919
416340,1,2,3,1.321722,103.917902
416341,1,0,1,1.321772,103.917848
416342,18,521,539,1.322953,103.919041
416343,2,2,4,1.321825,103.918004
416344,1,0,1,1.321779,103.917965
416345,0,1,1,1.321859,103.918038
416347,0,3,3,1.322898,103.918984
416348,11,1,12,1.322048,103.918211
416349,1,1064,1065,1.322449,103.919179
416351,2,0,2,1.322,103.918095
416352,10,5,15,1.322109,103.918284
416353,1,6,7,1.32253,103.919027
416354,0,1,1,1.321911,103.918073
416355,11,8,19,1.322502,103.918707
416356,1,0,1,1.322555,103.918881
416374,18,6,24,1.328889,103.908012
416375,2,0,2,1.322502,103.919115
416376,3,10,13,1.328332,103.908258
416377,7,1,8,1.328748,103.907912
416378,54,16,70,1.328273,103.908326
416380,0,1,1,1.322428,103.918654
416381,1,2,3,1.322008,103.918158
416382,4,73,77,1.328067,103.908653
416383,56,18,74,1.328032,103.908683
416384,2,14,16,1.328614,103.907879
416385,19,88,107,1.327987,103.908699
416386,3,2,5,1.327909,103.908797
416387,9,0,9,1.327839,103.908852
416388,21,89,110,1.32778,103.908949
416389,0,6,6,1.327942,103.908779
416390,1,9,10,1.327964,103.908758
416391,0,2,2,1.328654,103.907958
416392,46,32,78,1.328879,103.907941
416393,0,1,1,1.328662,103.907899
416394,1,1,2,1.328384,103.908182
416395,3,4,7,1.328716,103.907966
416396,2,4,6,1.32884,103.907998
416397,0,4,4,1.328783,103.907977
416406,0,4,4,1.325236,103.913779
416407,0,36,36,1.325173,103.913766
416408,11,0,11,1.325239,103.913835
416409,4,0,4,1.325184,103.91383
416410,12,1,13,1.325245,103.913903
416412,13,0,13,1.325257,103.913971
416413,1,0,1,1.328852,103.907931
416415,1,0,1,1.325207,103.913944
416416,20,19,39,1.325285,103.91414
416417,2,0,2,1.328817,103.907932
416418,2,0,2,1.325221,103.914063
416419,0,1,1,1.325207,103.914018
416421,7,3,10,1.325331,103.914421
416423,2,3,5,1.325449,103.915073
416424,9,0,9,1.325455,103.915119
416425,5,0,5,1.325467,103.915153
416426,1,1,2,1.325303,103.914227
416428,2,0,2,1.325354,103.914886
416430,2,2,4,1.325372,103.914992
416431,2,0,2,1.325365,103.914931
416433,60,1,61,1.325478,103.915318
416434,1,0,1,1.325314,103.91429
416435,2,10,12,1.325518,103.915539
416436,1,2,3,1.328159,103.908542
416437,1,0,1,1.325339,103.915033
416438,5,6,11,1.32539,103.915159
416439,12,2,14,1.325537,103.915638
416440,0,8,8,1.325401,103.915204
416441,0,2,2,1.32548,103.915269
416442,8,4,12,1.325413,103.91525
416443,9,0,9,1.325557,103.915763
416444,1,11,12,1.325418,103.915284
416445,1,0,1,1.32553,103.915588
416446,146,5,151,1.325425,103.915594
416447,9,1,10,1.325579,103.915888
416449,0,3,3,1.325352,103.915123
416467,2,25,27,1.324649,103.913661
416468,2,35,37,1.324577,103.913723
416469,1,0,1,1.325569,103.915825
416471,3,3,6,1.324672,103.913877
416472,1,0,1,1.324655,103.913746
416473,1,7,8,1.324684,103.913962
416474,5,1,6,1.324585,103.914028
416476,10,4,14,1.32466,103.914394
416477,0,4,4,1.324671,103.91448
416478,1,3,4,1.324683,103.914548
416479,0,3,3,1.32542,103.915724
416480,10,2,12,1.3247,103.914668
416481,1,21,22,1.324792,103.914877
416482,22,3,25,1.324628,103.914959
416483,56,0,56,1.324799,103.914931
416484,1,6,7,1.324633,103.915033
416485,1,2,3,1.324694,103.914594
416486,8,6,14,1.324633,103.915118
416487,1,1,2,1.325547,103.915703
416488,11,8,19,1.32484,103.915168
416489,99,25,124,1.324848,103.915282
416507,7,55,62,1.320082,103.910983
416508,12,576,588,1.320195,103.910893
416510,0,14,14,1.320132,103.910911
416512,1,4,5,1.320057,103.910928
416513,1,0,1,1.324601,103.91394
416514,14,12,26,1.319983,103.910933
416515,8,1,9,1.319827,103.911008
416516,0,17,17,1.319931,103.910945
416518,0,11,11,1.31988,103.910945
416519,0,1,1,1.319874,103.911003
416537,2,505,507,1.319425,103.906418
416538,5,0,5,1.319426,103.906422
416539,0,3,3,1.32481,103.915003
416540,1,0,1,1.319828,103.910951
416551,319,3457,3776,1.321062,103.91305
416553,2,1,3,1.319428,103.906432
416555,1,31,32,1.319742,103.909892
416557,3,107,110,1.321007,103.917493
416558,198,689,887,1.318359,103.905597
416575,12,7,19,1.327581,103.916549
416576,1,2,3,1.319721,103.909785
416577,1,0,1,1.319429,103.906441
416578,0,3,3,1.327497,103.916594
416581,1,1,2,1.324822,103.915073
416582,6,1,7,1.327479,103.916812
416583,5,1,6,1.327535,103.916949
416584,1,0,1,1.32758,103.916625
416585,7,1,8,1.327546,103.917064
416586,142,0,142,1.327447,103.91703
416587,18,2,20,1.32744,103.917125
416588,5,3,8,1.327523,103.9172
416589,13,1,14,1.327421,103.917226
416590,2,2,4,1.32752,103.917311
416592,0,1,1,1.32747,103.916909
416593,0,5,5,1.327387,103.917447
416596,0,2,2,1.327558,103.916834
416597,0,5,5,1.327373,103.917642
416598,0,2,2,1.327498,103.917592
416599,6,21,27,1.327426,103.91819
416600,1,13,14,1.327461,103.917922
416601,227,1708,1935,1.327371,103.918093
416602,2,9,11,1.327959,103.918025
416603,0,2,2,1.327489,103.917732
416604,11,2,13,1.32798,103.917799
416605,0,1,1,1.327515,103.917403
416606,2,0,2,1.327961,103.917901
416607,1,4,5,1.327993,103.917475
416609,0,1,1,1.327979,103.917688
416610,11,885,896,1.32777,103.918379
416611,1,1,2,1.327985,103.917584
416613,1,1,2,1.328008,103.91728
416614,2,0,2,1.328009,103.917153
416615,77,10,87,1.328022,103.918052
416616,1,1,2,1.328031,103.917051
416617,7,11,18,1.328046,103.91796
416618,0,1,1,1.328,103.917373
416619,10,14,24,1.328064,103.917631
416620,1,0,1,1.32804,103.916842
416621,0,2,2,1.32804,103.916948
416622,2,0,2,1.328107,103.917579
416623,1,21,22,1.328154,103.916957
416624,4,1,5,1.328069,103.91657
416625,0,1,1,1.328057,103.916753
416626,0,3,3,1.327491,103.916645
416627,0,5,5,1.328191,103.916532
416645,0,14,14,1.318699,103.907775
416646,1,0,1,1.328159,103.916815
416647,1,168,169,1.318713,103.907988
416648,0,13,13,1.318754,103.90807
416649,10,1,11,1.318678,103.907643
416653,0,13,13,1.318727,103.908076
416656,0,3,3,1.328183,103.916664
416657,4,3,7,1.318785,103.908246
416658,0,6,6,1.318788,103.908327
416659,1,1,2,1.32806,103.916659
416660,6,10,16,1.318803,103.908383
416661,1,1,2,1.318686,103.908023
416662,3,0,3,1.318784,103.908299
416663,3,8,11,1.318798,103.907987
416664,23,0,23,1.318799,103.908014
416665,1,2,3,1.318607,103.907304
416666,0,3,3,1.3188,103.908035
416667,1,3,4,1.318849,103.908172
416668,0,6,6,1.318841,103.908203
416670,2,4,6,1.31886,103.908331
416672,2,28,30,1.318842,103.908052
416673,1,17,18,1.318747,103.907773
416674,1,0,1,1.31822,103.9078
416675,1,3,4,1.318741,103.907675
416677,0,1,1,1.318745,103.907704
416678,1,0,1,1.318715,103.907507
416679,1,0,1,1.318704,103.907421
416680,9,0,9,1.318685,103.907317
416682,7,135,142,1.319396,103.907622
416683,1,476,477,1.318747,103.907738
416684,3,0,3,1.318811,103.908081
416685,1,0,1,1.318693,103.907361
416686,1,0,1,1.318735,103.907641
416687,0,8,8,1.318714,103.907525
416688,7,0,7,1.319368,103.907371
416690,5,1,6,1.319351,103.907282
416693,1,1,2,1.318632,103.907399
416697,4,0,4,1.320246,103.907927
416698,4,108,112,1.320207,103.907875
416699,3,55,58,1.320199,103.907792
416700,10,7,17,1.320654,103.90772
416701,1,3,4,1.320661,103.907775
416702,119,0,119,1.320664,103.907822
416703,0,16,16,1.32067,103.90787
416704,13,0,13,1.320676,103.907916
416705,4,8,12,1.320682,103.907972
416706,1,0,1,1.319386,103.907461
416707,2,0,2,1.320285,103.908174
416709,1,1,2,1.320702,103.908138
416711,9,0,9,1.320747,103.908012
416712,2,10,12,1.320738,103.907953
416713,67,2,69,1.320727,103.907871
416714,1,6,7,1.320733,103.90782
416715,2,4,6,1.321204,103.907544
416717,4,0,4,1.321204,103.907544
416718,0,3,3,1.319391,103.907561
416719,0,2,2,1.320748,103.908178
416720,12,4,16,1.320702,103.907666
416721,0,9,9,1.320715,103.907755
416724,4,1,5,1.320729,103.907901
416725,0,2,2,1.321204,103.907544
416727,2,0,2,1.320737,103.907994
416728,2,0,2,1.320746,103.908158
416729,548,95,643,1.320215,103.906864
416730,575,84,659,1.320819,103.907445
416731,2,2,4,1.318827,103.908498
416732,1,0,1,1.320701,103.908121
416735,0,1,1,1.318885,103.908366
416736,202,737,939,1.31884,103.908122
416738,2,9,11,1.321204,103.907544
416747,2,2,4,1.324529,103.906672
416748,2,3,5,1.324446,103.906696
416749,2,3,5,1.324272,103.906731
416750,2,11,13,1.324257,103.906725
416751,256,2,258,1.324371,103.906711
416752,2,0,2,1.320744,103.908201
416755,2,2,4,1.324063,103.906758
416756,5,0,5,1.324379,103.90681
416757,229,11,240,1.324313,103.906819
416758,8,8,16,1.324226,103.906849
416759,1,1,2,1.324508,103.906688
416760,2,4,6,1.32354,103.906855
416761,5,14,19,1.324031,103.906872
416762,2,0,2,1.324121,103.906855
416763,0,2,2,1.323973,103.906885
416764,5,0,5,1.323888,103.906894
416765,0,1,1,1.318862,103.908428
416766,4,0,4,1.323437,103.906887
416767,5,1,6,1.323741,103.906929
416768,103,0,103,1.323688,103.906935
416770,1,0,1,1.323794,103.906919
416771,2,0,2,1.323493,103.906866
416773,1,5,6,1.323311,103.906994
416774,18,19,37,1.323232,103.907003
416775,7,2,9,1.322893,103.90705
416776,2,0,2,1.323509,103.906973
416778,1,1,2,1.32283,103.907056
416779,15,0,15,1.32266,103.907007
416780,15,0,15,1.322551,103.907133
416781,17,3,20,1.322571,103.907036
416782,1,0,1,1.323581,103.906966
416783,3,0,3,1.320702,103.907693
416784,1,0,1,1.322476,103.907137
416803,3,1,4,1.319355,103.911605
416804,0,9,9,1.319425,103.911601
416805,7,17,24,1.319238,103.911723
416806,25,2,27,1.319324,103.911706
416807,0,12,12,1.319485,103.9116
416808,26,1,27,1.31941,103.9117
416809,1,6,7,1.319513,103.911677
416810,1,3,4,1.319541,103.911583
416811,0,9,9,1.319633,103.91166
416813,11,0,11,1.319654,103.911559
416814,30,0,30,1.319788,103.911603
416816,1,8,9,1.319732,103.911515
416817,43,23,66,1.319868,103.911592
416818,6,6,12,1.319983,103.911504
416819,2,17,19,1.320037,103.91149
416820,0,17,17,1.319965,103.911592
416821,0,7,7,1.320092,103.911463
416822,0,5,5,1.320175,103.91146
416823,22,19,41,1.320074,103.91158
416824,12,45,57,1.320244,103.911436
416825,7,567,574,1.321155,103.91204
416826,571,298,869,1.321281,103.912366
416827,988,216,1204,1.321796,103.912249
416828,164,17,181,1.321683,103.911859
416829,4,8,12,1.32105,103.91122
416830,62,15,77,1.321125,103.911203
416831,4,15,19,1.321246,103.911289
416832,129,5,134,1.321228,103.911175
416833,7,1,8,1.321336,103.911263
416834,0,7,7,1.32132,103.911152
416835,1,0,1,1.322423,103.907155
416836,3,1,4,1.321463,103.911129
416837,2,1,3,1.322432,103.907053
416840,7,6,13,1.321747,103.911215
416841,28,0,28,1.321749,103.911258
416842,54,1,55,1.321768,103.911312
416843,32,11,43,1.321791,103.911371
416844,76,0,76,1.321814,103.911422
416846,0,17,17,1.321846,103.911536
416847,1,5,6,1.321844,103.911147
416848,0,1,1,1.321432,103.911249
416849,2,0,2,1.322722,103.907104
416851,17,1,18,1.322039,103.911087
416853,0,5,5,1.32201,103.911088
416854,0,1,1,1.321785,103.911061
416855,6,0,6,1.322084,103.911065
416856,6,0,6,1.32196,103.910972
416857,49,2,51,1.32215,103.91104
416858,9,1,10,1.322163,103.91096
416859,5,0,5,1.322205,103.911018
416860,0,5,5,1.322231,103.910946
416861,0,2,2,1.321939,103.911118
416863,7,1,8,1.322498,103.910936
416864,9,1,10,1.322302,103.910917
416865,9,2,11,1.322566,103.910915
416866,1,2,3,1.321549,103.9111
416867,0,9,9,1.322667,103.91088
416868,21,7,28,1.322747,103.910862
416869,2,0,2,1.322377,103.910974
416870,0,52,52,1.322856,103.910824
416871,35,7,42,1.322927,103.9108
416872,5,8,13,1.323034,103.910771
416873,2,0,2,1.322523,103.910838
416874,2,0,2,1.322598,103.910803
416875,24,10,34,1.323105,103.910741
416876,13,0,13,1.322718,103.910782
416877,5,0,5,1.322787,103.910753
416878,295,1,296,1.322884,103.910719
416879,36,1,37,1.322936,103.910702
416880,20,0,20,1.323027,103.910673
416881,1,0,1,1.32185,103.910993
416882,19,17,36,1.322449,103.910877
416883,119,55,174,1.320912,103.911387
416884,13,14,27,1.323194,103.910717
416885,23,7,30,1.323288,103.910676
416886,2,1,3,1.32238,103.9109
416887,0,7,7,1.321928,103.911292
416888,6,5,11,1.299509,103.837
416899,3,0,3,1.322102,103.91096
416900,1,9,10,1.319302,103.910629
416902,254,0,254,1.319415,103.910614
416904,0,1,1,1.323091,103.910644
416905,214,62,276,1.31974,103.910554
416906,3,0,3,1.319228,103.910642
416908,112,1,113,1.319679,103.910549
416912,38,436,474,1.320028,103.910512
416913,42,33,75,1.32067,103.910024
416914,257,0,257,1.320874,103.91029
416915,1,47,48,1.32096,103.91026
416916,0,4,4,1.321057,103.91025
416917,0,2,2,1.32266,103.910798
416918,1,7,8,1.321164,103.910232
416920,5,2,7,1.321259,103.91021
416921,5,0,5,1.32137,103.910197
416922,19,49,68,1.321437,103.910187
416923,62,0,62,1.321574,103.910166
416925,2,0,2,1.321106,103.910246
416926,3,0,3,1.299509,103.837
416928,2,0,2,1.321809,103.910141
416929,30,0,30,1.322154,103.910096
416930,1,82,83,1.32075,103.910478
416932,2,14,16,1.322215,103.91006
416933,0,4,4,1.322328,103.910024
416934,2,0,2,1.322028,103.910118
416935,0,5,5,1.320858,103.910451
416936,1,2,3,1.32195,103.910135
416937,0,6,6,1.322564,103.910027
416938,6,0,6,1.320959,103.910409
416939,66,0,66,1.321094,103.910415
416940,21,2,23,1.322621,103.910013
416941,2,34,36,1.322696,103.910005
416942,3,7,10,1.321169,103.910398
416944,0,8,8,1.321323,103.910358
416945,11,1,12,1.323156,103.909911
416946,68,0,68,1.32326,103.909888
416947,10,0,10,1.321403,103.910335
416948,5,0,5,1.323363,103.909865
416949,1,0,1,1.319509,103.910607
416951,1,0,1,1.321478,103.910307
416952,23,0,23,1.323529,103.909831
416953,22,15,37,1.321649,103.910273
416954,13,3,16,1.323659,103.909736
416955,0,6,6,1.323647,103.909691
416956,3,3,6,1.323631,103.909644
416958,53,6,59,1.323614,103.909541
416959,1,0,1,1.323291,103.909862
416960,2,13,15,1.323586,103.909397
416961,8,10,18,1.321872,103.910247
416962,19,0,19,1.322027,103.910207
416963,1,16,17,1.323741,103.909769
416964,1,0,1,1.323597,103.909461
416965,2,16,18,1.323708,103.90963
416967,8,4,12,1.323686,103.909476
416968,0,1,1,1.323731,103.90971
416969,11,4,15,1.323651,103.909355
416970,7,1,8,1.323637,103.909288
416971,6,61,67,1.321968,103.910237
416972,117,21,138,1.322129,103.910215
416974,7,10,17,1.324198,103.909708
416975,3,0,3,1.32248,103.910033
416976,5,1,6,1.322395,103.910152
416977,1,3,4,1.322452,103.910166
416978,3,17,20,1.32429,103.909691
416979,15,15,30,1.324376,103.90968
416980,59,1,60,1.322572,103.910131
416981,17,73,90,1.324462,103.909668
416982,55,52,107,1.322643,103.910117
416983,0,6,6,1.322751,103.910083
416984,0,20,20,1.322822,103.910083
416985,34,2,36,1.32289,103.910078
416986,2,9,11,1.323038,103.910022
416987,0,3,3,1.322357,103.91016
416988,3,33,36,1.323093,103.910014
416989,3,2,5,1.323093,103.910014
416990,0,1,1,1.323668,103.909411
416991,1,0,1,1.323093,103.910014
416992,0,2,2,1.322364,103.910032
416993,1,2,3,1.323093,103.910014
416994,1,29,30,1.324753,103.90958
416995,20,19,39,1.323282,103.910059
416996,1,0,1,1.323306,103.910374
416997,1,3,4,1.32331,103.910159
416998,34,1,35,1.32333,103.910204
416999,1,0,1,1.323302,103.91011
417001,0,6,6,1.323405,103.910363
417002,0,2,2,1.323338,103.910467
417003,6,2,8,1.323419,103.910469
417005,104,10,114,1.323444,103.910576
417006,6,6,12,1.324876,103.909555
417007,46,15,61,1.323841,103.909942
417008,17,5,22,1.323862,103.909992
417009,11,5,16,1.32389,103.910044
417010,11,0,11,1.323919,103.910112
417011,1,0,1,1.323356,103.910267
417012,0,1,1,1.323948,103.910163
417013,3,3,6,1.32399,103.910269
417014,1,6,7,1.323997,103.910325
417015,3,0,3,1.323346,103.910508
417016,8,12,20,1.324036,103.910398
417017,64,21,85,1.299509,103.837
417018,0,16,16,1.32394,103.909961
417019,8,0,8,1.323957,103.909989
417020,27,1,28,1.323972,103.910007
417021,2,4,6,1.323992,103.910055
417022,12,3,15,1.324032,103.910141
417023,9,9,18,1.324046,103.910189
417024,5,0,5,1.323492,103.9098
417025,146,8,154,1.323665,103.909784
417026,206,0,206,1.322988,103.909935
417027,8,21,29,1.325527,103.909479
417028,6,9,15,1.325615,103.909459
417029,1,1,2,1.323414,103.910403
417030,374,28,402,1.323622,103.909247
417041,2,17,19,1.318898,103.909509
417042,1,0,1,1.323968,103.910206
417043,1,2,3,1.324025,103.910367
417044,3,1,4,1.319051,103.909563
417045,0,4,4,1.319115,103.909554
417046,7,5,12,1.319049,103.909487
417048,0,3,3,1.319004,103.909496
417049,0,11,11,1.319205,103.909449
417050,15,2,17,1.319205,103.909543
417051,30,2,32,1.319349,103.909446
417052,76,0,76,1.319508,103.909511
417053,6,0,6,1.299509,103.837
417056,0,21,21,1.319466,103.909426
417057,2,11,13,1.319594,103.909459
417058,16,3,19,1.319654,103.909467
417059,0,11,11,1.31957,103.909405
417060,6,13,19,1.319741,103.90946
417061,9,476,485,1.319824,103.909441
417062,0,12,12,1.319682,103.90939
417063,5,14,19,1.320486,103.909326
417064,9,0,9,1.320545,103.909332
417065,2,205,207,1.319816,103.909373
417066,7,134,141,1.32045,103.909337
417067,50,10,60,1.320907,103.909527
417068,3,8,11,1.320889,103.909329
417069,2,2,4,1.320733,103.909301
417070,0,5,5,1.320898,103.909474
417071,13,3,16,1.320916,103.90956
417072,4,2,6,1.320926,103.909626
417073,1,0,1,1.318931,103.909492
417075,1,0,1,1.320938,103.909677
417076,1,0,1,1.320963,103.909758
417077,1,0,1,1.320986,103.909773
417078,0,1,1,1.321034,103.909798
417079,2,10,12,1.320961,103.90928
417081,1,1,2,1.325704,103.909437
417082,12,1,13,1.32097,103.909445
417083,0,4,4,1.320992,103.909494
417086,1,1,2,1.32097,103.909391
417088,38,3,41,1.32084,103.909118
417089,0,19,19,1.321446,103.909191
417091,7,0,7,1.32147,103.909299
417093,1,0,1,1.32073,103.909133
417094,27,0,27,1.321483,103.909449
417095,21,0,21,1.321495,103.909509
417096,6,0,6,1.321128,103.909031
417097,2,0,2,1.321015,103.909673
417098,10,0,10,1.321049,103.90976
417099,5,1,6,1.321279,103.909012
417100,0,4,4,1.321431,103.909007
417101,7,2,9,1.321675,103.909108
417102,1,3,4,1.321514,103.908906
417103,5,1,6,1.321545,103.908919
417104,614,0,614,1.321936,103.909038
417105,0,3,3,1.319279,103.909452
417106,6,7,13,1.322028,103.909023
417107,7,1,8,1.322452,103.909353
417108,4,70,74,1.321858,103.908877
417109,5,0,5,1.321918,103.908836
417110,3,23,26,1.322394,103.909032
417111,1,0,1,1.321477,103.909371
417112,3,0,3,1.321716,103.908949
417113,0,6,6,1.322,103.908814
417115,8,3,11,1.32244,103.909305
417116,30,1,31,1.322439,103.909328
417117,62,7,69,1.322127,103.908785
417118,28,5,33,1.322236,103.908808
417119,5,0,5,1.322504,103.909524
417121,3,0,3,1.32242,103.909185
417122,5,0,5,1.322546,103.9095
417123,1,8,9,1.322333,103.908797
417124,152,4,156,1.322395,103.908782
417125,3,0,3,1.322546,103.9095
417126,2,0,2,1.321518,103.90954
417127,8,2,10,1.322471,103.90875
417130,5,0,5,1.322953,103.90888
417131,0,4,4,1.32264,103.908725
417132,19,3,22,1.322704,103.908685
417133,2,3,5,1.322765,103.908816
417134,67,6,73,1.322847,103.908798
417135,0,1,1,1.322412,103.9091
417136,14,0,14,1.323049,103.90888
417137,1,0,1,1.323012,103.908878
417138,28,12,40,1.323189,103.908897
417139,4,8,12,1.323073,103.908612
417141,1,0,1,1.32297,103.908614
417142,7,0,7,1.323351,103.908686
417143,0,2,2,1.322743,103.908926
417144,17,1,18,1.3235,103.9088
417145,1,18,19,1.323469,103.908528
417146,0,4,4,1.323432,103.908827
417147,15,6,21,1.323549,103.908543
417148,19,3,22,1.323666,103.908497
417149,19,0,19,1.323891,103.908533
417150,2,0,2,1.323454,103.908801
417151,118,11,129,1.323602,103.908777
417152,137,0,137,1.323665,103.908768
417154,5,0,5,1.32407,103.908509
417155,1,3,4,1.323722,103.908751
417156,2,0,2,1.323939,103.908534
417158,0,2,2,1.323777,103.908743
417159,0,2,2,1.324211,103.908507
417160,20,1,21,1.324204,103.908562
417161,10,0,10,1.324285,103.908566
417162,5,0,5,1.324462,103.908529
417163,4,1,5,1.324591,103.908521
417164,4,0,4,1.324759,103.908492
417165,2,0,2,1.324258,103.908513
417167,1,13,14,1.325337,103.908427
417168,0,3,3,1.322783,103.90893
417169,12,2,14,1.325479,103.90838
417171,7,0,7,1.325711,103.908348
417172,0,2,2,1.324839,103.908495
417173,0,2,2,1.324597,103.908603
417174,53,2,55,1.324755,103.908583
417175,149,1,150,1.326136,103.908261
417176,1,5,6,1.326194,103.908339
417177,4,2,6,1.326254,103.908312
417178,0,2,2,1.324689,103.908587
417179,2,0,2,1.326376,103.908227
417180,1,1,2,1.326351,103.908306
417181,0,21,21,1.326402,103.908282
417182,6,9,15,1.326417,103.908195
417183,119,26,145,1.32647,103.90817
417184,2,2,4,1.321226,103.909023
417185,0,12,12,1.322467,103.909038
417186,17,0,17,1.322473,103.9091
417187,3,0,3,1.325404,103.908405
417188,2,28,30,1.322506,103.909236
417189,3,0,3,1.322491,103.909168
417190,1,8,9,1.322539,103.909396
417191,1,4,5,1.319344,103.909511
417192,25,153,178,1.320405,103.909259
417193,1,1,2,1.326382,103.908201
417194,0,2,2,1.320447,103.909217
417195,3,1,4,1.320542,103.909183
417196,7,5,12,1.320616,103.909165
417197,11,4,15,1.326186,103.90824
417198,2,2,4,1.322125,103.908926
417199,50,4,54,1.321606,103.90914
417200,0,2,2,1.32049,103.909208
417201,2,6,8,1.318764,103.909082
417202,0,7,7,1.318818,103.909076
417203,0,5,5,1.31886,103.909063
417204,14,4,18,1.318928,103.90897
417205,1,11,12,1.318831,103.908978
417206,0,5,5,1.31892,103.909063
417207,0,7,7,1.31899,103.909043
417208,0,1,1,1.323289,103.908584
417209,28,1,29,1.319133,103.908935
417210,0,6,6,1.319127,103.909017
417211,0,9,9,1.319336,103.908987
417213,6,0,6,1.319559,103.908946
417214,2,12,14,1.319515,103.908875
417215,1,498,499,1.319688,103.90892
417216,148,35,183,1.320403,103.908675
417217,2,0,2,1.324851,103.908569
417218,7,0,7,1.320686,103.90863
417219,0,5,5,1.321131,103.908675
417220,0,8,8,1.320759,103.908602
417221,5,2,7,1.321263,103.908642
417222,3,3,6,1.321387,103.908601
417223,19,2,21,1.321477,103.908581
417224,5,4,9,1.321681,103.908559
417225,1,8,9,1.321791,103.908549
417227,3,0,3,1.322516,103.909294
417228,1,8,9,1.321895,103.908535
417230,1,0,1,1.318959,103.90897
417231,3,4,7,1.32133,103.908536
417232,1,17,18,1.322011,103.908492
417233,108,8,116,1.322049,103.908485
417234,0,5,5,1.322086,103.908487
417235,38,2,40,1.322192,103.908463
417236,0,2,2,1.320561,103.908655
417237,2,1,3,1.321192,103.908552
417238,85,1,86,1.32163,103.908472
417239,0,2,2,1.321544,103.908494
417240,21,0,21,1.322476,103.908395
417241,77,1,78,1.321789,103.908434
417242,1,2,3,1.322278,103.908454
417243,6,9,15,1.322626,103.908369
417244,2,0,2,1.321679,103.90846
417245,1,19,20,1.321893,103.908404
417246,4,0,4,1.322667,103.908357
417247,2,1,3,1.32183,103.908405
417248,0,2,2,1.321839,103.908438
417249,15,3,18,1.322463,103.908282
417250,17,0,17,1.322811,103.908439
417251,6,3,9,1.322708,103.908203
417252,3,2,5,1.322879,103.908383
417253,0,3,3,1.322004,103.908388
417254,2,5,7,1.322875,103.908157
417255,4,1,5,1.323229,103.908223
417256,1,0,1,1.32133,103.908536
417257,0,2,2,1.32275,103.908339
417258,10,5,15,1.323052,103.908116
417259,0,1,1,1.323295,103.908207
417260,1,0,1,1.32342,103.908161
417261,5,2,7,1.323055,103.908016
417262,2,9,11,1.323138,103.908086
417263,8,0,8,1.323651,103.908102
417264,17,0,17,1.323751,103.907926
417265,2,15,17,1.323873,103.907909
417266,106,0,106,1.323912,103.908038
417267,4,2,6,1.323953,103.908041
417268,32,8,40,1.323913,103.90788
417269,2,0,2,1.322999,103.90812
417270,14,1,15,1.324048,103.90802
417271,31,0,31,1.323981,103.907665
417272,31,0,31,1.323986,103.907577
417273,4,0,4,1.323966,103.907462
417274,1,2,3,1.32302,103.90829
417275,3,0,3,1.323948,103.907414
417276,1,1,2,1.324,103.908028
417277,14,1,15,1.324178,103.907995
417278,12,5,17,1.324347,103.907962
417279,4,4,8,1.324313,103.907954
417280,61,0,61,1.323999,103.90733
417281,11,4,15,1.324439,103.907942
417282,13,0,13,1.324073,103.90743
417283,4,0,4,1.324101,103.907502
417284,0,27,27,1.324119,103.90757
417285,37,1,38,1.324624,103.907897
417286,13,7,20,1.324315,103.907787
417287,1,1,2,1.324131,103.908001
417288,4,11,15,1.325925,103.907659
417289,10,0,10,1.325942,103.907845
417290,5,0,5,1.324442,103.907817
417291,2,0,2,1.324133,103.907727
417292,0,1,1,1.323525,103.908123
417293,1,5,6,1.324556,103.907805
417294,34,0,34,1.324721,103.907779
417295,6,1,7,1.324806,103.90777
417296,10,10,20,1.324806,103.90777
417297,390,65,455,1.326133,103.907603
417298,3,5,8,1.325408,103.907696
417299,0,44,44,1.326185,103.907601
417300,0,4,4,1.325461,103.907679
417301,109,48,157,1.326056,103.907563
417302,0,6,6,1.320683,103.908756
417303,0,2,2,1.324491,103.907819
417304,4,2,6,1.320766,103.908728
417305,77,3,80,1.320812,103.908729
417307,2,1,3,1.323945,103.907343
417308,0,3,3,1.320944,103.908691
417310,0,1,1,1.326053,103.907624
417311,1,2,3,1.320982,103.90867
417312,1,37,38,1.320168,103.908861
417313,0,25,25,1.320371,103.908823
417314,13,34,47,1.320438,103.908812
417315,0,24,24,1.320488,103.908783
417316,10,7,17,1.320557,103.908766
417319,128,3,131,1.325846,103.914344
417320,0,3,3,1.319276,103.908894
417321,46,0,46,1.32583,103.914259
417323,26,0,26,1.325815,103.914209
417325,4,1,5,1.325802,103.914129
417326,0,1,1,1.319175,103.908899
417328,2,0,2,1.320646,103.90875
417329,3,0,3,1.325487,103.914537
417330,1,0,1,1.325699,103.914492
417331,1,0,1,1.32584,103.914463
417332,14,0,14,1.325903,103.914456
417333,1,2,3,1.325792,103.914079
417335,2,10,12,1.325625,103.913836
417336,1,1,2,1.325773,103.914483
417337,0,22,22,1.325839,103.913983
417338,6,0,6,1.326077,103.914428
417339,2,0,2,1.32602,103.914433
417341,4,0,4,1.325867,103.914108
417342,9,1,10,1.326193,103.91443
417344,17,1,18,1.32623,103.914422
417345,4,0,4,1.32589,103.914239
417346,2,0,2,1.325856,103.914045
417347,0,1,1,1.325803,103.914035
417349,2,3,5,1.325898,103.914347
417350,3,1,4,1.326576,103.914398
417351,10,2,12,1.326389,103.91425
417352,68,0,68,1.326452,103.914389
417354,5,4,9,1.326507,103.91438
417355,1,0,1,1.325886,103.914275
417356,7,0,7,1.326375,103.914053
417357,0,2,2,1.326277,103.91442
417358,0,2,2,1.326349,103.914
417359,3,23,26,1.326317,103.913863
417360,0,6,6,1.326397,103.913831
417361,3,2,5,1.326399,103.91391
417362,2,1,3,1.325799,103.913998
417363,10,0,10,1.326433,103.914038
417364,3,0,3,1.32641,103.913978
417365,3,5,8,1.326461,103.914196
417366,2,0,2,1.326329,103.913933
417383,16,5,21,1.328448,103.914976
417384,0,14,14,1.328506,103.914944
417385,1,36,37,1.328568,103.914907
417386,9,10,19,1.328636,103.914856
417387,2,5,7,1.328692,103.914835
417388,1,5,6,1.328746,103.914802
417389,23,12,35,1.328811,103.914779
417390,65,82,147,1.328853,103.914746
417391,1032,108,1140,1.329142,103.914571
417392,891,196,1087,1.329142,103.914571
417393,655,78,733,1.329142,103.914571
417394,632,36,668,1.329142,103.914571
417395,169,193,362,1.329371,103.914659
417396,690,80,770,1.329142,103.914571
417397,967,23,990,1.329142,103.914571
417398,528,28,556,1.329155,103.914672
417408,148,127,275,1.323277,103.912753
417409,15,54,69,1.323346,103.91316
417410,0,6,6,1.323372,103.913121
417411,2,0,2,1.326555,103.91439
417412,3,1,4,1.323697,103.912631
417413,3,0,3,1.326444,103.914109
417415,10,35,45,1.323784,103.912472
417416,4,0,4,1.323984,103.912649
417417,0,40,40,1.323986,103.912562
417419,0,42,42,1.323884,103.912336
417420,1,0,1,1.326367,103.914138
417421,0,9,9,1.32415,103.912349
417422,15,76,91,1.324195,103.9123
417423,36,0,36,1.32426,103.912245
417424,1,244,245,1.324106,103.912058
417425,1,53,54,1.324334,103.912062
417426,3,79,82,1.324232,103.91192
417428,5,1,6,1.32443,103.912004
417429,0,56,56,1.324423,103.911963
417430,12,0,12,1.324489,103.911916
417431,0,18,18,1.324533,103.911814
417432,1,133,134,1.324556,103.91175
417433,1,0,1,1.32412,103.912446
417435,10,479,489,1.324579,103.911427
417436,5,6,11,1.32473,103.911441
417437,11,255,266,1.324813,103.911442
417438,21,0,21,1.324871,103.911464
417439,2,0,2,1.323709,103.912592
417440,5,294,299,1.325008,103.911447
417441,20,0,20,1.325142,103.911463
417442,1,29,30,1.325212,103.911492
417443,242,0,242,1.325286,103.91148
417444,5,0,5,1.325334,103.911503
417445,3,0,3,1.323739,103.912555
417446,6,72,78,1.325618,103.911266
417447,1,0,1,1.324588,103.911651
417448,3,0,3,1.325584,103.911276
417450,17,199,216,1.326093,103.911221
417451,1,481,482,1.326188,103.911199
417452,1,0,1,1.325892,103.911241
417454,671,152,823,1.328358,103.911843
417455,437,252,689,1.327827,103.911486
417456,271,27,298,1.328097,103.911773
417457,39,0,39,1.325774,103.911258
417458,10,421,431,1.325471,103.911261
417459,2,51,53,1.325561,103.911279
417460,5,330,335,1.325673,103.911266
417462,1,103,104,1.32652,103.911156
417463,18,13,31,1.326557,103.911156
417465,10,2,12,1.323467,103.913018
417466,1,0,1,1.326294,103.911166
417467,0,2,2,1.324976,103.911515
417468,1,0,1,1.323677,103.912657
417469,13,287,300,1.32361,103.912762
417470,1,49,50,1.324699,103.911431
417471,823,18,841,1.328281,103.912091
417472,1564,25,1589,1.328377,103.912355
417474,1,2,3,1.32594,103.911249
417476,34,1,35,1.325591,103.912988
417477,3,3,6,1.325657,103.912995
417478,3,0,3,1.325532,103.912977
417479,2,7,9,1.32576,103.912996
417480,36,36,72,1.325934,103.912971
417481,61,0,61,1.326014,103.912956
417482,33,0,33,1.326118,103.912959
417483,6,139,145,1.326155,103.912983
417485,15,0,15,1.326312,103.912969
417487,6,0,6,1.326516,103.912957
417488,39,0,39,1.326614,103.912957
417489,3,11,14,1.326849,103.91301
417490,4,12,16,1.326714,103.912953
417491,4,4,8,1.326797,103.912949
417492,16,0,16,1.326879,103.913019
417493,47,0,47,1.326863,103.912951
417494,21,3,24,1.326927,103.912941
417495,29,12,41,1.327033,103.913015
417496,1,4,5,1.32706,103.913026
417497,5,0,5,1.326996,103.912937
417498,1,0,1,1.323622,103.91273
417499,3,0,3,1.325715,103.912991
417500,11,1,12,1.327253,103.913032
417502,1,1,2,1.323644,103.912702
417503,4,13,17,1.327424,103.912996
417504,5,0,5,1.327454,103.913019
417505,21,0,21,1.327326,103.912918
417506,9,0,9,1.327593,103.912984
417507,2,4,6,1.327623,103.912998
417508,6,16,22,1.327439,103.91292
417509,1,1,2,1.327217,103.912925
417510,4,0,4,1.327594,103.912909
417511,9,0,9,1.327801,103.913007
417512,3,0,3,1.327231,103.91301
417513,5,6,11,1.327934,103.912973
417530,10,14,24,1.326881,103.913597
417531,5,5,10,1.326908,103.913603
417532,10,11,21,1.326873,103.913724
417533,45,11,56,1.326935,103.913732
417534,2,1,3,1.327727,103.912907
417535,0,4,4,1.326975,103.913732
417536,8,1,9,1.32704,103.913697
417537,10,3,13,1.327215,103.913582
417538,9,4,13,1.327093,103.913709
417539,2,3,5,1.327205,103.913704
417540,1,0,1,1.327068,103.912937
417542,1,0,1,1.327265,103.913592
417543,0,2,2,1.327781,103.912977
417544,14,1,15,1.327513,103.913669
417545,0,2,2,1.327403,103.913564
417546,5,2,7,1.3276,103.913534
417547,0,5,5,1.327665,103.913544
417548,18,8,26,1.327692,103.913667
417549,7,2,9,1.327778,103.913663
417550,5,0,5,1.327745,103.913549
417551,17,48,65,1.327897,103.913547
417552,26,0,26,1.328027,103.913651
417553,62,42,104,1.327974,103.913564
417554,218,22,240,1.328127,103.91364
417555,4,157,161,1.328207,103.913635
417557,133,9,142,1.326262,103.913618
417558,148,25,173,1.32796,103.913646
417573,11,3,14,1.326783,103.914301
417574,1,1,2,1.32761,103.913677
417575,5,0,5,1.327,103.91429
417576,3,1,4,1.32712,103.914273
417577,2,0,2,1.326895,103.914307
417578,5,0,5,1.327323,103.914266
417580,0,3,3,1.32709,103.913596
417581,2,6,8,1.327579,103.914251
417582,5,3,8,1.327662,103.914252
417583,91,1,92,1.327729,103.914244
417584,0,1,1,1.327404,103.913674
417586,50,16,66,1.327936,103.914223
417587,3,8,11,1.328007,103.914217
417588,20,18,38,1.328068,103.914219
417590,3,0,3,1.327475,103.914256
417591,3,35,38,1.328249,103.914197
417609,267,334,601,1.327273,103.911434
417610,0,183,183,1.326802,103.911237
417611,450,45,495,1.32759,103.911905
417612,12,9,21,1.326861,103.911304
417613,0,10,10,1.326902,103.911361
417614,1,0,1,1.327783,103.914236
417615,0,6,6,1.326968,103.911473
417617,28,14,42,1.32752,103.912092
417618,2,41,43,1.327693,103.912171
417619,3,21,24,1.327578,103.912168
417620,9,1,10,1.327766,103.912243
417621,4,1,5,1.327643,103.912238
417622,3,0,3,1.328186,103.914204
417623,2,2,4,1.327691,103.912309
417624,4,0,4,1.327933,103.912434
417625,2,0,2,1.327257,103.914272
417626,1,5,6,1.327964,103.912474
417627,4,10,14,1.327806,103.912444
417628,3,9,12,1.327989,103.912517
417629,3,0,3,1.327878,103.912388
417630,1,7,8,1.327881,103.912563
417631,6,22,28,1.327938,103.912625
417633,0,29,29,1.327985,103.91269
417634,16,0,16,1.328274,103.912941
417635,3,0,3,1.327831,103.912517
417636,1,2,3,1.328316,103.913042
417637,3,28,31,1.328258,103.913092
417638,21,37,58,1.328481,103.913289
417639,9,58,67,1.328606,103.913264
417640,11,11,22,1.328669,103.913299
417641,9,0,9,1.328279,103.913214
417642,342,32,374,1.328388,103.913735
417643,2,20,22,1.328421,103.913716
417644,0,1,1,1.326939,103.911411
417645,5,4,9,1.328438,103.913908
417646,4,24,28,1.32844,103.9141
417647,2,0,2,1.327745,103.912376
417648,2,4,6,1.328463,103.914161
417649,12,8,20,1.328463,103.914205
417650,19,7,26,1.328481,103.914281
417651,6,8,14,1.32849,103.914313
417652,26,49,75,1.328486,103.91436
417653,30,8,38,1.328468,103.91443
417654,20,51,71,1.328485,103.914484
417655,31,262,293,1.328501,103.914532
417656,35,299,334,1.328492,103.914602
417657,453,236,689,1.328848,103.913358
417658,1,1,2,1.328456,103.914077
417659,287,4,291,1.328186,103.912777
417660,1269,137,1406,1.328306,103.912997
417674,13,14,27,1.324241,103.913397
417675,0,18,18,1.324427,103.913298
417676,4,0,4,1.324301,103.913284
417677,45,12,57,1.324503,103.913191
417680,1,0,1,1.328431,103.913839
417681,4,1,5,1.324513,103.912943
417682,6,0,6,1.324536,103.912869
417684,16,64,80,1.3248,103.912667
417685,5,0,5,1.324621,103.912732
417686,10,0,10,1.324673,103.912681
417688,3,33,36,1.324725,103.912607
417689,22,0,22,1.32477,103.912561
417690,2,11,13,1.324852,103.912579
417694,6,0,6,1.32491,103.912329
417695,15,0,15,1.324944,103.912258
417696,1,0,1,1.324473,103.913005
417697,27,0,27,1.324994,103.912191
417698,2,0,2,1.327825,103.912311
417699,3,16,19,1.324932,103.912431
417700,1,0,1,1.324913,103.912477
417701,6,0,6,1.325164,103.912086
417703,0,8,8,1.325011,103.912306
417704,0,5,5,1.325061,103.912231
417705,27,30,57,1.325262,103.912143
417706,0,2,2,1.325045,103.912149
417707,1,0,1,1.325097,103.912117
417708,17,0,17,1.325762,103.912147
417709,2,3,5,1.325799,103.912132
417710,1,0,1,1.325732,103.912127
417711,5,2,7,1.326059,103.912136
417712,35,3,38,1.326172,103.912139
417713,1,1,2,1.325452,103.912141
417714,15,1,16,1.326357,103.912152
417715,2,1,3,1.328361,103.913149
417716,9,3,12,1.326502,103.912132
417717,37,0,37,1.326561,103.912132
417718,1,1,2,1.326243,103.91213
417720,1,1,2,1.326678,103.912149
417721,2,2,4,1.326888,103.912132
417722,3,0,3,1.326423,103.912121
417723,3,0,3,1.326945,103.912097
417724,2,6,8,1.327094,103.912082
417727,15,0,15,1.325341,103.912056
417728,5,0,5,1.325433,103.912056
417729,1,0,1,1.325933,103.912119
417730,42,0,42,1.325602,103.912046
417731,22,0,22,1.325688,103.912046
417732,1,1,2,1.326817,103.912143
417734,0,2,2,1.325774,103.912046
417737,2,8,10,1.326181,103.912052
417738,81,0,81,1.326261,103.912052
417739,10,0,10,1.326309,103.912034
417741,6,1,7,1.326452,103.912034
417742,22,3,25,1.326527,103.912034
417743,4,1,5,1.326601,103.91204
417745,1,2,3,1.327027,103.912089
417746,2,0,2,1.325923,103.912053
417748,1,1,2,1.326777,103.912025
417749,80,3,83,1.326942,103.912021
417750,0,5,5,1.327003,103.912018
417751,1,5,6,1.327068,103.912
417752,4,4,8,1.327143,103.911992
417753,47,5,52,1.327219,103.912002
417754,152,52,204,1.324679,103.912873
417755,17,5,22,1.324715,103.912875
417756,22,0,22,1.324758,103.912814
417758,11,0,11,1.324788,103.912714
417759,17,20,37,1.299509,103.837
417760,27,118,145,1.299509,103.837
417771,398,1,399,1.318558,103.90648
417775,7,2,9,1.318395,103.906591
417777,830,534,1364,1.318956,103.906595
417778,88,313,401,1.31874,103.906496
417779,4,2,6,1.31874,103.906496
417780,3,2,5,1.31874,103.906496
417781,10,0,10,1.31874,103.906496
417782,6,0,6,1.31874,103.906496
417783,55,0,55,1.31874,103.906496
417784,37,2,39,1.31874,103.906496
417785,6,4,10,1.318692,103.905977
417786,386,4,390,1.318991,103.906446
417794,1,17,18,1.341728,103.911573
417800,1044,144,1188,1.341604,103.911346
417801,275,104,379,1.341499,103.911322
417802,66,867,933,1.340599,103.911803
417803,29,229,258,1.340787,103.91169
417804,3,8,11,1.341954,103.911779
417805,1,6,7,1.342498,103.91269
417806,107,865,972,1.340356,103.909852
417807,310,175,485,1.338939,103.911596
417808,164,135,299,1.339076,103.911253
417809,33,729,762,1.299509,103.837
417810,106,340,446,1.340552,103.91116
417817,11,99,110,1.337872,103.902275
417818,5079,283,5362,1.335629,103.905346
417819,163,606,769,1.336547,103.903701
417820,26,42,68,1.338169,103.901983
417821,14,5,19,1.338335,103.902054
417822,3,190,193,1.338307,103.90208
417823,21,155,176,1.33778,103.902758
417824,2,0,2,1.32689,103.912023
417825,1,0,1,1.325519,103.91205
417826,1,0,1,1.337851,103.902661
417827,3,735,738,1.337851,103.902661
417828,13,0,13,1.337851,103.902661
417829,4,0,4,1.337851,103.902661
417830,13,0,13,1.337851,103.902661
417831,13,0,13,1.337851,103.902661
417833,25,0,25,1.337851,103.902661
417834,11,0,11,1.337851,103.902661
417835,177,275,452,1.336253,103.899836
417836,4,61,65,1.338357,103.90124
417837,89,348,437,1.336096,103.89909
417839,146,113,259,1.337016,103.898749
417840,276,1423,1699,1.337455,103.898036
417841,777,44,821,1.337697,103.898377
417842,805,957,1762,1.338192,103.897834
417843,19,230,249,1.338674,103.898116
417844,181,27,208,1.338756,103.898171
417845,6,5,11,1.338817,103.898223
417846,2,3,5,1.338896,103.898282
417847,2,6,8,1.338963,103.898306
417848,3,3,6,1.339025,103.898378
417849,5,3,8,1.339151,103.89845
417850,5,2,7,1.33923,103.898494
417851,0,3,3,1.326702,103.912025
417852,36,67,103,1.339427,103.898657
417853,18,5,23,1.339368,103.898603
417854,5,221,226,1.338768,103.897617
417855,0,49,49,1.338869,103.897661
417856,7,39,46,1.338918,103.8977
417857,53,39,92,1.338989,103.897779
417858,4,14,18,1.339121,103.897776
417859,47,9,56,1.339166,103.89783
417860,12,9,21,1.3392,103.897855
417861,4,11,15,1.339363,103.897948
417862,3,20,23,1.339437,103.897986
417863,97,15,112,1.339462,103.898064
417864,45,7,52,1.339566,103.898144
417865,14,135,149,1.339642,103.898196
417866,31,120,151,1.338695,103.900406
417867,13,30,43,1.33894,103.899732
417868,624,306,930,1.339058,103.899504
417869,61,102,163,1.338403,103.901494
417883,1200,5,1205,1.341353,103.912393
417884,9,27,36,1.340652,103.912858
417885,56,495,551,1.340862,103.913164
417892,53,253,306,1.299509,103.837
417893,5,22,27,1.340941,103.913507
417894,5,24,29,1.340399,103.911163
417895,50,115,165,1.340794,103.913597
417896,187,122,309,1.340885,103.914636
417897,45,186,231,1.299509,103.837
417901,127,793,920,1.341385,103.917099
417902,9,40,49,1.338137,103.914508
417920,6,300,306,1.33742,103.901221
417921,268,11,279,1.337275,103.90068
417938,1273,3632,4905,1.331578,103.903465
417939,1280,3937,5217,1.332626,103.903785
417940,226,3464,3690,1.332915,103.904277
417941,485,234,719,1.332789,103.90496
417942,448,51,499,1.333135,103.90558
417943,1865,1201,3066,1.336685,103.910716
417944,101,856,957,1.336301,103.911626
417945,40,86,126,1.336293,103.911609
417946,13,78,91,1.336285,103.911593
417947,71,206,277,1.336276,103.911577
417948,2,86,88,1.336268,103.91156
417949,20,527,547,1.33626,103.911544
417950,1,84,85,1.336252,103.911527
417951,5,170,175,1.336626,103.912062
417952,8,117,125,1.336655,103.912162
417953,26,168,194,1.336696,103.912237
417954,35,151,186,1.336748,103.91236
417955,0,125,125,1.336813,103.912444
417956,4,52,56,1.336849,103.912538
417957,2,66,68,1.336969,103.913131
417958,497,15,512,1.320774,103.905748
417959,5,2,7,1.320785,103.905816
417960,5,57,62,1.320953,103.905711
417961,12,2,14,1.320987,103.905706
417963,2,1,3,1.339274,103.898558
417964,1,5,6,1.321131,103.905697
417965,38,3,41,1.32118,103.905689
417966,4,0,4,1.321226,103.905692
417967,4,4,8,1.320788,103.9059
417968,9,0,9,1.320801,103.905952
417969,2,0,2,1.337851,103.902661
417970,1,0,1,1.337851,103.902661
417972,3,0,3,1.321088,103.905687
417974,0,1,1,1.320962,103.905998
417978,1,0,1,1.320805,103.906436
417979,4,0,4,1.320861,103.906597
417980,27,2,29,1.320876,103.906676
417983,3,31,34,1.320858,103.906831
417984,4,0,4,1.320984,103.906298
417985,1,0,1,1.320957,103.906121
417986,0,3,3,1.32044,103.906267
417987,5,1,6,1.321023,103.90667
417988,2,0,2,1.320967,103.905952
417989,1,0,1,1.321001,103.906387
417991,46,0,46,1.321051,103.907005
417992,58,19,77,1.321078,103.907171
417993,5,0,5,1.321117,103.907342
417994,5,0,5,1.321155,103.907514
417995,1,8,9,1.32102,103.906548
417996,3,12,15,1.320804,103.906052
417998,2,0,2,1.321054,103.906806
417999,2,0,2,1.320769,103.906139
418012,13,0,13,1.322544,103.91816
418013,4,0,4,1.322613,103.918132
418014,96,5,101,1.322657,103.918298
418016,187,15,202,1.323155,103.918093
418017,51,0,51,1.323267,103.918064
418019,7,0,7,1.323409,103.918042
418022,2,0,2,1.320731,103.906153
418023,2,2,4,1.32355,103.918163
418024,0,1,1,1.321091,103.906771
418025,5,0,5,1.323603,103.918157
418026,4,0,4,1.323693,103.918002
418027,3,2,5,1.323672,103.918113
418028,11,0,11,1.323755,103.917997
418029,1,2,3,1.321025,103.906464
418030,11,3,14,1.323833,103.917984
418031,8,1,9,1.3238,103.918132
418032,41,4,45,1.323925,103.917976
418034,5,8,13,1.324014,103.91798
418035,6,1,7,1.324073,103.917958
418036,4,0,4,1.324138,103.91795
418037,3,3,6,1.324185,103.917944
418038,7,7,14,1.324244,103.917939
418039,11,2,13,1.32429,103.917933
418040,19,28,47,1.324356,103.917922
418045,7,54,61,1.323892,103.918125
418046,17,0,17,1.322712,103.918258
418080,4,0,4,1.330631,103.906798
418081,20,836,856,1.330694,103.907231
418082,0,1,1,1.323624,103.918012
418083,3,8,11,1.330718,103.907263
418085,1,7,8,1.330611,103.90695
418086,31,1,32,1.330761,103.907293
418087,1,111,112,1.330839,103.907338
418088,2,0,2,1.323561,103.918022
418089,10,0,10,1.330585,103.907126
418090,4,6,10,1.330838,103.907373
418091,1,17,18,1.330959,103.907437
418092,0,20,20,1.331015,103.907463
418093,6,0,6,1.330569,103.907217
418094,4,0,4,1.33055,103.907304
418095,3,594,597,1.331057,103.90754
418096,18,0,18,1.330531,103.90738
418097,1,10,11,1.330358,103.907431
418098,1,0,1,1.330688,103.907248
418099,1,0,1,1.330926,103.90752
418100,0,1,1,1.330498,103.907533
418101,9,6,15,1.330752,103.90737
418102,0,1,1,1.330782,103.907365
418103,3,8,11,1.330831,103.907424
418105,2,0,2,1.330589,103.907073
418106,18,1,19,1.330448,103.907852
418107,2,15,17,1.330433,103.907921
418108,6,0,6,1.330368,103.908395
418109,182,2,184,1.330373,103.908333
418113,0,90,90,1.330377,103.908353
418115,0,19,19,1.330167,103.908321
418117,12,69,81,1.330856,103.907433
418119,1,20,21,1.330681,103.906598
418121,0,376,376,1.330693,103.906556
418122,3,1177,1180,1.330656,103.906477
418136,8,0,8,1.320292,103.914681
418138,0,1,1,1.33048,103.907621
418139,7,21,28,1.320421,103.91467
418141,3,3,6,1.320529,103.914657
418142,0,4,4,1.320378,103.914607
418143,2,5,7,1.320592,103.914658
418144,2,0,2,1.330457,103.907753
418145,0,1,1,1.32022,103.914624
418146,1,0,1,1.320664,103.91465
418147,0,10,10,1.320717,103.914641
418148,33,23,56,1.320769,103.91464
418149,7,334,341,1.320889,103.914547
418150,6,8,14,1.321532,103.914454
418151,4,9,13,1.321643,103.914444
418152,61,19,80,1.321743,103.914551
418153,19,12,31,1.321769,103.914405
418154,8,9,17,1.32195,103.914388
418155,0,1,1,1.320612,103.914594
418156,0,2,2,1.320466,103.914599
418157,19,4,23,1.322084,103.914502
418158,1,0,1,1.321963,103.914512
418159,12,0,12,1.322188,103.914488
418161,14,0,14,1.322249,103.914361
418162,14,13,27,1.322265,103.914475
418163,1,0,1,1.32217,103.914369
418164,0,1,1,1.322341,103.914461
418166,4,29,33,1.322403,103.914339
418167,39,0,39,1.323008,103.91436
418168,1,0,1,1.322306,103.914354
418169,1,4,5,1.323115,103.914361
418171,21,4,25,1.323211,103.914341
418172,1,3,4,1.322873,103.914269
418173,2,0,2,1.322052,103.914386
418174,16,2,18,1.323358,103.914326
418175,0,2,2,1.32329,103.914327
418176,2,13,15,1.323667,103.914164
418178,0,2,2,1.323447,103.914304
418179,15,1,16,1.324049,103.914481
418181,5,1,6,1.324295,103.914982
418182,0,1,1,1.322675,103.914293
418183,0,39,39,1.323999,103.913921
418184,0,52,52,1.324062,103.913833
418185,0,2,2,1.324022,103.914111
418186,1,2,3,1.323688,103.918147
418188,0,2,2,1.32408,103.913917
418190,3,0,3,1.324092,103.914048
418191,3,3,6,1.324163,103.914551
418192,1,0,1,1.324009,103.913976
418193,1,4,5,1.324185,103.914736
418194,0,3,3,1.32415,103.914464
418195,8,3,11,1.320837,103.914564
418196,3,2,5,1.323066,103.914257
418197,1,0,1,1.324185,103.914682
418198,5,0,5,1.322401,103.914453
418199,2,32,34,1.322475,103.914453
418200,1,0,1,1.322893,103.914389
418202,5,4,9,1.320537,103.914605
418203,39,21,60,1.299509,103.837
418211,1,3,4,1.32199,103.91745
418212,10,2,12,1.321963,103.91747
418213,1,2,3,1.320691,103.914575
418214,12,2,14,1.321857,103.917487
418215,0,203,203,1.321814,103.917505
418216,8,0,8,1.322212,103.917461
418217,1,1,2,1.324125,103.914269
418218,2,0,2,1.322105,103.917537
418219,43,0,43,1.322246,103.917511
418220,1,2,3,1.321913,103.917475
418221,1,0,1,1.324377,103.914975
418222,4,0,4,1.322338,103.917438
418223,0,3,3,1.322292,103.917444
418224,58,0,58,1.322394,103.917431
418225,2,3,5,1.322391,103.917489
418227,32,0,32,1.322443,103.917421
418228,2,0,2,1.322251,103.917451
418229,76,14,90,1.322487,103.917413
418230,6,3,9,1.322605,103.917446
418231,282,0,282,1.322556,103.917413
418232,48,1,49,1.322658,103.917435
418234,4,0,4,1.322679,103.917391
418235,46,9,55,1.323135,103.917403
418237,11,0,11,1.323272,103.917267
418238,3,0,3,1.322334,103.917497
418239,23,10,33,1.323357,103.91725
418240,6,3,9,1.32341,103.917372
418241,2,0,2,1.322543,103.917459
418242,2,0,2,1.323457,103.917371
418246,8,0,8,1.323735,103.917221
418249,0,1,1,1.322287,103.917505
418250,1,0,1,1.323725,103.917314
418251,1,1,2,1.323474,103.917241
418252,20,0,20,1.323873,103.917301
418254,11,3,14,1.324031,103.917175
418256,21,0,21,1.324315,103.917266
418257,1,0,1,1.323911,103.917186
418258,280,0,280,1.323513,103.917355
418259,3,8,11,1.323577,103.917342
418260,2,6,8,1.323645,103.917332
418261,0,3,3,1.323338,103.917381
418275,3,0,3,1.322057,103.91754
418287,4,421,425,1.32156,103.916833
418288,1,8,9,1.321588,103.916821
418289,11,0,11,1.322168,103.91664
418290,27,0,27,1.321638,103.916819
418291,2,0,2,1.323813,103.917298
418292,6,0,6,1.322303,103.916621
418293,1,0,1,1.324392,103.917302
418294,7,13,20,1.321763,103.916798
418295,3,0,3,1.322035,103.91667
418296,14,0,14,1.322497,103.916603
418297,10,1,11,1.322556,103.9166
418298,1,0,1,1.321737,103.916795
418299,21,10,31,1.321933,103.916768
418300,14,2,16,1.322671,103.916585
418301,43,0,43,1.322721,103.916589
418303,8,0,8,1.322032,103.916752
418304,31,24,55,1.322783,103.91633
418305,28,4,32,1.323018,103.916466
418307,6,4,10,1.322121,103.916746
418308,49,0,49,1.323167,103.916438
418309,7,0,7,1.322165,103.916744
418310,60,26,86,1.322241,103.916733
418311,4,0,4,1.323274,103.916424
418312,3,0,3,1.322431,103.916614
418313,1,0,1,1.321794,103.916791
418314,2,1,3,1.322282,103.916724
418315,3,1,4,1.323383,103.916446
418316,1,3,4,1.323437,103.916441
418317,1,1,2,1.32169,103.916807
418318,9,3,12,1.323544,103.916417
418319,1,0,1,1.322356,103.916718
418320,2,4,6,1.322452,103.916694
418321,0,1,1,1.323603,103.916408
418322,12,8,20,1.322502,103.916714
418323,59,41,100,1.323927,103.91639
418324,11,0,11,1.322608,103.916706
418325,1,7,8,1.322686,103.916702
418327,0,4,4,1.324051,103.916352
418328,4,0,4,1.323201,103.916609
418329,0,1,1,1.323702,103.916392
418330,0,1,1,1.323305,103.91659
418331,10,2,12,1.323421,103.916581
418332,42,8,50,1.323473,103.916576
418333,4,2,6,1.323525,103.916562
418335,9,0,9,1.324782,103.916313
418336,1,3,4,1.323605,103.916548
418337,2,0,2,1.323496,103.916422
418338,5,1,6,1.323884,103.916522
418340,4,0,4,1.323781,103.916534
418341,1,8,9,1.323752,103.916535
418342,3,0,3,1.322415,103.916714
418343,3,0,3,1.325064,103.916266
418344,28,0,28,1.32402,103.916497
418345,1,0,1,1.323369,103.916583
418346,9,11,20,1.324086,103.916483
418347,1,0,1,1.325223,103.91625
418348,4,0,4,1.324548,103.916449
418349,0,2,2,1.324877,103.916289
418350,1,11,12,1.325759,103.916223
418351,10,0,10,1.324725,103.916427
418352,3,4,7,1.325895,103.916231
418353,0,2,2,1.324631,103.916434
418354,1,4,5,1.325258,103.916364
418355,1,0,1,1.325353,103.916229
418357,2,10,12,1.325405,103.91635
418358,0,2,2,1.324804,103.916423
418359,2,14,16,1.326997,103.916237
418360,0,4,4,1.326995,103.916163
418361,28,3,31,1.327,103.916078
418362,3,4,7,1.327005,103.915986
418363,1,0,1,1.325308,103.916362
418364,1,1,2,1.325448,103.916345
418365,2,0,2,1.326998,103.915882
418366,0,2,2,1.326998,103.915819
418367,1,0,1,1.327008,103.915942
418368,1,12,13,1.327006,103.915548
418370,3,9,12,1.327007,103.915451
418371,13,14,27,1.325512,103.916329
418373,6,12,18,1.327067,103.916228
418374,1,2,3,1.323956,103.916501
418375,6,6,12,1.327076,103.916063
418376,11,0,11,1.327072,103.916008
418377,5,4,9,1.32707,103.915924
418378,10,0,10,1.327067,103.91584
418379,6,0,6,1.327075,103.915801
418380,25,3,28,1.327083,103.915752
418381,12,1,13,1.327076,103.915628
418382,0,2,2,1.327014,103.915728
418383,9,1,10,1.327089,103.915471
418384,142,2,144,1.327098,103.915419
418385,6,12,18,1.32709,103.915373
418386,11,2,13,1.325597,103.916332
418387,46,0,46,1.325626,103.916328
418388,36,15,51,1.32754,103.916232
418390,2,0,2,1.327098,103.915559
418391,6,2,8,1.327569,103.91599
418392,57,0,57,1.327574,103.915916
418393,1,1,2,1.327557,103.916077
418394,11,4,15,1.327568,103.91581
418395,105,7,112,1.327566,103.915773
418396,3,2,5,1.327566,103.915623
418397,2,6,8,1.327573,103.915552
418398,8,6,14,1.327584,103.915485
418400,8,13,21,1.327585,103.915398
418401,17,0,17,1.325713,103.91632
418402,0,2,2,1.327566,103.915879
418403,124,15,139,1.327601,103.916248
418404,10,4,14,1.327603,103.916193
418405,6,1,7,1.327608,103.916129
418406,9,2,11,1.327617,103.916068
418407,49,0,49,1.327615,103.915985
418408,5,105,110,1.327625,103.915945
418409,8,0,8,1.327623,103.915857
418410,21,0,21,1.327632,103.915798
418411,4,15,19,1.327639,103.915645
418412,4,0,4,1.327632,103.91559
418413,29,0,29,1.327638,103.915531
418414,4,0,4,1.32766,103.915426
418415,5,18,23,1.32767,103.915392
418416,4,3,7,1.327695,103.915355
418417,5,0,5,1.325778,103.916324
418418,4,2,6,1.325814,103.916329
418419,3,12,15,1.328088,103.916281
418420,0,1,1,1.327018,103.915667
418421,1,1,2,1.325744,103.916324
418422,1,0,1,1.328088,103.916235
418423,3,0,3,1.32707,103.916171
418424,5,0,5,1.328108,103.915997
418425,18,0,18,1.328113,103.915886
418426,0,7,7,1.3281,103.915835
418427,12,0,12,1.328098,103.915665
418428,3,1,4,1.328105,103.915599
418429,9,2,11,1.328111,103.915529
418430,1,3,4,1.328114,103.915482
418431,3,0,3,1.328102,103.91606
418432,4,55,59,1.328126,103.915346
418433,3,1,4,1.32585,103.916333
418434,7,0,7,1.325888,103.916339
418435,7,11,18,1.328159,103.916307
418436,4,0,4,1.328158,103.916236
418437,94,2,96,1.328159,103.916177
418438,8,1,9,1.328157,103.916126
418439,2,0,2,1.328093,103.916189
418440,159,12,171,1.328163,103.916003
418441,1,0,1,1.328089,103.916135
418442,0,1,1,1.328168,103.915931
418443,1,0,1,1.328172,103.915849
418444,6,0,6,1.328175,103.915716
418445,11,22,33,1.328177,103.915634
418446,1,1,2,1.32816,103.91607
418447,106,5,111,1.328193,103.915426
418448,1,0,1,1.328173,103.915782
418449,0,4,4,1.328193,103.915311
418450,3,0,3,1.32812,103.91541
418451,1,50,51,1.328197,103.915202
418453,53,4,57,1.325968,103.916342
418454,2,2,4,1.326014,103.916339
418456,2,0,2,1.32819,103.915485
418457,2,2,4,1.326147,103.916344
418458,2,0,2,1.326105,103.916338
418459,3,4,7,1.326238,103.916341
418460,2,2,4,1.328712,103.916178
418462,7,1,8,1.326326,103.91635
418463,2,0,2,1.326196,103.916342
418464,12,18,30,1.326364,103.916343
418465,0,1,1,1.328195,103.915372
418466,41,0,41,1.328722,103.916009
418467,6,2,8,1.326846,103.916461
418468,5,5,10,1.326853,103.916557
418469,4,4,8,1.326844,103.91664
418470,2,0,2,1.328718,103.91609
418471,0,4,4,1.326837,103.916858
418472,82,4,86,1.326821,103.916964
418473,2,4,6,1.326816,103.917046
418474,1,0,1,1.326391,103.91634
418475,2,0,2,1.326828,103.916744
418476,0,1,1,1.326813,103.917115
418477,1,0,1,1.32679,103.917379
418478,0,7,7,1.32674,103.917784
418479,3,15,18,1.328722,103.915925
418480,2,4,6,1.326926,103.916493
418481,48,5,53,1.326926,103.916566
418482,2,3,5,1.326906,103.916739
418483,10,3,13,1.326884,103.916867
418484,0,3,3,1.328197,103.915252
418485,1,1,2,1.326797,103.917193
418486,3,1,4,1.326873,103.917194
418487,0,1,1,1.326771,103.917543
418489,2,0,2,1.326874,103.917069
418490,1,2,3,1.326892,103.916942
418493,2,1070,1072,1.326836,103.917815
418494,19,1,20,1.328721,103.91586
418495,3,0,3,1.326814,103.917622
418496,30,0,30,1.328717,103.915625
418497,6,5,11,1.328767,103.91552
418498,0,7,7,1.328804,103.916115
418499,1,1,2,1.326829,103.917506
418500,21,2,23,1.328493,103.916425
418501,44,6,50,1.328594,103.916408
418502,1,1,2,1.328428,103.916424
418503,6,0,6,1.328766,103.916321
418504,1,0,1,1.326859,103.917265
418505,0,2,2,1.328695,103.916365
418506,16,0,16,1.328985,103.916058
418507,23,9,32,1.329041,103.915994
418508,27,2,29,1.329103,103.915922
418509,90,7,97,1.329156,103.915833
418510,34,56,90,1.329212,103.915771
418511,1,35,36,1.321749,103.916708
418512,0,2,2,1.328911,103.916142
418514,46,29,75,1.325696,103.916212
418515,2,12,14,1.32582,103.916219
418516,5,2,7,1.325452,103.916198
418517,95,8,103,1.325532,103.916201
418519,0,3,3,1.328723,103.91576
418520,1,0,1,1.328828,103.916235
418521,44,0,44,1.328365,103.916446
418523,1,0,1,1.323816,103.916385
418524,73,5,78,1.325951,103.916233
418528,0,2,2,1.32181,103.916691
418529,2,22,24,1.321821,103.915905
418530,0,2,2,1.322005,103.915921
418531,2,0,2,1.322053,103.915922
418532,0,25,25,1.322167,103.915913
418533,2,5,7,1.321969,103.915888
418534,22,27,49,1.322242,103.915944
418536,22,5,27,1.322147,103.915849
418537,10,1,11,1.322244,103.915846
418538,0,1,1,1.327561,103.915681
418539,0,2,2,1.321892,103.915894
418540,0,1,1,1.322372,103.915827
418541,5,3,8,1.322474,103.915868
418542,0,23,23,1.322581,103.915846
418543,5,20,25,1.322574,103.915798
418545,0,2,2,1.322405,103.915814
418547,0,7,7,1.323354,103.915785
418548,20,5,25,1.323347,103.915671
418549,0,2,2,1.323197,103.91597
418550,89,0,89,1.323401,103.915773
418551,0,7,7,1.323443,103.915767
418552,5,0,5,1.323511,103.915645
418553,24,0,24,1.323601,103.915648
418554,2,2,4,1.323569,103.915741
418555,2,0,2,1.323437,103.915676
418556,1,6,7,1.323694,103.915642
418557,1,0,1,1.322485,103.915812
418558,2,0,2,1.323613,103.915751
418559,8,0,8,1.323823,103.915758
418560,2,0,2,1.323759,103.915775
418561,0,6,6,1.323849,103.915629
418562,5,6,11,1.324012,103.915853
418563,19,1,20,1.323927,103.915619
418565,4,0,4,1.32403,103.915615
418568,104,9,113,1.32452,103.91563
418569,2,5,7,1.32463,103.915623
418570,4,5,9,1.325965,103.915272
418571,14,7,21,1.32598,103.915487
418572,0,2,2,1.323882,103.915729
418573,1,0,1,1.323767,103.915646
418575,5,0,5,1.325993,103.915639
418577,0,1,1,1.325987,103.915562
418579,1,2,3,1.324955,103.916395
418580,0,3,3,1.326004,103.915776
418584,3,0,3,1.325931,103.915023
418585,3,0,3,1.325915,103.914961
418586,11,0,11,1.32597,103.914876
418587,11,1,12,1.326089,103.915732
418589,0,3,3,1.326032,103.915898
418590,1,0,1,1.325999,103.915707
418591,1,29,30,1.326066,103.915527
418592,1,0,1,1.325974,103.914933
418593,0,2,2,1.325956,103.915218
418594,2,0,2,1.325986,103.915008
418595,37,4,41,1.326003,103.915161
418596,0,15,15,1.326012,103.915227
418597,2,2,4,1.326083,103.915324
418598,2,1,3,1.326066,103.915607
418600,3,1,4,1.32632,103.915284
418601,11,1,12,1.326415,103.91527
418603,0,17,17,1.321836,103.915961
418604,16,3,19,1.321893,103.915943
418605,18,2,20,1.321949,103.915936
418607,8,0,8,1.324275,103.915498
418608,10,38,48,1.324456,103.91546
418620,2,35,37,1.320604,103.915522
418621,5,15,20,1.320549,103.915506
418622,4,6,10,1.320813,103.915521
418623,46,10,56,1.320503,103.91548
418624,50,27,77,1.320453,103.91546
418625,26,40,66,1.32084,103.915542
418626,206,47,253,1.320422,103.915415
418627,4,1,5,1.320406,103.915367
418628,6,28,34,1.320853,103.915501
418629,13,4,17,1.320381,103.915333
418630,1,5,6,1.320367,103.91529
418631,4,3,7,1.320371,103.915247
418632,12,21,33,1.320352,103.915202
418633,21,0,21,1.320408,103.91519
418634,1,4,5,1.320434,103.915235
418635,2,7,9,1.320445,103.915285
418636,1,0,1,1.325974,103.91496
418637,1,13,14,1.32047,103.915328
418638,0,8,8,1.320609,103.915451
418639,0,1,1,1.320512,103.915394
418640,1,19,20,1.320937,103.915192
418641,2,0,2,1.32599,103.915071
418644,15,11,26,1.321789,103.915179
418645,3,20,23,1.321709,103.915134
418646,0,3,3,1.326145,103.915302
418647,0,6,6,1.321804,103.915125
418648,55,2,57,1.322094,103.915133
418649,1,11,12,1.321976,103.915087
418650,181,32,213,1.322312,103.915102
418651,3,3,6,1.322036,103.915088
418652,0,4,4,1.322459,103.915091
418653,0,29,29,1.322137,103.915078
418654,3,0,3,1.321937,103.915102
418660,0,3,3,1.322346,103.915048
418661,1,0,1,1.320547,103.915432
418662,4,1,5,1.322955,103.914928
418663,15,6,21,1.3232,103.915022
418664,1,6,7,1.323276,103.91499
418665,12,6,18,1.323216,103.914917
418666,5,5,10,1.32345,103.915643
418667,10,9,19,1.323335,103.914892
418668,3,0,3,1.323091,103.915047
418669,1,6,7,1.323449,103.914882
418670,9,9,18,1.323632,103.914952
418671,14,0,14,1.323708,103.91498
418673,18,0,18,1.323748,103.914955
418674,11,34,45,1.323587,103.914845
418675,6,12,18,1.32369,103.914833
418676,100,7,107,1.321951,103.915152
418677,1,6,7,1.323076,103.914922
418678,5,0,5,1.299509,103.837
418681,1,432,433,1.299509,103.837
418693,1,2,3,1.323516,103.914969
418695,0,1,1,1.323129,103.915041
418696,1,5,6,1.329274,103.90677
418697,2,0,2,1.32089,103.915202
418698,1,15,16,1.329241,103.906916
418699,6,0,6,1.329225,103.906991
418700,5,3,8,1.329071,103.907508
418701,20,4,24,1.329212,103.907063
418702,9,0,9,1.329199,103.907121
418703,2,5,7,1.329188,103.907187
418706,5,3,8,1.329161,103.907333
418707,6,0,6,1.329144,103.907407
418708,0,1,1,1.32929,103.90669
418709,4,9,13,1.329128,103.907493
418710,1,1,2,1.329257,103.906849
418711,36,2,38,1.329105,103.90763
418712,3,0,3,1.329088,103.907441
418713,21,0,21,1.329078,103.907773
418715,0,2,2,1.329117,103.907562
418717,3,392,395,1.328883,103.908524
418718,2,0,2,1.329064,103.907835
418719,0,1,1,1.329043,103.907624
418721,1,2,3,1.329096,103.907694
418722,6,0,6,1.328913,103.908436
418723,1,76,77,1.328814,103.908603
418724,2,0,2,1.328888,103.908507
418726,9,0,9,1.328935,103.908365
418727,3,0,3,1.328829,103.90856
418728,5,0,5,1.328951,103.908325
418729,0,73,73,1.328955,103.908304
418730,6,0,6,1.32896,103.908282
418731,9,3,12,1.328863,103.908453
418732,24,1,25,1.328849,103.908499
418733,5,66,71,1.329375,103.906296
418734,1,0,1,1.328897,103.908485
418735,5,3,8,1.329342,103.906465
418736,10,2,12,1.32932,103.906539
418737,2,0,2,1.328916,103.908412
418738,3,0,3,1.328943,103.908346
418739,14,0,14,1.329026,103.907987
418748,2,8,10,1.321422,103.907967
418751,0,2,2,1.329052,103.90788
418752,10,0,10,1.321777,103.907889
418753,11,34,45,1.321894,103.90786
418754,2,0,2,1.321665,103.907919
418755,1,1,2,1.321577,103.907863
418757,3,1,4,1.321539,103.907948
418758,1,0,1,1.329357,103.906376
418759,1,7,8,1.321304,103.908226
418774,4,0,4,1.329951,103.906641
418775,8,0,8,1.329938,103.906698
418776,1,0,1,1.321601,103.907931
418777,0,2,2,1.32176,103.907823
418778,1,1,2,1.329801,103.907112
418779,2,0,2,1.329909,103.906812
418780,1,0,1,1.329675,103.907019
418781,0,8,8,1.329782,103.907231
418782,0,1,1,1.32979,103.907169
418783,0,1,1,1.329908,103.906955
418784,120,0,120,1.329763,103.907278
418785,9,7,16,1.329749,103.90734
418786,3,0,3,1.329033,103.907935
418787,1,0,1,1.329897,103.907
418790,8,3,11,1.329723,103.90748
418791,3,0,3,1.329877,103.907075
418792,1,9,10,1.329829,103.90728
418794,6,9,15,1.329808,103.907409
418795,45,0,45,1.329678,103.907742
418796,2,0,2,1.329926,103.906845
418797,4,7,11,1.329653,103.907893
418798,4,6,10,1.329753,103.907749
418799,4,1,5,1.329741,103.907809
418800,9,0,9,1.329615,103.908072
418801,6,7,13,1.329718,103.907919
418802,4,0,4,1.32971,103.907954
418803,19,0,19,1.329605,103.90815
418804,262,77,339,1.329699,103.908079
418805,10,0,10,1.329601,103.908216
418806,2,0,2,1.329791,103.907526
418807,1,3,4,1.329583,103.908272
418808,2,3,5,1.329639,103.908397
418809,0,1,1,1.329856,103.907144
418810,0,10,10,1.329628,103.908489
418811,33,0,33,1.329567,103.908364
418812,2,351,353,1.329592,103.908577
418813,21,0,21,1.329554,103.908424
418815,6,2,8,1.329552,103.908466
418817,5,1,6,1.329665,103.907821
418818,3,215,218,1.330011,103.906299
418819,16,0,16,1.330001,103.906335
418820,0,2,2,1.329665,103.908211
418822,13,93,106,1.329802,103.906326
418823,8,4,12,1.329913,103.906382
418824,2,11,13,1.329887,103.906481
418825,10,5,15,1.329885,103.906533
418826,3,1,4,1.32987,103.906616
418827,4,1,5,1.329856,103.906692
418828,0,2,2,1.329989,103.906468
418829,16,3,19,1.329835,103.906885
418830,1,1,2,1.329849,103.906757
418831,0,5,5,1.329814,103.906966
418832,3,15,18,1.329636,103.907972
418855,13,9,22,1.326528,103.915535
418856,26,1,27,1.326511,103.915757
418857,0,2,2,1.32981,103.906909
418858,4,2,6,1.326528,103.915833
418859,10,0,10,1.32646,103.915635
418860,23,4,27,1.326511,103.915901
418862,22,1,23,1.3265,103.915966
418863,6,1,7,1.326459,103.915775
418864,1,0,1,1.329575,103.908312
418865,1,0,1,1.326491,103.916048
418866,11,17,28,1.326496,103.916123
418868,3,4,7,1.326495,103.916169
418869,6,34,40,1.326432,103.915994
418870,4,33,37,1.326195,103.916893
418871,0,3,3,1.32984,103.907243
418872,17,2,19,1.326068,103.916891
418873,4,2,6,1.326017,103.91689
418874,5,1,6,1.325971,103.916885
418875,15,1,16,1.325931,103.916884
418876,9,2,11,1.325897,103.916886
418877,8,8,16,1.325868,103.916878
418878,3,5,8,1.32582,103.916868
418879,3,3,6,1.325773,103.91687
418882,24,15,39,1.326353,103.917012
418883,1,11,12,1.325947,103.917067
418884,4,9,13,1.325717,103.916941
418885,5,3,8,1.326353,103.917072
418886,0,3,3,1.326144,103.916897
418888,3,0,3,1.325947,103.917112
418890,6,1,7,1.326353,103.917217
418891,1,9,10,1.325924,103.917243
418892,2,0,2,1.326473,103.915574
418893,6,0,6,1.325919,103.917306
418895,8,0,8,1.325907,103.917374
418896,12,0,12,1.326353,103.917414
418897,0,1,1,1.326446,103.915836
418898,1,7,8,1.326353,103.917482
418899,129,17,146,1.325896,103.917499
418900,2,0,2,1.326353,103.917277
418901,7,0,7,1.326325,103.917665
418902,5,8,13,1.326344,103.917625
418903,13,16,29,1.326479,103.915514
418904,1,0,1,1.325901,103.917437
418905,0,13,13,1.32655,103.915563
418906,3,2,5,1.299509,103.837
418907,3,1,4,1.299509,103.837
418920,3,22,25,1.319667,103.912555
418921,2,115,117,1.319632,103.91256
418922,3,4,7,1.319688,103.912649
418923,0,5,5,1.319677,103.912605
418924,70,12,82,1.319329,103.912473
418927,3,0,3,1.326353,103.917141
418928,25,0,25,1.319729,103.912838
418929,101,25,126,1.319749,103.91289
418930,8,71,79,1.319731,103.912523
418931,0,171,171,1.319736,103.912578
418932,1,4,5,1.319747,103.912599
418934,6,9,15,1.319771,103.912732
418935,137,30,167,1.319801,103.912884
418936,79,95,174,1.319904,103.912342
418937,13,0,13,1.319522,103.912408
418939,0,8,8,1.319709,103.912377
418941,212,30,242,1.32011,103.912385
418942,64,179,243,1.320142,103.912308
418943,3,18,21,1.320085,103.912315
418944,348,35912,36260,1.320291,103.912371
418945,21,65,86,1.320231,103.912271
418946,22,522,544,1.320316,103.912264
418962,56,3,59,1.323165,103.918779
418963,78,4,82,1.323084,103.918626
418964,9,0,9,1.323168,103.918723
418965,0,3,3,1.31972,103.912798
418966,1,1,2,1.326353,103.917559
418967,1,5,6,1.323071,103.918489
418968,8,1,9,1.323145,103.918601
418969,4,26,30,1.323045,103.918395
418970,0,1,1,1.32653,103.915627
418971,3,2,5,1.323028,103.918312
418972,9,0,9,1.323136,103.918466
418973,4,17,21,1.323016,103.918257
418974,30,5,35,1.323124,103.918402
418975,9,3,12,1.323001,103.918012
418976,17,0,17,1.32312,103.918335
418977,2,1,3,1.32307,103.918564
418978,0,15,15,1.323104,103.918279
418979,2,0,2,1.323154,103.918662
418980,4,18,22,1.323101,103.918239
418981,1,0,1,1.323146,103.918527
418982,2,10,12,1.32298,103.917803
418983,25,0,25,1.322968,103.917746
418984,14,0,14,1.322954,103.917672
418985,3,3,6,1.322942,103.917603
418986,3,0,3,1.323005,103.917983
418987,8,3,11,1.32293,103.917445
418988,7,7,14,1.322903,103.917176
418989,0,1,1,1.322984,103.917872
418990,11,21,32,1.32298,103.917166
418991,1,0,1,1.322891,103.917085
418993,3,0,3,1.322938,103.917528
418994,8,0,8,1.322958,103.917052
418995,170,3,173,1.322851,103.916823
418996,14,5,19,1.322953,103.916979
418997,1,2,3,1.322874,103.916914
418999,11,5,16,1.32292,103.916788
419000,0,23,23,1.322909,103.91674
419001,3,0,3,1.322941,103.916926
419002,58,2,60,1.32286,103.916261
419003,1,0,1,1.32288,103.917
419004,14,0,14,1.32284,103.916101
419005,0,7,7,1.322829,103.916043
419006,15,12,27,1.322808,103.9155
419007,41,12,53,1.322633,103.915284
419008,2,14,16,1.322774,103.915353
419009,1,0,1,1.322851,103.916188
419010,4,0,4,1.322759,103.915223
419011,3,4,7,1.322759,103.915161
419012,21,14,35,1.322756,103.915125
419013,4,11,15,1.32264,103.914785
419014,1,1,2,1.322989,103.917929
419015,4,3,7,1.322614,103.914598
419016,11,19,30,1.322563,103.914106
419017,3,22,25,1.322607,103.914924
419018,0,6,6,1.322586,103.914842
419019,1,11,12,1.322577,103.9148
419020,5,8,13,1.322563,103.914729
419021,7,1,8,1.323086,103.918708
419022,0,2,2,1.32265,103.914694
419036,0,268,268,1.323395,103.918924
419037,1,2,3,1.322876,103.916365
419038,0,5,5,1.323615,103.918893
419039,0,4,4,1.323724,103.918875
419040,2,2,4,1.323827,103.918853
419041,0,415,415,1.323953,103.91883
419059,9,27,36,1.323854,103.914922
419060,4,1,5,1.323903,103.914915
419062,1,0,1,1.322771,103.915273
419063,3,4,7,1.324202,103.915703
419064,6,3,9,1.324237,103.915729
419066,0,1,1,1.323941,103.915176
419067,1,1,2,1.322753,103.916164
419068,46,0,46,1.324275,103.916039
419069,2,0,2,1.32425,103.915913
419070,6,0,6,1.324294,103.916202
419071,28,1,29,1.324301,103.91627
419072,1,22,23,1.324299,103.916332
419073,17,9,26,1.324262,103.916864
419074,116,0,116,1.32438,103.916768
419075,1,4,5,1.324261,103.916841
419076,1,0,1,1.324237,103.915836
419077,6,0,6,1.324276,103.91695
419078,0,1,1,1.324376,103.916874
419079,18,4,22,1.32429,103.917015
419080,6,3,9,1.324383,103.917023
419081,3,5,8,1.324299,103.917062
419082,28,1,29,1.32416,103.915228
419083,117,0,117,1.324172,103.915314
419084,10,0,10,1.324189,103.915373
419085,1,2,3,1.323501,103.918921
419086,5,0,5,1.324261,103.916699
419099,1,149,150,1.319809,103.914053
419103,5,116,121,1.320364,103.913967
419104,0,15,15,1.320433,103.913961
419105,1,183,184,1.320502,103.913956
419106,1,402,403,1.32149,103.913882
419107,26,237,263,1.321549,103.91383
419108,0,16,16,1.321611,103.913807
419109,3,84,87,1.321719,103.913802
419110,1,163,164,1.321768,103.913774
419111,2,101,103,1.321836,103.913782
419113,6,361,367,1.321954,103.913776
419114,1,139,140,1.322025,103.913757
419115,1,248,249,1.322077,103.913738
419116,4,0,4,1.322144,103.913726
419117,2,0,2,1.324282,103.9161
419118,0,2,2,1.322187,103.913726
419119,24,453,477,1.3223,103.913719
419120,21,538,559,1.322363,103.913713
419121,2,242,244,1.322569,103.913681
419122,1,90,91,1.32262,103.913674
419123,0,40,40,1.322696,103.913673
419124,17,166,183,1.322766,103.913671
419125,1,340,341,1.322839,103.913665
419126,0,234,234,1.323395,103.913634
419127,0,31,31,1.323512,103.913625
419128,2,21,23,1.323562,103.913618
419129,0,12,12,1.32361,103.913605
419130,0,2,2,1.322245,103.913724
419131,13,0,13,1.323856,103.913576
419132,8,0,8,1.323931,103.913578
419133,92,2,94,1.324033,103.913571
419134,1,20,21,1.32409,103.913561
419135,16,1,17,1.324545,103.913507
419136,3,17,20,1.324695,103.913496
419138,4,0,4,1.324821,103.913476
419139,11,0,11,1.324899,103.913464
419140,5,14,19,1.324962,103.913466
419141,15,0,15,1.325038,103.913457
419142,40,12,52,1.325038,103.913457
419143,1,0,1,1.324386,103.916961
419145,131,0,131,1.325177,103.913445
419146,7,30,37,1.325238,103.913442
419147,13,21,34,1.325452,103.913246
419148,0,7,7,1.325446,103.913197
419149,17,13,30,1.325441,103.913157
419150,2,0,2,1.323727,103.913601
419151,4,0,4,1.325419,103.91305
419152,1,0,1,1.325094,103.913462
419153,3,143,146,1.321664,103.913787
419154,2241,1365,3606,1.320095,103.913655
419155,0,8,8,1.323663,103.913599
419156,9,13,22,1.323778,103.913591
419157,1,0,1,1.325416,103.913001
419160,1,0,1,1.325393,103.912934
419161,1,0,1,1.325393,103.912934
419162,5,222,227,1.321719,103.913802
419163,1,24,25,1.299509,103.837
419164,3,103,106,1.299509,103.837
419170,11,29,40,1.321774,103.905793
419171,21,0,21,1.321775,103.905892
419172,0,18,18,1.32177,103.905985
419173,1,2,3,1.324202,103.915467
419174,0,2,2,1.325435,103.913109
419175,1,3,4,1.321729,103.906129
419176,6,0,6,1.321764,103.906151
419177,2,5,7,1.321763,103.906259
419178,1,1,2,1.321775,103.906083
419179,0,8,8,1.321845,103.905873
419180,144,0,144,1.32179,103.906418
419181,3,16,19,1.321778,103.906348
419182,15,1,16,1.321853,103.905961
419184,0,4,4,1.321815,103.906558
419185,1,1,2,1.321845,103.905873
419186,0,4,4,1.321847,103.906043
419187,0,8,8,1.321865,103.906135
419188,8,0,8,1.321851,103.906612
419190,1,1,2,1.321799,103.906521
419191,1,2,3,1.321855,103.905777
419192,3,0,3,1.321863,103.906257
419193,3,5,8,1.321876,103.906395
419196,1,0,1,1.325393,103.912934
419198,1,1,2,1.321863,103.906257
419200,2,0,2,1.321905,103.906934
419201,7,2,9,1.321955,103.906637
419205,10,3,13,1.321938,103.907217
419206,1,0,1,1.321907,103.906518
419207,4,7,11,1.321996,103.906951
419208,6,0,6,1.321938,103.907331
419209,3,4,7,1.321938,103.907331
419210,2,0,2,1.321955,103.906637
419211,23,0,23,1.321962,103.907401
419212,8,2,10,1.321979,103.907054
419213,6,9,15,1.321962,103.90746
419214,11,0,11,1.321967,103.9075
419215,4,9,13,1.322012,103.907155
419216,0,10,10,1.321989,103.90764
419217,2,1,3,1.321868,103.906336
419218,0,1,1,1.321938,103.907217
419219,3,0,3,1.321989,103.907694
419220,4,1,5,1.322046,103.907377
419221,1,1,2,1.321962,103.907401
419222,33,2,35,1.322052,103.907565
419223,3,2,5,1.322051,103.907658
419224,12,2,14,1.322051,103.907658
419225,24,0,24,1.322051,103.907658
419226,72,1,73,1.322087,103.907776
419227,0,10,10,1.322115,103.90793
419228,5,1,6,1.32211,103.908044
419229,1,2,3,1.322046,103.907377
419230,6,18,24,1.322161,103.908249
419231,103,798,901,1.321853,103.905652
419247,0,1,1,1.322027,103.907274
419248,0,1,1,1.322753,103.906067
419250,2,5,7,1.322554,103.906124
419251,12,0,12,1.322423,103.906147
419252,0,1,1,1.322711,103.906088
419253,1,0,1,1.322354,103.90618
419256,6,0,6,1.322511,103.906232
419257,3,1,4,1.322592,103.906208
419258,0,6,6,1.322631,103.906194
419259,3,9,12,1.322722,103.906169
419260,3,6,9,1.322912,103.905896
419261,0,251,251,1.32292,103.905974
419262,20,0,20,1.322643,103.906258
419264,4,0,4,1.322907,103.905848
419267,3,6,9,1.322975,103.906086
419268,2,0,2,1.322046,103.907469
419269,8,2,10,1.322815,103.906916
419270,19,0,19,1.323008,103.906319
419272,39,0,39,1.322988,103.906221
419273,1,5,6,1.322923,103.907293
419274,0,2,2,1.322956,103.906826
419275,25,0,25,1.322892,103.907472
419276,1,0,1,1.322233,103.906307
419277,10,6,16,1.323046,103.906626
419278,24,0,24,1.322906,103.907634
419279,11,2,13,1.323052,103.906704
419280,10,3,13,1.322907,103.907738
419281,47,27,74,1.323061,103.906791
419282,12,0,12,1.322775,103.907811
419283,4,0,4,1.322689,103.907829
419285,65,0,65,1.32311,103.907165
419286,2,38,40,1.323209,103.907463
419289,34,0,34,1.3232,103.907499
419291,1,4,5,1.323221,103.907579
419292,9,0,9,1.323257,103.907756
419293,1,16,17,1.323266,103.907859
419294,5,0,5,1.322614,103.907851
419296,12,8,20,1.323283,103.907953
419297,8,7,15,1.322938,103.907378
419311,0,1,1,1.323041,103.906599
419312,1,175,176,1.324593,103.905963
419313,10,20,30,1.324799,103.906412
419314,1,2,3,1.322144,103.908152
419315,1,0,1,1.324638,103.906025
419317,6,1,7,1.324659,103.906325
419318,3,2,5,1.324663,103.906264
419319,1,0,1,1.324781,103.906323
419320,1,2,3,1.324723,103.906138
419321,52,0,52,1.324587,103.90726
419323,4,0,4,1.324671,103.907368
419325,0,2,2,1.323024,103.906518
419327,1,2,3,1.324816,103.90656
419328,12,0,12,1.324676,103.907556
419329,22,0,22,1.324651,103.9076
419333,4,1,5,1.324877,103.906905
419334,56,1,57,1.324904,103.907026
419335,5,6,11,1.324874,103.907926
419336,0,6,6,1.324968,103.907226
419337,1,6,7,1.324978,103.907257
419338,5,2,7,1.325001,103.90791
419339,19,0,19,1.324997,103.907317
419340,37,2,39,1.325001,103.907379
419342,11,6,17,1.325046,103.907465
419343,1,0,1,1.324795,103.906497
419344,1,2,3,1.324652,103.907422
419346,2,2,4,1.325039,103.908071
419347,4,10,14,1.32509,103.907955
419349,0,1,1,1.324995,103.907557
419352,20,1,21,1.325071,103.908167
419353,3,0,3,1.32502,103.908014
419355,103,4,107,1.325094,103.908289
419357,1,0,1,1.325044,103.908114
419358,2,4,6,1.325103,103.90835
419360,1,1,2,1.324844,103.906783
419363,1,0,1,1.325303,103.908766
419364,7,7,14,1.325212,103.908877
419365,2,0,2,1.32534,103.908984
419366,3,14,17,1.325356,103.909071
419367,0,4,4,1.325373,103.909133
419368,2,0,2,1.325233,103.908951
419369,6,0,6,1.325268,103.909098
419370,8,0,8,1.325414,103.90926
419372,4,0,4,1.32528,103.909168
419373,1,0,1,1.325198,103.908797
419374,0,1,1,1.325298,103.909243
419375,8,0,8,1.325315,103.909314
419376,1,6,7,1.325317,103.909365
419377,19,0,19,1.324584,103.907268
419378,0,9,9,1.299509,103.837
419379,27,6,33,1.299509,103.837
419380,0,26,26,1.299509,103.837
419381,0,34,34,1.299509,103.837
419394,4,12,16,1.32432,103.908679
419396,5,0,5,1.324414,103.908782
419397,2,0,2,1.325247,103.909054
419398,131,0,131,1.324339,103.908806
419399,2,1,3,1.325081,103.908232
419401,6,1,7,1.324463,103.909071
419402,4,4,8,1.324376,103.90896
419403,1,0,1,1.325386,103.909235
419405,5,1,6,1.324502,103.909202
419406,10,1,11,1.324392,103.909107
419407,185,0,185,1.324527,103.909266
419408,202,1,203,1.324555,103.909388
419409,10,0,10,1.324432,103.909232
419410,3,3,6,1.324455,103.90934
419411,6,0,6,1.324496,103.909471
419412,0,16,16,1.324385,103.908645
419413,0,6,6,1.324404,103.908727
419431,4,1,5,1.325069,103.917079
419432,2,0,2,1.324426,103.908889
419433,10,0,10,1.324945,103.917049
419434,8,0,8,1.324905,103.917106
419436,5,2,7,1.325001,103.917193
419437,11,0,11,1.324962,103.917258
419438,1,0,1,1.324393,103.909036
419439,3,0,3,1.324351,103.908855
419440,6,2,8,1.324929,103.917333
419441,1,0,1,1.32487,103.917151
419442,11,1,12,1.324796,103.917259
419443,1,5,6,1.324767,103.917299
419444,2,14,16,1.324874,103.917407
419445,6,3,9,1.324815,103.91752
419446,4,4,8,1.324629,103.917588
419448,37,5,42,1.324738,103.917623
419449,2,1,3,1.324836,103.917191
419450,6,256,262,1.324692,103.917714
419451,2,0,2,1.324968,103.917003
419452,0,1,1,1.324813,103.917231
419453,0,1,1,1.324629,103.917793
419454,9,1,10,1.324523,103.917777
419455,17,0,17,1.324484,103.917808
419456,4,0,4,1.324537,103.917953
419457,9,1,10,1.324474,103.918044
419458,2,17,19,1.324417,103.918141
419459,0,1,1,1.324595,103.917873
419460,27,22,49,1.324335,103.918292
419461,3,0,3,1.324564,103.917675
419463,1,1,2,1.324534,103.917717
419464,1,0,1,1.324377,103.918234
419465,30,3,33,1.324104,103.918709
419476,125,23,148,1.324376,103.918029
419477,2,2,4,1.324331,103.918115
419478,7,9,16,1.32429,103.918173
419479,86,0,86,1.32426,103.918207
419480,1,10,11,1.324227,103.918274
419481,3,0,3,1.324245,103.918454
419482,3,1,4,1.32414,103.918392
419483,10,0,10,1.324101,103.918454
419486,5,1,6,1.324015,103.918666
419487,2,0,2,1.324145,103.918596
419488,17,0,17,1.325114,103.916833
419489,9,2,11,1.325088,103.916873
419490,11,3,14,1.325049,103.916924
419491,134,0,134,1.324991,103.916969
419493,39,316,355,1.31818,103.904927
419494,86,811,897,1.318873,103.905111
419495,55,3277,3332,1.319692,103.905147
419496,9,5239,5248,1.320287,103.905226
419497,4,701,705,1.320341,103.905231
419498,4,596,600,1.32044,103.905243
419499,1,44,45,1.320393,103.90524
419500,14,311,325,1.320585,103.905237
419502,69,348,417,1.320986,103.90528
419503,0,37,37,1.321008,103.905272
419504,7,0,7,1.321056,103.905337
419505,3,228,231,1.32106,103.90529
419506,3,1,4,1.321133,103.905301
419507,0,757,757,1.321157,103.905303
419508,24,146,170,1.321597,103.905335
419509,7,999,1006,1.321656,103.905347
419510,7,38,45,1.321721,103.905349
419511,12,0,12,1.321572,103.905345
419512,0,436,436,1.321545,103.905338
419515,1,48,49,1.322156,103.905438
419516,0,67,67,1.322206,103.905445
419517,28,88,116,1.322252,103.905448
419518,3,14,17,1.322304,103.905455
419519,3,264,267,1.32239,103.905461
419520,2,453,455,1.322482,103.905461
419521,1,3562,3563,1.322579,103.905472
419522,42,1214,1256,1.323356,103.905617
419523,10,741,751,1.323459,103.905634
419524,8,0,8,1.323557,103.905628
419525,3,157,160,1.324095,103.905694
419526,5,61,66,1.324147,103.905701
419527,2,115,117,1.324237,103.905715
419528,2,60,62,1.324308,103.905724
419529,605,977,1582,1.324223,103.904727
419530,1,102,103,1.32781,103.906094
419531,1,30,31,1.327864,103.906092
419532,5,118,123,1.327888,103.9061
419533,2,33,35,1.327922,103.906101
419534,21,545,566,1.327952,103.906096
419535,1062,2878,3940,1.329434,103.905715
419536,3,161,164,1.323649,103.905639
419537,394,907,1301,1.299509,103.837
419538,92,67,159,1.328293,103.906476
419539,154,87,241,1.299509,103.837
419540,327,42,369,1.299509,103.837
419541,395,280,675,1.299509,103.837
419542,408,374,782,1.299509,103.837
419543,305,13,318,1.328286,103.906485
419544,511,13,524,1.299509,103.837
419545,343,5,348,1.327913,103.906548
419546,388,9,397,1.327913,103.906548
419547,256,30,286,1.299509,103.837
419548,218,29,247,1.299509,103.837
419549,281,17,298,1.327913,103.906548
419550,178,25,203,1.327913,103.906548
419551,96,3,99,1.299509,103.837
419552,411,8,419,1.299509,103.837
419553,1,516,517,1.325425,103.906255
419554,2,0,2,1.323979,103.918743
419555,4,52,56,1.325442,103.906371
419556,2,116,118,1.325564,103.90674
419557,2,3,5,1.32545,103.906424
419558,2,14,16,1.325602,103.906896
419559,0,2,2,1.325428,103.906319
419560,36,0,36,1.325506,103.906675
419561,1,5,6,1.325671,103.907267
419562,0,1,1,1.32412,103.918654
419563,3,0,3,1.324204,103.918341
419564,0,5,5,1.325543,103.906925
419565,24,0,24,1.325899,103.908201
419566,35,0,35,1.325578,103.907109
419567,22,5,27,1.325953,103.908452
419568,1,0,1,1.325518,103.906747
419569,1,0,1,1.325586,103.907177
419570,18,11,29,1.326577,103.908641
419571,2,1,3,1.325696,103.907404
419572,1801,306,2107,1.326114,103.909005
419573,24,0,24,1.325632,103.907364
419576,10,262,272,1.326132,103.909239
419577,2,4,6,1.325737,103.907827
419578,1,0,1,1.325597,103.907226
419579,3,121,124,1.326153,103.909355
419580,24,0,24,1.325757,103.90795
419581,2,2,4,1.325765,103.908006
419582,2,0,2,1.325467,103.906511
419583,24,0,24,1.325885,103.90855
419584,10,2,12,1.325897,103.90867
419585,2,0,2,1.325772,103.908078
419586,1,0,1,1.325745,103.907867
419587,11,85,96,1.325964,103.908931
419588,6,1,7,1.325978,103.909006
419589,51,138,189,1.326003,103.909129
419590,69,21,90,1.326052,103.909266
419591,632,205,837,1.326237,103.909746
419592,1508,176,1684,1.327112,103.910052
419593,445,332,777,1.32632,103.910557
419594,686,254,940,1.32745,103.910574
419595,0,3,3,1.325624,103.90732
419596,3,1,4,1.325711,103.907464
419597,6,0,6,1.325718,103.907506
419598,4,8,12,1.325724,103.907536
419599,2,2,4,1.325397,103.906987
419601,3,3,6,1.325969,103.908518
419602,96,9,105,1.326004,103.908739
419603,15,131,146,1.326029,103.908843
419612,516,1408,1924,1.334289,103.910319
419613,6,487,493,1.299509,103.837
419630,5,7,12,1.323684,103.905981
419631,5,1,6,1.323784,103.906026
419632,79,0,79,1.323779,103.906114
419634,3,0,3,1.325676,103.907307
419635,7,2,9,1.323771,103.906333
419636,0,2,2,1.325925,103.908743
419637,131,4,135,1.323759,103.906459
419638,0,1,1,1.325935,103.908817
419640,0,6,6,1.323745,103.906674
419641,8,1,9,1.323644,103.906475
419643,33,0,33,1.323621,103.906674
419644,1,0,1,1.32376,103.90655
419679,561,7,568,1.328881,103.906998
419680,0,4,4,1.328564,103.90731
419681,0,1,1,1.323673,103.906065
419682,1,1,2,1.32366,103.906259
419683,7,1,8,1.328541,103.907544
419684,408,236,644,1.299509,103.837
419701,7,6769,6776,1.316361,103.898783
419702,1,217,218,1.316388,103.898939
419703,6,4605,4611,1.316408,103.899049
419704,0,17,17,1.316424,103.899129
419706,0,1862,1862,1.316453,103.899176
419707,16,627,643,1.316416,103.89927
419708,7,3133,3140,1.316417,103.899435
419709,89,388,477,1.316914,103.899011
419710,4,13,17,1.316462,103.899368
419711,5,1615,1620,1.316473,103.899454
419712,18,7839,7857,1.316459,103.899432
419713,20,2854,2874,1.316419,103.899836
419714,14,192,206,1.316374,103.900066
419715,182,4259,4441,1.316626,103.900239
419716,9,64,73,1.316775,103.901013
419717,1,10,11,1.316789,103.901106
419718,129,760,889,1.316803,103.901177
419719,12,2892,2904,1.316857,103.901441
419720,4,639,643,1.316862,103.901498
419721,2,4,6,1.316868,103.901549
419722,0,111,111,1.31688,103.9016
419723,0,180,180,1.316885,103.901651
419724,20,259,279,1.316897,103.901702
419725,10,359,369,1.316903,103.901748
419726,2,138,140,1.316908,103.901794
419727,8,3568,3576,1.31692,103.901845
419728,16,263,279,1.317011,103.902274
419729,1,533,534,1.317108,103.902756
419730,26,0,26,1.316993,103.902731
419731,0,682,682,1.317085,103.902835
419732,0,1113,1113,1.317123,103.902817
419734,141,967,1108,1.317256,103.903484
419735,1,931,932,1.317109,103.903886
419736,1,725,726,1.317351,103.904046
419737,30,1692,1722,1.317369,103.904221
419738,2,215,217,1.317444,103.904473
419739,2,1263,1265,1.317449,103.904497
419740,77,153,230,1.317463,103.904572
419741,154,36,190,1.317467,103.904605
419742,2,278,280,1.31748,103.904649
419743,2,224,226,1.317666,103.905409
419744,3,0,3,1.323769,103.906235
419745,2,2,4,1.317726,103.905421
419746,17,264,281,1.317742,103.905826
419747,11,110,121,1.317765,103.905756
419748,3,234,237,1.317771,103.905904
419749,7,260,267,1.317801,103.906076
419750,0,37,37,1.317846,103.906231
419751,0,129,129,1.317845,103.906282
419752,2,0,2,1.328552,103.907478
419753,1,111,112,1.317864,103.906351
419754,0,51,51,1.317873,103.9064
419755,13,1,14,1.317879,103.90646
419756,15,289,304,1.317636,103.906208
419757,1,35,36,1.317898,103.906508
419758,1,336,337,1.317649,103.906289
419759,13,550,563,1.317906,103.906559
419760,2,0,2,1.317894,103.906236
419761,1,187,188,1.317672,103.906414
419762,6,375,381,1.317987,103.906765
419763,1,0,1,1.328559,103.907399
419764,1,300,301,1.317974,103.906808
419765,2,328,330,1.31768,103.906561
419766,3,37,40,1.318004,103.906925
419767,1,0,1,1.317681,103.906466
419768,4,520,524,1.317714,103.906648
419769,3,6,9,1.318013,103.906982
419770,3,0,3,1.317696,103.905453
419771,9,141,150,1.318068,103.907124
419773,18,15,33,1.31809,103.907292
419774,2,13,15,1.317739,103.906797
419775,1,153,154,1.318109,103.907262
419776,0,357,357,1.317748,103.90685
419777,5,86,91,1.318117,103.90732
419778,3,0,3,1.317724,103.906694
419779,2,0,2,1.317662,103.906346
419780,8,199,207,1.317764,103.906977
419781,15,271,286,1.318109,103.907413
419782,10,0,10,1.317776,103.907032
419783,2,148,150,1.318161,103.907535
419784,0,43,43,1.317783,103.907089
419785,0,44,44,1.318205,103.90768
419787,1,122,123,1.318225,103.907723
419788,4,365,369,1.3178,103.9072
419789,1,263,264,1.318238,103.907837
419790,2,2,4,1.317819,103.907288
419791,0,37,37,1.317833,103.907357
419792,0,465,465,1.31784,103.907421
419793,6,0,6,1.317847,103.90749
419794,135,38,173,1.318273,103.908156
419795,2,415,417,1.317864,103.90755
419796,127,405,532,1.318277,103.908225
419797,0,233,233,1.317872,103.907622
419798,8,0,8,1.318296,103.908307
419799,49,2143,2192,1.317961,103.90801
419800,0,61,61,1.318318,103.908431
419801,0,1695,1695,1.318285,103.9087
419803,2,361,363,1.318296,103.908748
419804,3,9,12,1.318331,103.908493
419805,0,9,9,1.318316,103.908832
419806,1,132,133,1.318339,103.90853
419807,2,359,361,1.318336,103.908894
419808,1,525,526,1.318357,103.909016
419809,80,1,81,1.318384,103.909227
419810,9,140,149,1.318513,103.908788
419811,3,150,153,1.318488,103.909187
419812,10,58,68,1.318505,103.909259
419814,1,0,1,1.317703,103.906592
419815,4,212,216,1.318527,103.909385
419817,9,651,660,1.318546,103.909486
419818,19,214,233,1.318566,103.909544
419819,1,7,8,1.318634,103.909747
419820,0,259,259,1.318639,103.909811
419821,16,357,373,1.318648,103.90987
419822,2,318,320,1.318347,103.910086
419823,1,0,1,1.318518,103.909326
419824,1,178,179,1.318361,103.910171
419825,3,25,28,1.318347,103.910223
419826,1,6,7,1.318368,103.910224
419832,227,1751,1978,1.318511,103.910773
419833,286,6,292,1.318471,103.910811
419835,5,176,181,1.318503,103.910932
419836,2,7,9,1.318754,103.910314
419837,6,0,6,1.318503,103.910932
419838,3,405,408,1.318748,103.910371
419839,1,0,1,1.318351,103.910125
419840,5,0,5,1.318783,103.91046
419841,3,3,6,1.318503,103.910932
419842,2,91,93,1.318791,103.910515
419843,12,458,470,1.318811,103.910562
419844,0,7,7,1.318805,103.910596
419845,156,706,862,1.318621,103.911143
419846,3,380,383,1.319013,103.910932
419847,10,5,15,1.318953,103.911056
419848,0,168,168,1.319046,103.911032
419850,6,0,6,1.319212,103.910997
419851,1,0,1,1.318503,103.910932
419856,0,645,645,1.318922,103.911138
419857,1,1,2,1.318163,103.907484
419858,1,479,480,1.318928,103.911226
419860,3,263,266,1.318959,103.911403
419861,4,2795,2799,1.318918,103.911694
419862,5,905,910,1.318943,103.911826
419863,0,514,514,1.318957,103.911905
419864,0,77,77,1.318964,103.91149
419865,0,239,239,1.318976,103.911976
419866,4,807,811,1.318995,103.911547
419867,0,194,194,1.318989,103.912056
419868,4,170,174,1.318971,103.911595
419869,0,324,324,1.319013,103.912107
419870,2,154,156,1.319056,103.911653
419871,378,0,378,1.318718,103.911716
419872,2,1029,1031,1.319044,103.912273
419873,1,1034,1035,1.31903,103.911912
419874,4,235,239,1.319084,103.912084
419875,1,569,570,1.319095,103.912119
419876,2,5,7,1.31911,103.912193
419877,45,5,50,1.318734,103.912206
419878,2,1598,1600,1.319116,103.91227
419879,4,9,13,1.31913,103.912329
419880,7,1779,1786,1.319137,103.912392
419881,4,693,697,1.31916,103.912448
419882,7,117,124,1.319178,103.912641
419883,23,1313,1336,1.319177,103.913078
419884,2,465,467,1.319176,103.912691
419886,17,423,440,1.319297,103.912824
419887,9,18,27,1.3193,103.912864
419890,1,16,17,1.318599,103.913357
419891,12,1187,1199,1.319309,103.913188
419892,4,0,4,1.319302,103.913082
419893,5,12,17,1.319305,103.913128
419894,1,1038,1039,1.319295,103.913404
419895,7,539,546,1.319307,103.913458
419896,9,0,9,1.319318,103.913495
419898,2,785,787,1.319345,103.913583
419899,2,17,19,1.319364,103.913625
419900,3,0,3,1.31776,103.906914
419901,4,440,444,1.31939,103.9137
419903,15,92,107,1.319414,103.913769
419904,18,118,136,1.319419,103.913793
419905,6,42,48,1.319563,103.914258
419906,1,0,1,1.31927,103.910977
419907,1,51,52,1.319567,103.914303
419910,1,259,260,1.319597,103.914391
419912,1,7,8,1.319878,103.914926
419914,3,42,45,1.319899,103.914971
419915,20,0,20,1.319688,103.914591
419916,1,0,1,1.319673,103.914311
419917,0,102,102,1.319712,103.914647
419918,2,74,76,1.319927,103.915082
419920,1,102,103,1.319512,103.914905
419922,3,127,130,1.319879,103.915119
419923,1,8,9,1.320751,103.915924
419924,25,1,26,1.32078,103.915953
419925,6,0,6,1.320814,103.915976
419926,1,0,1,1.319915,103.915025
419928,3,55,58,1.320941,103.916044
419929,0,48,48,1.320058,103.915694
419930,1,32,33,1.319806,103.91593
419931,4,130,134,1.320101,103.915801
419932,0,99,99,1.320258,103.916303
419933,5,0,5,1.320302,103.9165
419934,0,24,24,1.320359,103.916698
419935,0,32,32,1.32022,103.916995
419936,1,59,60,1.320292,103.917171
419937,0,40,40,1.320478,103.917091
419938,1,80,81,1.320544,103.9173
419939,0,76,76,1.320769,103.917914
419940,2,348,350,1.320866,103.918188
419941,5,293,298,1.320842,103.918096
419944,17,655,672,1.321113,103.918977
419945,6,89,95,1.321125,103.919078
419946,9,26,35,1.320422,103.91621
419947,14,198,212,1.320387,103.916363
419948,79,2,81,1.320427,103.916448
419949,3,2,5,1.32045,103.916528
419950,0,6,6,1.320485,103.916625
419951,1,12,13,1.320519,103.91671
419952,2,8,10,1.320542,103.916784
419953,0,29,29,1.320588,103.91687
419954,5,0,5,1.320622,103.916949
419955,1,82,83,1.320657,103.917029
419956,5,35,40,1.320685,103.917114
419957,133,7,140,1.320888,103.917166
419958,2,121,123,1.321088,103.916294
419959,1,18,19,1.320991,103.916254
419960,7,1,8,1.321099,103.916241
419961,29,0,29,1.321043,103.916256
419962,3,108,111,1.321011,103.916201
419963,0,2,2,1.318948,103.911299
419964,0,5,5,1.320724,103.915998
419965,1,3,4,1.318722,103.91016
419966,5,114,119,1.318699,103.910084
419967,3,0,3,1.319373,103.91366
419969,9,0,9,1.31873,103.910136
419970,5,0,5,1.31978,103.914584
419971,6,42,48,1.319801,103.914624
419972,0,11,11,1.319758,103.914516
419973,324,180,504,1.317004,103.902196
419974,104,392,496,1.317116,103.902915
419975,25,410,435,1.31903,103.912232
419977,64,279,343,1.31819,103.909327
419978,1,7,8,1.319223,103.910905
419979,8,20,28,1.319325,103.910886
419980,1,31,32,1.319419,103.910871
419981,0,6,6,1.319511,103.91086
420001,1471,5637,7108,1.31575,103.8984
420002,161,46,207,1.315517,103.899079
420003,8,77,85,1.315499,103.899025
420004,36,96,132,1.315165,103.898544
423371,8680,2454,11134,1.304644,103.904497
423372,4,5,9,1.299509,103.837
423373,0,10,10,1.299509,103.837
423384,5,0,5,1.299509,103.837
423385,24,1,25,1.299509,103.837
423387,5,0,5,1.299509,103.837
423388,1,0,1,1.320855,103.916004
423389,1,0,1,1.299509,103.837
423390,5,0,5,1.299509,103.837
423391,19,1,20,1.299509,103.837
423392,38,0,38,1.299509,103.837
423393,1,0,1,1.299509,103.837
423394,1,38,39,1.299509,103.837
423395,6,0,6,1.299509,103.837
423397,7,4,11,1.299509,103.837
423399,2,0,2,1.320798,103.916049
423400,2,1,3,1.318698,103.910027
423401,4,34,38,1.299509,103.837
423402,1,6,7,1.299509,103.837
423403,50,9,59,1.299509,103.837
423404,295,1,296,1.299509,103.837
423405,36,2,38,1.299509,103.837
423407,0,1,1,1.299509,103.837
423408,0,1,1,1.299509,103.837
423409,22,1,23,1.299509,103.837
423410,1,1,2,1.299509,103.837
423411,9,0,9,1.299509,103.837
423412,15,0,15,1.299509,103.837
423413,11,2,13,1.299509,103.837
423414,8,0,8,1.299509,103.837
423415,3,0,3,1.299509,103.837
423416,4,0,4,1.299509,103.837
423417,6,7,13,1.299509,103.837
423421,1,0,1,1.299509,103.837
423422,1,0,1,1.299509,103.837
423423,335,710,1045,1.309781,103.916033
423466,7,0,7,1.315613,103.914657
423467,219,38,257,1.308389,103.914456
423468,264,37,301,1.311254,103.900565
423469,16,1,17,1.312786,103.90759
423470,2,4,6,1.307725,103.901007
423471,0,2,2,1.299509,103.837
423472,52,8,60,1.310764,103.899666
423473,12,4,16,1.314339,103.912033
423474,5,3,8,1.313708,103.900651
423476,0,1,1,1.299509,103.837
423477,6,0,6,1.309956,103.902924
423479,5,0,5,1.309956,103.902924
423480,11,4,15,1.309777,103.903259
423483,28,8,36,1.313847,103.901208
423484,476,54,530,1.31478,103.914415
423485,3,4,7,1.313903,103.901113
423487,2,0,2,1.307742,103.901134
423488,1,0,1,1.313708,103.900651
423489,0,3,3,1.299509,103.837
423490,0,1,1,1.314145,103.912746
423491,182,46,228,1.314849,103.914767
423492,25,3670,3695,1.316076,103.897298
423493,4,7,11,1.310424,103.904464
423494,2,4,6,1.310349,103.904521
423495,5,1,6,1.310477,103.904523
423496,54,2,56,1.310163,103.904568
423497,14,0,14,1.310506,103.904554
423498,0,1,1,1.313753,103.909768
423501,2,0,2,1.314082,103.901002
423503,0,2,2,1.310552,103.904676
423504,1,0,1,1.310388,103.904579
423508,0,2,2,1.310592,103.904709
423509,1,0,1,1.3105,103.90475
423514,55,0,55,1.310715,103.904887
423515,1,4,5,1.31072,103.905048
423517,5,0,5,1.310744,103.905085
423518,43,19,62,1.310809,103.905015
423519,2,4,6,1.310764,103.905125
423520,1,7,8,1.310877,103.905038
423538,10,4,14,1.314054,103.900403
423539,1,0,1,1.310581,103.904878
423540,11,1,12,1.314016,103.900322
423541,20,3,23,1.314077,103.900355
423543,0,2,2,1.310638,103.904782
423544,21,9,30,1.313998,103.900408
423556,2,8,10,1.314017,103.900253
423557,1,1,2,1.314046,103.900378
423558,3,0,3,1.312934,103.907607
423559,1,0,1,1.313977,103.900421
423561,2,4,6,1.314071,103.900214
423562,0,1,1,1.313905,103.900066
423563,1,38,39,1.313778,103.900415
423564,1,3,4,1.313755,103.900424
423566,2,0,2,1.313929,103.900187
423567,0,4,4,1.313737,103.900442
423570,0,2,2,1.313764,103.900418
423571,20,1,21,1.313752,103.900436
423572,0,4,4,1.313329,103.900407
423575,2,5,7,1.31378,103.899756
423576,3,1,4,1.313037,103.901043
423577,6,379,385,1.313053,103.901041
423578,36,0,36,1.312992,103.901098
423579,0,114,114,1.312974,103.901109
423580,48,1,49,1.312944,103.90113
423581,12,121,133,1.31291,103.901159
423582,6,0,6,1.312893,103.901179
423583,2,115,117,1.312864,103.901194
423584,4,0,4,1.312907,103.901358
423585,5,224,229,1.312824,103.901216
423586,125,44,169,1.31248,103.901237
423587,3,346,349,1.312466,103.90133
423588,2,144,146,1.312295,103.901313
423592,0,60,60,1.312169,103.901495
423593,1,32,33,1.312087,103.90157
423594,54,189,243,1.312073,103.901575
423595,4,7,11,1.311848,103.901723
423596,176,20,196,1.311925,103.901632
423597,28,43,71,1.311737,103.901761
423603,8,118,126,1.311475,103.901989
423604,1,4,5,1.311434,103.902005
423605,118,2,120,1.311476,103.901823
423606,1,2,3,1.313907,103.900119
423609,86,2,88,1.311378,103.901706
423610,1,0,1,1.313874,103.899926
423611,4,0,4,1.311322,103.901608
423613,5,45,50,1.311315,103.902096
423615,0,19,19,1.311276,103.902137
423617,6,75,81,1.311236,103.902176
423619,16,12,28,1.311195,103.902209
423621,1,38,39,1.311148,103.902246
423623,8,38,46,1.311107,103.902285
423637,2,1,3,1.311419,103.901751
423638,9,30,39,1.310876,103.90238
423639,2,80,82,1.310858,103.902186
423640,13,102,115,1.310986,103.902525
423641,25,19,44,1.31088,103.902168
423642,2,8,10,1.311062,103.902479
423643,6,30,36,1.310751,103.902498
423644,0,9,9,1.310916,103.902574
423646,0,4,4,1.310844,103.902635
423647,2,64,66,1.310769,103.902514
423648,0,11,11,1.310792,103.902685
423649,9,263,272,1.31038,103.902836
423650,5,18,23,1.310348,103.902866
423651,27,1,28,1.310306,103.902892
423652,21,4,25,1.310271,103.902916
423653,5,0,5,1.310234,103.902944
423654,87,19,106,1.31019,103.902981
423655,105,19,124,1.310129,103.902971
423656,11,1,12,1.309956,103.902924
423657,70,0,70,1.309956,103.902924
423658,22,0,22,1.309956,103.902924
423659,7,0,7,1.309956,103.902924
423660,1,1,2,1.313767,103.900432
423661,3,0,3,1.310784,103.90213
423662,4,4,8,1.310077,103.903012
423663,48,0,48,1.310118,103.903117
423664,0,20,20,1.310079,103.903125
423665,5,5,10,1.310032,103.903044
423666,36,0,36,1.310062,103.90314
423667,3,5,8,1.309989,103.903076
423668,39,6,45,1.309973,103.903217
423669,10,5,15,1.309971,103.903093
423670,24,8,32,1.310172,103.903241
423671,68,6,74,1.309946,103.903107
423672,36,9,45,1.309947,103.90326
423673,36,23,59,1.309895,103.903181
423674,1,0,1,1.311338,103.901658
423675,2,0,2,1.309956,103.902924
423676,42,8,50,1.309874,103.903318
423677,1,5,6,1.309715,103.903293
423678,2,0,2,1.309801,103.903227
423679,399,11,410,1.309639,103.9033
423680,8,22,30,1.309829,103.903374
423681,8,2,10,1.30979,103.90339
423682,0,30,30,1.309749,103.903423
423683,12,6,18,1.309399,103.903495
423684,17,10,27,1.309342,103.903529
423685,10,54,64,1.30963,103.903474
423686,57,4,61,1.309326,103.903545
423687,17,0,17,1.30937,103.903514
423688,1,8,9,1.309576,103.903516
423689,23,18,41,1.309525,103.903555
423690,5,4,9,1.309365,103.903661
423691,10,8,18,1.309274,103.903601
423692,62,9,71,1.309323,103.903711
423693,4,15,19,1.309234,103.90365
423694,0,5,5,1.309299,103.903729
423696,3,7,10,1.309252,103.90378
423697,6,12,18,1.309233,103.903801
423698,4,3,7,1.309068,103.903901
423699,1,5,6,1.309027,103.903916
423701,9,2,11,1.308986,103.903941
423702,102,0,102,1.308903,103.903982
423703,0,8,8,1.308884,103.904011
423704,1,10,11,1.308707,103.904143
423705,2,2,4,1.308656,103.904196
423706,28,1,29,1.308601,103.90424
423707,0,4,4,1.308537,103.904262
423709,0,7,7,1.308463,103.904327
423710,1,0,1,1.309901,103.903298
423711,5,19,24,1.30833,103.904418
423712,1,6,7,1.308391,103.904235
423713,0,2,2,1.309844,103.903351
423714,0,3,3,1.309956,103.902924
423715,44,2,46,1.30821,103.904528
423716,4,0,4,1.308141,103.904565
423717,5,15,20,1.308091,103.904609
423718,246,2,248,1.30802,103.904638
423719,18,0,18,1.30785,103.904657
423720,304,7,311,1.308583,103.905474
423721,217,8,225,1.308174,103.905804
423722,62,1,63,1.307703,103.904756
423723,40,1,41,1.307663,103.904917
423724,0,20,20,1.307592,103.904972
423725,82,2,84,1.307428,103.904923
423726,7,11,18,1.307414,103.905086
423727,0,5,5,1.307379,103.905109
423728,384,11,395,1.307272,103.905037
423729,0,9,9,1.307288,103.90519
423730,7,42,49,1.307216,103.905221
423731,115,628,743,1.30646,103.905339
423732,2,0,2,1.308235,103.904502
423733,3,17,20,1.30708,103.905309
423734,44,28,72,1.307116,103.9053
423735,204,0,204,1.307065,103.905344
423736,0,8,8,1.307043,103.905365
423737,1,3,4,1.306986,103.905376
423738,4,16,20,1.306945,103.905405
423739,5,0,5,1.306891,103.905448
423740,0,16,16,1.306842,103.90549
423741,3,37,40,1.306806,103.905518
423742,22,19,41,1.308102,103.904423
423743,1,15,16,1.31373,103.900588
423744,0,11,11,1.313749,103.90057
423745,0,1,1,1.308382,103.904383
423746,0,27,27,1.30784,103.904808
423747,15,36,51,1.307766,103.904838
423748,2,1,3,1.308209,103.904345
423749,3,0,3,1.307812,103.904845
423750,14,1,15,1.307548,103.904981
423751,13,0,13,1.307457,103.905049
423752,8,34,42,1.307489,103.90502
423753,0,22,22,1.314032,103.90038
423754,2,0,2,1.307149,103.905286
423755,313,20,333,1.313508,103.901295
423756,3,751,754,1.318057,103.908514
423757,3,27,30,1.317988,103.90853
423758,0,6,6,1.317938,103.908555
423759,0,74,74,1.317875,103.908569
423760,1,0,1,1.313712,103.900604
423761,203,5,208,1.317781,103.90865
423762,362,1,363,1.317387,103.908772
423763,260,49,309,1.317433,103.908766
423764,4,394,398,1.317225,103.908859
423765,1,54,55,1.317192,103.908852
423766,0,2,2,1.314041,103.900407
423767,0,73,73,1.317453,103.908726
423768,2,73,75,1.317132,103.908781
423769,1,54,55,1.317217,103.908813
423770,0,2,2,1.317143,103.90885
423771,0,1,1,1.317303,103.908777
423772,2,1,3,1.307724,103.904876
423774,14,16,30,1.317084,103.908868
423776,6,168,174,1.316618,103.909201
423777,0,1,1,1.317244,103.908831
423778,0,5,5,1.316643,103.909355
423779,0,4,4,1.316652,103.909384
423780,3,6,9,1.316671,103.90944
423781,6,81,87,1.316941,103.909434
423782,11,0,11,1.316598,103.909467
423784,1,4,5,1.316585,103.909398
423785,0,2,2,1.317254,103.908797
423786,1,4,5,1.316552,103.909327
423787,12,378,390,1.316535,103.909277
423788,46,0,46,1.316465,103.908914
423789,5,4,9,1.299509,103.837
423791,1,16,17,1.315633,103.909421
423792,3,94,97,1.315781,103.909454
423793,5,279,284,1.315746,103.90948
423794,1,0,1,1.316628,103.909255
423795,12,2,14,1.315618,103.90953
423796,2,134,136,1.31559,103.909561
423797,7,12,19,1.315285,103.90969
423799,6,471,477,1.314845,103.909766
423800,1,23,24,1.314799,103.909794
423801,0,177,177,1.314752,103.909813
423802,6,89,95,1.314688,103.909839
423803,25,196,221,1.31464,103.909858
423804,5,57,62,1.3146,103.909877
423805,18,187,205,1.315243,103.909685
423806,7,104,111,1.314557,103.909759
423807,2,652,654,1.315197,103.909705
423810,3,357,360,1.314461,103.909794
423811,0,106,106,1.31507,103.909768
423812,2,7,9,1.313697,103.910192
423813,1,48,49,1.31364,103.910293
423814,0,79,79,1.313547,103.910327
423815,1,13,14,1.313487,103.910356
423816,2,3,5,1.313479,103.910495
423817,0,70,70,1.313437,103.910382
423818,10,1,11,1.313512,103.910453
423819,0,15,15,1.313376,103.910405
423820,9,0,9,1.313436,103.910481
423821,0,49,49,1.313324,103.910427
423822,0,26,26,1.313498,103.910484
423823,5,9,14,1.31325,103.910418
423824,281,12,293,1.31323,103.910584
423825,0,218,218,1.313229,103.910459
423826,21,6,27,1.313162,103.9105
423827,18,979,997,1.312717,103.910774
423828,8,336,344,1.312631,103.910819
423829,13,783,796,1.312539,103.910833
423832,3,12,15,1.312286,103.910952
423833,65,840,905,1.312347,103.910934
423835,63,165,228,1.312087,103.910877
423836,109,1359,1468,1.311576,103.911159
423838,102,507,609,1.311535,103.911305
423841,1,0,1,1.3157,103.909493
423842,6,5,11,1.311535,103.911305
423843,2,6,8,1.311347,103.911348
423844,61,1,62,1.311235,103.91126
423845,5,84,89,1.310587,103.911595
423847,157,0,157,1.310404,103.911758
423848,0,42,42,1.310216,103.911807
423849,0,37,37,1.310185,103.911857
423850,0,7,7,1.31011,103.911897
423851,35,169,204,1.310031,103.911899
423852,2,107,109,1.310361,103.911681
423853,179,102,281,1.310328,103.911697
423854,3,16,19,1.310182,103.911758
423855,67,53,120,1.310134,103.911761
423856,4,117,121,1.310116,103.911796
423857,0,262,262,1.309702,103.91197
423858,692,254,946,1.309645,103.911998
423859,2,34,36,1.309595,103.912028
423861,2,32,34,1.309619,103.912307
423863,7,43,50,1.309507,103.912145
423865,3,105,108,1.309427,103.91218
423866,0,1,1,1.311535,103.911305
423867,0,72,72,1.309332,103.912267
423868,0,2,2,1.316569,103.90937
423870,67,114,181,1.30875,103.912461
423871,32,93,125,1.308603,103.912522
423872,7,284,291,1.30843,103.91261
423873,14,0,14,1.308451,103.912589
423874,10,0,10,1.308387,103.912654
423875,4,1,5,1.308301,103.912698
423876,11,9,20,1.308257,103.912734
423877,23,338,361,1.308179,103.912755
423878,3,78,81,1.308074,103.912759
423879,7,53,60,1.308002,103.912791
423880,2,9,11,1.30793,103.912822
423881,8,19,27,1.307858,103.912854
423882,0,5,5,1.307786,103.912885
423883,0,11,11,1.307714,103.912917
423884,0,3,3,1.317181,103.908823
423885,1,8,9,1.30757,103.91298
423886,2,3,5,1.307498,103.913012
423887,0,3,3,1.307642,103.912949
423888,0,5,5,1.307354,103.913075
423889,15,16,31,1.307622,103.912747
423890,10,18,28,1.307282,103.913107
423891,0,8,8,1.307542,103.912799
423892,0,9,9,1.307211,103.913138
423893,0,50,50,1.307411,103.912659
423894,0,18,18,1.307139,103.91317
423895,5,4,9,1.307264,103.912996
423896,0,2,2,1.309326,103.912151
423897,0,27,27,1.306995,103.913233
423898,3,3,6,1.306923,103.913265
423899,0,44,44,1.306851,103.913296
423900,0,3,3,1.307426,103.913043
423901,3,26,29,1.306707,103.91336
423902,1,14,15,1.306796,103.912574
423903,10,7,17,1.306635,103.913391
423904,1,20,21,1.306577,103.91342
423905,69,14,83,1.306525,103.913436
423906,34,282,316,1.306468,103.913448
423907,5,27,32,1.317256,103.908847
423908,1,64,65,1.310503,103.911625
423909,1,98,99,1.310458,103.911617
423910,88,2363,2451,1.31197,103.911091
423911,64,0,64,1.31039,103.911667
423912,444,79,523,1.317841,103.908929
423922,6,13,19,1.307876,103.908876
423924,2,38,40,1.307802,103.908929
423925,0,1,1,1.3094,103.912115
423926,3,24,27,1.307681,103.90898
423927,1,0,1,1.307746,103.908958
423928,20,34,54,1.307586,103.909026
423929,15,3,18,1.307546,103.909047
423930,0,19,19,1.307527,103.909056
423931,2,2,4,1.3075,103.909065
423932,5,37,42,1.307118,103.908338
423933,12,202,214,1.307439,103.90909
423934,369,35,404,1.306898,103.909372
423935,84,455,539,1.306161,103.909441
423936,1004,1038,2042,1.306393,103.909987
423937,751,997,1748,1.306014,103.909838
423950,83,219,302,1.30853,103.908579
423951,139,1527,1666,1.308578,103.908502
423953,99,40,139,1.309044,103.907915
423955,0,581,581,1.309244,103.908069
423956,4,103,107,1.309375,103.908333
423958,0,3,3,1.306779,103.913328
423959,0,80,80,1.310067,103.90785
423960,2,48,50,1.310124,103.907835
423961,1,56,57,1.310331,103.907807
423962,2,8,10,1.310403,103.907786
423964,2,103,105,1.310514,103.907753
423965,1,44,45,1.310581,103.907742
423966,0,5,5,1.31061,103.907712
423967,1,22,23,1.310709,103.907683
423969,0,5,5,1.310786,103.907663
423970,5,161,166,1.310933,103.907625
423971,23,0,23,1.311054,103.907472
423972,1,72,73,1.311091,103.907461
423973,2,6,8,1.311178,103.907465
423974,12,41,53,1.31127,103.907424
423977,15,51,66,1.31143,103.907357
423978,6,8,14,1.311479,103.907361
423979,7,60,67,1.311669,103.907276
423980,4,63,67,1.311829,103.907214
423982,9,171,180,1.311973,103.90715
423983,9,446,455,1.312247,103.907046
423984,13,281,294,1.312302,103.907006
423985,2,412,414,1.312402,103.90699
423986,3,1,4,1.312486,103.906953
423987,1,4,5,1.312582,103.906912
423988,212,2205,2417,1.313513,103.906284
423990,7,1002,1009,1.314806,103.906264
423991,90,255,345,1.314944,103.906145
423992,9,416,425,1.315436,103.905693
423993,2,98,100,1.315469,103.905697
423994,1,83,84,1.315549,103.905502
423995,1,45,46,1.3157,103.905586
423996,0,42,42,1.315626,103.905609
423997,1,46,47,1.31566,103.905466
423998,0,61,61,1.315719,103.905566
423999,1,589,590,1.315774,103.905554
424000,0,4,4,1.316039,103.90546
424003,1,96,97,1.316091,103.905282
424004,4,128,132,1.316244,103.905721
424005,0,27,27,1.312369,103.906974
424007,1,43,44,1.311418,103.907622
424008,13,92,105,1.316607,103.905471
424009,8,31,39,1.311463,103.907332
424010,2,0,2,1.307067,103.913202
424011,1,0,1,1.307637,103.909007
424018,11,63,74,1.310681,103.908085
424019,5,2,7,1.310665,103.908151
424020,2,154,156,1.310673,103.909088
424021,38,1,39,1.310717,103.908321
424022,1,1,2,1.310983,103.907531
424023,15,0,15,1.310626,103.908331
424024,0,1,1,1.31096,103.907545
424025,0,2,2,1.310611,103.908262
424027,0,1,1,1.310597,103.908311
424028,0,1,1,1.310647,103.908459
424029,1,1,2,1.310633,103.908404
424030,1,0,1,1.310739,103.908516
424032,3,2,5,1.310792,103.908667
424033,0,4,4,1.310784,103.908789
424035,68,3,71,1.310802,103.908875
424037,4,3,7,1.310834,103.909076
424038,8,2,10,1.310687,103.908674
424039,3,3,6,1.310653,103.908656
424040,10,0,10,1.310679,103.908757
424041,125,0,125,1.310688,103.908854
424044,1,0,1,1.310733,103.908602
424045,4,0,4,1.310767,103.909102
424046,1,0,1,1.310728,103.908877
424047,3,3,6,1.310765,103.909211
424048,3,5,8,1.31088,103.909162
424049,1,0,1,1.310765,103.909182
424051,2,0,2,1.310726,103.908548
424064,23,10,33,1.308157,103.907183
424065,170,4,174,1.308216,103.907192
424066,7,6,13,1.308131,103.907132
424067,20,1,21,1.3082,103.907145
424068,11,0,11,1.308104,103.90709
424069,6,1,7,1.308563,103.906865
424070,2,3,5,1.30808,103.907051
424071,1,0,1,1.310874,103.909216
424072,0,5,5,1.308058,103.90701
424073,3,5,8,1.308137,103.907063
424074,14,4,18,1.30804,103.906976
424076,7,0,7,1.308016,103.906939
424077,107,2,109,1.308083,103.906969
424078,15,1,16,1.307987,103.906899
424079,0,1,1,1.308174,103.90712
424080,32,0,32,1.307966,103.906856
424095,6,16,22,1.308177,103.907508
424096,2,2,4,1.308205,103.907559
424097,2,0,2,1.31086,103.909119
424099,1,1,2,1.308256,103.907579
424100,2,0,2,1.308298,103.907701
424115,5,3,8,1.307479,103.90977
424116,0,4,4,1.3075,103.909833
424117,1,1,2,1.308339,103.907771
424118,33,0,33,1.307512,103.909896
424119,59,0,59,1.307394,103.909854
424120,0,3,3,1.30978,103.908223
424121,2,0,2,1.307381,103.909751
424123,4,0,4,1.307429,103.910027
424125,1,6,7,1.307458,103.910139
424126,2,0,2,1.307417,103.909938
424127,21,0,21,1.307481,103.910268
424128,63,0,63,1.307488,103.910329
424129,0,1,1,1.308056,103.906922
424131,0,1,1,1.307499,103.910388
424132,6,8,14,1.307533,103.910578
424133,5,2,7,1.307573,103.91017
424134,4,4,8,1.307615,103.910774
424137,0,4,4,1.307651,103.911015
424138,6,5,11,1.30759,103.910246
424140,0,1,1,1.307523,103.91051
424141,2,1,3,1.307525,103.909949
424142,0,2,2,1.307464,103.910208
424143,9,19,28,1.308074,103.912304
424145,8,0,8,1.308066,103.912243
424146,0,8,8,1.307891,103.912374
424147,11,2,13,1.308071,103.912253
424148,0,6,6,1.307899,103.912438
424149,5,0,5,1.308058,103.912227
424150,1,167,168,1.307917,103.912508
424153,19,0,19,1.308064,103.912288
424156,4,1,5,1.307221,103.913532
424157,2,2,4,1.307481,103.913834
424158,3,0,3,1.307624,103.911194
424159,3,2,5,1.307707,103.913729
424160,486,20,506,1.307982,103.913903
424162,562,3,565,1.307531,103.913834
424163,840,94,934,1.307122,103.914033
424164,157,247,404,1.308306,103.913332
424165,188,5,193,1.308375,103.913652
424166,143,19,162,1.308417,103.91401
424167,367,67,434,1.308344,103.913561
424168,17,3,20,1.308441,103.914118
424169,44,33,77,1.307632,103.914667
424170,0,3,3,1.307588,103.913838
424171,319,29,348,1.307431,103.914947
424172,1,2,3,1.308457,103.91424
424173,1,8,9,1.308526,103.914604
424174,7,125,132,1.30856,103.91477
424175,479,77,556,1.308362,103.915011
424176,5,19,24,1.308647,103.915244
424177,39,64,103,1.308362,103.915011
424178,0,2,2,1.307644,103.91126
424179,9,15,24,1.308362,103.915011
424180,12,12,24,1.308362,103.915011
424181,9,84,93,1.308347,103.915235
424182,3,26,29,1.308347,103.915235
424183,8,3,11,1.308347,103.915235
424184,5,0,5,1.307933,103.915475
424185,1,2,3,1.308499,103.914429
424187,1,0,1,1.307636,103.911167
424188,6,4,10,1.308381,103.915063
424189,0,3,3,1.307861,103.915508
424192,0,2,2,1.308362,103.915011
424194,0,3,3,1.308381,103.915063
424196,0,30,30,1.307266,103.915326
424197,1,1,2,1.307782,103.915152
424198,1,19,20,1.307283,103.915502
424200,1,694,695,1.30736,103.915652
424201,1,891,892,1.307363,103.915752
424202,227,2,229,1.307834,103.916056
424203,13,2,15,1.308574,103.915671
424205,6,0,6,1.308035,103.913061
424206,2,7,9,1.308065,103.913135
424207,34,0,34,1.308095,103.913223
424208,69,18,87,1.308121,103.913315
424209,35,17,52,1.308582,103.915751
424210,523,242,765,1.308568,103.915627
424211,229,188,417,1.308654,103.915944
424212,457,114,571,1.308669,103.916003
424213,962,1033,1995,1.307528,103.916354
424214,324,2908,3232,1.307406,103.916076
424215,115,322,437,1.306716,103.913734
424216,64,345,409,1.307121,103.915052
424217,544,135,679,1.307104,103.914791
424218,208,24,232,1.307736,103.914783
424219,4,20,24,1.306363,103.906339
424220,8,16,24,1.306298,103.906509
424222,1,3,4,1.306241,103.906549
424223,1,0,1,1.30775,103.915577
424224,2,0,2,1.307271,103.915392
424226,7,1,8,1.306154,103.906659
424227,2,0,2,1.306197,103.906635
424228,263,23,286,1.305944,103.906796
424229,1,6,7,1.306136,103.906529
424230,1,0,1,1.306327,103.906357
424231,5,7,12,1.306036,103.906605
424232,43,1,44,1.305971,103.906668
424238,34,0,34,1.305759,103.906948
424239,142,1,143,1.305669,103.906995
424240,1,5,6,1.305944,103.906689
424241,1,0,1,1.306077,103.906577
424242,16,12,28,1.305847,103.90675
424243,47,6,53,1.305807,103.906772
424244,239,65,304,1.305661,103.906858
424246,14,0,14,1.305384,103.907124
424247,82,29,111,1.305415,103.907246
424248,21,2,23,1.305246,103.907352
424249,11,63,74,1.305252,103.907038
424250,0,18,18,1.305225,103.907362
424251,9,13,22,1.305129,103.907193
424252,0,7,7,1.305178,103.907389
424253,0,2,2,1.306299,103.906388
424254,8,4,12,1.304998,103.907305
424255,22,19,41,1.304893,103.907394
424256,34,121,155,1.304856,103.907398
424257,30,350,380,1.30484,103.907323
424258,8,154,162,1.304914,103.907263
424259,13,2,15,1.305008,103.907223
424260,15,0,15,1.305057,103.907194
424261,5,2,7,1.305087,103.907177
424262,4,3,7,1.305118,103.90716
424264,3,2,5,1.305077,103.907478
424265,0,19,19,1.305033,103.907529
424266,5,9,14,1.304997,103.90755
424267,16,847,863,1.304949,103.907571
424268,56,0,56,1.305618,103.907065
424277,20,39,59,1.3136,103.905052
424278,8,340,348,1.313947,103.904726
424279,1,17,18,1.313623,103.905037
424280,6,2,8,1.313895,103.904765
424281,5,0,5,1.313655,103.905018
424282,71,6,77,1.313828,103.904812
424283,9,1,10,1.313584,103.905062
424285,3,1,4,1.313563,103.905058
424286,0,4,4,1.313683,103.904879
424287,1,0,1,1.305912,103.906705
424288,1,1,2,1.30506,103.907241
424289,0,1,1,1.313531,103.905062
424290,1,3,4,1.313381,103.905156
424291,0,1,1,1.313437,103.905134
424292,441,1,442,1.313459,103.905036
424293,10,42,52,1.313296,103.90525
424294,1,0,1,1.313344,103.905205
424299,8,1,9,1.313221,103.905237
424300,83,4,87,1.313014,103.905426
424301,26,22,48,1.313122,103.905394
424302,64,0,64,1.313375,103.905094
424317,3,39,42,1.311387,103.904956
424318,2,0,2,1.313629,103.904913
424319,0,2,2,1.311313,103.904882
424320,2,0,2,1.311577,103.904974
424321,3,0,3,1.30765,103.915228
424323,4,0,4,1.311176,103.904683
424325,4,0,4,1.311421,103.905049
424326,12,1,13,1.311127,103.904708
424327,56,0,56,1.311357,103.905096
424328,0,36,36,1.311357,103.905096
424330,1,11,12,1.311289,103.904933
424331,111,0,111,1.311196,103.905206
424332,91,0,91,1.311196,103.905186
424333,0,7,7,1.310982,103.905208
424334,45,3,48,1.310992,103.905343
424335,6,5,11,1.310935,103.905368
424336,48,1,49,1.310912,103.905406
424337,0,8,8,1.310889,103.905404
424338,4,2,6,1.310842,103.905459
424339,8,0,8,1.310795,103.905474
424340,462,22,484,1.310702,103.905565
424341,1,0,1,1.31325,103.905276
424343,0,1,1,1.310702,103.905545
424344,3,3,6,1.310562,103.905671
424345,98,5,103,1.310524,103.905737
424346,3,1,4,1.310457,103.905813
424348,1,3,4,1.310207,103.906016
424349,0,10,10,1.310465,103.905657
424350,1,0,1,1.310701,103.905544
424351,1,0,1,1.310423,103.905683
424352,94,18,112,1.311304,103.905133
424366,245,0,245,1.312304,103.905926
424367,11,31,42,1.312365,103.905871
424368,30,0,30,1.312224,103.905832
424369,1,0,1,1.310368,103.905733
424370,1,0,1,1.3122,103.905859
424371,0,43,43,1.312113,103.90607
424372,0,25,25,1.312081,103.90596
424373,9,0,9,1.312118,103.906226
424375,0,17,17,1.312118,103.906226
424376,180,3,183,1.31171,103.906172
424377,0,4,4,1.312118,103.906226
424378,139,2,141,1.311642,103.906303
424379,22,0,22,1.312118,103.906226
424380,13,0,13,1.312118,103.906226
424381,4,55,59,1.311863,103.906245
424382,87,1,88,1.311371,103.906487
424383,16,3,19,1.311197,103.906248
424384,1,59,60,1.311826,103.906285
424385,143,5,148,1.311246,103.906314
424386,17,0,17,1.311329,103.906408
424388,1,0,1,1.312167,103.906038
424389,1,0,1,1.311292,103.906361
424390,2,39,41,1.311766,103.906359
424394,1,6,7,1.311253,103.906605
424395,2,2,4,1.311255,103.906743
424396,5,3,8,1.31118,103.906666
424397,6,3,9,1.311155,103.90683
424398,2,8,10,1.311141,103.906688
424399,0,1,1,1.311258,103.90631
424400,0,11,11,1.3111,103.906736
424402,0,1,1,1.311073,103.906879
424403,9,3,12,1.310859,103.907055
424404,2,0,2,1.31128,103.904799
424405,0,3,3,1.311248,103.904793
424406,10,0,10,1.310541,103.907137
424408,3,0,3,1.31066,103.907186
424409,1,0,1,1.310929,103.906987
424410,0,1,1,1.310478,103.907181
424411,1,1,2,1.3108,103.907088
424412,0,1,1,1.310451,103.907205
424413,1,0,1,1.310345,103.907283
424414,0,3,3,1.310507,103.907163
424415,4,1,5,1.310475,103.907296
424417,54,7,61,1.310413,103.907327
424418,1,0,1,1.310507,103.907278
424419,1,36,37,1.310351,103.907413
424420,32,0,32,1.310188,103.907434
424421,71,10,81,1.311201,103.906823
424435,0,366,366,1.309354,103.901217
424436,3,103,106,1.30935,103.901159
424437,0,15,15,1.309277,103.901102
424438,1,19,20,1.309228,103.901032
424439,1,688,689,1.309068,103.900687
424440,3,143,146,1.309072,103.900712
424442,6,1,7,1.309057,103.900656
424443,5,24,29,1.306543,103.90605
424444,1,3,4,1.309011,103.900605
424445,5,32,37,1.308966,103.900523
424446,0,1,1,1.310152,103.907408
424448,23,16,39,1.308885,103.900545
424449,2,14,16,1.308835,103.900532
424450,0,23,23,1.308819,103.900376
424451,0,3,3,1.310307,103.907273
424452,0,4,4,1.308807,103.900357
424453,0,7,7,1.308631,103.900195
424454,1,4,5,1.308781,103.900318
424455,1,0,1,1.308939,103.900634
424456,10,25,35,1.308756,103.900278
424457,1,20,21,1.308552,103.900042
424458,3,0,3,1.30867,103.900335
424463,0,1,1,1.30858,103.900127
424478,9,520,529,1.315309,103.89734
424479,1,109,110,1.315278,103.897368
424480,3,89,92,1.315253,103.897378
424481,24,5,29,1.315227,103.897409
424482,243,74,317,1.315044,103.897279
424483,22,31,53,1.315202,103.89743
424484,46,9062,9108,1.315581,103.896776
424485,2,25,27,1.315165,103.89746
424486,1,11,12,1.315129,103.897483
424487,165,44,209,1.315102,103.897491
424488,0,29,29,1.31503,103.897548
424489,1,35,36,1.315014,103.897563
424490,0,75,75,1.314956,103.897622
424491,24,68,92,1.314915,103.897655
424492,2,50,52,1.314873,103.897559
424494,5,160,165,1.314759,103.897585
424496,1,11,12,1.314857,103.897654
424497,19,0,19,1.314728,103.897606
424499,3,35,38,1.314789,103.897702
424500,10,0,10,1.314686,103.897631
424501,0,30,30,1.314702,103.897614
424502,14,0,14,1.314646,103.897658
424503,0,317,317,1.314713,103.897623
424504,11,145,156,1.314595,103.897688
424505,1,0,1,1.308554,103.899965
424507,5,1,6,1.314456,103.897832
424508,5,88,93,1.314289,103.897963
424509,0,21,21,1.31426,103.897974
424511,0,47,47,1.314169,103.898057
424512,0,4,4,1.314131,103.898078
424513,2,40,42,1.314261,103.898063
424514,0,23,23,1.314098,103.898096
424515,0,1,1,1.314624,103.897677
424516,0,31,31,1.314042,103.898133
424517,4,24,28,1.314141,103.898144
424518,8,1,9,1.313984,103.898173
424519,1,5,6,1.314087,103.89817
424521,0,1,1,1.314209,103.898096
424522,49,75,124,1.314015,103.898234
424523,47,36,83,1.313878,103.898248
424524,5,5,10,1.313931,103.898296
424525,62,25,87,1.313877,103.898322
424526,0,49,49,1.31384,103.898358
424527,2,8,10,1.313805,103.898386
424528,0,89,89,1.313758,103.898414
424529,0,1,1,1.31405,103.898206
424530,5,6,11,1.313752,103.898352
424531,0,19,19,1.313613,103.898512
424532,9,46,55,1.31367,103.898408
424534,1,27,28,1.313611,103.898441
424535,0,49,49,1.313541,103.898576
424536,33,151,184,1.313493,103.898518
424537,10,30,40,1.313386,103.89861
424538,6,35,41,1.313507,103.898598
424539,12,47,59,1.313325,103.898647
424540,17,30,47,1.313289,103.898669
424541,0,1,1,1.313719,103.898437
424542,12,4,16,1.313199,103.898741
424543,2,1,3,1.308731,103.900239
424544,2,45,47,1.313228,103.898839
424545,0,7,7,1.313122,103.898798
424547,2,18,20,1.313022,103.89885
424549,0,5,5,1.312947,103.898903
424550,0,5,5,1.313118,103.89892
424551,2,1,3,1.313159,103.898768
424552,0,41,41,1.31299,103.899019
424553,3,17,20,1.312909,103.89894
424554,0,4,4,1.313034,103.898982
424555,1,31,32,1.312882,103.89897
424556,0,7,7,1.312952,103.899033
424557,2,55,57,1.312734,103.899091
424558,0,32,32,1.312861,103.899048
424559,1,26,27,1.312716,103.899098
424560,1,0,1,1.313226,103.898715
424561,0,20,20,1.312804,103.89903
424562,0,113,113,1.312772,103.899142
424563,5,175,180,1.31261,103.899273
424564,3,0,3,1.31308,103.898955
424565,1,0,1,1.312812,103.899096
424566,2,3,5,1.312494,103.899367
424567,0,3,3,1.312559,103.899332
424568,0,2,2,1.31038,103.907254
424569,1,8,9,1.312386,103.89947
424570,2,0,2,1.312413,103.899445
424572,0,2,2,1.312317,103.899533
424573,2,5,7,1.312197,103.899601
424574,7,1,8,1.312262,103.899421
424575,1,7,8,1.312214,103.899447
424576,0,1,1,1.312575,103.89931
424577,23,8,31,1.312183,103.899478
424578,0,2,2,1.312345,103.899339
424579,0,2,2,1.312098,103.899681
424582,0,15,15,1.31205,103.899601
424583,3,9,12,1.312001,103.899763
424584,1,7,8,1.311997,103.899618
424585,10,0,10,1.311964,103.899776
424586,0,4,4,1.311959,103.89966
424588,157,2,159,1.311835,103.899847
424589,3,19,22,1.31185,103.899753
424591,1,4,5,1.311806,103.899782
424592,0,2,2,1.312105,103.899549
424593,0,20,20,1.311752,103.899931
424594,4,7,11,1.311711,103.899854
424595,2,9,11,1.311704,103.899958
424596,4,28,32,1.311697,103.899866
424597,329,0,329,1.311672,103.899998
424598,9,0,9,1.311657,103.899896
424599,0,2,2,1.311797,103.899883
424600,0,9,9,1.311616,103.89992
424601,0,9,9,1.311578,103.900071
424602,0,5,5,1.311548,103.899988
424603,0,2,2,1.311615,103.900041
424604,0,1,1,1.312151,103.899642
424605,1,11,12,1.3115,103.900129
424606,0,5,5,1.311461,103.900052
424607,0,15,15,1.311431,103.900184
424609,2,15,17,1.311389,103.900102
424610,1,0,1,1.31151,103.900018
424611,1,2,3,1.312436,103.899399
424612,1,3,4,1.311321,103.900171
424613,4,0,4,1.311273,103.900188
424615,0,1,1,1.311341,103.900127
424616,0,3,3,1.311353,103.900259
424618,0,7,7,1.311189,103.900259
424619,0,75,75,1.311246,103.900304
424620,0,93,93,1.310951,103.900503
424621,2,5,7,1.311028,103.900495
424622,0,60,60,1.310983,103.900527
424623,0,17,17,1.310954,103.90041
424624,15,6,21,1.310993,103.900482
424625,0,3,3,1.311292,103.90031
424626,1,3,4,1.310937,103.900573
424627,2,9,11,1.31083,103.900486
424628,3,4,7,1.310875,103.900603
424630,21,14,35,1.310843,103.900626
424631,1,5,6,1.310745,103.900562
424632,5,0,5,1.310681,103.900587
424633,1,0,1,1.311221,103.900223
424636,19,2,21,1.310749,103.90068
424638,1,9,10,1.310637,103.900743
424640,0,6,6,1.310517,103.900829
424641,45,0,45,1.310468,103.900866
424642,0,7,7,1.310456,103.9009
424643,7,10,17,1.310541,103.900707
424645,10,6,16,1.310324,103.901006
424647,1,4,5,1.310202,103.901102
424648,3,0,3,1.310888,103.90045
424649,3,4,7,1.310147,103.901122
424650,3,0,3,1.310402,103.90079
424651,109,15,124,1.310094,103.901166
424652,22,17,39,1.310353,103.900799
424653,53,3,56,1.310053,103.901204
424654,12,6,18,1.309998,103.901232
424655,128,10,138,1.310207,103.900918
424656,3,8,11,1.309944,103.901277
424657,6,1,7,1.310063,103.901008
424658,2,3,5,1.310121,103.900996
424659,0,7,7,1.310033,103.901018
424660,4,1,5,1.310009,103.901066
424661,2,0,2,1.311546,103.900093
424662,2,635,637,1.309328,103.901556
424663,2,1,3,1.310317,103.900836
424664,1,1,2,1.309287,103.901705
424666,0,24,24,1.309168,103.901684
424667,2,0,2,1.309252,103.901614
424668,2,2,4,1.309131,103.901834
424671,26,1,27,1.309067,103.901887
424672,9,0,9,1.309008,103.901778
424674,0,1,1,1.310767,103.900656
424677,19,14,33,1.308938,103.901819
424681,3,1,4,1.308895,103.901998
424683,2,0,2,1.309123,103.901709
424684,0,1,1,1.30904,103.901912
424685,96,0,96,1.308856,103.902024
424686,12,0,12,1.308677,103.901954
424687,1,0,1,1.308731,103.901918
424688,8,1,9,1.308656,103.902192
424692,0,6,6,1.308541,103.902274
424693,1,0,1,1.30864,103.902036
424696,0,1,1,1.308548,103.902055
424697,0,8,8,1.308449,103.902358
424698,5,3,8,1.308402,103.902265
424699,0,6,6,1.308403,103.902389
424700,2,5,7,1.308417,103.902207
424701,1,73,74,1.308343,103.902437
424702,19,10,29,1.308257,103.902355
424703,2,21,23,1.308075,103.902479
424704,2,10,12,1.308091,103.902571
424705,2,0,2,1.308797,103.901895
424706,3,6,9,1.308019,103.902657
424707,0,1,1,1.308485,103.902127
424708,0,3,3,1.309186,103.901789
424711,57,4,61,1.307883,103.902591
424713,4,0,4,1.307896,103.902722
424714,2,0,2,1.308038,103.902497
424715,0,1,1,1.308003,103.902536
424717,3,4,7,1.307827,103.902647
424718,1,0,1,1.307856,103.902617
424719,0,3,3,1.307938,103.902696
424720,0,1,1,1.307772,103.902684
424721,12,1,13,1.307688,103.902739
424722,1,4,5,1.307717,103.902836
424723,17,2,19,1.307619,103.902786
424725,11,1,12,1.307625,103.902937
424727,0,2,2,1.307852,103.902578
424728,0,6,6,1.307529,103.902844
424729,3,0,3,1.307759,103.902668
424730,1,0,1,1.307739,103.902697
424731,8,1,9,1.307512,103.903023
424732,11,0,11,1.307449,103.902916
424733,0,2,2,1.307587,103.902966
424734,1,0,1,1.307487,103.902871
424735,64,2,66,1.307322,103.903149
424736,0,1,1,1.30742,103.902948
424737,44,0,44,1.307357,103.902979
424738,9,0,9,1.307222,103.903243
424739,3,16,19,1.307166,103.903233
424740,0,2,2,1.307366,103.903077
424741,3,7,10,1.306878,103.903417
424742,5,1,6,1.306836,103.903447
424743,1,0,1,1.307237,103.903151
424744,2,0,2,1.307339,103.903007
424745,5,2,7,1.306808,103.903511
424746,0,1,1,1.307261,103.903048
424747,5,1,6,1.30712,103.903136
424748,0,18,18,1.306961,103.903088
424749,4,0,4,1.306625,103.903554
424750,0,2,2,1.30683,103.903486
424751,0,2,2,1.306692,103.903427
424752,18,0,18,1.306738,103.903553
424753,1,12,13,1.306624,103.903455
424754,59,8,67,1.306701,103.90357
424755,2,15,17,1.306566,103.903532
424757,32,10,42,1.306614,103.903595
424758,101,70,171,1.306384,103.903617
424759,65,0,65,1.306571,103.903622
424760,14,23,37,1.306533,103.903647
424761,2,1,3,1.307563,103.902994
424764,0,2,2,1.306723,103.903568
424766,0,49,49,1.306427,103.903803
424767,1,1,2,1.306341,103.903797
424768,124,1836,1960,1.309487,103.901549
424770,16,2,18,1.306669,103.903446
424771,22,5,27,1.308326,103.902244
424772,17,0,17,1.308938,103.901985
424773,23,488,511,1.309807,103.901398
424774,124,163,287,1.30897,103.901951
424775,1019,3,1022,1.3059,103.903924
424776,37,47,84,1.306298,103.903759
424777,0,59,59,1.308914,103.901848
424778,0,1,1,1.307148,103.90314
424779,0,3,3,1.306482,103.903717
424780,1700,5731,7431,1.31583,103.897113
424781,44,39,83,1.299509,103.837
424782,10,4,14,1.308046,103.910518
424783,0,5,5,1.307999,103.910558
424784,16,2,18,1.307948,103.910586
424785,1,12,13,1.307914,103.910596
424786,16,4,20,1.307784,103.910648
424787,0,9,9,1.307749,103.910647
424788,1,1,2,1.306324,103.903813
424789,1,19,20,1.307383,103.910837
424790,61,1,62,1.307964,103.910429
424791,2,0,2,1.308091,103.910392
424792,0,6,6,1.307775,103.910462
424793,0,11,11,1.307827,103.910426
424794,114,0,114,1.307557,103.911565
424795,78,21,99,1.307313,103.910736
424796,847,131,978,1.30715,103.910899
424797,7,147,154,1.299509,103.837
424798,0,6,6,1.299509,103.837
424800,1,68,69,1.306972,103.910768
424801,4,16,20,1.30697,103.910733
424802,12,19,31,1.306943,103.91064
424803,0,4,4,1.306948,103.910596
424804,2,6,8,1.306937,103.910558
424805,2,0,2,1.307906,103.910449
424806,14,0,14,1.306904,103.910472
424807,3,2,5,1.306926,103.910438
424808,547,1915,2462,1.306359,103.911539
424820,40,2,42,1.306832,103.910199
424821,146,660,806,1.306931,103.910846
424837,5,1,6,1.304716,103.902431
424838,8,7,15,1.304856,103.902486
424840,11,7,18,1.304896,103.902466
424842,2,4,6,1.304931,103.902431
424843,6,0,6,1.304855,103.902327
424844,0,3,3,1.307769,103.902801
424845,0,10,10,1.304889,103.902316
424846,2,2,4,1.304995,103.902384
424847,3,1,4,1.304917,103.902293
424848,0,1,1,1.307446,103.903046
424849,1,1,2,1.306919,103.910501
424851,2,0,2,1.304949,103.902269
424852,0,3,3,1.304973,103.902411
424853,0,6,6,1.305004,103.902236
424854,0,1,1,1.30506,103.90236
424855,2,0,2,1.304974,103.902256
424856,19,2,21,1.305189,103.90227
424857,1,2,3,1.305124,103.902311
424858,1,1,2,1.305031,103.902214
424859,28,8,36,1.305086,103.902172
424860,53,6,59,1.305257,103.902216
424861,1,3,4,1.30511,103.902155
424862,6,1,7,1.305145,103.902131
424863,0,2,2,1.305228,103.902244
424864,3,6,9,1.305214,103.902083
424865,24,0,24,1.305248,103.902059
424866,1,0,1,1.305152,103.9023
424867,7,0,7,1.305317,103.902012
424868,0,34,34,1.305351,103.901988
424869,7,10,17,1.305515,103.902063
424870,4,0,4,1.305386,103.901964
424871,2,2,4,1.305658,103.901954
424872,9,0,9,1.30542,103.90194
424873,5,2,7,1.305731,103.90191
424874,3,0,3,1.305059,103.902195
424875,5,3,8,1.305802,103.901879
424876,1,0,1,1.305282,103.902036
424877,278,0,278,1.305832,103.901836
424878,2,0,2,1.305179,103.902107
424879,4,6,10,1.305886,103.901792
424880,9,0,9,1.305558,103.901845
424881,1,0,1,1.305489,103.901893
424882,0,18,18,1.305627,103.901797
424883,1,18,19,1.306658,103.901246
424884,0,58,58,1.306715,103.90119
424885,29,3,32,1.306139,103.901431
424886,216,15,231,1.306429,103.901217
424887,264,0,264,1.306552,103.901119
424888,1,2,3,1.305455,103.901916
424890,1,12,13,1.306788,103.901142
424891,13,1,14,1.306922,103.90089
424892,2,14,16,1.306866,103.901093
424893,4,14,18,1.30698,103.900861
424894,118,12,130,1.307065,103.900787
424895,52,54,106,1.307195,103.900841
424896,0,8,8,1.307269,103.900644
424898,0,4,4,1.30732,103.900606
424899,3,2,5,1.307262,103.900803
424900,2,2,4,1.307369,103.900569
424902,5,1,6,1.307419,103.900536
424903,1,0,1,1.305592,103.901821
424905,60,1,61,1.30736,103.900742
424906,15,0,15,1.307546,103.9006
424907,10,3,13,1.307599,103.900567
424909,7,0,7,1.307625,103.900534
424910,2,13,15,1.307689,103.900363
424911,0,13,13,1.307664,103.900513
424912,1,11,12,1.307789,103.900314
424913,0,1,1,1.307325,103.900762
424914,31,2,33,1.307833,103.900285
424915,13,0,13,1.30784,103.900417
424916,3,3,6,1.307981,103.900187
424917,5,6,11,1.308074,103.900117
424918,0,2,2,1.305523,103.901869
424920,0,2,2,1.30794,103.90038
424921,7,1,8,1.308148,103.900212
424922,2,1,3,1.306764,103.901004
424923,1,2,3,1.308197,103.900176
424924,0,2,2,1.308064,103.900287
424925,3,0,3,1.3083,103.899941
424931,2,0,2,1.299509,103.837
424932,0,18,18,1.299509,103.837
424942,0,2,2,1.299509,103.837
424943,4,3,7,1.314437,103.903175
424944,2,0,2,1.314473,103.903148
424945,2,1,3,1.299509,103.837
424946,6,14,20,1.314689,103.902853
424947,60,13,73,1.314602,103.902916
424948,38,0,38,1.314627,103.902874
424949,3,2,5,1.314562,103.902941
424950,71,0,71,1.314498,103.902979
424951,1,0,1,1.307752,103.900461
424952,3,0,3,1.314618,103.903093
424953,5,3,8,1.314366,103.903086
424954,9,24,33,1.314249,103.903147
424955,0,2,2,1.31459,103.903095
424956,0,1,1,1.314457,103.903004
424958,12,2,14,1.313395,103.903796
424959,0,2,2,1.314134,103.903217
424960,4,1,5,1.31338,103.903812
424961,3,0,3,1.314404,103.903053
424962,5,0,5,1.313314,103.903874
424963,1,0,1,1.313495,103.903735
424964,0,41,41,1.313242,103.903914
424965,22,26,48,1.312978,103.904091
424966,29,0,29,1.312978,103.904091
424967,3,1,4,1.312978,103.904091
424968,390,15,405,1.312866,103.904624
424969,8,0,8,1.312978,103.904091
424979,204,2,206,1.312636,103.904401
424980,511,143,654,1.313297,103.903963
424981,158,3,161,1.314221,103.903325
424994,5,6,11,1.308591,103.907223
424995,8,0,8,1.308625,103.907304
424996,1,3,4,1.308639,103.907329
424999,0,1,1,1.313361,103.903933
425000,2,7,9,1.3086,103.907152
425001,0,6,6,1.308626,103.907197
425002,0,5,5,1.308627,103.906946
425003,1,0,1,1.308307,103.907714
425004,3,0,3,1.313429,103.903857
425005,3,48,51,1.308535,103.906816
425006,81,0,81,1.308514,103.906777
425007,2,0,2,1.313482,103.903842
425008,22,0,22,1.308456,103.906679
425009,2,0,2,1.308478,103.906713
425011,3,0,3,1.308575,103.906875
425012,5,3,8,1.308718,103.906902
425013,0,2,2,1.308415,103.90659
425014,18,0,18,1.308626,103.906812
425015,0,1,1,1.308603,103.906921
425016,0,5,5,1.308573,103.906734
425017,9,0,9,1.308548,103.906674
425018,7,2,9,1.308506,103.906646
425019,9,0,9,1.308497,103.906612
425020,1,0,1,1.308599,103.906775
425021,3,0,3,1.308644,103.907233
425022,21,7,28,1.309104,103.90664
425023,1,0,1,1.308482,103.906546
425025,5,5,10,1.309013,103.906496
425026,15,1,16,1.309001,103.906481
425027,2,4,6,1.308966,103.906437
425028,28,2,30,1.308939,103.906398
425029,1,62,63,1.308895,103.906345
425030,1,33,34,1.308873,103.906298
425032,5,0,5,1.308853,103.906236
425033,7,0,7,1.308736,103.907367
425034,2,5,7,1.308853,103.906236
425035,0,1,1,1.309085,103.906598
425036,3,0,3,1.30867,103.907276
425037,0,9,9,1.309068,103.906989
425038,192,0,192,1.308853,103.906236
425039,0,8,8,1.309107,103.907057
425040,49,4,53,1.308865,103.906199
425041,1,0,1,1.308767,103.907404
425042,13,4,17,1.308865,103.906199
425043,3,0,3,1.308853,103.906236
425044,59,0,59,1.308865,103.906199
425045,19,0,19,1.30918,103.907187
425046,15,0,15,1.308865,103.906199
425047,5,0,5,1.309239,103.907272
425048,3,3,6,1.309286,103.905676
425049,6,0,6,1.30928,103.907364
425050,109,1,110,1.309285,103.905676
425052,7,0,7,1.309282,103.905704
425055,0,4,4,1.309474,103.90769
425056,4,0,4,1.309513,103.907735
425057,3,273,276,1.309557,103.907786
425058,6,32,38,1.308937,103.906274
425060,2,10,12,1.309001,103.906352
425062,1,0,1,1.309134,103.907134
425063,2,6,8,1.30905,103.90648
425064,19,0,19,1.309072,103.906493
425065,0,5,5,1.309129,103.906549
425066,0,1,1,1.309047,103.90642
425067,1,5,6,1.309112,103.906907
425069,5,18,23,1.309163,103.906972
425070,9,5,14,1.309174,103.907009
425071,1,0,1,1.309139,103.906596
425073,2,0,2,1.308678,103.906868
425075,0,1,1,1.30925,103.907116
425080,18,280,298,1.309724,103.907832
425081,1,0,1,1.30953,103.907507
425082,18,23,41,1.309171,103.907141
425083,1,22,23,1.309212,103.907204
425085,1,2,3,1.309265,103.907301
425086,0,2,2,1.309472,103.907459
425087,2,3,5,1.309405,103.90759
425095,5,63,68,1.311632,103.90655
425096,27,1,28,1.311856,103.90667
425097,7,0,7,1.311672,103.906618
425100,0,5,5,1.311974,103.906772
425102,0,3,3,1.309325,103.907372
425103,9,0,9,1.311795,103.906785
425104,3,1,4,1.312056,103.906919
425105,10,9,19,1.311821,103.906825
425120,62,65,127,1.309228,103.908498
425126,1,275,276,1.309142,103.908589
425127,3,0,3,1.312001,103.906858
425128,2,0,2,1.309364,103.90748
425129,52,10,62,1.30915,103.908678
425130,0,6,6,1.309315,103.9089
425131,3,2,5,1.309318,103.908933
425132,1,1,2,1.309284,103.908788
425133,3,0,3,1.309277,103.9087
425134,11,7,18,1.309307,103.908973
425135,0,10,10,1.309313,103.909021
425136,4,3,7,1.308998,103.909037
425137,12,0,12,1.309228,103.908994
425138,14,0,14,1.309321,103.909086
425139,1,3,4,1.309243,103.909119
425140,1,1,2,1.309191,103.908904
425141,273,5,278,1.309344,103.909127
425142,47,39,86,1.309412,103.909457
425145,314,14,328,1.309486,103.909753
425147,5,1,6,1.309409,103.909964
425148,2,0,2,1.309238,103.909185
425149,1,0,1,1.309224,103.907236
425150,2,9,11,1.309474,103.91022
425151,5,13,18,1.309555,103.910158
425152,10,0,10,1.309545,103.910202
425153,6,8,14,1.309515,103.910511
425154,15,0,15,1.309588,103.910311
425155,0,22,22,1.309521,103.910556
425159,2,24,26,1.309624,103.91053
425160,47,7,54,1.309575,103.91074
425161,4,1,5,1.309651,103.910656
425162,37,0,37,1.30968,103.910804
425163,163,3,166,1.309651,103.911229
425164,0,10,10,1.309721,103.910922
425165,0,4,4,1.299509,103.837
425166,15,14,29,1.309761,103.911035
425167,1,3,4,1.299509,103.837
425168,260,1,261,1.309712,103.911005
425169,2,6,8,1.309753,103.911124
425171,87,8,95,1.309793,103.911382
425172,2,359,361,1.309863,103.912157
425173,5,1,6,1.309866,103.912264
425174,5,11,16,1.309889,103.912334
425175,0,1,1,1.309524,103.910062
425176,3,0,3,1.309199,103.908951
425177,9,0,9,1.309953,103.912322
425178,6,0,6,1.309993,103.9124
425179,2,1,3,1.309906,103.91244
425181,0,1,1,1.309906,103.91244
425183,5,2,7,1.31001,103.912901
425184,0,1,1,1.309977,103.912769
425185,2,0,2,1.309523,103.910015
425187,5,27,32,1.310026,103.912996
425189,161,0,161,1.310058,103.913163
425190,2,18,20,1.310053,103.912623
425191,4,0,4,1.310044,103.91269
425192,24,68,92,1.310069,103.913248
425193,2,8,10,1.310082,103.913296
425194,0,1,1,1.310001,103.912514
425196,7,0,7,1.310078,103.913272
425197,7,7,14,1.310056,103.91321
425198,3,0,3,1.309929,103.912562
425200,49,5,54,1.310156,103.913073
425201,1,0,1,1.310081,103.913307
425203,35,1,36,1.310227,103.913318
425204,3,7,10,1.310246,103.914125
425205,7,1,8,1.31024,103.913416
425206,36,13,49,1.310255,103.914203
425207,1,1,2,1.310028,103.912587
425208,3,4,7,1.310308,103.914384
425209,4,9,13,1.310314,103.914471
425210,2,1,3,1.309851,103.913477
425211,2,4,6,1.31034,103.914567
425212,7,4,11,1.3103,103.913884
425213,6,11,17,1.31034,103.914624
425214,2,18,20,1.310327,103.913993
425215,3,13,16,1.310354,103.9141
425216,3,4,7,1.310347,103.914675
425217,7,5,12,1.310438,103.914215
425218,18,1,19,1.310453,103.914293
425219,5,0,5,1.310419,103.91433
425221,1,0,1,1.310147,103.91314
425222,2,0,2,1.310265,103.913529
425223,0,9,9,1.310351,103.914756
425224,12,19,31,1.310441,103.914536
425225,4,1,5,1.310509,103.914638
425226,2,0,2,1.310447,103.914495
425228,5,17,22,1.310545,103.914832
425230,2,36,38,1.310383,103.914878
425231,155,40,195,1.310579,103.915077
425233,0,12,12,1.31039,103.914937
425234,24,15,39,1.310431,103.915034
425235,0,39,39,1.310446,103.915104
425236,283,17,300,1.310499,103.915284
425238,53,2,55,1.310594,103.915268
425239,414,40,454,1.310545,103.915561
425240,5,1,6,1.310634,103.915419
425241,1,18,19,1.310579,103.915783
425242,0,3,3,1.310293,103.913664
425243,0,3,3,1.310656,103.915497
425244,449,20,469,1.310669,103.915612
425245,1,1,2,1.310476,103.914701
425246,5,7,12,1.310698,103.915705
425247,7,2,9,1.310697,103.915779
425248,16,7,23,1.310727,103.915956
425249,2,13,15,1.310691,103.916312
425250,153,15,168,1.310706,103.916342
425251,203,121,324,1.310807,103.916232
425252,39,7,46,1.310734,103.916453
425253,250,1,251,1.310797,103.91622
425254,6,0,6,1.299509,103.837
425255,5,0,5,1.310797,103.91622
425258,2,1,3,1.310579,103.915752
425259,170,3,173,1.310868,103.916553
425260,4,1,5,1.310863,103.916577
425261,462,432,894,1.310773,103.916572
425262,157,176,333,1.310228,103.916919
425263,48,0,48,1.309481,103.910342
425264,1,0,1,1.310438,103.914436
425265,363,0,363,1.310579,103.915013
425266,24,1,25,1.299509,103.837
425268,0,2,2,1.299509,103.837
425277,13,138,151,1.310129,103.908287
425278,1,14,15,1.310163,103.908359
425279,555,0,555,1.310059,103.9084
425280,6,91,97,1.310179,103.908444
425281,1,37,38,1.310191,103.908511
425282,3,4,7,1.310209,103.908543
425283,335,0,335,1.310099,103.908648
425284,4,19,23,1.310222,103.90867
425285,4,18,22,1.310226,103.90869
425286,102,0,102,1.310151,103.908826
425287,38,0,38,1.310245,103.908761
425288,3,0,3,1.310797,103.91622
425289,15,1,16,1.310163,103.908969
425290,0,27,27,1.310261,103.908852
425291,7,0,7,1.310261,103.908852
425292,46,20,66,1.310288,103.90895
425293,10,6,16,1.310327,103.909082
425294,6,3,9,1.310186,103.909036
425295,1,2,3,1.31025,103.908805
425296,13,4,17,1.310358,103.909231
425297,0,1,1,1.309489,103.910406
425298,0,32,32,1.310362,103.909324
425299,1,1,2,1.299509,103.837
425300,13,0,13,1.310233,103.909252
425301,1,0,1,1.310363,103.909282
425302,2,1,3,1.310365,103.909185
425303,520,2,522,1.310428,103.909547
425304,8,14,22,1.310306,103.909534
425305,2,6,8,1.310333,103.90963
425306,86,0,86,1.310373,103.909891
425307,26,7,33,1.310481,103.90973
425308,30,9,39,1.310498,103.909824
425310,167,3,170,1.310551,103.910072
425311,4,13,17,1.310572,103.910208
425312,117,4,121,1.3105,103.91032
425313,90,0,90,1.310586,103.910417
425314,8,0,8,1.310605,103.910534
425315,2,1,3,1.310296,103.909441
425316,137,95,232,1.310665,103.910793
425317,128,1,129,1.310595,103.910764
425318,0,12,12,1.310595,103.910764
425322,0,3,3,1.310685,103.910705
425323,1,21,22,1.31073,103.910964
425324,11,2,13,1.310756,103.911092
425325,6,188,194,1.310802,103.911262
425326,4,529,533,1.310873,103.911715
425327,0,1,1,1.310258,103.909397
425328,9,13,22,1.310907,103.911844
425329,0,1,1,1.310889,103.911779
425330,20,0,20,1.310691,103.911178
425331,0,40,40,1.310917,103.911951
425333,9,460,469,1.31079,103.911746
425334,1,0,1,1.310896,103.911904
425335,1,1,2,1.310224,103.909145
425336,198,15,213,1.31085,103.912035
425337,4,22,26,1.310938,103.912113
425338,1,0,1,1.310805,103.911828
425339,1,2,3,1.310715,103.910868
425340,0,14,14,1.310987,103.912271
425341,18,11,29,1.310999,103.912366
425342,610,1,611,1.310905,103.912293
425343,4,5,9,1.310884,103.912204
425344,1,13,14,1.31101,103.912459
425345,4,1,5,1.311041,103.912542
425346,594,2,596,1.310917,103.912365
425348,1,7,8,1.311087,103.912717
425349,0,5,5,1.311101,103.912771
425352,2,11,13,1.311117,103.912854
425353,0,1,1,1.310959,103.912187
425354,27,3,30,1.310986,103.912755
425355,1,13,14,1.311144,103.913014
425356,0,12,12,1.311169,103.913122
425358,0,40,40,1.311181,103.913191
425359,9,11,20,1.311205,103.913327
425360,10,0,10,1.311053,103.913023
425361,0,2,2,1.310829,103.911931
425362,1,5,6,1.311279,103.913614
425363,7,10,17,1.311091,103.913238
425364,1,2,3,1.310867,103.912114
425365,171,39,210,1.311099,103.913381
425366,4,1,5,1.317756,103.882247
425367,0,6,6,1.299509,103.837
425368,0,7,7,1.31114,103.913543
425369,49,0,49,1.311352,103.913899
425370,3,13,16,1.311201,103.913801
425371,3,59,62,1.311201,103.913801
425372,338,0,338,1.311352,103.913899
425373,1,7,8,1.311217,103.913945
425374,0,4,4,1.311229,103.914001
425375,0,2,2,1.311276,103.913522
425376,0,1,1,1.311131,103.912723
425377,1,1,2,1.311236,103.91404
425378,1,1,2,1.31128,103.914222
425380,605,2,607,1.31129,103.914284
425381,4,1,5,1.311304,103.914316
425382,2,0,2,1.311265,103.914175
425383,5,0,5,1.311328,103.914389
425387,696,41,737,1.311396,103.914719
425388,1,0,1,1.311246,103.914108
425390,9,3,12,1.311675,103.915779
425391,1,27,28,1.311687,103.915824
425393,28,0,28,1.31171,103.915915
425394,9,5,14,1.311727,103.915961
425396,1,19,20,1.31175,103.916063
425397,14,2,16,1.311444,103.914996
425398,0,1,1,1.311416,103.914798
425399,103,0,103,1.31147,103.915096
425400,5,0,5,1.311505,103.915321
425401,1,1,2,1.31133,103.914442
425402,12,6,18,1.311534,103.915541
425403,382,1,383,1.311657,103.915994
425405,2,1,3,1.311352,103.913899
425406,2,3,5,1.310656,103.911034
425407,0,6,6,1.31067,103.911093
425408,29,85,114,1.310361,103.909712
425409,3,108,111,1.310411,103.910044
425411,30,4,34,1.299509,103.837
425412,344,18,362,1.310875,103.914266
425413,520,120,640,1.310875,103.914266
425414,397,48,445,1.299509,103.837
425415,213,0,213,1.299509,103.837
425416,22,0,22,1.299509,103.837
425417,8,0,8,1.299509,103.837
425418,53,0,53,1.299509,103.837
425419,0,42,42,1.311165,103.907915
425420,0,2,2,1.311487,103.915219
425422,2,3,5,1.311211,103.908056
425423,2,0,2,1.311204,103.908004
425424,0,1,1,1.311761,103.91612
425425,1,2,3,1.310637,103.910945
425426,18,0,18,1.311169,103.90827
425427,5,0,5,1.311254,103.908195
425428,3,8,11,1.311173,103.908358
425429,2,3,5,1.311182,103.908388
425430,154,0,154,1.311209,103.908454
425431,10,0,10,1.311281,103.908282
425432,1,0,1,1.311124,103.908097
425433,1,1,2,1.311193,103.907981
425434,136,0,136,1.310794,103.908765
425435,2,0,2,1.31078,103.908718
425437,1,0,1,1.311221,103.908527
425438,2,3,5,1.31133,103.909079
425439,0,5,5,1.311346,103.909149
425440,14,0,14,1.311408,103.909456
425441,17,0,17,1.311435,103.909529
425442,45,1,46,1.3114,103.909404
425443,29,0,29,1.3114,103.909404
425445,2,0,2,1.311252,103.90868
425446,12,4,16,1.311421,103.908551
425447,1,11,12,1.311488,103.908523
425448,6,1,7,1.311545,103.908509
425449,61,0,61,1.311592,103.908503
425450,3,0,3,1.311153,103.90818
425451,1,1,2,1.311435,103.909529
425452,3,0,3,1.311631,103.908492
425453,2,6,8,1.311421,103.908648
425454,1,2,3,1.311435,103.909529
425455,15,0,15,1.311535,103.908629
425457,3,22,25,1.311601,103.908596
425458,1,4,5,1.311635,103.908576
425459,0,1,1,1.311292,103.908888
425460,9,27,36,1.31152,103.909107
425461,146,5,151,1.311567,103.909095
425462,0,3,3,1.311447,103.908632
425463,12,11,23,1.311646,103.909072
425464,3,0,3,1.31158,103.909056
425466,0,1,1,1.311708,103.908539
425467,5,27,32,1.311533,103.909183
425468,6,1,7,1.311563,103.909176
425469,0,18,18,1.311585,103.909175
425470,23,1,24,1.311631,103.909154
425471,2,4,6,1.311742,103.909123
425472,13,2,15,1.31177,103.909121
425473,4,2,6,1.311814,103.90911
425475,4,8,12,1.31163,103.909649
425476,3,4,7,1.311691,103.909633
425477,10,3,13,1.311817,103.909609
425478,2,0,2,1.311706,103.908483
425479,1,0,1,1.311789,103.909029
425480,1,1,2,1.311857,103.909603
425481,4,1,5,1.311937,103.909562
425482,0,7,7,1.311501,103.909781
425483,3,21,24,1.311627,103.909726
425484,114,8,122,1.311714,103.909725
425485,4,0,4,1.311666,103.909724
425486,1,0,1,1.311877,103.909597
425487,1,0,1,1.311744,103.909735
425488,0,2,2,1.311877,103.909577
425489,78,1,79,1.311872,103.909667
425491,7,110,117,1.311726,103.910164
425492,1,3,4,1.311775,103.910171
425493,3,0,3,1.311682,103.909065
425494,2,1,3,1.311843,103.910134
425495,3,0,3,1.31186,103.910137
425496,0,2,2,1.311815,103.909682
425497,19,0,19,1.312022,103.91012
425498,2,0,2,1.312004,103.910111
425500,257,175,432,1.311723,103.910552
425502,14,0,14,1.311107,103.909856
425503,3,0,3,1.311969,103.910124
425504,43,9,52,1.311269,103.910083
425505,4,3,7,1.311277,103.910235
425509,418,1,419,1.31127,103.910346
425510,3,2,5,1.311276,103.910429
425511,244,0,244,1.31119,103.910504
425512,4,152,156,1.311939,103.91154
425513,103,2,105,1.311956,103.911625
425514,0,15,15,1.311972,103.911701
425515,120,1,121,1.311969,103.911778
425516,21,23,44,1.311738,103.911783
425517,2,4,6,1.311781,103.911909
425518,1,31,32,1.311822,103.91206
425520,0,36,36,1.311844,103.912141
425522,15,2,17,1.311838,103.912265
425523,6,32,38,1.311883,103.912311
425524,18,0,18,1.311874,103.912423
425525,357,2,359,1.312009,103.912021
425526,12,32,44,1.311906,103.912503
425527,50,5,55,1.31204,103.912125
425528,30,24,54,1.311934,103.912564
425530,6,19,25,1.311949,103.912598
425531,3,5,8,1.311966,103.912759
425532,22,1,23,1.31219,103.91278
425533,2,16,18,1.312011,103.912896
425534,0,3,3,1.311051,103.909884
425535,2,14,16,1.312024,103.913057
425536,13,0,13,1.312195,103.91289
425537,143,11,154,1.312207,103.91294
425539,3,60,63,1.312122,103.913256
425540,23,0,23,1.312282,103.913166
425541,8,3,11,1.312107,103.913471
425542,85,0,85,1.312331,103.913227
425543,2,0,2,1.311485,103.909711
425545,5,8,13,1.312332,103.913452
425546,1,1,2,1.31199,103.913558
425547,0,7,7,1.312094,103.91391
425550,11,2,13,1.31189,103.913967
425551,14,2,16,1.312385,103.913691
425552,64,0,64,1.312001,103.914102
425553,81,1,82,1.31147,103.909592
425554,180,0,180,1.312399,103.913821
425555,4,100,104,1.312143,103.91423
425557,71,1,72,1.312156,103.914355
425558,2,0,2,1.312153,103.913849
425560,0,10,10,1.311476,103.90962
425561,1,7,8,1.311475,103.909619
425562,811,94,905,1.312569,103.914547
425563,561,75,636,1.312126,103.914695
425564,41,2,43,1.311477,103.909629
425565,558,0,558,1.313147,103.914186
425566,283,2,285,1.312358,103.914656
425567,8,9,17,1.299509,103.837
425568,1,46,47,1.312593,103.914642
425569,418,91,509,1.312249,103.915187
425570,16,16,32,1.312625,103.914742
425571,248,1,249,1.312668,103.914907
425572,1,17,18,1.312916,103.91544
425573,1,0,1,1.311769,103.909697
425574,3,9,12,1.312933,103.915433
425575,4,0,4,1.312965,103.915419
425576,5,1,6,1.312466,103.915833
425577,3,0,3,1.312185,103.912838
425578,7,0,7,1.312467,103.915835
425579,9,3,12,1.312998,103.915405
425580,2,1,3,1.312467,103.915868
425581,3,0,3,1.31303,103.915391
425582,27,0,27,1.313096,103.915363
425583,2,3,5,1.313146,103.915421
425584,3,0,3,1.313063,103.915377
425585,1,1,2,1.312503,103.914219
425586,13,0,13,1.313068,103.915451
425587,8,12,20,1.313045,103.915456
425588,12,2,14,1.313007,103.915473
425589,3,13,16,1.312955,103.915505
425590,3,1,4,1.311881,103.913553
425591,9,3,12,1.311843,103.913587
425592,30,1,31,1.312229,103.913792
425593,17,52,69,1.312257,103.91379
425594,10,0,10,1.312317,103.913294
425595,1,0,1,1.312419,103.915677
425597,38,4,42,1.312132,103.912466
425598,1,0,1,1.312317,103.913294
425600,25,74,99,1.311104,103.908035
425601,10,22,32,1.312118,103.913499
425602,260,3,263,1.312569,103.914547
425603,565,25,590,1.313389,103.91413
425604,12,0,12,1.31216,103.907691
425605,8,233,241,1.312247,103.907458
425606,6,1,7,1.312162,103.907718
425607,6,45,51,1.312168,103.907738
425608,1,3,4,1.312169,103.907759
425609,30,0,30,1.312169,103.90779
425610,42,0,42,1.312175,103.907824
425611,12,0,12,1.312265,103.907658
425612,810,17,827,1.312327,103.908199
425613,64,22,86,1.312278,103.907734
425614,13,1,14,1.312306,103.907768
425615,2,0,2,1.313101,103.915437
425616,2,1,3,1.313121,103.915429
425617,3,15,18,1.312346,103.907932
425618,4,0,4,1.312346,103.907932
425619,1,3,4,1.312346,103.907932
425620,16,0,16,1.312346,103.907932
425621,4,5,9,1.312346,103.907932
425622,5,0,5,1.312346,103.907932
425623,6,143,149,1.312386,103.908538
425624,1,5,6,1.312364,103.908157
425625,3,32,35,1.312393,103.908276
425626,9,0,9,1.312385,103.908218
425627,1,12,13,1.312559,103.908568
425628,1,0,1,1.312461,103.914087
425629,0,1,1,1.312607,103.908567
425630,29,1,30,1.31267,103.908545
425631,4,0,4,1.312416,103.908649
425632,21,0,21,1.312785,103.908491
425635,87,0,87,1.312871,103.908474
425636,2,0,2,1.312304,103.907829
425637,0,5,5,1.31283,103.908569
425639,1,0,1,1.312588,103.90859
425640,0,3,3,1.312376,103.908452
425641,77,24,101,1.312462,103.908907
425642,115,2,117,1.31265,103.908653
425643,13,3,16,1.312616,103.908678
425645,3,17,20,1.312577,103.908687
425646,118,1,119,1.312526,103.908899
425647,5,5,10,1.312561,103.909021
425648,58,0,58,1.312578,103.909104
425649,274,8,282,1.312503,103.909231
425650,2,17,19,1.312744,103.90936
425651,117,3,120,1.312524,103.909334
425652,2,41,43,1.312693,103.909369
425653,352,0,352,1.312553,103.909464
425654,1,0,1,1.312728,103.908602
425656,0,7,7,1.299509,103.837
425658,0,2,2,1.312441,103.908822
425661,3,44,47,1.312621,103.909705
425662,1,0,1,1.299509,103.837
425663,0,3,3,1.312721,103.908623
425664,1,1,2,1.299509,103.837
425665,1,2,3,1.312628,103.909764
425666,309,37,346,1.312645,103.909823
425667,1,122,123,1.312798,103.909457
425668,0,24,24,1.312745,103.909487
425669,7,0,7,1.312929,103.909464
425670,3,0,3,1.312953,103.909382
425671,189,22,211,1.312832,103.909456
425672,94,62,156,1.312863,103.910984
425673,43,0,43,1.312841,103.910103
425674,2,0,2,1.313024,103.909379
425675,2,255,257,1.312847,103.910317
425676,138,4,142,1.312898,103.911143
425677,4,719,723,1.312897,103.910833
425678,2,1,3,1.312849,103.910896
425679,5,2,7,1.312933,103.910953
425680,0,4,4,1.312946,103.910995
425681,1,2,3,1.312919,103.910892
425682,6,1,7,1.312961,103.91109
425683,1,0,1,1.312969,103.909281
425684,0,1,1,1.312973,103.911169
425685,5,6,11,1.312988,103.911241
425686,2,0,2,1.312877,103.911059
425687,972,121,1093,1.312928,103.91134
425688,21,0,21,1.313029,103.911421
425689,16,3,19,1.313068,103.911481
425690,1,89,90,1.312979,103.91157
425691,0,23,23,1.312979,103.91157
425692,181,22,203,1.31309,103.911598
425693,0,3,3,1.31295,103.911053
425694,0,3,3,1.312976,103.911504
425695,1,38,39,1.313096,103.911805
425696,0,2,2,1.312998,103.911313
425698,0,2,2,1.312989,103.911598
425700,1,4,5,1.313114,103.911883
425701,275,2,277,1.313004,103.911653
425702,151,22,173,1.31301,103.911687
425703,3,35,38,1.313045,103.911825
425704,0,7,7,1.31303,103.911759
425705,0,4,4,1.313061,103.911928
425706,1,1,2,1.312995,103.911633
425707,4,2,6,1.31303,103.911759
425710,143,4,147,1.313122,103.912258
425711,400,0,400,1.313147,103.912037
425712,8,0,8,1.313147,103.912037
425713,0,1,1,1.312887,103.911104
425714,1,1,2,1.313063,103.911881
425716,1,0,1,1.313109,103.912166
425718,4,68,72,1.313179,103.912192
425719,6,21,27,1.313211,103.912347
425720,16,0,16,1.313185,103.912449
425723,20,36,56,1.313219,103.91261
425724,3,1,4,1.313313,103.912755
425725,3,0,3,1.312976,103.911504
425727,1,0,1,1.313164,103.912097
425732,3,28,31,1.313279,103.913389
425734,68,121,189,1.313383,103.91295
425735,19,2,21,1.313073,103.913463
425736,33,0,33,1.313037,103.913482
425737,2,10,12,1.313368,103.912926
425738,5,3,8,1.313107,103.913536
425739,2,1,3,1.313258,103.912858
425740,2,0,2,1.313164,103.912097
425741,74,2,76,1.313209,103.913492
425743,41,119,160,1.3133,103.913475
425744,0,10,10,1.313618,103.912985
425745,4,0,4,1.313652,103.912974
425746,335,41,376,1.313443,103.91371
425747,102,0,102,1.313692,103.912939
425748,0,2,2,1.31352,103.913002
425749,2,1,3,1.313008,103.91357
425750,2,4,6,1.313482,103.913929
425751,0,1,1,1.313259,103.912895
425752,0,5,5,1.313472,103.913863
425754,0,1,1,1.3135,103.914051
425757,0,20,20,1.313584,103.914322
425758,70,7,77,1.313669,103.913048
425759,0,25,25,1.313599,103.914379
425760,458,28,486,1.313595,103.913569
425761,1,20,21,1.313606,103.914412
425762,265,29,294,1.313623,103.914127
425763,4,9,13,1.313625,103.914516
425764,6,8,14,1.313619,103.914558
425766,282,88,370,1.313719,103.914463
425767,101,0,101,1.313664,103.914722
425769,566,150,716,1.313667,103.914765
425770,164,12,176,1.31379,103.91472
425771,4,2,6,1.313681,103.91486
425772,6,11,17,1.313718,103.915017
425774,218,8,226,1.313819,103.914921
425775,6,6,12,1.313756,103.915257
425776,1,24,25,1.313775,103.915315
425777,869,196,1065,1.313839,103.915161
425778,35,28,63,1.313096,103.911805
425779,5,1,6,1.313264,103.91256
425780,289,3,292,1.312699,103.910133
425781,672,2,674,1.31235,103.90834
425785,0,4,4,1.299509,103.837
425786,0,29,29,1.299509,103.837
425787,0,3,3,1.3135,103.914051
425788,2,15,17,1.299509,103.837
425790,54,0,54,1.299509,103.837
425792,2,0,2,1.313557,103.914264
425793,2,130,132,1.313229,103.907201
425794,6,2,8,1.313237,103.907277
425795,3,51,54,1.313021,103.907485
425796,20,121,141,1.312831,103.907566
425797,5,4,9,1.312863,103.907633
425799,6,4,10,1.313209,103.907487
425800,7,26,33,1.313313,103.90778
425801,18,0,18,1.313339,103.907879
425802,1,1,2,1.313288,103.907197
425805,2,1,3,1.299509,103.837
425806,6,0,6,1.313388,103.907648
425807,6,0,6,1.313406,103.907728
425808,7,0,7,1.313421,103.907867
425809,11,0,11,1.313433,103.907893
425810,2,0,2,1.313352,103.907954
425811,2,0,2,1.313391,103.908078
425812,37,1,38,1.313433,103.908217
425813,2,19,21,1.313645,103.908278
425814,111,0,111,1.31348,103.908109
425815,32,0,32,1.313432,103.908294
425816,1,0,1,1.313542,103.914217
425817,1,0,1,1.313487,103.908074
425818,99,0,99,1.313468,103.908023
425819,1,0,1,1.31347,103.908055
425820,1,0,1,1.313481,103.908092
425821,1,0,1,1.313871,103.908155
425822,1,4,5,1.313991,103.908177
425824,6,0,6,1.313913,103.908272
425825,5,5,10,1.313876,103.908289
425826,1,0,1,1.313454,103.908002
425827,2,0,2,1.31341,103.908143
425828,60,0,60,1.313554,103.908547
425829,3,0,3,1.313377,103.908013
425830,1,0,1,1.313496,103.908563
425831,2,26,28,1.313754,103.90833
425832,34,0,34,1.313562,103.908577
425833,3,0,3,1.31351,103.908622
425834,0,6,6,1.313469,103.908837
425835,2,2,4,1.313565,103.908615
425836,27,7,34,1.313602,103.908646
425837,7,1,8,1.313484,103.908868
425838,10,0,10,1.31335,103.908924
425839,1,0,1,1.313524,103.908688
425840,1,0,1,1.31326,103.908945
425841,54,1,55,1.313561,103.908923
425842,2,3,5,1.313394,103.908958
425844,6,0,6,1.313269,103.909016
425845,31,0,31,1.313206,103.909047
425847,15,8,23,1.313606,103.909021
425848,4,1,5,1.313627,103.908781
425850,2,0,2,1.313819,103.908307
425852,15,9,24,1.313843,103.908944
425853,15,3,18,1.313802,103.908995
425854,16,0,16,1.313631,103.908823
425855,6,7,13,1.313671,103.908868
425856,37,0,37,1.314053,103.908847
425857,115,4,119,1.31413,103.90882
425859,2,7,9,1.313776,103.909099
425860,122,1,123,1.313662,103.909315
425861,7,5,12,1.314076,103.908954
425862,2,1,3,1.313403,103.908887
425863,49,3,52,1.313756,103.909439
425864,1,5,6,1.313607,103.909482
425865,8,0,8,1.313486,103.90955
425866,4,0,4,1.313413,103.909579
425867,10,14,24,1.313368,103.909619
425868,1,0,1,1.313226,103.908974
425869,38,2,40,1.313781,103.909491
425870,0,3,3,1.313676,103.909393
425871,1,1,2,1.313633,103.908851
425872,5,2,7,1.313792,103.909629
425873,24,0,24,1.31374,103.909709
425874,8,1,9,1.313808,103.909702
425875,6,79,85,1.313763,103.909845
425876,0,6,6,1.31382,103.909759
425878,3,99,102,1.299509,103.837
425879,1,8,9,1.313889,103.910444
425880,1,1,2,1.31379,103.909574
425881,3,0,3,1.313722,103.909627
425882,93,10,103,1.313843,103.909888
425883,2,7,9,1.313949,103.910762
425885,1,5,6,1.313962,103.91082
425886,5,0,5,1.313972,103.91076
425887,1,0,1,1.313307,103.909649
425888,1,0,1,1.313977,103.910773
425889,1,0,1,1.313982,103.910786
425890,1,1,2,1.313897,103.910493
425891,8,2,10,1.313424,103.911214
425892,3,232,235,1.313861,103.90993
425893,0,5,5,1.313949,103.910995
425895,3,0,3,1.313916,103.910552
425896,2,0,2,1.313996,103.910823
425897,4,0,4,1.313758,103.911058
425898,0,1,1,1.313992,103.910804
425901,7,1,8,1.313398,103.911187
425902,0,2,2,1.313779,103.911053
425903,0,3,3,1.31385,103.911031
425904,2,0,2,1.314072,103.911367
425906,3,1,4,1.313876,103.911486
425907,1,0,1,1.313676,103.911073
425908,3,1,4,1.313741,103.91154
425909,2,1,3,1.314087,103.9114
425910,0,3,3,1.313717,103.911547
425912,1,0,1,1.314021,103.911412
425914,42,4,46,1.313817,103.911617
425915,36,0,36,1.31378,103.911618
425916,26,0,26,1.313751,103.91163
425918,1,3,4,1.314148,103.912001
425919,126,3,129,1.314115,103.912028
425920,5,0,5,1.314055,103.91206
425922,1,0,1,1.313949,103.91157
425923,92,1,93,1.313904,103.912097
425924,38,15,53,1.313882,103.912112
425926,1,9,10,1.314358,103.912115
425927,58,2,60,1.313761,103.912143
425929,4,1,5,1.314868,103.911932
425930,2,9,11,1.314022,103.912156
425931,1,0,1,1.313958,103.912075
425933,3,0,3,1.314108,103.911507
425934,1,1,2,1.314028,103.911455
425935,3,10,13,1.314421,103.912437
425936,4,0,4,1.314455,103.91248
425938,2,0,2,1.314111,103.91212
425939,16,9,25,1.314495,103.91269
425940,30,16,46,1.314321,103.912632
425941,0,1,1,1.313992,103.912161
425942,15,4,19,1.314203,103.912712
425943,2,0,2,1.31458,103.912558
425944,3,5,8,1.31407,103.912782
425945,5,0,5,1.314558,103.91303
425946,28,3,31,1.31452,103.91311
425947,2,0,2,1.31456,103.912972
425948,27,3,30,1.314564,103.913096
425949,2,2,4,1.314582,103.913182
425950,10,4,14,1.314602,103.91326
425952,1,0,1,1.314551,103.912892
425955,4,14,18,1.314698,103.913538
425956,6,30,36,1.314689,103.913559
425957,11,0,11,1.314712,103.913647
425958,2,0,2,1.31457,103.913047
425959,2,2,4,1.314729,103.913703
425960,1,0,1,1.314647,103.913429
425962,3,9,12,1.314662,103.913773
425964,1,0,1,1.314359,103.913824
425965,2,0,2,1.314284,103.913815
425966,18,0,18,1.314706,103.914012
425967,4,7,11,1.314719,103.914077
425968,67,0,67,1.31473,103.914157
425969,4,0,4,1.31475,103.913867
425970,3,8,11,1.314761,103.913919
425971,54,0,54,1.314781,103.914359
425972,136,0,136,1.314821,103.914645
425975,0,1,1,1.314681,103.913872
425976,1,0,1,1.313657,103.911611
425977,3,0,3,1.314482,103.912608
425978,22,16,38,1.313457,103.909619
425979,4,0,4,1.313527,103.909597
425980,6,0,6,1.314406,103.913798
425981,4,0,4,1.313769,103.91222
425982,78,0,78,1.313856,103.909065
425985,23,25,48,1.313995,103.910591
425986,2,10,12,1.313452,103.90838
425987,46,0,46,1.313447,103.908335
425988,11,1,12,1.314626,103.91337
425989,3,5,8,1.315319,103.906359
425990,7,218,225,1.315358,103.906129
425991,248,44,292,1.315317,103.906341
425992,72,15,87,1.315361,103.906202
425993,182,0,182,1.314846,103.906644
425994,1,5,6,1.31538,103.906274
425995,2,94,96,1.315399,103.906359
425996,1,0,1,1.313657,103.911611
425997,23,26,49,1.315353,103.906458
425998,4,0,4,1.315377,103.906632
425999,18,6,24,1.315435,103.906495
426000,8,1,9,1.31541,103.906745
426001,54,14,68,1.315454,103.906595
426002,4,0,4,1.315427,103.906837
426003,2,0,2,1.314698,103.91395
426005,11,2,13,1.315437,103.906906
426006,1,1,2,1.315466,103.906656
426008,5,0,5,1.315239,103.907301
426009,103,0,103,1.315572,103.907006
426011,2,28,30,1.315467,103.907028
426013,31,1,32,1.315297,103.907292
426014,2,0,2,1.315528,103.906896
426016,0,4,4,1.315172,103.907353
426017,20,0,20,1.315564,103.907069
426018,13,18,31,1.315261,103.907402
426019,7,0,7,1.315166,103.907448
426020,70,1,71,1.315587,103.908228
426021,0,24,24,1.315677,103.907607
426022,9,0,9,1.315605,103.907727
426024,0,35,35,1.315638,103.907894
426025,183,0,183,1.315534,103.908203
426026,23,6,29,1.315713,103.90784
426027,6,43,49,1.315693,103.908206
426028,0,3,3,1.313328,103.909684
426030,1,1,2,1.315269,103.907297
426031,0,2,2,1.315516,103.908246
426032,94,3,97,1.315358,103.908313
426033,1,0,1,1.315412,103.90643
426034,2,0,2,1.315462,103.908226
426035,0,93,93,1.31564,103.9083
426036,11,1,12,1.315606,103.908317
426037,0,2,2,1.31573,103.907917
426038,1,1,2,1.315496,103.908362
426039,9,1,10,1.315429,103.90845
426040,0,1,1,1.315332,103.908332
426041,2,2,4,1.315312,103.908453
426042,43,0,43,1.315754,103.90801
426043,2,0,2,1.315434,103.908403
426044,1,0,1,1.315371,103.908447
426045,173,0,173,1.315839,103.908334
426048,3,16,19,1.315774,103.908487
426049,38,20,58,1.315824,103.908705
426050,0,10,10,1.315825,103.908767
426051,6,13,19,1.315877,103.908922
426052,56,25,81,1.315887,103.908662
426053,1,16,17,1.316061,103.909931
426054,1,21,22,1.316002,103.909708
426055,12,460,472,1.316047,103.90945
426056,54,0,54,1.316064,103.909502
426058,2,19,21,1.316098,103.910072
426059,13,1,14,1.316086,103.910027
426061,33,0,33,1.316112,103.909644
426062,1,4,5,1.316111,103.909677
426063,0,2,2,1.315768,103.908097
426064,5,2,7,1.316128,103.910189
426065,83,9,92,1.316175,103.909934
426066,6,7,13,1.316145,103.910269
426067,12,3,15,1.316156,103.910344
426068,179,7,186,1.316197,103.910054
426069,0,3,3,1.315565,103.908229
426070,3,1,4,1.316184,103.910487
426071,5,0,5,1.316265,103.910358
426073,10,5,15,1.316215,103.910631
426074,1,0,1,1.315815,103.908298
426075,1,1,2,1.316111,103.910138
426076,2,0,2,1.316242,103.910714
426077,7,0,7,1.316264,103.910819
426078,33,0,33,1.316331,103.91068
426079,0,9,9,1.31633,103.910758
426080,2,0,2,1.316347,103.910635
426081,2,0,2,1.31629,103.911023
426082,24,0,24,1.316433,103.911011
426083,2,7,9,1.316314,103.911154
426084,60,0,60,1.316433,103.911166
426085,1,10,11,1.316334,103.911263
426086,7,0,7,1.316352,103.911342
426087,2,0,2,1.31639,103.910959
426088,1,4,5,1.316393,103.911489
426090,3,1,4,1.316457,103.911269
426091,63,0,63,1.316414,103.911628
426092,14,0,14,1.316481,103.911365
426093,22,11,33,1.316443,103.911708
426094,9,0,9,1.316529,103.911565
426095,0,19,19,1.316455,103.911755
426096,0,1,1,1.316309,103.910583
426097,4,2,6,1.316472,103.911823
426098,0,5,5,1.31649,103.911871
426099,1,6,7,1.316495,103.911911
426100,80,3,83,1.316542,103.911645
426101,92,19,111,1.316506,103.911954
426102,182,5,187,1.316576,103.911871
426103,3,17,20,1.316518,103.912013
426104,14,9,23,1.316607,103.912015
426105,10,23,33,1.31642,103.912175
426106,12,6,18,1.31664,103.912089
426107,2,0,2,1.316367,103.911395
426108,0,9,9,1.316528,103.912039
426109,0,3,3,1.316174,103.910445
426110,1,0,1,1.316559,103.91174
426112,10,10,20,1.316556,103.912205
426114,17,0,17,1.316728,103.912435
426115,2,2,4,1.316737,103.912494
426116,0,48,48,1.316606,103.912464
426117,129,48,177,1.316781,103.912701
426118,231,0,231,1.31674,103.912626
426119,10,2,12,1.316616,103.912522
426120,6,0,6,1.316819,103.91284
426121,125,3,128,1.316823,103.912897
426122,2,0,2,1.31665,103.91212
426123,9,0,9,1.316709,103.9129
426124,3,30,33,1.316876,103.913029
426125,19,1,20,1.316726,103.912966
426126,20,1,21,1.316843,103.91306
426127,5,0,5,1.316726,103.913077
426128,5,3,8,1.316752,103.913191
426129,30,12,42,1.316883,103.913101
426130,6,0,6,1.316876,103.91323
426131,3,2,5,1.316777,103.913297
426132,3,3,6,1.316924,103.913363
426133,1,0,1,1.316676,103.9122
426134,10,0,10,1.316783,103.913384
426135,1,1,2,1.316832,103.912941
426136,19,0,19,1.31696,103.913511
426137,3,0,3,1.316539,103.912106
426138,6,0,6,1.31705,103.913702
426139,3,19,22,1.316803,103.913459
426140,199,116,315,1.317022,103.913828
426141,0,7,7,1.316854,103.913647
426143,1,1,2,1.316951,103.913473
426144,6,4,10,1.316887,103.91374
426145,5,10,15,1.317021,103.913929
426146,868,20,888,1.316916,103.913847
426147,40,6,46,1.317042,103.914
426148,0,360,360,1.315878,103.909009
426149,7,5,12,1.316262,103.910774
426150,0,1,1,1.31694,103.913402
426151,73,12,85,1.315353,103.906458
426152,0,36,36,1.316628,103.912596
426153,2,14,16,1.316659,103.912742
426154,176,33,209,1.315895,103.908725
426155,94,211,305,1.31591,103.908794
426156,2,0,2,1.316994,103.913784
426162,6,6,12,1.316243,103.905787
426163,8,8,16,1.316273,103.905907
426164,16,203,219,1.316188,103.905823
426165,15,13,28,1.316281,103.906008
426166,6,39,45,1.316197,103.905933
426167,1,0,1,1.315056,103.907453
426168,47,9,56,1.316319,103.906192
426169,11,0,11,1.316215,103.906011
426170,3,3,6,1.31624,103.906114
426171,1,7,8,1.316347,103.906268
426173,1,0,1,1.316299,103.906083
426175,2,2,4,1.316256,103.906211
426176,6,0,6,1.316385,103.906486
426177,2,1,3,1.317003,103.913628
426178,4,0,4,1.316306,103.906423
426180,0,4,4,1.316331,103.906772
426182,0,1,1,1.31636,103.906353
426183,17,0,17,1.316173,103.906831
426184,18,0,18,1.31613,103.906862
426187,38,1,39,1.316117,103.906948
426188,4,26,30,1.316531,103.907246
426189,7,0,7,1.316428,103.907019
426190,11,0,11,1.316587,103.907428
426191,0,5,5,1.31644,103.907056
426194,117,55,172,1.316682,103.907944
426195,33,0,33,1.316472,103.907189
426197,18,0,18,1.316518,103.907393
426198,3,0,3,1.316421,103.906651
426199,3,4,7,1.316705,103.908049
426200,0,4,4,1.31654,103.907489
426201,0,1,1,1.316199,103.90682
426203,5,0,5,1.316546,103.907522
426204,10,1,11,1.316817,103.908466
426205,15,6,21,1.316588,103.907713
426206,21,30,51,1.316604,103.907788
426207,2,0,2,1.299509,103.837
426209,0,1,1,1.316746,103.908237
426211,0,125,125,1.316859,103.908707
426212,1,2,3,1.316514,103.907362
426214,3,3,6,1.31671,103.908295
426215,6,3,9,1.316741,103.908421
426217,47,0,47,1.31696,103.909172
426219,0,3,3,1.316679,103.908125
426220,1,275,276,1.316774,103.908596
426221,77,0,77,1.316993,103.909304
426222,4,6,10,1.317004,103.90938
426223,72,1,73,1.316965,103.909559
426224,248,50,298,1.317138,103.909652
426225,462,5,467,1.317046,103.909629
426231,303,0,303,1.317006,103.909684
426232,7,26,33,1.317077,103.909757
426233,11,1,12,1.317021,103.909844
426234,3,64,67,1.317082,103.909788
426235,144,7,151,1.317047,103.909919
426236,8,1,9,1.317192,103.910247
426237,103,0,103,1.317078,103.91007
426238,22,61,83,1.317214,103.910328
426239,4,2,6,1.317081,103.910127
426240,3,1,4,1.317106,103.910241
426241,4,59,63,1.317242,103.910407
426242,7,0,7,1.317146,103.910379
426243,0,25,25,1.317178,103.91054
426244,148,117,265,1.317256,103.910468
426245,0,1,1,1.316845,103.908653
426246,0,40,40,1.317213,103.910685
426247,5,12,17,1.31723,103.910747
426248,283,1,284,1.317308,103.91108
426258,378,2,380,1.317335,103.911188
426259,15,0,15,1.317468,103.911287
426260,0,1,1,1.317185,103.910616
426261,1,13,14,1.317503,103.911457
426262,4,12,16,1.317367,103.911341
426263,2,12,14,1.317516,103.911542
426264,1,0,1,1.317484,103.91138
426265,11,1,12,1.317395,103.911482
426266,3,4,7,1.317528,103.911578
426268,1,0,1,1.31738,103.911402
426269,4,21,25,1.317533,103.911635
426270,3,0,3,1.316767,103.908569
426271,27,0,27,1.317647,103.912173
426273,7,2,9,1.31766,103.912251
426274,5,0,5,1.317531,103.912155
426275,0,3,3,1.317458,103.911716
426276,3,6,9,1.317715,103.912415
426277,35,5,40,1.317685,103.912377
426278,49,18,67,1.318425,103.912229
426279,9,31,40,1.317573,103.912361
426282,84,2,86,1.31773,103.912628
426283,267,36,303,1.317625,103.912548
426284,2,9,11,1.317605,103.912508
426286,0,1,1,1.317436,103.911619
426289,2,0,2,1.31684,103.908588
426290,1,0,1,1.317626,103.912699
426291,3,4,7,1.317661,103.912771
426292,0,18,18,1.317904,103.913154
426293,0,1,1,1.316847,103.912988
426294,1,0,1,1.317944,103.913149
426295,0,1,1,1.318018,103.913128
426296,2,0,2,1.317726,103.912741
426297,1,2,3,1.317682,103.912327
426300,5,1,6,1.318156,103.91308
426301,32,5,37,1.318196,103.913073
426302,3,0,3,1.317696,103.912958
426303,1,2,3,1.318227,103.913068
426304,2,0,2,1.317694,103.912892
426305,82,6,88,1.318228,103.913134
426306,1,8,9,1.318157,103.91317
426307,1,0,1,1.318088,103.913095
426309,15,4,19,1.318037,103.913196
426310,4,0,4,1.317764,103.913346
426311,8,2,10,1.317995,103.913213
426312,34,120,154,1.317882,103.913381
426313,211,0,211,1.31783,103.913537
426314,5,2,7,1.299509,103.837
426315,36,0,36,1.317884,103.91362
426316,33,9,42,1.299509,103.837
426317,110,4,114,1.317941,103.91357
426318,32,0,32,1.317568,103.912316
426319,1,55,56,1.316947,103.909104
426320,2,1,3,1.318256,103.913056
426321,0,28,28,1.316625,103.907613
426322,6,0,6,1.316589,103.907476
426323,655,114,769,1.31737,103.910952
426324,18,30,48,1.317087,103.909836
426325,4,1,5,1.316723,103.90815
426327,99,19,118,1.317284,103.910641
426332,2,310,312,1.314322,103.909835
426333,1,1,2,1.317721,103.913191
426336,0,1,1,1.31775,103.913283
426337,1,3,4,1.314218,103.909511
426338,1,0,1,1.314229,103.909551
426339,0,5,5,1.314193,103.909442
426340,3,16,19,1.314169,103.909314
426341,288,5,293,1.314209,103.909251
426342,8,2,10,1.314261,103.909421
426356,9,310,319,1.318273,103.909614
426357,20,26,46,1.318013,103.909587
426359,6,2,8,1.318058,103.909607
426360,0,2,2,1.314288,103.909764
426361,0,4,4,1.317955,103.909657
426362,1,3,4,1.318105,103.909676
426364,2,3,5,1.31806,103.909691
426365,1,5,6,1.317857,103.90968
426366,1,0,1,1.314209,103.909458
426367,0,1,1,1.318027,103.909729
426368,3,1,4,1.317733,103.909748
426369,4,4,8,1.317645,103.909779
426370,1,3,4,1.317872,103.909787
426371,22,1,23,1.317605,103.909788
426372,34,2,36,1.317644,103.909908
426373,2,2,4,1.317531,103.909835
426374,2,4,6,1.317441,103.909972
426375,8,0,8,1.317463,103.909865
426376,0,4,4,1.317565,103.909956
426377,6,2,8,1.317537,103.91012
426390,18,25,43,1.317089,103.904514
426391,55,16,71,1.317026,103.90441
426392,0,6,6,1.316946,103.904448
426393,1,8,9,1.316872,103.904444
426394,1,21,22,1.31702,103.904533
426395,1,6,7,1.316757,103.904484
426396,0,2,2,1.318132,103.909669
426397,0,7,7,1.316864,103.90456
426398,5,1,6,1.316698,103.904473
426399,17,1,18,1.316645,103.904497
426400,6,12,18,1.316611,103.90461
426401,6,3,9,1.316543,103.904624
426402,27,8,35,1.31651,103.904626
426403,3,6,9,1.316475,103.904635
426404,0,5,5,1.316362,103.904668
426405,2,1,3,1.316974,103.909123
426406,0,11,11,1.316124,103.904703
426407,0,33,33,1.316057,103.904716
426408,0,9,9,1.316265,103.904567
426409,2,29,31,1.316005,103.904718
426410,0,7,7,1.316183,103.904587
426411,59,238,297,1.315946,103.904729
426412,1,3,4,1.316128,103.904595
426413,0,1,1,1.317908,103.909764
426414,68,10,78,1.316747,103.904571
426415,8,40,48,1.316747,103.904571
426428,0,1,1,1.316069,103.90459
426430,0,30,30,1.316865,103.903932
426431,11,3,14,1.316648,103.903978
426432,47,4,51,1.3166,103.903979
426433,1,6,7,1.316532,103.904003
426434,11,18,29,1.316498,103.904013
426435,2,9,11,1.316363,103.904038
426436,0,13,13,1.316219,103.904066
426437,0,1,1,1.316986,103.903905
426439,0,1,1,1.316657,103.903861
426442,20,0,20,1.316027,103.904091
426443,4,4,8,1.316479,103.903925
426446,36,0,36,1.316265,103.903924
426447,0,19,19,1.316147,103.903962
426448,36,1,37,1.316086,103.903954
426449,1,4,5,1.316031,103.903962
426451,3,1,4,1.315901,103.903988
426466,2,18,20,1.31658,103.903329
426467,7,4,11,1.316548,103.903342
426468,0,4,4,1.316548,103.90325
426469,0,5,5,1.316513,103.903344
426470,0,4,4,1.316372,103.90338
426471,3,0,3,1.316389,103.904543
426474,1,0,1,1.316604,103.903868
426477,0,1,1,1.31636,103.90329
426478,1,0,1,1.316167,103.903418
426479,1,32,33,1.316128,103.903478
426480,0,4,4,1.315846,103.903362
426482,1,1,2,1.31694,103.904525
426483,4,0,4,1.315881,103.903462
426484,0,2,2,1.315784,103.90338
426485,95,1,96,1.315854,103.903464
426487,2,0,2,1.315639,103.903394
426488,0,2,2,1.315812,103.903529
426489,6,0,6,1.316055,103.903328
426490,7,0,7,1.315975,103.903349
426502,6,0,6,1.31675,103.902676
426503,11,1,12,1.316685,103.90269
426504,0,2,2,1.316192,103.903307
426505,9,1,10,1.316584,103.902716
426506,0,1,1,1.316012,103.903335
426507,0,1,1,1.316421,103.902749
426508,1,0,1,1.316325,103.902759
426509,0,4,4,1.316427,103.902624
426510,10,3,13,1.316127,103.90277
426511,0,2,2,1.316652,103.902701
426512,11,8,19,1.316328,103.902644
426513,0,1,1,1.31618,103.902774
426515,0,1,1,1.316267,103.902662
426516,5,0,5,1.316092,103.902728
426517,14,15,29,1.31605,103.902738
426518,3,0,3,1.316453,103.903263
426520,21,4,25,1.315849,103.902763
426521,0,8,8,1.315812,103.902777
426522,2,1,3,1.316023,103.902721
426523,8,0,8,1.315743,103.902858
426524,1,0,1,1.315927,103.90276
426525,2,0,2,1.316388,103.902644
426526,21,0,21,1.31569,103.902791
426527,1,1,2,1.315778,103.902867
426528,14,1,15,1.315648,103.902798
426529,1,0,1,1.315726,103.902789
426530,9,14,23,1.315412,103.902786
426531,0,4,4,1.315587,103.902882
426532,2,1,3,1.315761,103.902782
426533,42,1,43,1.315607,103.902888
426534,18,3,21,1.315548,103.902902
426535,2,13,15,1.315456,103.90289
426536,310,31,341,1.315942,103.902813
426550,2,10,12,1.316608,103.901967
426551,7,6,13,1.316564,103.901981
426552,2,14,16,1.316509,103.901991
426553,1,17,18,1.316319,103.902099
426556,5,6,11,1.316278,103.902109
426558,8,1,9,1.316034,103.902054
426559,4,2,6,1.316172,103.902159
426560,2,0,2,1.315897,103.902828
426561,112,5,117,1.316153,103.90214
426562,1,4,5,1.315917,103.902083
426563,3,2,5,1.316092,103.902157
426564,25,1,26,1.31587,103.902092
426566,333,9,342,1.315779,103.902086
426567,2,1,3,1.315656,103.90287
426568,1,0,1,1.315706,103.902891
426569,2,14,16,1.315931,103.902193
426570,6,6,12,1.315722,103.902136
426571,13,41,54,1.315859,103.902182
426572,7,0,7,1.315608,103.902147
426574,8,10,18,1.315524,103.90218
426575,1,0,1,1.315673,103.902136
426577,2,8,10,1.315739,103.902207
426579,4,12,16,1.315711,103.902211
426580,0,18,18,1.315369,103.902179
426581,6,32,38,1.315614,103.90223
426582,1,1,2,1.315949,103.90206
426583,0,3,3,1.31597,103.902181
426585,0,14,14,1.315324,103.902487
426586,1,2,3,1.31547,103.902269
426600,0,1,1,1.315761,103.902199
426601,1,14,15,1.316032,103.900908
426602,4,12,16,1.315998,103.900933
426603,20,13,33,1.316031,103.900753
426604,12,8,20,1.315914,103.90094
426605,0,50,50,1.315842,103.90094
426606,0,6,6,1.315657,103.900992
426607,0,15,15,1.315579,103.900999
426608,181,1,182,1.315682,103.900868
426609,15,12,27,1.315717,103.900863
426610,2,0,2,1.315552,103.902251
426611,2,0,2,1.315696,103.900866
426614,1,1,2,1.315637,103.900884
426615,1,1,2,1.315587,103.900878
426616,0,6,6,1.315413,103.901018
426617,3,2,5,1.315511,103.900899
426618,0,2,2,1.315491,103.901011
426619,4,2,6,1.315454,103.900915
426620,1,4,5,1.315262,103.901043
426621,2,0,2,1.315358,103.901037
426623,2,0,2,1.315408,103.900928
426624,1,0,1,1.316125,103.9009
426626,67,7,74,1.315224,103.900963
426641,253,76,329,1.315603,103.900081
426642,13,54,67,1.315295,103.899693
426643,10,265,275,1.315269,103.899615
426644,0,6,6,1.315273,103.899546
426645,2,12,14,1.315249,103.899494
426646,1,8,9,1.31524,103.899426
426647,0,9,9,1.315235,103.899391
426648,0,1,1,1.315339,103.90093
426649,1,9,10,1.315235,103.899835
426650,0,6,6,1.315159,103.899844
426651,0,8,8,1.315121,103.899851
426652,0,5,5,1.31509,103.899902
426653,1,12,13,1.315021,103.899867
426654,0,19,19,1.314953,103.900028
426655,0,16,16,1.315218,103.899302
426656,0,53,53,1.315216,103.89928
426657,207,71,278,1.315019,103.899781
426658,0,22,22,1.314803,103.89982
426659,0,5,5,1.314657,103.899843
426660,1,12,13,1.314612,103.89984
426662,2,4,6,1.31456,103.899851
426666,0,5,5,1.314519,103.89995
426667,17,3,20,1.314519,103.89995
426668,1,6,7,1.314591,103.899906
426669,58,6,64,1.314519,103.89995
426670,0,7,7,1.314519,103.89995
426671,5,117,122,1.314441,103.899929
426686,0,17,17,1.314994,103.900421
426689,1,0,1,1.31527,103.899832
426690,19,1,20,1.314875,103.900266
426691,197,17,214,1.314956,103.900299
426692,0,1,1,1.314944,103.900269
426693,3,0,3,1.316211,103.902161
426698,0,3,3,1.314983,103.900665
426700,1,7,8,1.314919,103.900581
426701,6,0,6,1.314974,103.900558
426702,12,0,12,1.314922,103.90061
426706,0,9,9,1.315082,103.901217
426707,2,0,2,1.315312,103.900944
426708,0,6,6,1.314958,103.900807
426709,2,0,2,1.315085,103.901277
426711,0,1,1,1.314878,103.900314
426712,0,6,6,1.31497,103.900897
426715,1,0,1,1.315135,103.901339
426717,2,1,3,1.314907,103.900517
426718,2,8,10,1.315003,103.901072
426719,8,33,41,1.315146,103.901533
426721,1,2,3,1.315123,103.901477
426722,0,1,1,1.315111,103.901423
426723,0,1,1,1.315021,103.901215
426724,2,15,17,1.315061,103.901828
426726,0,2,2,1.31509,103.901324
426727,6,2,8,1.315148,103.902057
426729,0,1,1,1.315039,103.901314
426730,4,2,6,1.315172,103.902246
426731,49,9,58,1.3152,103.9023
426733,1,0,1,1.315171,103.902198
426735,2,0,2,1.315068,103.90192
426737,1,1,2,1.315227,103.902465
426738,1,2,3,1.315008,103.901171
426739,1,0,1,1.315212,103.902389
426740,12,0,12,1.315248,103.903053
426742,22,0,22,1.315411,103.903277
426743,1,0,1,1.315184,103.902901
426744,13,2,15,1.315323,103.90351
426745,0,3,3,1.315265,103.902642
426747,0,16,16,1.31557,103.903608
426748,0,2,2,1.315246,103.902538
426749,1,0,1,1.315432,103.903414
426751,1,1,2,1.315387,103.903735
426752,11,4,15,1.315616,103.903828
426753,0,4,4,1.315424,103.90392
426754,0,2,2,1.315612,103.903726
426756,14,0,14,1.315638,103.903946
426757,1,13,14,1.315647,103.904016
426759,7,1,8,1.315659,103.904238
426760,0,1,1,1.315579,103.903688
426761,1,7,8,1.315705,103.904274
426762,2,1,3,1.315476,103.90363
426763,1,0,1,1.315581,103.904156
426764,0,1,1,1.315699,103.904344
426765,3,1,4,1.315706,103.904387
426766,1,0,1,1.315607,103.904339
426767,2,2,4,1.315701,103.904428
426768,7,0,7,1.315623,103.904406
426769,2,1,3,1.315587,103.904223
426770,1,0,1,1.315625,103.904371
426771,0,12,12,1.315764,103.904608
426772,3,18,21,1.315818,103.904877
426773,1,4,5,1.315825,103.905026
426774,0,56,56,1.315825,103.905026
426775,21,399,420,1.315862,103.905196
426776,1,3,4,1.315617,103.904551
426778,7,0,7,1.315638,103.90454
426780,2,0,2,1.315629,103.903895
426781,0,7,7,1.315701,103.904779
426782,6,12,18,1.315707,103.904849
426784,41,0,41,1.315754,103.904967
426785,1,22,23,1.315763,103.905053
426786,2,0,2,1.315621,103.904496
426787,14,1,15,1.315793,103.905192
426788,4,1,5,1.3158,103.905221
426790,16,0,16,1.314828,103.900072
426791,4,25,29,1.314834,103.900018
426794,18,1,19,1.31581,103.904948
426796,0,1,1,1.31575,103.904556
426797,0,2,2,1.315763,103.905104
426798,3,6,9,1.299509,103.837
426803,5,17,22,1.31171,103.915609
426804,0,1,1,1.299509,103.837
426805,4,0,4,1.311808,103.915586
426806,7,0,7,1.311854,103.915581
426807,4,1,5,1.311899,103.915569
426808,0,1,1,1.311768,103.915598
426809,9,0,9,1.311997,103.915552
426810,1,1,2,1.299509,103.837
426811,2,0,2,1.312043,103.915541
426812,2,0,2,1.312028,103.915644
426827,3,10,13,1.311502,103.914504
426828,1,10,11,1.311532,103.914565
426830,41,0,41,1.311567,103.914557
426831,4,0,4,1.311614,103.914478
426832,86,7,93,1.311598,103.914539
426833,1,1,2,1.311969,103.915651
426834,9,1,10,1.311634,103.914525
426835,16,0,16,1.311706,103.91446
426836,29,0,29,1.311665,103.914525
426837,4,0,4,1.311751,103.914435
426838,52,1,53,1.311705,103.91452
426839,1,0,1,1.311945,103.915558
426840,30,0,30,1.311746,103.914512
426841,29,1,30,1.311815,103.914422
426842,2,0,2,1.311665,103.914469
426857,13,10,23,1.311596,103.915079
426858,4,72,76,1.311581,103.915141
426859,1,0,1,1.311786,103.914407
426860,54,0,54,1.311627,103.91513
426861,7,0,7,1.311677,103.915071
426862,4,0,4,1.311673,103.915124
426863,24,5,29,1.311717,103.915065
426866,12,0,12,1.311781,103.915113
426867,1,0,1,1.311631,103.915082
426869,14,0,14,1.311854,103.915037
426871,0,1,1,1.311808,103.915042
426872,4,0,4,1.311907,103.91509
426888,4,204,208,1.307588,103.908045
426896,1,5,6,1.307398,103.908078
426897,47,1042,1089,1.307472,103.908126
426900,0,4,4,1.307322,103.908103
426901,1,0,1,1.311894,103.915023
426902,0,1,1,1.307216,103.908303
426903,0,3,3,1.31575,103.904498
426905,37,0,37,1.307053,103.908369
426906,6,3,9,1.307086,103.908265
426907,3,7,10,1.307022,103.908389
426908,4,2,6,1.306987,103.908294
426909,37,3,40,1.306947,103.908435
426910,0,6,6,1.306827,103.908295
426911,3,1,4,1.306911,103.908469
426912,52,2,54,1.306865,103.908404
426913,51,11,62,1.306818,103.908516
426914,6,1,7,1.306738,103.908449
426915,2,3,5,1.306712,103.908627
426916,0,4,4,1.306696,103.908503
426917,5,31,36,1.306602,103.908666
426918,23,0,23,1.306585,103.908575
426919,27,0,27,1.306504,103.908732
426920,3,4,7,1.306501,103.908581
426921,7,49,56,1.306396,103.908777
426922,10,1,11,1.306348,103.908699
426923,1,3,4,1.306344,103.90885
426924,6,7,13,1.306317,103.908709
426925,2,9,11,1.306286,103.908887
426928,1,3,4,1.306196,103.908792
426929,5,0,5,1.306095,103.908974
426930,0,8,8,1.30603,103.908911
426931,0,3,3,1.30716,103.908323
426932,0,13,13,1.305987,103.908922
426934,0,5,5,1.305962,103.908957
426935,7,60,67,1.305941,103.909054
426936,0,12,12,1.305885,103.908998
426951,1,32,33,1.310076,103.90228
426952,0,1,1,1.307204,103.908167
426953,1,65,66,1.31012,103.90229
426954,5,80,85,1.310076,103.90242
426955,3,31,34,1.310106,103.902321
426957,0,38,38,1.310138,103.902349
426958,3,37,40,1.310118,103.902489
426959,24,50,74,1.310208,103.902446
426960,19,0,19,1.310165,103.902528
426961,8,0,8,1.310309,103.902519
426962,4,33,37,1.310183,103.902549
426963,0,51,51,1.310251,103.902489
426965,6,0,6,1.310351,103.902572
426966,5,27,32,1.310217,103.902599
426967,0,25,25,1.310324,103.902632
426968,61,2,63,1.310397,103.902629
426969,3,2,5,1.310421,103.902691
426970,2,6,8,1.310439,103.902727
426971,2,185,187,1.310514,103.90301
426972,30,189,219,1.310675,103.902582
426973,4,88,92,1.310168,103.903059
426974,5,0,5,1.31055,103.903075
426975,0,27,27,1.310607,103.903113
426976,0,54,54,1.310657,103.903246
426977,1,111,112,1.310638,103.903199
426980,9,1,10,1.310744,103.903331
426983,41,0,41,1.310852,103.903467
426985,2,84,86,1.310879,103.903514
426986,0,73,73,1.310923,103.903562
426988,6,53,59,1.311004,103.903665
426990,6,43,49,1.311198,103.903932
426991,0,8,8,1.311228,103.903973
426992,6,48,54,1.311203,103.903817
426993,0,9,9,1.311261,103.904025
426994,21,33,54,1.311274,103.9039
426995,1,16,17,1.311251,103.904011
426996,12,6,18,1.311376,103.903975
426997,8,0,8,1.311284,103.904057
426998,37,68,105,1.311359,103.903982
426999,0,28,28,1.311322,103.904092
427000,1,0,1,1.310052,103.902375
427001,126,5,131,1.311332,103.904155
427002,2,16,18,1.311477,103.904091
427004,2,1,3,1.306061,103.909004
427006,1,18,19,1.311537,103.904171
427007,18,0,18,1.31146,103.904174
427009,2,0,2,1.311782,103.914504
427010,5,1,6,1.311914,103.903868
427011,5,18,23,1.311516,103.904382
427012,7,15,22,1.311518,103.904446
427013,207,19,226,1.311683,103.904218
427014,113,0,113,1.311752,103.90414
427015,7,0,7,1.311812,103.904117
427016,0,9,9,1.311855,103.904071
427017,1,0,1,1.311383,103.904003
427019,13,34,47,1.311543,103.904436
427020,9,42,51,1.311657,103.904225
427021,76,0,76,1.311582,103.904455
427022,22,218,240,1.311697,103.904191
427023,5,14,19,1.311637,103.904516
427024,88,0,88,1.311697,103.904469
427026,35,21,56,1.311766,103.904677
427027,2,106,108,1.311898,103.904868
427028,235,361,596,1.311893,103.904656
427029,1,7,8,1.311917,103.904903
427030,138,0,138,1.31187,103.904712
427031,3,91,94,1.311957,103.904947
427032,81,9,90,1.312108,103.904904
427033,1,0,1,1.311906,103.90404
427034,0,86,86,1.311953,103.905077
427035,33,222,255,1.312111,103.905157
427036,5,6,11,1.312176,103.905053
427037,124,0,124,1.31208,103.905202
427039,13,1,14,1.312217,103.905184
427041,2,141,143,1.312214,103.905306
427042,2,2,4,1.312305,103.905302
427043,1,0,1,1.311981,103.905008
427044,0,4,4,1.312371,103.905384
427045,4,77,81,1.312415,103.905599
427048,1,36,37,1.312574,103.90571
427049,6,139,145,1.312731,103.90586
427051,53,1,54,1.312676,103.905795
427053,10,0,10,1.312773,103.905963
427056,3,17,20,1.312879,103.905992
427057,2,179,181,1.3128,103.906122
427058,5,4,9,1.312895,103.906122
427059,384,1,385,1.312835,103.906213
427060,323,8,331,1.312836,103.906179
427061,2,60,62,1.312881,103.90624
427062,0,30,30,1.312914,103.906288
427063,33,4,37,1.313113,103.906322
427064,0,8,8,1.312889,103.906415
427065,3,249,252,1.312943,103.906441
427066,3,72,75,1.313155,103.906368
427067,2,35,37,1.313004,103.906379
427068,0,15,15,1.312939,103.906342
427069,0,25,25,1.313043,103.906444
427070,4,312,316,1.313066,103.906466
427071,16,7,23,1.312992,103.906238
427072,350,81,431,1.311559,103.902621
427085,0,55,55,1.307871,103.909622
427086,0,2,2,1.311428,103.904098
427090,13,5,18,1.307937,103.909457
427092,4,0,4,1.307863,103.909485
427093,4,4,8,1.307962,103.909959
427094,0,10,10,1.307832,103.909501
427096,0,1,1,1.312263,103.905478
427097,0,6,6,1.307772,103.909525
427098,1,0,1,1.307791,103.909524
427099,32,2,34,1.307694,103.909555
427100,1,0,1,1.307982,103.910043
427102,1,0,1,1.307989,103.910058
427103,130,3,133,1.307596,103.909597
427104,2,12,14,1.307542,103.909608
427119,8,0,8,1.314914,103.911812
427120,1,1,2,1.308021,103.909428
427121,25,0,25,1.314953,103.911957
427122,2,0,2,1.314935,103.911888
427123,23,15,38,1.31498,103.912066
427125,0,11,11,1.314996,103.912193
427126,0,2,2,1.314962,103.912032
427127,2,0,2,1.31502,103.912219
427129,7,6,13,1.315061,103.91229
427130,8,0,8,1.315059,103.912386
427131,10,4,14,1.315062,103.912433
427132,5,2,7,1.314969,103.912583
427133,2,3,5,1.315066,103.9125
427134,8,2,10,1.31501,103.912613
427135,7,14,21,1.315082,103.91255
427137,27,0,27,1.315103,103.912599
427139,13,8,21,1.31511,103.912661
427140,1,0,1,1.307649,103.909583
427141,4,3,7,1.315119,103.912753
427142,3,3,6,1.315056,103.912912
427143,33,3,36,1.315145,103.912817
427144,2,1,3,1.311504,103.904145
427145,3,2,5,1.315154,103.912883
427146,8,0,8,1.315123,103.91306
427147,0,1,1,1.315054,103.912855
427148,56,0,56,1.315184,103.913052
427150,1,6,7,1.315204,103.913136
427151,8,0,8,1.315165,103.91334
427152,2,1,3,1.315096,103.912991
427153,1,0,1,1.315167,103.912961
427154,0,2,2,1.314839,103.911846
427155,15,7,22,1.31517,103.913418
427158,4,0,4,1.315297,103.913522
427159,5,0,5,1.315206,103.913585
427160,9,6,15,1.3153,103.913573
427161,2,0,2,1.31527,103.913442
427162,2,0,2,1.315203,103.913625
427163,0,1,1,1.315165,103.913379
427164,4,3,7,1.315327,103.913656
427165,1,2,3,1.315245,103.913372
427166,6,6,12,1.3149,103.91226
427168,0,1,1,1.315232,103.913667
427169,2,0,2,1.315309,103.913615
427170,5,9,14,1.314991,103.912522
427171,7,1,8,1.31511,103.913118
427172,9,1,10,1.315139,103.913212
427180,50,81,131,1.314214,103.899535
427181,4,0,4,1.314204,103.899471
427182,1,7,8,1.314216,103.899545
427183,16,12,28,1.314224,103.899554
427184,1,10,11,1.314224,103.899596
427185,130,18,148,1.31423,103.899646
427186,12,7,19,1.314234,103.89967
427187,5,23,28,1.314247,103.899713
427188,1,1,2,1.31498,103.912409
427189,2,25,27,1.314271,103.899839
427190,184,46,230,1.314288,103.899883
427194,0,22,22,1.314388,103.900187
427195,170,11,181,1.314402,103.900242
427197,9,30,39,1.31434,103.900298
427198,9,8,17,1.31435,103.900413
427199,126,14,140,1.314408,103.900301
427200,1,2,3,1.315255,103.913732
427201,19,3,22,1.314369,103.900478
427203,3,11,14,1.314414,103.900412
427204,2,1,3,1.314411,103.900346
427205,4,1,5,1.31439,103.900615
427206,4,5,9,1.31442,103.900457
427207,2,0,2,1.314259,103.899756
427208,0,4,4,1.314428,103.900504
427209,14,4,18,1.314434,103.900558
427211,0,7,7,1.314443,103.900606
427215,119,10,129,1.314459,103.900705
427217,4,3,7,1.31447,103.900744
427219,9,1,10,1.314471,103.900792
427221,181,25,206,1.31448,103.900836
427222,4,53,57,1.314408,103.900757
427223,19,0,19,1.314485,103.900883
427224,2,0,2,1.314397,103.900656
427226,1,22,23,1.314426,103.900844
427228,3,0,3,1.31438,103.900571
427229,4,23,27,1.314503,103.900994
427230,0,9,9,1.314451,103.900946
427231,19,7,26,1.31451,103.901022
427232,0,1,1,1.314956,103.912362
427233,4,2,6,1.314514,103.901057
427234,0,1,1,1.314457,103.901002
427235,1,3,4,1.314527,103.901098
427236,12,1,13,1.314466,103.901093
427237,0,4,4,1.314477,103.901152
427238,8,1,9,1.314537,103.901151
427239,3,5,8,1.314482,103.901176
427240,22,8,30,1.314545,103.901211
427241,3,5,8,1.314485,103.901201
427243,2,2,4,1.314491,103.901237
427244,3,5,8,1.314495,103.901257
427245,0,13,13,1.31456,103.901334
427246,9,2,11,1.314499,103.901279
427247,2,8,10,1.314576,103.901402
427248,51,32,83,1.314506,103.901318
427249,4,22,26,1.314666,103.901828
427250,8,23,31,1.314674,103.901896
427251,7,0,7,1.314686,103.901953
427252,4,3,7,1.314692,103.902009
427253,178,7,185,1.314515,103.901594
427254,0,9,9,1.314699,103.902072
427255,0,5,5,1.314707,103.902125
427256,106,84,190,1.314561,103.901921
427257,2,14,16,1.31472,103.902193
427258,2,0,2,1.314416,103.900807
427259,2,0,2,1.314723,103.902262
427260,11,21,32,1.314736,103.902326
427261,3,0,3,1.314438,103.900894
427262,6,12,18,1.314749,103.902456
427264,3,0,3,1.314742,103.902388
427265,0,18,18,1.314786,103.902655
427266,0,4,4,1.314792,103.902733
427267,7,0,7,1.314641,103.902518
427268,3,6,9,1.314804,103.902788
427269,1,3,4,1.314812,103.902848
427270,0,1,1,1.314467,103.901045
427271,6,0,6,1.314828,103.902949
427272,0,4,4,1.314836,103.903012
427273,0,8,8,1.314841,103.903048
427274,1,33,34,1.314741,103.903226
427275,31,3,34,1.314849,103.903102
427276,0,1,1,1.314812,103.902904
427277,9,0,9,1.314865,103.90318
427278,10,21,31,1.314872,103.903224
427279,5,13,18,1.314895,103.903328
427281,1,6,7,1.314899,103.903417
427282,381,0,381,1.314803,103.903425
427283,2,0,2,1.314602,103.902192
427284,0,7,7,1.314939,103.90366
427285,1,10,11,1.314944,103.903751
427286,5,38,43,1.314816,103.903644
427287,1,0,1,1.314857,103.90314
427288,1,0,1,1.314964,103.903816
427289,1,0,1,1.314814,103.903672
427291,1,0,1,1.314982,103.903874
427292,6,1,7,1.314853,103.903852
427293,2,0,2,1.314919,103.903508
427294,7,1,8,1.314853,103.903852
427295,0,1,1,1.314838,103.903776
427298,11,0,11,1.314853,103.903852
427299,12,41,53,1.314989,103.903953
427300,1,6,7,1.314871,103.904031
427302,0,5,5,1.314884,103.904122
427303,225,1,226,1.314877,103.903994
427304,3,45,48,1.31502,103.904107
427305,384,1,385,1.314958,103.904441
427306,2,0,2,1.314853,103.903852
427307,7,23,30,1.314972,103.904525
427308,9,8,17,1.315054,103.904317
427309,0,15,15,1.314978,103.904601
427310,6,24,30,1.315069,103.904415
427312,0,103,103,1.315078,103.904491
427314,0,3,3,1.314773,103.902593
427315,1,95,96,1.315108,103.904688
427316,9,0,9,1.31512,103.904763
427317,538,4,542,1.315023,103.904839
427318,0,48,48,1.315125,103.90483
427320,2,30,32,1.315135,103.904897
427322,1,0,1,1.314853,103.903852
427323,19,15,34,1.315147,103.904948
427324,82,23,105,1.315053,103.904995
427325,0,21,21,1.315161,103.905014
427326,111,1,112,1.315063,103.905068
427327,0,4,4,1.315173,103.905104
427328,0,9,9,1.315075,103.90513
427329,43,0,43,1.315186,103.905145
427330,0,3,3,1.315102,103.904625
427331,0,47,47,1.315194,103.905198
427332,354,9,363,1.315096,103.905307
427333,0,1,1,1.299509,103.837
427334,131,0,131,1.315111,103.905401
427335,3,45,48,1.315198,103.905267
427336,47,5,52,1.315117,103.905454
427338,16,1339,1355,1.315155,103.905623
427339,0,63,63,1.315785,103.905249
427353,375,2140,2515,1.315714,103.897706
427357,70,1152,1222,1.315557,103.897852
427364,46,1794,1840,1.315387,103.898005
427365,23,4276,4299,1.315335,103.898051
427366,17,18446,18463,1.315361,103.898024
427367,21,12392,12413,1.315305,103.898064
427368,27,4729,4756,1.315275,103.898092
427369,2,3,5,1.315244,103.898106
427370,16,47,63,1.315227,103.898127
427371,1,40,41,1.315097,103.89821
427372,6,1026,1032,1.315206,103.898134
427373,245,2527,2772,1.315077,103.898489
427374,6,199,205,1.315046,103.898231
427375,2,120,122,1.314991,103.898286
427376,0,207,207,1.314964,103.898303
427377,4,343,347,1.314912,103.898337
427378,3,370,373,1.3117385,103.888281
427379,6,0,6,1.314508,103.898686
427380,11,1431,1442,1.31444,103.898736
427382,8,772,780,1.314402,103.898762
427383,4,23,27,1.314461,103.898726
427384,2,178,180,1.314374,103.89877
427385,12,559,571,1.314148,103.899064
427386,7,81,88,1.314326,103.898804
427387,2,147,149,1.314102,103.899091
427388,5,49,54,1.314298,103.898818
427389,6,163,169,1.314055,103.899119
427390,2,21,23,1.31427,103.898837
427391,1,137,138,1.314019,103.899147
427392,3,2,5,1.314138,103.898912
427393,1,96,97,1.313969,103.899181
427394,0,18,18,1.314211,103.898869
427395,9,259,268,1.313933,103.899208
427396,2,2,4,1.314166,103.898902
427397,2,17,19,1.314118,103.898945
427398,8,445,453,1.313872,103.899255
427399,1,105,106,1.314005,103.898993
427400,47,534,581,1.313831,103.899282
427401,103,127,230,1.31399,103.899014
427403,0,4,4,1.31389,103.899247
427407,72,120,192,1.313933,103.899077
427408,1,463,464,1.313643,103.899423
427410,6,304,310,1.313605,103.899442
427411,4,76,80,1.313858,103.89914
427412,1,141,142,1.313571,103.899465
427413,1,167,168,1.313533,103.899477
427414,3,195,198,1.313496,103.899504
427415,0,32,32,1.313457,103.899524
427416,4,0,4,1.313411,103.89956
427417,6,1753,1759,1.313354,103.899596
427420,5,22,27,1.313553,103.899314
427421,0,10,10,1.313518,103.899335
427422,0,14,14,1.313482,103.899355
427423,0,14,14,1.313417,103.899398
427424,6,23,29,1.313385,103.899427
427425,9,555,564,1.312937,103.899879
427426,2,14,16,1.313339,103.899459
427427,11,973,984,1.312893,103.899912
427428,0,1,1,1.315196,103.90523
427429,3,404,407,1.312859,103.899935
427430,18,74,92,1.313236,103.899535
427431,3,307,310,1.312822,103.899971
427432,2,103,105,1.313191,103.899567
427433,18,1151,1169,1.312779,103.900002
427434,13,1022,1035,1.313139,103.8996
427435,12,614,626,1.312747,103.900024
427436,134,1478,1612,1.312708,103.900055
427437,5,1005,1010,1.312953,103.899774
427438,7,980,987,1.312934,103.899645
427439,2,0,2,1.315026,103.904199
427440,0,47,47,1.312883,103.899816
427441,5,129,134,1.312853,103.899848
427442,6,2077,2083,1.312517,103.900204
427443,8,159,167,1.312814,103.899881
427444,3,1588,1591,1.312448,103.900248
427445,2,0,2,1.312923,103.899795
427446,8,3157,3165,1.312403,103.900278
427447,23,110,133,1.31272,103.89994
427449,9,873,882,1.312684,103.899973
427451,25,206,231,1.312628,103.900006
427452,523,476,999,1.312239,103.900395
427453,2,0,2,1.312778,103.899908
427455,2,7,9,1.31253,103.900079
427456,12,2116,2128,1.312026,103.90055
427457,0,784,784,1.312491,103.90011
427458,102,27,129,1.312004,103.900566
427459,4,0,4,1.312458,103.900133
427460,22,335,357,1.311982,103.90058
427461,2,173,175,1.312411,103.90016
427462,5,0,5,1.311937,103.900609
427463,3,73,76,1.312387,103.900161
427464,13,279,292,1.311869,103.900658
427465,0,31,31,1.312345,103.90018
427466,0,10,10,1.311897,103.900636
427467,3,75,78,1.312307,103.900207
427468,0,296,296,1.311919,103.900625
427469,5,220,225,1.312285,103.900233
427470,1,0,1,1.313297,103.89949
427471,33,348,381,1.312228,103.900272
427472,15,2154,2169,1.311658,103.900795
427475,10,368,378,1.312173,103.900302
427476,9,0,9,1.311542,103.900883
427477,1,2022,2023,1.312137,103.90032
427478,0,5,5,1.312098,103.900355
427479,1,868,869,1.312067,103.900379
427480,0,2,2,1.312585,103.900035
427481,3,633,636,1.311498,103.900919
427483,84,1142,1226,1.311926,103.900477
427484,2,227,229,1.311887,103.900498
427485,646,252,898,1.311342,103.901022
427486,0,9,9,1.311848,103.900521
427487,4,407,411,1.311805,103.900574
427488,23,4,27,1.311209,103.901147
427489,62,794,856,1.311153,103.901189
427490,1,6,7,1.311068,103.901247
427491,12,388,400,1.31101,103.901287
427492,1,0,1,1.311878,103.900649
427493,16,293,309,1.311706,103.900617
427494,11,1701,1712,1.31091,103.901347
427495,1033,16,1049,1.311624,103.900688
427496,10,780,790,1.310859,103.901383
427498,3,1370,1373,1.310801,103.901428
427501,8,40,48,1.311545,103.900734
427502,4,532,536,1.310767,103.901453
427503,20,608,628,1.311507,103.900769
427504,0,965,965,1.310722,103.901493
427505,2,531,533,1.310678,103.901531
427506,1,1210,1211,1.311347,103.900917
427507,9,587,596,1.310626,103.901563
427508,4,721,725,1.311295,103.900947
427509,2,759,761,1.310569,103.901601
427510,5,1,6,1.31125,103.900982
427511,2,468,470,1.310514,103.90164
427512,3,1579,1582,1.311215,103.901004
427513,8,1,9,1.310466,103.901681
427514,0,1,1,1.310958,103.901313
427515,5,767,772,1.310399,103.901724
427516,5,484,489,1.311147,103.90105
427517,4,0,4,1.310347,103.90174
427518,0,1,1,1.311175,103.90102
427519,3,1118,1121,1.310317,103.90176
427520,32,421,453,1.311057,103.901105
427521,11,1,12,1.310281,103.901793
427522,3,0,3,1.315083,103.905238
427523,7,997,1004,1.310252,103.901816
427524,3,3,6,1.310989,103.901145
427525,1,729,730,1.310218,103.901845
427526,123,11,134,1.310932,103.901194
427527,0,21,21,1.310181,103.901872
427528,8,16,24,1.310877,103.901233
427529,5,386,391,1.310148,103.901901
427530,5,13,18,1.31082,103.901259
427531,1,347,348,1.310115,103.901931
427532,5,15,20,1.310771,103.901305
427533,2,499,501,1.310067,103.901951
427534,2,109,111,1.3106,103.901395
427535,5,699,704,1.310029,103.901971
427536,3,29,32,1.31054,103.90143
427537,2,399,401,1.309995,103.902003
427538,3,1,4,1.310489,103.90145
427539,0,313,313,1.310016,103.902188
427540,2,330,332,1.309798,103.902158
427541,3,272,275,1.309745,103.902199
427542,12,956,968,1.31027,103.901686
427543,10,727,737,1.309702,103.902227
427544,4,339,343,1.310209,103.901723
427547,5,844,849,1.310102,103.901802
427549,14,445,459,1.310035,103.901843
427550,4,537,541,1.309562,103.902313
427551,25,2044,2069,1.309657,103.902146
427552,4,204,208,1.309523,103.902345
427553,8,407,415,1.309616,103.902173
427554,8,287,295,1.309487,103.902379
427555,2,194,196,1.309567,103.902211
427556,791,514,1305,1.309452,103.902408
427557,9,214,223,1.309521,103.902249
427558,9,462,471,1.309403,103.902449
427559,7,322,329,1.309477,103.902283
427560,3,523,526,1.309369,103.902481
427561,20,0,20,1.309456,103.902297
427562,0,3,3,1.311018,103.901127
427563,1,79,80,1.309423,103.902315
427564,1,347,348,1.309279,103.902534
427565,2,0,2,1.312027,103.900407
427566,11,1,12,1.30925,103.902559
427567,10,72,82,1.309391,103.902348
427568,0,274,274,1.309214,103.902582
427569,12,52,64,1.309364,103.902372
427570,5,26,31,1.309192,103.902599
427571,2,36,38,1.309218,103.902485
427572,159,105,264,1.309164,103.902624
427573,0,113,113,1.299509,103.837
427576,0,253,253,1.299509,103.837
427579,1,0,1,1.311108,103.901079
427580,25,333,358,1.309134,103.902649
427582,5,216,221,1.309097,103.902669
427584,24,245,269,1.309058,103.902655
427585,68,33,101,1.308994,103.902629
427586,2,89,91,1.309056,103.902694
427587,1,1,2,1.309351,103.902388
427588,25,689,714,1.308949,103.902786
427589,5,1,6,1.308893,103.902834
427590,12,1,13,1.308856,103.902855
427591,7,33,40,1.308804,103.902888
427592,8,293,301,1.308878,103.902743
427593,8,771,779,1.308758,103.902928
427594,0,12,12,1.308842,103.902773
427595,28,213,241,1.308799,103.9028
427596,5,114,119,1.308754,103.902835
427597,8,142,150,1.308721,103.902861
427598,5,160,165,1.308674,103.902895
427599,14,861,875,1.308626,103.902925
427600,12,557,569,1.308479,103.902999
427601,6,183,189,1.308433,103.903025
427602,29,1076,1105,1.308441,103.903148
427603,5,213,218,1.30839,103.903053
427604,22,979,1001,1.308392,103.903184
427605,3,197,200,1.308355,103.903084
427606,5,3,8,1.308351,103.903218
427607,57,0,57,1.308316,103.9031
427608,24,1614,1638,1.308318,103.903243
427609,6,262,268,1.308282,103.903136
427610,20,1509,1529,1.308258,103.903281
427611,5,329,334,1.308247,103.903167
427612,9,907,916,1.308156,103.903368
427613,5,249,254,1.308207,103.903209
427614,7,1496,1503,1.308086,103.903412
427615,28,274,302,1.308172,103.903234
427616,6,187,193,1.308018,103.903463
427617,7,24,31,1.308132,103.903277
427618,14,2010,2024,1.307946,103.903524
427619,1,44,45,1.308091,103.903302
427620,4,353,357,1.308057,103.903321
427621,117,267,384,1.307828,103.903631
427622,34,215,249,1.307989,103.903357
427623,108,33,141,1.307734,103.903713
427624,2,265,267,1.307848,103.903453
427625,38,217,255,1.307691,103.903738
427626,6,299,305,1.30775,103.903497
427627,4,275,279,1.30766,103.903773
427628,8,198,206,1.307609,103.903807
427629,0,1,1,1.309168,103.902519
427630,1,39,40,1.307567,103.903614
427631,0,183,183,1.307508,103.90367
427632,1,108,109,1.30746,103.903696
427633,58,118,176,1.307355,103.904027
427634,6,1809,1815,1.307332,103.903891
427635,1,710,711,1.307286,103.903908
427636,10,0,10,1.30724,103.903941
427637,4,0,4,1.307208,103.903968
427638,1,552,553,1.307172,103.904002
427639,2,297,299,1.307145,103.904034
427640,7,424,431,1.307102,103.904057
427641,10,184,194,1.307062,103.904081
427642,139,392,531,1.307034,103.904109
427643,50,1058,1108,1.306997,103.904135
427644,6,235,241,1.306959,103.904153
427646,2,902,904,1.3069,103.904217
427648,4,369,373,1.306799,103.904274
427649,0,1,1,1.307643,103.903556
427650,18,95,113,1.307151,103.904158
427651,6,459,465,1.306718,103.90433
427652,25,125,150,1.307112,103.904183
427653,2,719,721,1.306686,103.904363
427654,5,141,146,1.307056,103.904221
427655,2,117,119,1.306643,103.904394
427656,23,127,150,1.307013,103.904249
427657,5,156,161,1.306613,103.904411
427659,4,210,214,1.30657,103.904447
427661,4,190,194,1.306535,103.904468
427663,7,111,118,1.306503,103.904502
427664,21,409,430,1.306846,103.904373
427665,7,216,223,1.306474,103.904511
427667,1,1,2,1.309004,103.902733
427669,2,2,4,1.306394,103.904541
427671,18,229,247,1.306366,103.904569
427673,0,41,41,1.306309,103.904601
427674,15,302,317,1.306269,103.904622
427675,31,280,311,1.30662,103.904532
427676,1,0,1,1.306758,103.904296
427677,17,166,183,1.306582,103.904559
427678,12,0,12,1.306541,103.90459
427679,15,603,618,1.306516,103.904609
427680,1,122,123,1.306457,103.90465
427681,5,150,155,1.306424,103.904674
427682,2,124,126,1.306384,103.904706
427683,2,119,121,1.306343,103.904736
427684,8,18,26,1.306305,103.904765
427686,3,667,670,1.299509,103.837
427687,30,694,724,1.305686,103.905299
427688,7,1,8,1.305686,103.905299
427691,114,0,114,1.305676,103.905257
427692,0,1,1,1.30623,103.904667
427693,83,32,115,1.305529,103.905342
427694,145,304,449,1.305413,103.905439
427695,3,55,58,1.304899,103.905598
427696,6,0,6,1.305298,103.905539
427697,2,605,607,1.304868,103.905614
427698,1,6,7,1.304836,103.905633
427699,0,6,6,1.304793,103.905644
427700,1,556,557,1.304767,103.905648
427701,29,32,61,1.304958,103.905792
427702,1,57,58,1.304363,103.906061
427704,0,1,1,1.305693,103.905328
427705,2,7,9,1.304818,103.905902
427707,0,1,1,1.304605,103.905759
427708,0,1,1,1.30475,103.905967
427709,1,82,83,1.304708,103.905991
427710,1369,3,1372,1.304574,103.905792
427711,1553,132,1685,1.304222,103.906149
427712,1,32,33,1.30428,103.906064
427713,0,2,2,1.306434,103.904542
427714,2,0,2,1.304327,103.906047
427716,1,1,2,1.304346,103.905999
427717,3,385,388,1.304262,103.906035
427718,1,50,51,1.304409,103.905939
427719,1,131,132,1.304274,103.905996
427720,21,771,792,1.304304,103.905998
427721,5,2,7,1.30437,103.90595
427722,0,2,2,1.304344,103.905916
427723,1,7,8,1.304291,103.905859
427724,8,409,417,1.304314,103.905896
427725,36,1908,1944,1.314293,103.898997
427726,691,753,1444,1.314768,103.898422
427727,12,0,12,1.3137,103.899224
427728,2,0,2,1.30435,103.905968
427729,20,950,970,1.312654,103.900335
427739,81,660,741,1.313267,103.899838
427741,0,9,9,1.313281,103.899934
427742,25,19,44,1.31328,103.899965
427743,2,1,3,1.309322,103.902499
427744,51,15,66,1.313292,103.900036
427747,32,10,42,1.313311,103.900161
427748,2,28,30,1.313323,103.900244
427749,1,114,115,1.31333,103.900288
427750,1,0,1,1.304656,103.905736
427751,0,48,48,1.313344,103.90038
427752,0,66,66,1.313349,103.900421
427753,0,90,90,1.313354,103.900456
427754,19,1350,1369,1.313341,103.900886
427755,1,132,133,1.313359,103.900486
427756,3,52,55,1.313354,103.90096
427757,0,132,132,1.313363,103.900525
427758,8,32,40,1.313364,103.90102
427759,1,74,75,1.313367,103.900554
427760,43,15,58,1.313379,103.901074
427761,37,1,38,1.313372,103.900582
427762,21,24,45,1.313389,103.901125
427763,15,23,38,1.313383,103.900607
427764,7,16,23,1.313393,103.901167
427765,7,1041,1048,1.313385,103.900646
427766,43,25,68,1.3134,103.901203
427767,30,0,30,1.313416,103.900827
427768,5,19,24,1.313407,103.901264
427769,7,185,192,1.313438,103.900926
427770,5,1,6,1.313415,103.901309
427771,4,72,76,1.313448,103.900982
427772,2,125,127,1.313428,103.901403
427773,18,122,140,1.31346,103.901045
427774,0,1,1,1.313335,103.900332
427775,21,23,44,1.313467,103.901085
427776,1,119,120,1.313447,103.901506
427777,2,204,206,1.313467,103.901119
427779,2,0,2,1.310156,103.901757
427780,25,171,196,1.31346,103.901597
427781,2,55,57,1.313483,103.901201
427782,3,0,3,1.313288,103.9
427783,12,172,184,1.313492,103.901248
427784,53,195,248,1.313482,103.901708
427785,29,14,43,1.313488,103.90175
427786,65,124,189,1.31349,103.901797
427787,286,176,462,1.313522,103.901456
427788,35,40,75,1.313529,103.901507
427789,13,66,79,1.313548,103.902199
427790,192,1,193,1.313538,103.901567
427791,3,125,128,1.313562,103.902285
427794,40,147,187,1.313578,103.902356
427795,4,122,126,1.313588,103.902418
427796,7,80,87,1.313553,103.901716
427797,5,2,7,1.3136,103.902483
427798,18,99,117,1.31356,103.901753
427799,8,31,39,1.313604,103.902546
427800,250,44,294,1.313564,103.901789
427801,67,0,67,1.313618,103.902615
427802,3,54,57,1.313573,103.901831
427803,52,17,69,1.313627,103.902663
427804,19,415,434,1.313581,103.901867
427805,8,0,8,1.313632,103.902709
427806,54,0,54,1.313714,103.902545
427813,6,147,153,1.313645,103.90275
427814,29,310,339,1.313656,103.902309
427817,9,0,9,1.313651,103.902804
427818,3,67,70,1.313662,103.902349
427819,85,20,105,1.313659,103.902863
427820,5,43,48,1.313669,103.902394
427821,38,0,38,1.313675,103.902918
427822,32,24,56,1.31368,103.90244
427823,58,23,81,1.313686,103.902981
427824,1,6,7,1.313685,103.902485
427826,9,0,9,1.313694,103.903038
427827,21,17,38,1.313694,103.902529
427830,9,67,76,1.313703,103.903113
427831,6,14,20,1.313703,103.902568
427832,6,8,14,1.313703,103.902604
427833,4,29,33,1.313717,103.903162
427834,7,24,31,1.313717,103.902658
427835,3,32,35,1.313723,103.902691
427836,7,16,23,1.313728,103.902736
427837,0,11,11,1.313733,103.903253
427838,0,21,21,1.313741,103.903306
427839,65,6,71,1.313731,103.90278
427841,0,7,7,1.313752,103.903356
427842,18,7,25,1.313738,103.902822
427843,13,11,24,1.313748,103.902861
427845,55,0,55,1.313762,103.903399
427846,49,11,60,1.313754,103.902898
427849,0,87,87,1.313779,103.903446
427850,1,13,14,1.313761,103.902948
427851,29,116,145,1.313804,103.903676
427852,1,39,40,1.313769,103.902999
427853,0,46,46,1.313821,103.903783
427854,5,0,5,1.313778,103.903042
427855,4,0,4,1.313815,103.903762
427856,6,0,6,1.31379,103.903096
427858,17,92,109,1.31383,103.903886
427859,20,2,22,1.313793,103.903125
427861,45,2,47,1.313829,103.903859
427862,70,285,355,1.313797,103.903159
427864,32,0,32,1.313834,103.903901
427865,6,0,6,1.313801,103.903202
427866,129,0,129,1.313836,103.903954
427867,0,2,2,1.313473,103.901165
427868,35,0,35,1.313819,103.903283
427869,1,63,64,1.313826,103.90331
427870,3,2,5,1.313827,103.903347
427871,9,0,9,1.313827,103.903347
427872,3,178,181,1.313831,103.903388
427873,136,48,184,1.313881,103.90359
427874,1,52,53,1.313885,103.903657
427875,8,27,35,1.313894,103.903719
427876,0,10,10,1.313894,103.903719
427877,3,0,3,1.313471,103.901653
427878,8,256,264,1.313865,103.904259
427879,1,19,20,1.313907,103.903838
427880,3,5,8,1.299509,103.837
427881,18,5,23,1.313909,103.903887
427882,2,1,3,1.313899,103.90379
427883,0,9,9,1.313916,103.90393
427884,48,0,48,1.31387,103.904368
427885,0,11,11,1.313923,103.903953
427886,19,10,29,1.313928,103.903995
427887,1,17,18,1.313935,103.904035
427888,25,36,61,1.313943,103.904082
427889,74,261,335,1.313975,103.904832
427890,3,0,3,1.313875,103.9043
427891,0,114,114,1.313988,103.904986
427892,40,0,40,1.31399,103.905059
427893,4,143,147,1.314001,103.905117
427895,1,63,64,1.314016,103.905246
427896,4,0,4,1.314025,103.905309
427897,84,90,174,1.314017,103.904416
427898,0,205,205,1.314036,103.905357
427899,3,29,32,1.314032,103.904615
427900,2,5,7,1.314034,103.905396
427901,9,1,10,1.314044,103.904652
427902,4,284,288,1.314048,103.905475
427903,37,15,52,1.314049,103.904701
427904,305,9,314,1.314053,103.904744
427905,9,9,18,1.314061,103.904795
427906,1,29,30,1.314062,103.904843
427907,7,0,7,1.314122,103.905009
427908,62,0,62,1.314122,103.905009
427909,1,1,2,1.313812,103.903248
427911,2,0,2,1.314122,103.905009
427912,37,0,37,1.314122,103.905009
427913,0,4,4,1.314122,103.905009
427914,0,5,5,1.314122,103.905009
427915,7,4,11,1.314136,103.905167
427916,27,0,27,1.314136,103.905167
427919,21,0,21,1.314136,103.905167
427920,6,0,6,1.314136,103.905167
427922,10,27,37,1.31416,103.906064
427923,5,570,575,1.314151,103.906044
427924,0,27,27,1.314162,103.905328
427925,3,0,3,1.313974,103.904914
427926,82,0,82,1.314171,103.905389
427927,15,0,15,1.314249,103.905646
427928,111,131,242,1.314232,103.905609
427929,2,0,2,1.314122,103.905009
427930,5,1,6,1.314232,103.905609
427931,9,0,9,1.314293,103.905596
427932,43,0,43,1.314261,103.905602
427933,93,0,93,1.314232,103.905609
427934,10,0,10,1.314297,103.905669
427935,21,345,366,1.314214,103.905866
427936,3,1918,1921,1.314231,103.905947
427941,219,320,539,1.314338,103.907178
427942,5,255,260,1.31434,103.906558
427943,0,12,12,1.314353,103.90662
427944,42,13,55,1.314378,103.907422
427946,64,0,64,1.314391,103.907485
427947,0,108,108,1.314375,103.906715
427948,12,2,14,1.314386,103.906754
427949,8,150,158,1.314445,103.907667
427950,12,71,83,1.314396,103.906795
427951,11,54,65,1.314484,103.907803
427952,6,42,48,1.314408,103.906866
427953,1,56,57,1.314423,103.906944
427954,2,33,35,1.314507,103.907894
427955,106,0,106,1.314449,103.907103
427956,1,42,43,1.314524,103.907968
427957,1,1,2,1.314232,103.905609
427958,15,128,143,1.314527,103.908338
427959,5,11,16,1.314491,103.907309
427961,0,7,7,1.314458,103.908375
427962,327,8,335,1.314527,103.90745
427963,1,7,8,1.314402,103.908393
427964,10,271,281,1.314542,103.907559
427965,2,0,2,1.314469,103.907164
427966,25,0,25,1.314566,103.907678
427967,10,2,12,1.314291,103.908439
427969,1,1,2,1.314339,103.908419
427970,186,3,189,1.314612,103.907878
427971,2,0,2,1.314248,103.908456
427972,33,16,49,1.314658,103.908085
427974,2,0,2,1.314201,103.908477
427975,1,1,2,1.314233,103.908568
427977,0,2,2,1.31429,103.908544
427978,65,4,69,1.314478,103.908473
427979,42,287,329,1.314554,103.908449
427980,1,1,2,1.314412,103.908499
427981,1,0,1,1.313439,103.901458
427982,138,0,138,1.314631,103.908729
427983,1,0,1,1.314696,103.90832
427985,2,6,8,1.314732,103.908511
427986,18,370,388,1.314653,103.908845
427987,3,140,143,1.314664,103.908902
427988,7,219,226,1.314685,103.909017
427989,1761,7,1768,1.31495,103.909332
427990,314,11608,11922,1.31495,103.909332
427991,2,1,3,1.314148,103.905352
427994,1,7,8,1.315078,103.910092
427997,4,423,427,1.31477,103.909341
427998,1,1,2,1.314688,103.90827
427999,0,15,15,1.31479,103.909391
428000,1,2,3,1.314726,103.90911
428001,1,342,343,1.314789,103.909365
428002,90,1,91,1.315138,103.910357
428003,0,8,8,1.31515,103.910424
428005,0,1,1,1.314715,103.908368
428006,1,1,2,1.3151,103.910195
428007,6,1,7,1.315204,103.910697
428008,0,1,1,1.315185,103.91063
428010,0,3,3,1.315115,103.910253
428012,2,3,5,1.315275,103.911051
428013,1,0,1,1.31521,103.910752
428014,0,8,8,1.315298,103.911167
428015,3,0,3,1.315249,103.910931
428016,4,24,28,1.315339,103.91134
428017,2,0,2,1.315195,103.910668
428018,1,2,3,1.315318,103.911253
428020,1,0,1,1.315284,103.911108
428021,2,4,6,1.31546,103.911892
428022,16,0,16,1.315476,103.911953
428023,14,0,14,1.315505,103.911991
428024,0,2,2,1.315362,103.911432
428025,38,2,40,1.315504,103.912098
428026,15,0,15,1.315515,103.912159
428027,5,3,8,1.315533,103.912228
428028,1,1,2,1.31549,103.912041
428029,37,0,37,1.315552,103.912367
428030,39,1,40,1.315579,103.912448
428031,1,2,3,1.31537,103.911495
428032,10,5,15,1.315606,103.912531
428033,23,5,28,1.315648,103.912719
428034,1,3,4,1.315668,103.91281
428035,1,0,1,1.315402,103.911626
428036,1,0,1,1.315688,103.912902
428037,3,2,5,1.315716,103.913035
428038,12,14,26,1.315727,103.913083
428039,42,0,42,1.315748,103.913142
428040,1,1,2,1.315538,103.91229
428041,133,1,134,1.31577,103.913271
428043,5,1,6,1.315795,103.913378
428044,230,8,238,1.315808,103.913436
428045,4,0,4,1.315011,103.910599
428046,1,0,1,1.315701,103.912971
428047,0,1,1,1.315283,103.911507
428048,38,0,38,1.315318,103.911613
428051,10,7,17,1.315355,103.911796
428052,2,0,2,1.31576,103.913195
428053,0,1,1,1.315305,103.911537
428055,14,0,14,1.315399,103.912064
428056,3,0,3,1.315592,103.912491
428057,14,0,14,1.31543,103.912209
428058,15,5,20,1.315449,103.912288
428059,4,0,4,1.315462,103.912368
428060,1,2,3,1.315415,103.912127
428061,30,0,30,1.315499,103.912533
428062,1,0,1,1.315374,103.911919
428063,4,3,7,1.315539,103.91273
428064,1,0,1,1.315517,103.912639
428065,3,0,3,1.315469,103.912449
428066,6,1,7,1.31558,103.912919
428067,110,4,114,1.315597,103.912993
428068,11,1,12,1.315664,103.913194
428069,14,18,32,1.315668,103.913257
428070,113,0,113,1.315683,103.913321
428071,9,0,9,1.315693,103.913394
428072,4,14,18,1.315705,103.913458
428073,1,5,6,1.315713,103.91352
428074,7,1,8,1.315721,103.91358
428076,0,17,17,1.313724,103.903213
428077,1,89,90,1.314676,103.90896
428078,0,1,1,1.315559,103.912815
428081,2,0,2,1.315355,103.911854
428084,1,0,1,1.314764,103.910925
428085,6,33,39,1.299509,103.837
428090,1,16,17,1.312111,103.900849
428091,2,0,2,1.315011,103.910599
428092,0,14,14,1.312121,103.90091
428093,0,29,29,1.312232,103.900802
428094,34,0,34,1.312135,103.900985
428095,6,6,12,1.312187,103.901283
428096,36,213,249,1.312732,103.901465
428098,0,51,51,1.31219,103.900888
428099,36,0,36,1.313174,103.902223
428100,40,0,40,1.313354,103.902111
428101,100,0,100,1.312814,103.902473
428102,74,6,80,1.312467,103.903195
428103,85,98,183,1.312609,103.90304
428104,381,44,425,1.312605,103.903375
428105,6,0,6,1.312671,103.90369
428106,10,124,134,1.31264,103.903627
428107,1,0,1,1.315011,103.910599
428108,1,0,1,1.312493,103.903302
428109,236,10,246,1.312536,103.903532
428110,5,21,26,1.312555,103.903789
428111,231,0,231,1.312661,103.903807
428112,33,0,33,1.312561,103.903813
428113,2,14,16,1.312574,103.903927
428114,6,0,6,1.312597,103.904017
428115,412,22,434,1.312625,103.904201
428116,56,88,144,1.312192,103.901487
428117,1,0,1,1.299509,103.837
428118,2,3,5,1.312172,103.901165
428119,5,0,5,1.312186,103.901223
428120,48,0,48,1.312553,103.903723
428121,86,49,135,1.312777,103.902489
428122,56,1,57,1.31316,103.902158
428123,47,190,237,1.31306,103.902227
428124,106,1,107,1.31309,103.902215
428125,46,0,46,1.313188,103.902151
428126,128,11,139,1.313074,103.902285
428127,101,69,170,1.312559,103.901791
428128,137,22,159,1.312577,103.901598
428129,13,45,58,1.312767,103.900519
428130,8,0,8,1.315526,103.909858
428131,1,0,1,1.312161,103.901102
428133,5,6,11,1.315572,103.910072
428134,1,0,1,1.315542,103.909932
428135,99,18,117,1.315526,103.910242
428137,0,1,1,1.315597,103.910165
428138,2,0,2,1.312201,103.900745
428139,2,1,3,1.31557,103.912865
428140,3,1,4,1.315641,103.910344
428141,40,1,41,1.315566,103.910436
428142,1,0,1,1.315536,103.910307
428146,0,1,1,1.315654,103.910411
428149,1,0,1,1.31568,103.910538
428150,2,0,2,1.315626,103.910279
428151,1,2,3,1.315551,103.91037
428155,3,1,4,1.315708,103.911052
428156,16,3,19,1.315718,103.911109
428157,0,1,1,1.315638,103.910776
428158,160,0,160,1.315742,103.91125
428160,3,1,4,1.31576,103.911318
428161,7,1,8,1.31589,103.911451
428162,18,3,21,1.315779,103.911392
428163,20,2,22,1.315906,103.911516
428164,2,2,4,1.315791,103.911459
428165,0,1,1,1.315729,103.911154
428166,138,1,139,1.315816,103.911518
428167,7,2,9,1.315928,103.911645
428169,4,1,5,1.315863,103.911689
428170,5,1,6,1.315875,103.911771
428171,3,2,5,1.315981,103.911858
428172,4,2,6,1.315889,103.911836
428173,1,0,1,1.315914,103.911583
428174,56,4,60,1.315911,103.91191
428176,11,1,12,1.315929,103.911975
428177,0,3,3,1.315657,103.910844
428178,6,10,16,1.315946,103.912042
428179,0,6,6,1.316037,103.912089
428180,0,12,12,1.315956,103.912086
428181,1,1,2,1.315709,103.910678
428182,2,1,3,1.316023,103.912036
428183,0,1,1,1.315996,103.911912
428184,6,1,7,1.315982,103.912216
428185,13,5,18,1.316072,103.912256
428186,1,5,6,1.315992,103.912287
428187,2,0,2,1.316053,103.912138
428188,9,1,10,1.316005,103.912355
428189,2,0,2,1.316086,103.912324
428190,45,0,45,1.316015,103.912409
428191,0,1,1,1.316065,103.912195
428192,0,2,2,1.316106,103.912396
428193,26,0,26,1.316177,103.912689
428194,6,0,6,1.316078,103.912662
428195,19,4,23,1.316093,103.912746
428196,4,1,5,1.316109,103.912821
428197,89,1,90,1.316122,103.912894
428198,2,3,5,1.316132,103.912972
428199,1,11,12,1.31619,103.912752
428202,7,7,14,1.316161,103.913108
428203,8,0,8,1.316169,103.913156
428204,1,2,3,1.315968,103.912158
428205,22,0,22,1.316183,103.913216
428206,0,11,11,1.316193,103.913277
428207,51,1,52,1.316205,103.913328
428208,2,0,2,1.316063,103.912588
428209,3,0,3,1.316241,103.913036
428210,6,0,6,1.299509,103.837
428222,1,23,24,1.318254,103.911692
428224,0,5,5,1.317999,103.911754
428225,1,13,14,1.317912,103.911776
428227,0,6,6,1.317817,103.911796
428228,100,11,111,1.317937,103.911654
428229,26,3,29,1.317724,103.911821
428232,9,15,24,1.317597,103.911973
428233,13,25,38,1.318561,103.911593
428234,0,7,7,1.31834,103.911649
428247,37,75,112,1.307667,103.914434
428248,1,122,123,1.308115,103.914104
428249,0,8,8,1.307722,103.91442
428250,0,17,17,1.307939,103.914161
428251,20,10,30,1.307779,103.914388
428252,0,8,8,1.307976,103.914163
428253,4,5,9,1.307839,103.914369
428254,0,1,1,1.316136,103.912535
428255,4,4,8,1.307907,103.914337
428256,1,2,3,1.316224,103.912928
428257,2,9,11,1.307968,103.914297
428258,2,3,5,1.30773,103.914223
428259,6,7,13,1.308004,103.914291
428260,25,2,27,1.307647,103.914304
428261,0,11,11,1.308054,103.914282
428262,34,4,38,1.307522,103.914345
428263,1,1,2,1.315734,103.910804
428264,0,3,3,1.307807,103.914245
428265,0,5,5,1.308141,103.914246
428266,13,13,26,1.307349,103.914399
428267,3,2,5,1.308195,103.91424
428268,83,1799,1882,1.307221,103.91447
428269,4,11,15,1.308274,103.914323
428270,4,0,4,1.307221,103.91447
428271,2,9,11,1.307221,103.91447
428286,1,0,1,1.308141,103.914122
428287,10,4,14,1.307895,103.911184
428290,21,0,21,1.307978,103.911047
428291,3,2,5,1.307992,103.911134
428292,2,1,3,1.307418,103.914377
428293,2,0,2,1.308086,103.914258
428294,2,0,2,1.308015,103.911124
428296,0,2,2,1.308131,103.910991
428297,2,1,3,1.308008,103.911038
428298,1,0,1,1.307905,103.911097
428299,5,0,5,1.3082,103.911038
428314,15,9,24,1.308012,103.911631
428315,0,3,3,1.308143,103.911065
428317,13,0,13,1.30812,103.911709
428318,1,1,2,1.308163,103.910977
428319,3,0,3,1.308008,103.911721
428321,2,1,3,1.308189,103.911683
428322,0,4,4,1.308236,103.911621
428323,4,0,4,1.308325,103.911638
428324,0,4,4,1.308244,103.911577
428325,13,1,14,1.308398,103.911632
428326,3,0,3,1.308238,103.911681
428327,4,0,4,1.308379,103.911572
428342,4,3,7,1.307702,103.911484
428343,3,1,4,1.307638,103.911516
428344,50,3,53,1.307519,103.911568
428345,0,3,3,1.308311,103.911581
428346,3,5,8,1.307285,103.911692
428347,0,1,1,1.308114,103.911087
428348,0,1,1,1.307231,103.911688
428349,3,2,5,1.307037,103.911794
428350,4,5,9,1.306923,103.911833
428351,2,24,26,1.30687,103.911852
428352,1,46,47,1.306873,103.911964
428353,2,14,16,1.306705,103.911925
428354,24,0,24,1.306839,103.912006
428355,11,2,13,1.306634,103.911966
428356,34,6,40,1.306775,103.912057
428357,8,155,163,1.306595,103.912019
428358,2,3,5,1.306717,103.912052
428359,86,0,86,1.306661,103.912076
428360,43,1,44,1.306628,103.91209
428361,2,0,2,1.308104,103.911635
428362,14,1,15,1.306602,103.912102
428363,0,70,70,1.306588,103.912107
428378,33,626,659,1.311197,103.911487
428379,0,1,1,1.3071,103.91175
428380,3,4,7,1.311237,103.911657
428381,19,0,19,1.311259,103.911738
428382,10,1,11,1.311271,103.911844
428383,0,4,4,1.311285,103.911915
428384,24,0,24,1.311312,103.912028
428385,0,1,1,1.311213,103.911569
428386,1,0,1,1.311384,103.911916
428387,0,2,2,1.306615,103.912097
428388,2,0,2,1.311407,103.912013
428389,0,1,1,1.311329,103.912113
428391,25,2,27,1.311462,103.912226
428392,6,1,7,1.311384,103.912374
428393,4,0,4,1.311491,103.912352
428394,3,0,3,1.307499,103.911588
428395,2,0,2,1.31135,103.912211
428396,12,3,15,1.311535,103.912533
428397,1,1,2,1.311404,103.912443
428398,2,7,9,1.311546,103.912591
428399,2,5,7,1.311441,103.912619
428400,4,2,6,1.311563,103.912669
428401,66,1,67,1.311465,103.912696
428402,35,1,36,1.311576,103.91273
428403,7,0,7,1.311483,103.912773
428404,1,1,2,1.311425,103.912534
428405,4,4,8,1.311497,103.912884
428406,28,6,34,1.311633,103.913017
428407,9,3,12,1.31153,103.912982
428408,3,7,10,1.311645,103.913077
428409,273,0,273,1.311563,103.913135
428410,3,4,7,1.311596,103.91326
428411,2,4,6,1.311628,103.913386
428412,2,0,2,1.311597,103.912831
428413,53,3,56,1.311616,103.912908
428426,1,2,3,1.311508,103.912422
428427,36,6,42,1.307413,103.907724
428428,3,0,3,1.30748,103.90767
428432,49,2,51,1.307086,103.907925
428434,1,0,1,1.311444,103.91214
428435,4,0,4,1.306834,103.908048
428437,0,1,1,1.306921,103.908004
428439,4,1,5,1.306552,103.908223
428440,3,0,3,1.30734,103.907767
428441,9,2,11,1.306418,103.908302
428442,2,0,2,1.311753,103.913383
428443,1,3,4,1.306309,103.908372
428444,2,0,2,1.306348,103.908349
428445,0,3,3,1.306477,103.908273
428446,1,0,1,1.306677,103.908144
428447,94,5,99,1.306071,103.908522
428448,0,3,3,1.306183,103.908458
428449,0,1,1,1.306117,103.908495
428450,12,1,13,1.305878,103.908634
428451,11,7,18,1.305827,103.908669
428452,11,2,13,1.305777,103.908703
428453,1,1,2,1.306243,103.908414
428454,4,3,7,1.30567,103.908744
428455,6,0,6,1.305583,103.908799
428456,5,181,186,1.305513,103.908849
428471,1,21,22,1.306903,103.903177
428472,0,4,4,1.306862,103.903158
428473,2,17,19,1.306838,103.903115
428474,1,1,2,1.305723,103.908727
428475,0,8,8,1.306777,103.903039
428477,0,9,9,1.30675,103.902992
428478,1,2,3,1.305997,103.90857
428479,5,0,5,1.30666,103.902866
428480,4,2,6,1.306621,103.902823
428481,1,8,9,1.306605,103.902777
428482,2,3,5,1.306873,103.903005
428483,1,0,1,1.30593,103.908593
428484,4,9,13,1.305867,103.901685
428485,1,0,1,1.306568,103.902708
428486,2,0,2,1.306808,103.90308
428488,3,0,3,1.306684,103.902894
428489,6,0,6,1.305767,103.901547
428490,3,0,3,1.306467,103.902408
428491,3,2,5,1.305726,103.901493
428492,2,67,69,1.306405,103.902322
428493,1,0,1,1.305847,103.901657
428495,4,11,15,1.306011,103.901575
428496,1,0,1,1.305686,103.901438
428499,0,1,1,1.306107,103.901489
428501,0,3,3,1.306415,103.902408
428502,0,2,2,1.306507,103.902529
428503,0,2,2,1.306496,103.902641
428505,1,393,394,1.307479,103.903557
428516,36,4,40,1.316481,103.901433
428517,0,14,14,1.316394,103.901463
428518,6,2,8,1.316261,103.901384
428519,1,4,5,1.316314,103.901465
428520,0,4,4,1.316173,103.901395
428521,3,0,3,1.30602,103.90148
428522,87,64,151,1.316057,103.901527
428523,24,13,37,1.316046,103.90143
428524,92,14,106,1.315976,103.901532
428525,0,5,5,1.315961,103.901449
428527,0,1,1,1.305977,103.901557
428529,0,10,10,1.315766,103.90146
428530,7,18,25,1.315846,103.901564
428531,0,12,12,1.315686,103.90147
428532,1,0,1,1.315875,103.90146
428533,0,1,1,1.315755,103.901574
428535,0,25,25,1.31548,103.90151
428536,0,21,21,1.315629,103.901607
428537,9,41,50,1.315376,103.901527
428539,4,14,18,1.315053,103.9015
428540,1,11,12,1.315491,103.901624
428542,0,3,3,1.316118,103.901431
428543,2,2,4,1.31493,103.901655
428544,4,1,5,1.315366,103.901641
428545,12,0,12,1.314873,103.901664
428546,15,6,21,1.315319,103.901665
428547,2,24,26,1.314786,103.901681
428562,80,0,80,1.314314,103.901503
428563,4,19,23,1.314268,103.901541
428564,52,0,52,1.314236,103.901557
428566,37,6,43,1.314205,103.901584
428567,24,25,49,1.314186,103.901604
428568,21,0,21,1.314166,103.901619
428569,2,8,10,1.314141,103.901635
428570,2,17,19,1.314096,103.901652
428571,56,19,75,1.314051,103.90167
428572,169,6,175,1.314007,103.901693
428573,5,8,13,1.313951,103.901722
428574,6,59,65,1.313934,103.901757
428576,17,112,129,1.313201,103.902407
428577,16,0,16,1.313208,103.902506
428578,7,3,10,1.313238,103.902519
428579,7,6,13,1.313224,103.902587
428580,2,0,2,1.306419,103.902573
428581,36,14,50,1.313245,103.902733
428582,12,2,14,1.31329,103.902868
428583,0,13,13,1.313314,103.903081
428584,11,8,19,1.313312,103.902976
428585,102,4,106,1.313347,103.903234
428588,1,0,1,1.31559,103.901494
428589,0,1,1,1.31331,103.903395
428590,3,0,3,1.315411,103.901637
428591,12,0,12,1.313213,103.903465
428592,12,0,12,1.31329,103.903339
428594,15,4,19,1.313273,103.903246
428595,2,2,4,1.313256,103.903131
428596,44,12,56,1.313239,103.903089
428597,2,1,3,1.3133,103.903597
428598,7,10,17,1.313179,103.902943
428600,0,6,6,1.313149,103.90279
428601,0,29,29,1.313134,103.902666
428602,12,0,12,1.312902,103.902615
428603,6,15,21,1.312926,103.902425
428604,2,6,8,1.312843,103.902624
428606,1,0,1,1.313299,103.903622
428607,23,6,29,1.312709,103.902575
428608,12,10,22,1.312782,103.902685
428609,4,41,45,1.312658,103.90262
428610,140,4,144,1.312759,103.902727
428611,2,1,3,1.313192,103.903008
428612,0,18,18,1.312637,103.902731
428613,29,51,80,1.312302,103.903004
428614,10,9,19,1.312166,103.903086
428615,32,5,37,1.312119,103.903124
428616,73,10,83,1.312071,103.903157
428617,0,40,40,1.311851,103.903293
428618,48,0,48,1.311828,103.903342
428619,2,0,2,1.313243,103.902642
428620,29,0,29,1.311779,103.903389
428622,45,27,72,1.311721,103.903443
428623,3,1,4,1.311654,103.903483
428624,6,3,9,1.311587,103.903523
428625,30,4,34,1.311542,103.903535
428626,2,0,2,1.311802,103.903365
428627,0,6,6,1.311246,103.903862
428628,36,11,47,1.310929,103.90399
428629,24,0,24,1.310873,103.904035
428630,17,0,17,1.310831,103.904067
428631,2,11,13,1.310818,103.904082
428632,5,6,11,1.310806,103.903949
428633,13,1,14,1.310781,103.904091
428635,354,0,354,1.310705,103.904173
428636,4,2,6,1.310222,103.90373
428637,64,0,64,1.310724,103.904148
428638,8,0,8,1.310718,103.904039
428639,2,26,28,1.310589,103.904255
428640,16,0,16,1.310657,103.904087
428641,1,0,1,1.312808,103.902631
428643,3,0,3,1.312713,103.902737
428645,4,0,4,1.310446,103.904236
428646,4,1,5,1.309938,103.904714
428647,2,0,2,1.311486,103.903576
428650,0,4,4,1.309865,103.904787
428651,17,0,17,1.310315,103.904315
428653,1,13,14,1.310262,103.904393
428654,14,7,21,1.309702,103.904863
428655,4,1,5,1.310034,103.904202
428656,3,1,4,1.310052,103.903837
428657,3,0,3,1.310159,103.904348
428658,4,3,7,1.310023,103.904161
428659,77,1,78,1.309993,103.904114
428660,7,15,22,1.309971,103.904062
428662,8,1,9,1.310171,103.903646
428663,1,1,2,1.310388,103.904272
428665,1,0,1,1.310591,103.904122
428666,4,0,4,1.309969,103.903818
428667,1,0,1,1.310011,103.90377
428668,21,0,21,1.309735,103.903955
428669,3,2,5,1.309705,103.903904
428670,5,2,7,1.309459,103.903624
428671,1,0,1,1.3099,103.90386
428672,6,0,6,1.310131,103.903793
428673,0,13,13,1.309879,103.904151
428674,1,0,1,1.31019,103.903772
428675,1,0,1,1.309809,103.904046
428676,13,0,13,1.309731,103.904013
428677,1,0,1,1.309741,103.904029
428679,11,9,20,1.309884,103.904183
428680,2,4,6,1.309972,103.904578
428681,1,0,1,1.309676,103.903957
428682,44,3,47,1.310022,103.90434
428683,101,1,102,1.310038,103.904371
428684,1,0,1,1.309954,103.904271
428685,14,4,18,1.310113,103.904461
428686,2,1,3,1.310094,103.903825
428687,24,1,25,1.309817,103.904665
428688,11,1,12,1.309742,103.904713
428691,3,0,3,1.309875,103.904656
428693,1012,0,1012,1.314079,103.902417
428694,31,7,38,1.299509,103.837
428695,4,11,15,1.299509,103.837
428696,0,1,1,1.310084,103.90443
428707,3,59,62,1.302721,103.902888
428708,11,2,13,1.302674,103.902921
428709,2,2,4,1.302647,103.902936
428710,1,4,5,1.302609,103.902959
428711,0,2,2,1.31012,103.903691
428712,8,3,11,1.302534,103.902981
428713,55,4,59,1.302511,103.902987
428714,0,4,4,1.302441,103.903034
428715,1,5,6,1.302387,103.903059
428716,13,3,16,1.30233,103.903082
428717,2,1,3,1.30988,103.904228
428718,4,8,12,1.302275,103.903116
428719,34,4,38,1.302247,103.903124
428720,4,7,11,1.302225,103.903138
428721,4,683,687,1.302201,103.903154
428722,221,63,284,1.304617,103.901888
428723,172,2092,2264,1.30395,103.902269
428724,0,2,2,1.302559,103.902969
428725,0,6,6,1.303688,103.902411
428726,0,11,11,1.303635,103.902472
428727,1,0,1,1.299509,103.837
428728,6,6,12,1.303406,103.902556
428729,123,2,125,1.303363,103.902566
428730,0,7,7,1.303327,103.902586
428731,3,1,4,1.303206,103.902651
428732,1,3,4,1.303206,103.902671
428733,2,1,3,1.302302,103.903103
428734,4,0,4,1.303137,103.902683
428735,1,1,2,1.303771,103.902368
428736,0,21,21,1.303056,103.90272
428737,1,6,7,1.302934,103.902815
428738,7,10,17,1.303016,103.902751
428739,2,23,25,1.302961,103.902789
428740,5,1314,1319,1.31206,103.923541
428741,26,417,443,1.304117,103.902379
428742,3,0,3,1.303181,103.902699
428743,29,510,539,1.303916,103.902301
428744,10,1369,1379,1.31206,103.923541
428745,8,429,437,1.303846,103.902329
428746,90,3019,3109,1.304574,103.90244
428747,123,3418,3541,1.303882,103.90231
428748,1,1,2,1.303116,103.902721
428749,20,3631,3651,1.304727,103.902788
428750,10,915,925,1.304737,103.902836
428751,845,1,846,1.303775,103.902914
428752,6,991,997,1.304839,103.902865
428753,3,428,431,1.304793,103.902858
428754,6,956,962,1.304764,103.90282
428755,9,1137,1146,1.304804,103.902931
428756,13,0,13,1.304859,103.902914
428757,0,8,8,1.303854,103.903227
428758,12,14,26,1.303767,103.903244
428759,15,2,17,1.303719,103.903252
428760,53,7,60,1.303632,103.903273
428761,4,0,4,1.304878,103.902996
428762,665,178,843,1.304175,103.902927
428763,6,222,228,1.303348,103.90342
428764,8,0,8,1.304863,103.903023
428765,64,3362,3426,1.304897,103.903078
428766,806,589,1395,1.304483,103.903276
428767,14,6,20,1.304939,103.903061
428768,177,3004,3181,1.304949,103.903131
428769,6827,31617,38444,1.304351,103.904048
428770,24,423,447,1.30498,103.903259
428771,28,3364,3392,1.305008,103.903296
428772,4,0,4,1.305038,103.903342
428773,1,1156,1157,1.305068,103.903381
428774,1,0,1,1.303468,103.902516
428775,5,1981,1986,1.305125,103.903487
428776,241,1,242,1.305149,103.903531
428777,7,2178,2185,1.305193,103.903547
428778,21,961,982,1.30511,103.903808
428779,6,1136,1142,1.305201,103.903609
428780,3,910,913,1.305218,103.903653
428781,5,3261,3266,1.30526,103.9037
428782,1,4,5,1.305298,103.903779
428783,6,1425,1431,1.305349,103.903825
428784,1,522,523,1.305387,103.903833
428785,7,588,595,1.305397,103.90387
428786,8,795,803,1.30545,103.903895
428787,5,724,729,1.305431,103.903956
428788,6487,1628,8115,1.304451,103.904757
428789,10,597,607,1.305452,103.903986
428790,5,463,468,1.305473,103.904021
428791,1,301,302,1.305531,103.904027
428792,1,120,121,1.305553,103.904126
428793,6,1543,1549,1.30558,103.904171
428794,1,24,25,1.305611,103.904211
428795,1,0,1,1.305096,103.90344
428796,6,1718,1724,1.305647,103.904274
428797,3,2,5,1.305659,103.904304
428798,2,868,870,1.305684,103.904337
428799,3,22,25,1.305708,103.904356
428800,6,853,859,1.30573,103.904414
428801,3,2,5,1.305752,103.904457
428802,4793,56255,61048,1.305511,103.904622
428803,12,1011,1023,1.305891,103.904485
428804,25,111,136,1.305798,103.904528
428805,4,8,12,1.305826,103.904574
428806,3,277,280,1.305857,103.904617
428807,2,1393,1395,1.305893,103.904681
428808,5,1,6,1.305928,103.904726
428809,25,692,717,1.305851,103.905107
428810,14,1123,1137,1.305965,103.904773
428811,8,639,647,1.305999,103.905151
428812,5,837,842,1.305932,103.904768
428816,30,1156,1186,1.306044,103.904968
428817,3,291,294,1.306091,103.905315
428819,2,280,282,1.306113,103.905377
428820,9,744,753,1.306076,103.905019
428821,5,15,20,1.306123,103.905403
428822,18,835,853,1.306117,103.905066
428823,1,0,1,1.305623,103.904241
428824,3,3,6,1.306166,103.90515
428828,5,519,524,1.306144,103.905411
428829,10,24,34,1.306204,103.905166
428830,4,156,160,1.306211,103.905507
428831,0,145,145,1.306244,103.905204
428832,86,0,86,1.3062,103.905489
428833,6,105,111,1.306402,103.905156
428834,13,135,148,1.306232,103.90555
428835,23,619,642,1.306162,103.905545
428836,11,3,14,1.306301,103.905604
428837,43,1497,1540,1.306225,103.905709
428838,6,0,6,1.306076,103.905812
428839,38,0,38,1.305981,103.905847
428840,23,1,24,1.306018,103.905858
428841,2,0,2,1.31206,103.923541
428842,14,1,15,1.305933,103.905892
428843,2,2,4,1.305804,103.905986
428844,0,1,1,1.306141,103.90512
428845,3,2,5,1.305735,103.906001
428848,1,0,1,1.305823,103.905939
428849,5,0,5,1.30554,103.906112
428850,10,0,10,1.305559,103.90611
428852,10,2,12,1.305436,103.906194
428854,7,0,7,1.305374,103.906231
428855,253,3,256,1.306384,103.905722
428856,2,2,4,1.305862,103.906091
428857,1,1,2,1.305914,103.905903
428858,1,0,1,1.305656,103.906068
428859,1,0,1,1.305744,103.906181
428860,1,0,1,1.305692,103.90621
428861,2,0,2,1.305809,103.906138
428862,3,0,3,1.31206,103.923541
428863,1,0,1,1.305673,103.906231
428864,13,255,268,1.306409,103.905767
428865,14,0,14,1.306438,103.905818
428866,1,8,9,1.306465,103.905856
428867,7,0,7,1.306499,103.905906
428868,1,102,103,1.30652,103.905941
428870,1,0,1,1.305517,103.906344
428871,0,2,2,1.30562,103.906257
428872,0,62,62,1.306567,103.90603
428873,13,1987,2000,1.306594,103.905798
428874,9,1,10,1.306493,103.906196
428875,1,3,4,1.306619,103.905833
428876,23,555,578,1.306599,103.906081
428877,906,329,1235,1.306639,103.905873
428878,2,49,51,1.306625,103.906115
428879,0,1,1,1.306547,103.905989
428880,3,517,520,1.306709,103.906199
428881,9,809,818,1.306769,103.906006
428882,5,209,214,1.306729,103.906261
428884,13,8,21,1.306766,103.906283
428885,0,13,13,1.306775,103.906048
428886,7,595,602,1.30679,103.906334
428887,16,975,991,1.306829,103.90615
428888,8,537,545,1.306822,103.906379
428889,13,93,106,1.306865,103.906214
428890,17,0,17,1.306843,103.906417
428891,9,537,546,1.306904,103.906267
428892,12,467,479,1.306875,103.906469
428893,27,374,401,1.306966,103.906317
428894,7,3,10,1.306915,103.90654
428895,3,406,409,1.306952,103.906351
428896,4,842,846,1.306939,103.906559
428897,37,518,555,1.306979,103.906392
428898,15,1693,1708,1.306967,103.906603
428899,3,75,78,1.307004,103.906434
428900,6,123,129,1.307035,103.906472
428901,5,0,5,1.30706,103.906513
428902,22,1954,1976,1.307092,103.906555
428903,22,1036,1058,1.307212,103.907027
428904,8,0,8,1.307171,103.906671
428905,4,225,229,1.307266,103.907081
428906,5,11,16,1.307198,103.906684
428907,10,140,150,1.307258,103.907141
428908,4,195,199,1.30719,103.906718
428909,5,169,174,1.307314,103.907147
428910,8,921,929,1.307216,103.906754
428911,8,308,316,1.307342,103.907219
428912,6,832,838,1.307249,103.906796
428913,6,81,87,1.307333,103.907265
428914,6,116,122,1.307379,103.907299
428915,51,792,843,1.307532,103.906951
428916,2,1,3,1.305458,103.906319
428917,12,131,143,1.307425,103.907418
428918,9,1095,1104,1.307482,103.907112
428919,5,0,5,1.307461,103.907404
428920,12,197,209,1.307487,103.907151
428921,28,131,159,1.307487,103.907436
428922,5,21,26,1.307553,103.90722
428923,17,0,17,1.307508,103.907456
428924,10,199,209,1.307619,103.9073
428925,20,859,879,1.307527,103.907498
428927,11,229,240,1.307675,103.90739
428928,7,35,42,1.307695,103.907422
428929,25,945,970,1.307721,103.907491
428930,50,568,618,1.307738,103.907521
428931,37,1003,1040,1.307947,103.907848
428932,44,591,635,1.308307,103.907988
428933,0,101,101,1.30895,103.907808
428934,1,37,38,1.30895,103.907808
428935,0,3,3,1.307338,103.907331
428936,1,1,2,1.299509,103.837
428941,4,444,448,1.308198,103.908834
428942,2,177,179,1.308198,103.908901
428943,0,1,1,1.306662,103.905913
428944,33,444,477,1.308225,103.908956
428946,10,353,363,1.308228,103.909074
428948,17,183,200,1.308266,103.909174
428949,1,99,100,1.308275,103.90921
428950,17,80,97,1.308278,103.90923
428951,19,463,482,1.308286,103.909291
428952,1,1,2,1.30895,103.907808
428953,1,0,1,1.308211,103.908937
428954,1,0,1,1.308295,103.909003
428955,2,4,6,1.308325,103.909162
428956,2,0,2,1.30828,103.908932
428957,8,26,34,1.30836,103.909321
428960,214,149,363,1.308477,103.909875
428961,28,612,640,1.308224,103.909848
428962,6,326,332,1.308443,103.910124
428963,16,900,916,1.308493,103.910425
428964,2,2,4,1.3085,103.909991
428965,0,4,4,1.308511,103.910478
428966,26,667,693,1.308527,103.91055
428967,4,0,4,1.308543,103.910621
428968,3,119,122,1.308523,103.910078
428969,5,156,161,1.308556,103.910677
428970,5,0,5,1.308596,103.910327
428971,6,0,6,1.308562,103.910737
428972,83,747,830,1.308945,103.910797
428973,20,788,808,1.308571,103.910787
428974,9,9,18,1.308855,103.911177
428975,131,0,131,1.308585,103.910849
428976,11,1,12,1.308864,103.911264
428979,2,1,3,1.30895,103.907808
428981,177,1179,1356,1.308608,103.910998
428982,11,447,458,1.308631,103.911106
428983,8,0,8,1.308644,103.911142
428984,29,333,362,1.308655,103.911222
428985,7,0,7,1.308669,103.911285
428986,20,597,617,1.308684,103.911353
428987,5,0,5,1.308691,103.911391
428988,28,362,390,1.30871,103.911469
428990,178,756,934,1.308721,103.911518
428991,5,0,5,1.308731,103.911546
428992,6,48,54,1.308747,103.911575
428993,2,63,65,1.308761,103.911649
428994,28,684,712,1.308801,103.911759
428995,14,1509,1523,1.308829,103.911955
428996,564,317,881,1.308826,103.911987
428997,28,55,83,1.308838,103.912036
428998,33,148,181,1.308853,103.912105
428999,16,179,195,1.308868,103.912136
429000,5,200,205,1.30874,103.912224
429001,6,335,341,1.308766,103.912368
429002,17,157,174,1.308975,103.912669
429003,40,0,40,1.308968,103.912611
429004,8,231,239,1.308872,103.911644
429005,1,0,1,1.308311,103.909089
429006,3,70,73,1.308977,103.911733
429007,2,5,7,1.309001,103.912729
429008,71,63,134,1.308917,103.911754
429009,0,12,12,1.309015,103.912835
429010,10,104,114,1.308903,103.911864
429011,1,3,4,1.309038,103.912918
429012,2,15,17,1.308908,103.911908
429013,1,0,1,1.308499,103.912587
429014,8,88,96,1.308951,103.911948
429015,11,1,12,1.309071,103.913061
429016,2,0,2,1.308349,103.909255
429017,39,531,570,1.309081,103.913133
429018,9,500,509,1.308965,103.911991
429019,3,172,175,1.30901,103.912425
429020,0,1,1,1.309051,103.912987
429021,360,157,517,1.308736,103.913452
429024,342,145,487,1.309018,103.912594
429026,251,1,252,1.309035,103.912656
429027,7,70,77,1.309196,103.913878
429028,1,2,3,1.308864,103.911495
429029,5,37,42,1.309216,103.913919
429030,1,20,21,1.309052,103.912775
429031,0,7,7,1.309224,103.913977
429032,2,460,462,1.30907,103.912841
429033,6,293,299,1.309229,103.914021
429035,5,13,18,1.309268,103.914146
429036,0,1,1,1.309019,103.912463
429037,3,16,19,1.309275,103.914216
429039,290,0,290,1.309293,103.91427
429040,2,1,3,1.309045,103.912716
429042,0,1,1,1.309091,103.912963
429043,19,12,31,1.309142,103.913205
429044,15,411,426,1.309174,103.914617
429045,0,5,5,1.309106,103.91468
429047,1,5,6,1.308942,103.914751
429048,0,4,4,1.308869,103.914794
429049,0,17,17,1.309149,103.91326
429050,16,157,173,1.309191,103.914739
429051,5,7,12,1.308886,103.914846
429052,4,4,8,1.309164,103.913325
429053,2,161,163,1.309456,103.915172
429054,1,32,33,1.308904,103.915374
429055,4,142,146,1.30897,103.91576
429056,13,918,931,1.309361,103.915649
429058,864,31,895,1.30923,103.916644
429059,2,194,196,1.309193,103.913466
429060,5,5,10,1.309205,103.913527
429061,19,1,20,1.309213,103.913577
429063,21,641,662,1.309236,103.913701
429064,63,94,157,1.30934,103.91401
429066,0,190,190,1.309407,103.914423
429067,1,0,1,1.309122,103.913129
429069,718,1,719,1.309897,103.91449
429070,187,0,187,1.309915,103.914552
429071,69,0,69,1.309952,103.914638
429072,125,0,125,1.309973,103.914704
429073,357,168,525,1.309501,103.914917
429074,374,18,392,1.309522,103.914979
429075,280,0,280,1.309541,103.915139
429076,2,19,21,1.30955,103.915164
429077,0,284,284,1.309554,103.915211
429079,45,4,49,1.310157,103.915719
429080,52,43,95,1.309698,103.915777
429081,191,10,201,1.309781,103.916033
429082,216,10,226,1.309745,103.916277
429083,96,545,641,1.309805,103.916513
429084,22,51,73,1.309847,103.916566
429085,1,0,1,1.309399,103.914365
429088,0,351,351,1.30989,103.916988
429089,6,0,6,1.311969,103.922831
429090,8,1,9,1.303526,103.903352
429091,0,6,6,1.303472,103.903393
429092,1,6,7,1.303422,103.903418
429093,10,73,83,1.303464,103.903345
429094,6,1,7,1.308623,103.910438
429095,4,7,11,1.308637,103.910487
429096,13,118,131,1.308641,103.910533
429099,516,0,516,1.308424,103.909644
429100,256,1,257,1.309039,103.909456
429101,232,39,271,1.309206,103.909778
429102,138,1329,1467,1.309896,103.917394
429104,4,34,38,1.304315,103.902245
429105,0,5,5,1.304339,103.902229
429106,0,2,2,1.309128,103.911943
429107,0,19,19,1.304434,103.902165
429108,2,1,3,1.309112,103.913058
429109,3,20,23,1.304529,103.902101
429110,3,14,17,1.304576,103.902069
429111,1,0,1,1.30985,103.91676
429112,3,11,14,1.304671,103.902005
429113,2,5,7,1.304719,103.901973
429114,0,11,11,1.304766,103.901941
429115,2,0,2,1.304386,103.902197
429116,2,0,2,1.304814,103.901909
429117,0,27,27,1.304909,103.901845
429119,2,0,2,1.304861,103.901877
429120,0,4,4,1.305051,103.901749
429122,8,37,45,1.305175,103.901636
429123,2,7,9,1.305146,103.901685
429124,1,11,12,1.305165,103.901652
429125,0,2,2,1.305004,103.901781
429126,1,9,10,1.305186,103.901588
429127,0,2,2,1.305194,103.901653
429128,46,0,46,1.30526,103.90156
429129,0,1,1,1.304624,103.902037
429130,0,11,11,1.305318,103.901562
429133,4,0,4,1.305384,103.901525
429148,12,2,14,1.308355,103.903595
429150,1,8,9,1.308518,103.903624
429151,0,30,30,1.308547,103.903672
429152,0,5,5,1.30857,103.903703
429153,0,13,13,1.308389,103.903641
429155,0,9,9,1.308592,103.903747
429158,1,2,3,1.304481,103.902133
429160,0,2,2,1.305241,103.901621
429161,1,2,3,1.308618,103.903798
429162,0,7,7,1.308661,103.903877
429163,3,4,7,1.30852,103.9038
429164,2,1,3,1.308494,103.903783
429165,7,21,28,1.308669,103.903949
429166,0,3,3,1.308564,103.903877
429167,9,39,48,1.308731,103.904004
429169,3,18,21,1.308685,103.904022
429170,0,15,15,1.309014,103.904532
429171,3,0,3,1.308606,103.903888
429172,0,5,5,1.308853,103.904638
429174,0,3,3,1.308918,103.9046
429175,4,8,12,1.308732,103.904751
429176,1,0,1,1.305289,103.901589
429177,23,1,24,1.308636,103.904807
429179,10,5,15,1.308482,103.904774
429180,2,0,2,1.308644,103.903838
429181,4,153,157,1.308389,103.904832
429182,10,20,30,1.309137,103.904579
429183,58,0,58,1.308296,103.90495
429185,12,12,24,1.309224,103.904703
429186,1,8,9,1.308941,103.904677
429187,0,9,9,1.308972,103.904644
429188,34,101,135,1.308764,103.904825
429189,1,33,34,1.309268,103.904766
429190,203,38,241,1.308796,103.904795
429191,0,4,4,1.309311,103.904828
429192,87,14,101,1.309399,103.905001
429193,1,0,1,1.308715,103.904767
429194,7,0,7,1.309405,103.905011
429195,0,3,3,1.30881,103.904677
429196,3,10,13,1.309421,103.905014
429197,0,3,3,1.309398,103.904952
429198,10,0,10,1.309437,103.905035
429199,13,15,28,1.309454,103.905056
429200,2,7,9,1.309469,103.90505
429201,18,0,18,1.309487,103.905098
429202,1,4,5,1.309486,103.905097
429203,5,3,8,1.309497,103.905086
429204,39,4,43,1.309554,103.905158
429205,0,7,7,1.30961,103.90523
429206,10,8,18,1.309638,103.905358
429207,52,1,53,1.309666,103.905301
429208,6,2,8,1.309672,103.905419
429209,1,6,7,1.309722,103.905373
429210,1,2,3,1.309431,103.905004
429211,11,2,13,1.309754,103.905391
429212,0,12,12,1.309745,103.90551
429213,2,28,30,1.309777,103.905424
429214,19,0,19,1.309792,103.905572
429215,63,15,78,1.309816,103.905471
429216,54,0,54,1.309799,103.905444
429217,1,0,1,1.309354,103.90489
429218,3,3,6,1.310098,103.905136
429219,0,2,2,1.308433,103.904821
429220,2,5,7,1.310185,103.905067
429221,6,11,17,1.3105,103.905261
429222,1,0,1,1.310036,103.905147
429223,3,45,48,1.309834,103.905621
429225,5,5,10,1.310135,103.905355
429226,1,2,3,1.30971,103.905465
429227,0,6,6,1.310011,103.905704
429228,2,3,5,1.309884,103.905678
429229,16,4,20,1.31026,103.905759
429230,1,5,6,1.310229,103.906041
429231,0,9,9,1.31028,103.906101
429232,43,3,46,1.309973,103.905756
429233,106,1,107,1.310357,103.906181
429234,0,5,5,1.309995,103.905788
429235,24,0,24,1.310326,103.906141
429237,12,3,15,1.310384,103.906241
429239,1,19,20,1.310131,103.905978
429240,7,0,7,1.31013,103.905977
429242,10,0,10,1.310164,103.906021
429243,10,0,10,1.310163,103.90602
429244,21,0,21,1.310163,103.90602
429245,1,2,3,1.309867,103.905658
429246,3,5,8,1.310232,103.906175
429247,850,76,926,1.310468,103.906402
429248,0,29,29,1.310278,103.906212
429249,6,5,11,1.310531,103.90648
429250,9,0,9,1.310342,103.906303
429251,0,6,6,1.310685,103.906628
429252,1,38,39,1.310397,103.90637
429254,49,3,52,1.310501,103.906533
429255,2,8,10,1.310797,103.906818
429256,4,2,6,1.310543,103.906563
429257,0,9,9,1.310847,103.906856
429259,5,1,6,1.310616,103.906644
429262,8,0,8,1.310759,103.906822
429263,13,2,15,1.310807,103.906884
429264,2,2,4,1.310168,103.905678
429265,3,0,3,1.310431,103.90635
429266,318,15,333,1.309112,103.904975
429277,0,2,2,1.310162,103.905118
429278,24,4,28,1.309679,103.905893
429279,2,1,3,1.310279,103.90501
429280,3,0,3,1.309685,103.905963
429281,36,4,40,1.30963,103.905987
429282,11,1,12,1.309596,103.90595
429283,4,0,4,1.309583,103.906006
429285,2,1,3,1.309633,103.905907
429286,2,2,4,1.309493,103.906038
429287,7,0,7,1.309457,103.906076
429303,5,0,5,1.310205,103.906559
429304,11,4,15,1.310197,103.906674
429305,5,0,5,1.310154,103.906589
429306,1,1,2,1.309745,103.905932
429307,0,2,2,1.310151,103.90671
429308,0,1,1,1.310421,103.905244
429309,23,6,29,1.310077,103.906652
429310,0,5,5,1.30997,103.906804
429312,8,20,28,1.309924,103.90685
429313,3,1,4,1.310024,103.906743
429314,2,38,40,1.309935,103.906812
429315,3,0,3,1.309467,103.906086
429316,4,0,4,1.309836,103.906632
429318,129,3,132,1.309836,103.906632
429319,1,0,1,1.310095,103.906709
429320,2,1,3,1.309837,103.906633
429321,3,0,3,1.309836,103.906632
429322,8,4,12,1.309605,103.906564
429325,11,0,11,1.309673,103.90668
429326,0,10,10,1.30973,103.906784
429327,40,21,61,1.309797,103.906863
429328,1,0,1,1.309836,103.906632
429329,1,3,4,1.309848,103.906944
429330,2,0,2,1.299509,103.837
429331,1,2,3,1.309585,103.906537
429332,5,0,5,1.309819,103.907269
429333,0,3,3,1.3099,103.907044
429335,89,0,89,1.309924,103.907368
429350,5,3,8,1.312918,103.899566
429351,2,109,111,1.312951,103.899444
429352,2,4,6,1.312525,103.899347
429353,3,0,3,1.309872,103.907301
429355,0,1,1,1.309836,103.90689
429356,72,73,145,1.312547,103.899319
429357,4,3,7,1.312506,103.898953
429359,5,5,10,1.312445,103.898881
429360,5,24,29,1.312427,103.898851
429361,4,0,4,1.312227,103.898442
429363,4,0,4,1.312192,103.898408
429364,0,1,1,1.312951,103.899444
429365,48,4,52,1.312167,103.898373
429366,0,1,1,1.31222,103.89852
429367,19,0,19,1.31214,103.898349
429368,1,15,16,1.312152,103.898434
429369,0,1,1,1.312184,103.898473
429370,1,5,6,1.312127,103.898402
429371,4,2,6,1.31208,103.898282
429372,1,2,3,1.312951,103.899444
429373,0,2,2,1.309863,103.906988
429374,1,9,10,1.312073,103.898325
429377,4,43,47,1.312036,103.898284
429380,3,45,48,1.312009,103.898244
429381,116,119,235,1.311979,103.898137
429384,2,0,2,1.312059,103.898252
429400,2,137,139,1.317075,103.905685
429401,0,7,7,1.316641,103.906854
429402,14,0,14,1.317096,103.90632
429417,1,6,7,1.313831,103.905725
429418,0,3,3,1.312097,103.898365
429419,2,0,2,1.311951,103.898102
429420,1,0,1,1.31211,103.898322
429421,1,2,3,1.313812,103.905733
429422,0,2,2,1.313875,103.905792
429424,3,0,3,1.313875,103.905792
429425,1,0,1,1.313864,103.905692
429426,1,0,1,1.313714,103.905819
429428,3,2,5,1.313677,103.90583
429430,1,0,1,1.313653,103.905856
429432,9,1,10,1.313585,103.905914
429433,21,160,181,1.313584,103.905984
429434,21,3,24,1.313601,103.905904
429435,0,1,1,1.313604,103.905857
429450,6,3,9,1.306967,103.905919
429451,8,16,24,1.307387,103.905934
429452,0,1,1,1.313538,103.905961
429453,0,1,1,1.307435,103.905999
429454,3,1,4,1.307475,103.906055
429455,1,0,1,1.307096,103.905834
429456,7,0,7,1.307066,103.905862
429457,26,1,27,1.307517,103.906104
429458,4,2,6,1.307547,103.906161
429459,0,1,1,1.30749,103.906085
429460,9,0,9,1.307581,103.906229
429461,9,3,12,1.307617,103.90626
429462,1,7,8,1.307211,103.905769
429463,24,5,29,1.30768,103.906226
429465,11,0,11,1.307283,103.905716
429466,18,21,39,1.307237,103.90575
429467,50,1,51,1.307962,103.905889
429468,3,2,5,1.307573,103.90608
429471,3,0,3,1.313744,103.905797
429472,8,1,9,1.307472,103.905902
429473,3,9,12,1.307441,103.905852
429474,3,0,3,1.307324,103.905671
429475,70,7,77,1.307764,103.905576
429476,4,9,13,1.307799,103.905625
429478,166,9,175,1.307841,103.905691
429479,2,1,3,1.307317,103.905696
429480,0,1,1,1.307144,103.905807
429482,0,3,3,1.307529,103.905993
429483,2,2,4,1.307949,103.905876
429484,21,0,21,1.307625,103.906157
429485,0,3,3,1.307597,103.906129
429486,4,0,4,1.307626,103.905466
429487,0,1,1,1.30748,103.90557
429502,2,3,5,1.306957,103.907069
429503,21,0,21,1.306913,103.9071
429504,0,2,2,1.313772,103.905762
429505,1,0,1,1.307687,103.905435
429506,1,1,2,1.306879,103.907154
429509,454,24,478,1.306943,103.90666
429510,174,46,220,1.30655,103.907374
429511,3,22,25,1.306306,103.907384
429512,19,46,65,1.306197,103.907406
429515,91,0,91,1.30645,103.907779
429516,0,4,4,1.306132,103.90759
429520,80,2,82,1.306127,103.907771
429521,1,0,1,1.306842,103.907161
429522,6,0,6,1.305951,103.90771
429523,10,2,12,1.306033,103.907763
429524,0,15,15,1.305902,103.907742
429525,8,2,10,1.305941,103.907857
429526,6,16,22,1.305871,103.90777
429527,2,0,2,1.306818,103.907166
429528,5,7,12,1.305795,103.90783
429530,8,5,13,1.30572,103.907889
429531,25,8,33,1.30575,103.907999
429532,5,0,5,1.305688,103.907904
429533,6,3,9,1.305717,103.908039
429534,3,34,37,1.305643,103.90794
429535,1,1,2,1.305835,103.907803
429536,125,0,125,1.305606,103.907941
429537,11,3,14,1.305652,103.908077
429538,57,9,66,1.305575,103.907955
429539,7,1,8,1.305547,103.908143
429540,2,0,2,1.305675,103.90806
429541,3,0,3,1.308035,103.905991
429542,19,5,24,1.305512,103.90803
429543,1,2,3,1.305468,103.908205
429544,1,0,1,1.305986,103.907696
429545,179,89,268,1.305357,103.908334
429546,21,0,21,1.30537,103.908147
429547,2,15,17,1.306308,103.907277
429548,137,38,175,1.299509,103.837
429561,8,0,8,1.307608,103.906636
429562,0,1,1,1.305448,103.908098
429564,1,5,6,1.307715,103.906659
429565,0,6,6,1.307767,103.906551
429566,10,4,14,1.307807,103.906527
429567,2,9,11,1.307815,103.906598
429568,5,10,15,1.307891,103.906496
429569,2,4,6,1.307861,103.906569
429570,0,3,3,1.305415,103.908261
429571,11,0,11,1.30793,103.906527
429572,4,3,7,1.308009,103.906415
429573,0,5,5,1.308027,103.906507
429574,30,1,31,1.30807,103.906366
429575,2,12,14,1.308102,103.906419
429576,2,3,5,1.308135,103.90633
429577,5,3,8,1.308173,103.906392
429578,0,2,2,1.305582,103.907974
429579,2,0,2,1.308202,103.906276
429580,2,9,11,1.308264,103.906226
429581,2,1,3,1.307942,103.906456
429582,0,4,4,1.30763,103.90673
429583,20,1,21,1.307664,103.906712
429584,5,1,6,1.307782,103.906619
429596,7,23,30,1.305221,103.903071
429597,2,3,5,1.305205,103.90299
429598,6,0,6,1.305236,103.902956
429599,4,0,4,1.305278,103.902937
429600,10,0,10,1.30527,103.903054
429601,5,36,41,1.30532,103.902907
429602,2,140,142,1.305298,103.903019
429603,4,64,68,1.305362,103.902874
429604,4,28,32,1.305348,103.902973
429605,2,2,4,1.305398,103.902845
429606,21,15,36,1.305387,103.902943
429607,4,92,96,1.305441,103.902811
429609,2,8,10,1.305477,103.902789
429611,11,208,219,1.305509,103.902761
429613,207,0,207,1.30576,103.902398
429615,74,2,76,1.305718,103.90261
429616,1,240,241,1.305796,103.902657
429619,1,0,1,1.307645,103.906608
429620,10,0,10,1.30589,103.902476
429621,80,1,81,1.305919,103.902587
429623,53,0,53,1.305989,103.902524
429624,6,42,48,1.306014,103.902392
429626,2,0,2,1.30822,103.906331
429627,2,6,8,1.306146,103.902389
429628,7,14,21,1.306173,103.902256
429629,245,7,252,1.306216,103.902339
429630,121,18,139,1.306072,103.901626
429631,49,17,66,1.306644,103.902024
429632,9,2,11,1.307085,103.901609
429633,6,1,7,1.307139,103.901568
429634,101,16,117,1.30691,103.902071
429635,12,1,13,1.30718,103.901522
429637,0,14,14,1.307221,103.90149
429638,44,3,47,1.307018,103.901741
429640,1,2,3,1.308394,103.906476
429642,2,0,2,1.306118,103.902298
429643,31,8,39,1.307488,103.901315
429645,1,1,2,1.307155,103.901625
429646,54,4,58,1.307253,103.901557
429647,5,0,5,1.307618,103.901216
429648,2,0,2,1.307546,103.901264
429649,8,11,19,1.307396,103.901451
429650,2,7,9,1.307566,103.901357
429651,34,0,34,1.307847,103.901044
429653,0,7,7,1.30767,103.901265
429655,0,10,10,1.307792,103.901213
429656,0,8,8,1.307805,103.901163
429657,1,0,1,1.30586,103.902644
429658,0,6,6,1.307881,103.901094
429659,20,14,34,1.30793,103.901063
429660,3,1,4,1.307982,103.901035
429661,0,15,15,1.308023,103.901009
429662,6,24,30,1.308018,103.900921
429663,1,8,9,1.308023,103.901009
429664,1,12,13,1.308074,103.900976
429665,52,0,52,1.308061,103.900898
429666,2,2,4,1.308134,103.900921
429667,5,26,31,1.308183,103.900783
429668,1,0,1,1.307843,103.901129
429669,2,1,3,1.307115,103.90166
429671,1,2,3,1.308182,103.900894
429672,1,5,6,1.308346,103.900694
429673,6,1,7,1.308346,103.900694
429674,145,17,162,1.308305,103.900823
429675,1,6,7,1.308384,103.900668
429676,18,0,18,1.308457,103.900612
429677,2,27,29,1.308499,103.900675
429678,8,0,8,1.308532,103.900551
429679,133,3,136,1.308603,103.900635
429680,3,0,3,1.30832,103.900709
429681,17,0,17,1.308836,103.899946
429684,1,0,1,1.308229,103.900759
429686,1,0,1,1.308836,103.899946
429688,5,0,5,1.308836,103.899946
429690,194,1,195,1.309144,103.900001
429691,12,209,221,1.30958,103.899932
429692,0,3,3,1.308837,103.899947
429693,1,0,1,1.308836,103.899946
429694,5,7,12,1.30981,103.899769
429695,3,3,6,1.309864,103.899748
429696,5,0,5,1.309873,103.899723
429697,3,61,64,1.309945,103.899695
429698,16,0,16,1.309981,103.899644
429699,3,12,15,1.310042,103.899611
429700,1,4,5,1.310185,103.899509
429701,16,20,36,1.31057,103.899483
429702,14,42,56,1.310378,103.899346
429703,8,23,31,1.310372,103.89931
429704,110,3,113,1.310376,103.899287
429705,1,3,4,1.31041,103.899282
429706,1,0,1,1.309752,103.899823
429708,36,10,46,1.310563,103.899167
429709,9,0,9,1.310639,103.89911
429710,1,0,1,1.310486,103.899224
429711,10,3,13,1.310671,103.899066
429712,9,4,13,1.310715,103.899052
429714,52,1,53,1.310791,103.898995
429715,6,0,6,1.31079,103.898994
429716,2,1,3,1.309704,103.899848
429718,12,0,12,1.310944,103.89888
429719,9,5,14,1.310784,103.898932
429720,1,0,1,1.310638,103.899109
429721,2,1,3,1.31084,103.898939
429722,1,0,1,1.31102,103.898823
429723,8,16,24,1.311027,103.898781
429724,28,10,38,1.311173,103.898708
429725,0,6,6,1.311093,103.898732
429726,3,5,8,1.311249,103.898651
429727,4,6,10,1.311181,103.89865
429728,2,0,2,1.307356,103.901483
429729,28,4,32,1.311222,103.898625
429730,14,0,14,1.311475,103.898512
429731,2,0,2,1.311325,103.898594
429732,1,0,1,1.311039,103.898767
429733,0,1,1,1.311524,103.898465
429734,4,3,7,1.311695,103.898371
429735,1,3,4,1.311746,103.898341
429737,11,2,13,1.311282,103.898584
429738,2,4,6,1.311322,103.898551
429740,19,0,19,1.307808,103.900779
429741,2,32,34,1.311445,103.898471
429742,1,14,15,1.311096,103.898766
429743,2,11,13,1.310947,103.898842
429744,178,38,216,1.310072,103.899418
429745,0,7,7,1.306462,103.902133
429746,2,25,27,1.311561,103.898355
429747,14,114,128,1.311689,103.898277
429748,239,4,243,1.305372,103.902991
429749,106,8,114,1.305629,103.902781
429750,1,1,2,1.311548,103.898452
429751,1,0,1,1.311604,103.898426
429753,32,1,33,1.314348,103.897399
429754,243,10,253,1.314229,103.897251
429755,0,11,11,1.314128,103.897416
429756,0,1,1,1.314428,103.897532
429757,1,3,4,1.314128,103.897416
429758,4,8,12,1.314093,103.897374
429759,11,0,11,1.31404,103.897478
429760,0,3,3,1.310891,103.898887
429761,39,2,41,1.313973,103.897462
429762,5,0,5,1.313977,103.897526
429763,138,0,138,1.313905,103.897509
429764,0,3,3,1.314021,103.897423
429765,5,4,9,1.313854,103.897555
429766,1,3,4,1.313852,103.897619
429767,1,0,1,1.314128,103.897416
429769,1,2,3,1.313913,103.897578
429773,2,0,2,1.307695,103.901174
429776,51,0,51,1.313691,103.897726
429777,44,73,117,1.313514,103.897781
429780,1,0,1,1.313789,103.897573
429781,6,3,9,1.313188,103.897916
429782,1,4,5,1.313295,103.898056
429783,3,5,8,1.313235,103.898096
429790,6,61,67,1.313063,103.898218
429791,5,35,40,1.313016,103.898261
429792,4,4,8,1.312964,103.898288
429796,0,9,9,1.312741,103.898311
429798,0,2,2,1.313668,103.897666
429799,0,1,1,1.313367,103.897988
429800,10,6,16,1.312514,103.898467
429801,1,0,1,1.312569,103.898421
429802,2,4,6,1.312498,103.898475
429804,1,8,9,1.312466,103.898501
429805,0,4,4,1.312413,103.898538
429806,8,0,8,1.312546,103.898562
429808,0,4,4,1.312388,103.898556
429809,11,0,11,1.312451,103.89862
429811,0,6,6,1.312359,103.898574
429812,7,6,13,1.312406,103.898648
429813,0,29,29,1.312525,103.898856
429814,0,33,33,1.312338,103.898595
429815,8,4,12,1.312085,103.89885
429816,3,5,8,1.312085,103.89885
429818,0,1,1,1.312663,103.898483
429819,0,6,6,1.311994,103.898922
429820,3,6,9,1.311943,103.898951
429821,12,0,12,1.311892,103.898999
429822,2,0,2,1.31264,103.898375
429823,16,8,24,1.311841,103.899037
429824,12,6,18,1.311901,103.898919
429825,20,1,21,1.311789,103.899066
429826,132,12,144,1.311842,103.898957
429827,4,0,4,1.311742,103.899108
429828,91,6,97,1.311787,103.898999
429829,3,0,3,1.313734,103.897634
429830,1,5,6,1.311696,103.899148
429831,21,9,30,1.311726,103.899051
429832,3,6,9,1.311726,103.899051
429833,3,0,3,1.311787,103.898999
429834,2,3,5,1.3116,103.899213
429835,7,1,8,1.311562,103.899253
429836,11,3,14,1.311523,103.899183
429837,1,0,1,1.31204,103.898884
429838,4,2,6,1.311465,103.899316
429839,5,1,6,1.311457,103.899226
429840,38,8,46,1.311433,103.899248
429841,30,0,30,1.311425,103.899354
429842,5,0,5,1.311371,103.899302
429843,0,1,1,1.311509,103.899276
429844,1,0,1,1.311354,103.89931
429845,0,3,3,1.311647,103.899184
429846,3,0,3,1.311366,103.899392
429847,5,4,9,1.311189,103.899433
429848,1,3,4,1.311143,103.899456
429849,1,2,3,1.311229,103.899404
429850,4,2,6,1.311319,103.899434
429851,122,0,122,1.311075,103.899498
429852,1,0,1,1.311273,103.899367
429853,18,2,20,1.311245,103.899497
429854,10,2,12,1.311049,103.899512
429855,2,0,2,1.311969,103.898864
429856,6,10,16,1.311167,103.899547
429857,3,0,3,1.311319,103.899434
429858,3,0,3,1.311167,103.899547
429859,13,0,13,1.311101,103.899604
429860,17,1,18,1.310925,103.899625
429861,1,0,1,1.311245,103.899497
429864,2,9,11,1.311028,103.899563
429865,0,8,8,1.310571,103.900028
429866,1,14,15,1.310157,103.899527
429868,2,2,4,1.310437,103.900105
429869,4,0,4,1.310379,103.900138
429870,4,1,5,1.310404,103.900176
429872,0,9,9,1.310627,103.899882
429873,17,0,17,1.310577,103.89992
429874,1,6,7,1.310526,103.899949
429875,10,0,10,1.310492,103.899974
429876,27,2,29,1.310443,103.900002
429877,0,6,6,1.310265,103.900213
429878,11,3,14,1.310365,103.900046
429879,2,0,2,1.310993,103.899558
429880,28,0,28,1.310298,103.900094
429881,4,0,4,1.31026,103.900306
429882,1,1,2,1.310246,103.900269
429885,1,0,1,1.311021,103.899675
429886,2,10,12,1.310057,103.900262
429888,0,1,1,1.310231,103.900363
429889,2,0,2,1.310219,103.90015
429890,0,2,2,1.309964,103.900322
429891,0,14,14,1.309768,103.900571
429892,1,262,263,1.309828,103.900421
429893,1,65,66,1.309706,103.900605
429894,0,3,3,1.310948,103.899593
429895,2,9,11,1.30891,103.901236
429896,2,0,2,1.309989,103.900433
429897,3,2,5,1.308822,103.90123
429898,0,2,2,1.308856,103.901281
429899,12,1,13,1.308832,103.901145
429900,2,4,6,1.308696,103.901363
429902,0,1,1,1.310025,103.900405
429903,1,1,2,1.308739,103.901329
429904,55,1,56,1.30863,103.901429
429905,14,0,14,1.308661,103.901661
429906,2,4,6,1.308567,103.901323
429907,1,1,2,1.308698,103.901244
429908,67,0,67,1.308522,103.901361
429909,1,3,4,1.308425,103.901457
429911,0,1,1,1.308703,103.901403
429912,6,6,12,1.308439,103.901638
429913,6,4,10,1.308405,103.901446
429914,42,8,50,1.308376,103.90162
429915,8,3,11,1.308403,103.901465
429916,21,0,21,1.308332,103.901686
429917,0,1,1,1.308461,103.901416
429918,0,4,4,1.308243,103.901693
429919,2,0,2,1.308509,103.901523
429920,28,3,31,1.3082,103.901747
429921,0,15,15,1.308352,103.901526
429922,0,1,1,1.308379,103.90148
429923,1,3,4,1.308312,103.902276
429924,0,7,7,1.308147,103.901676
429925,0,13,13,1.307754,103.902087
429926,1,2,3,1.308986,103.901176
429927,0,3,3,1.30768,103.902122
429928,0,2,2,1.308258,103.901591
429929,7,0,7,1.307639,103.902162
429930,4,1,5,1.308112,103.901698
429931,2,0,2,1.308115,103.90167
429932,0,4,4,1.308058,103.901742
429933,1,2,3,1.308133,103.901642
429934,1,4,5,1.307967,103.9018
429935,8,0,8,1.307518,103.902253
429936,2,2,4,1.307497,103.902249
429937,3,0,3,1.307616,103.902227
429938,3,1,4,1.307385,103.902341
429939,10,0,10,1.307291,103.902396
429940,12,3,15,1.30771,103.901988
429941,76,1,77,1.307625,103.902072
429942,0,1,1,1.308304,103.901572
429943,4,0,4,1.307548,103.902102
429944,2,2,4,1.307515,103.902132
429946,1,2,3,1.307436,103.902333
429947,3,7,10,1.307395,103.902244
429948,0,2,2,1.307586,103.902195
429949,1,0,1,1.30759,103.902091
429950,0,6,6,1.307245,103.902364
429951,10,0,10,1.307215,103.902387
429952,0,12,12,1.307186,103.902375
429953,0,21,21,1.307162,103.902402
429954,25,1,26,1.30712,103.902422
429955,2,9,11,1.307109,103.902391
429956,2,1,3,1.307418,103.90223
429957,41,0,41,1.307036,103.902461
429958,1,4,5,1.307011,103.902486
429961,1,4,5,1.306906,103.902546
429963,4,3,7,1.306881,103.902621
429964,36,6,42,1.30685,103.902651
429966,25,2,27,1.312897,103.89833
429968,1,3,4,1.31282,103.898383
429970,8,1,9,1.312741,103.898425
429971,0,1,1,1.307333,103.902297
429972,9,0,9,1.31358,103.897727
429973,5,1,6,1.312576,103.898532
429974,629,44,673,1.31276,103.898254
429975,8,13,21,1.312195,103.898773
429976,2,2,4,1.314093,103.897374
429977,10,5,15,1.299509,103.837
429979,124,149,273,1.304191,103.903803
429984,282,256,538,1.303376,103.903907
429986,290,104,394,1.303908,103.903649
430001,1097,275,1372,1.311343,103.897426
430002,482,56,538,1.312448,103.89746
430003,1304,410,1714,1.31175,103.897224
430004,613,531,1144,1.312169,103.897001
430005,519,682,1201,1.312657,103.896445
430006,506,168,674,1.313193,103.897008
430007,1215,450,1665,1.313872,103.896635
430008,403,647,1050,1.313745,103.895902
430009,348,1265,1613,1.314452,103.895864
430010,676,393,1069,1.314855,103.895652
430011,498,301,799,1.314895,103.896401
430012,62,1887,1949,1.315636,103.896008
430013,26,90,116,1.314987,103.895167
430014,50,16851,16901,1.315383,103.895481
430021,108,145,253,1.313124,103.895063
430022,110,2798,2908,1.313873,103.895025
430023,343,2478,2821,1.313655,103.895285
431001,190,2088,2278,1.303548,103.883727
431002,284,3492,3776,1.303228,103.883784
431003,105,129,234,1.302871,103.883823
431004,69,23,92,1.301913,103.884039
431005,14,2744,2758,1.30162,103.883978
431006,268,2683,2951,1.301355,103.883958
431007,109,57,166,1.302407,103.883568
431008,221,97,318,1.302746,103.883066
431009,271,513,784,1.302847,103.882942
431010,362,272,634,1.301943,103.882927
431011,575,558,1133,1.30161,103.882607
431012,360,539,899,1.300918,103.883667
431014,605,127,732,1.300243,103.884217
432004,15,29,44,1.302428,103.883923
432005,11,854,865,1.30151,103.883502
432014,12,40,52,1.30031,103.883614
436353,0,1,1,1.312708,103.898455
436504,2,5,7,1.299509,103.837
436509,53,19,72,1.305721,103.894315
436510,14,0,14,1.299509,103.837
436511,3,0,3,1.307077,103.902412
436512,7,9,16,1.299509,103.837
436513,1,1,2,1.307353,103.90228
436519,27,8,35,1.299509,103.837
436520,0,1,1,1.299509,103.837
436524,12,0,12,1.300035,103.893761
436525,1,0,1,1.299509,103.837
436526,1,0,1,1.299987,103.893703
436527,2,0,2,1.299509,103.837
436528,200,0,200,1.300196,103.893515
436529,13,0,13,1.300238,103.893577
436530,3,0,3,1.299509,103.837
436531,31,1,32,1.300248,103.893716
436532,4,0,4,1.30029,103.893751
436533,5,1,6,1.300321,103.893802
436534,13,25,38,1.300331,103.893879
436535,4,8,12,1.299509,103.837
436536,15,4,19,1.299509,103.837
436539,2,2,4,1.301044,103.890837
436544,1,5,6,1.30461,103.893208
436545,4,2,6,1.30461,103.893208
436546,6,10,16,1.30461,103.893208
436547,77,6,83,1.30448,103.8935
436548,0,1,1,1.299976,103.893676
436549,0,1,1,1.30461,103.893208
436552,4,0,4,1.304292,103.893523
436554,58,15,73,1.302834,103.893055
436556,10,0,10,1.299509,103.837
436558,0,1,1,1.30461,103.893208
436559,188,0,188,1.301864,103.88758
436562,10,0,10,1.302693,103.892028
436563,9,28,37,1.302692,103.892031
436565,30,5,35,1.30579,103.894218
436566,0,3,3,1.300262,103.893633
436567,9,8,17,1.305799,103.894066
436568,2,41,43,1.305792,103.893946
436569,60,2,62,1.30329,103.886724
436570,9,2,11,1.303283,103.886608
436571,4,2,6,1.30327,103.886171
436573,1,1,2,1.299951,103.893619
436574,1,0,1,1.299509,103.837
436575,40,0,40,1.304427,103.890719
436576,13,0,13,1.304427,103.890719
436577,5,0,5,1.304427,103.890719
436578,14,13,27,1.304611,103.893209
436579,16,191,207,1.298306,103.894748
436580,2,4,6,1.304999,103.893127
436582,0,1,1,1.304448,103.889056
436583,9,0,9,1.300056,103.893823
436586,5,0,5,1.303225,103.8957
436587,13,81,94,1.303221,103.895731
436588,0,3,3,1.305804,103.894164
436589,3,0,3,1.303203,103.895761
436590,104,1,105,1.302466,103.895569
436591,15,0,15,1.302483,103.895657
436592,8,0,8,1.302494,103.895727
436593,3482,939,4421,1.300827,103.881803
436594,10,0,10,1.303219,103.892974
436595,2,67,69,1.305504,103.893761
436596,35,0,35,1.305374,103.893645
436597,53,0,53,1.3054,103.893672
436598,5,10,15,1.301849,103.893672
436599,0,6,6,1.302198,103.893275
436600,2,9,11,1.30262,103.896384
436601,1,0,1,1.300051,103.893907
436602,6,1,7,1.302704,103.896176
436603,109,7,116,1.301553,103.891927
436604,35,0,35,1.301626,103.892228
436605,2,4,6,1.301607,103.892137
436606,1024,117,1141,1.296242,103.873149
436607,4203,295,4498,1.296014,103.872569
436608,909,190,1099,1.296224,103.872152
436609,0,2,2,1.301807,103.892484
436612,5,20,25,1.302116,103.894108
436613,46,0,46,1.302107,103.894007
436617,1,0,1,1.302618,103.896304
436618,4,0,4,1.302278,103.895588
436619,1,0,1,1.302304,103.895668
436620,1,1,2,1.301807,103.892484
436621,75,42,117,1.299004,103.872907
436622,0,29,29,1.304776,103.901323
436623,0,5,5,1.304204,103.885955
436624,0,2,2,1.301513,103.891595
436625,3,0,3,1.302454,103.895501
436626,3,0,3,1.304649,103.885909
436627,1,2,3,1.304814,103.88589
436628,4,8,12,1.304851,103.886243
436629,4,16,20,1.304866,103.886384
436630,11,0,11,1.304873,103.886451
436631,29,0,29,1.304955,103.885956
436632,4,25,29,1.304885,103.886479
436633,7,2,9,1.305011,103.885978
436634,9,9,18,1.30502,103.885977
436635,16,7,23,1.305031,103.885977
436636,3,0,3,1.304842,103.886105
436638,11,4,15,1.305232,103.885944
436639,25,4,29,1.305232,103.885964
436640,0,4,4,1.305341,103.885915
436641,9,3,12,1.305417,103.885956
436642,1,3,4,1.304386,103.88593
436643,4,6,10,1.304476,103.885938
436654,8,5,13,1.299509,103.837
436657,7,3,10,1.303165,103.896488
436658,11,5,16,1.30313,103.896236
436659,1,13,14,1.303282,103.896319
436660,0,1,1,1.301533,103.891762
436661,9,0,9,1.303301,103.896156
436662,2,0,2,1.304457,103.886029
436663,4,14,18,1.303216,103.895988
436664,23,12,35,1.30314,103.896082
436665,16,0,16,1.303195,103.895709
436666,3,0,3,1.305185,103.885916
436667,39,6,45,1.303198,103.895455
436668,165,0,165,1.303189,103.895494
436669,39,9,48,1.303102,103.895753
436670,1,7,8,1.303182,103.895413
436671,2,0,2,1.3033,103.89626
436672,2,16,18,1.303131,103.89482
436673,138,32,170,1.303041,103.895489
436674,10,0,10,1.303096,103.894649
436675,17,1,18,1.30315,103.894484
436676,0,3,3,1.303332,103.89559
436677,0,7,7,1.303041,103.895236
436678,0,1,1,1.303288,103.896052
436679,3,0,3,1.303123,103.894486
436680,102,4,106,1.30299,103.894923
436681,1,0,1,1.303005,103.895137
436683,0,1,1,1.303062,103.894192
436684,7,5,12,1.302977,103.894572
436685,9,0,9,1.303026,103.893861
436686,3,0,3,1.303081,103.894353
436688,5,6,11,1.302944,103.894391
436690,36,0,36,1.302696,103.894259
436691,50,42,92,1.302866,103.894074
436693,11,0,11,1.302664,103.89409
436694,6,3,9,1.302847,103.893897
436695,1,2,3,1.302963,103.894473
436696,8,0,8,1.302642,103.893965
436697,2,4,6,1.302826,103.893724
436698,3,0,3,1.302883,103.892841
436699,101,2,103,1.302822,103.893552
436700,0,2,2,1.303165,103.895054
436701,103,2,105,1.302901,103.892406
436702,60,1,61,1.302834,103.892924
436704,11,0,11,1.302796,103.892715
436705,0,16,16,1.302899,103.892147
436706,1,13,14,1.302794,103.892571
436707,9,0,9,1.302872,103.892026
436708,23,0,23,1.302773,103.892385
436709,56,0,56,1.302715,103.89242
436710,7,21,28,1.302764,103.892263
436711,2,3,5,1.302851,103.89153
436712,13,0,13,1.302823,103.891296
436713,3,0,3,1.302612,103.893804
436714,2,1,3,1.302811,103.891038
436715,22,0,22,1.302754,103.890753
436716,27,0,27,1.302191,103.891828
436717,49,2,51,1.302743,103.890607
436719,31,9,40,1.302663,103.891249
436720,10,2,12,1.302661,103.891078
436721,44,0,44,1.302619,103.890778
436722,118,2,120,1.30267,103.890105
436723,39,9,48,1.302648,103.889905
436724,7,0,7,1.302552,103.890173
436725,34,0,34,1.302665,103.88982
436726,1,0,1,1.303034,103.89408
436727,0,2,2,1.302923,103.892596
436728,1,0,1,1.302553,103.889824
436730,81,1,82,1.302193,103.88938
436731,94,0,94,1.302661,103.889455
436732,4,4,8,1.302644,103.889347
436733,7,2,9,1.30275,103.88914
436734,0,5,5,1.302627,103.889058
436736,2,2,4,1.302606,103.88891
436737,1,0,1,1.30217,103.889641
436738,2,0,2,1.302648,103.889621
436740,1,2,3,1.302233,103.892042
436741,14,11,25,1.302471,103.887352
436742,1,0,1,1.301977,103.888765
436743,5,13,18,1.302425,103.886987
436744,14,15,29,1.302425,103.886836
436745,10,0,10,1.302411,103.886712
436746,0,6,6,1.302353,103.88656
436747,3,0,3,1.30278,103.888662
436748,17,0,17,1.302364,103.886266
436749,2,46,48,1.302354,103.88614
436750,1,55,56,1.302355,103.886014
436751,8,367,375,1.302361,103.885788
436752,246,91,337,1.302126,103.88607
436753,1,0,1,1.302443,103.887128
436754,0,1,1,1.302713,103.89029
436755,1,0,1,1.302929,103.890882
436756,3,41,44,1.302747,103.892009
436757,28,1,29,1.30273,103.891891
436758,2,12,14,1.303091,103.894708
436759,5,2,7,1.303187,103.89521
436760,7,2,9,1.302633,103.890903
436761,6,20,26,1.302578,103.890594
436764,15,0,15,1.302547,103.890041
436765,0,2,2,1.302589,103.888787
436766,109,0,109,1.303255,103.895818
436767,1,0,1,1.302929,103.890875
436768,11,234,245,1.308079,103.894728
436769,0,1,1,1.303269,103.895986
436770,5,1,6,1.308071,103.894661
436771,10,0,10,1.307935,103.894568
436772,0,1,1,1.307971,103.894668
436773,2,0,2,1.302898,103.894314
436774,16,6,22,1.308004,103.894515
436777,0,2,2,1.307835,103.894347
436778,2,1,3,1.302377,103.886396
436779,1,2,3,1.307914,103.89394
436780,7,6,13,1.307902,103.893735
436781,29,0,29,1.307827,103.893534
436782,4,8,12,1.307889,103.89353
436783,5,1,6,1.307888,103.893529
436784,13,5,18,1.30785,103.893208
436785,1,4,5,1.307877,103.893325
436786,165,0,165,1.307835,103.892959
436787,0,4,4,1.307865,103.89312
436788,47,3,50,1.30782,103.89271
436789,11,1,12,1.307852,103.892915
436790,12,3,15,1.307775,103.892629
436791,4,11,15,1.30784,103.89271
436792,10,2,12,1.307766,103.892516
436793,0,7,7,1.30784,103.89271
436794,21,18,39,1.307766,103.892259
436795,5,2,7,1.307802,103.892232
436796,8,6,14,1.307737,103.892036
436797,2,31,33,1.307834,103.891975
436799,2,1,3,1.30788,103.893706
436800,7,23,30,1.307861,103.893995
436801,9,3,12,1.307849,103.893207
436802,3,6,9,1.307839,103.892709
436803,8,0,8,1.307761,103.892454
436804,152,1,153,1.307901,103.893734
436806,2,4,6,1.307851,103.892914
436810,0,3,3,1.307967,103.894376
436811,14,10,24,1.307864,103.893119
436812,2,21,23,1.30784,103.892154
436814,11,412,423,1.300342,103.892933
436816,1,0,1,1.307868,103.89444
436818,1,0,1,1.299733,103.893169
436819,81,1,82,1.299975,103.892699
436820,15,25,40,1.299602,103.893206
436821,44,0,44,1.299556,103.893039
436822,3,0,3,1.307765,103.893419
436823,1,0,1,1.299745,103.892984
436824,39,14,53,1.299499,103.893315
436825,8,1,9,1.29955,103.89353
436826,178,1,179,1.299394,103.893585
436827,20,16,36,1.299345,103.893387
436838,1,6,7,1.310832,103.894695
436839,2,1,3,1.299338,103.893084
436840,13,415,428,1.310664,103.894464
436841,8,2,10,1.310807,103.894815
436842,19,2,21,1.31024,103.894821
436843,131,5,136,1.310837,103.894918
436844,34,0,34,1.310241,103.894994
436845,102,9,111,1.310868,103.895031
436846,15,0,15,1.310682,103.894872
436847,19,4,23,1.310915,103.895209
436848,0,2,2,1.307926,103.894145
436849,9,7,16,1.310929,103.895287
436850,0,1,1,1.299865,103.892848
436851,12,0,12,1.310801,103.895432
436852,72,11,83,1.310923,103.895555
436853,75,10,85,1.310855,103.89559
436854,1,38,39,1.31096,103.895751
436855,39,5,44,1.310899,103.895802
436856,1,12,13,1.310997,103.895946
436857,26,4,30,1.310939,103.896016
436858,64,5,69,1.311034,103.896142
436859,9,2,11,1.310981,103.896201
436860,1,46,47,1.311051,103.896338
436861,0,33,33,1.31107,103.896436
436862,1,38,39,1.311142,103.896614
436863,38,2478,2516,1.311213,103.896793
436864,133,38,171,1.311071,103.896338
436865,42,20,62,1.31109,103.896436
436866,12,0,12,1.311162,103.896614
436867,7,1477,1484,1.311223,103.896783
436879,2001,605,2606,1.29669,103.884532
436880,9,270,279,1.2983,103.884904
436881,2407,198,2605,1.297548,103.884455
436882,1441,285,1726,1.297884,103.883432
436883,25,570,595,1.29859,103.884183
436884,243,122,365,1.298823,103.884239
436885,486,102,588,1.299324,103.884276
436886,296,20,316,1.299561,103.884208
436887,2116,1201,3317,1.297909,103.883339
436888,65,4712,4777,1.298324,103.883989
436889,486,159,645,1.298847,103.884001
436891,128,20,148,1.29921,103.884013
436892,542,180,722,1.299595,103.884005
436894,2170,1279,3449,1.297428,103.882461
436895,897,1135,2032,1.29836,103.882979
436896,2906,392,3298,1.296704,103.882756
436897,94,958,1052,1.296695,103.883641
436899,1391,2003,3394,1.297198,103.881148
436900,491,3199,3690,1.297309,103.880847
436902,1,507,508,1.297353,103.878322
436904,1533,128,1661,1.297463,103.874445
436910,50,516,566,1.297285,103.874526
436914,2094,2647,4741,1.296571,103.87494
436915,551,7,558,1.298043,103.874465
436916,592,106,698,1.297286,103.874091
436917,2811,568,3379,1.296988,103.870522
436918,6956,3501,10457,1.297359,103.872026
436919,3783,4019,7802,1.297419,103.870545
436920,560,102,662,1.297856,103.870247
436921,1359,42,1401,1.298043,103.870945
436922,1901,558,2459,1.29595,103.8717
436923,913,98,1011,1.295942,103.871361
436924,933,184,1117,1.295719,103.87032
436925,3657,405,4062,1.295979,103.870677
436926,164,716,880,1.296766,103.871661
436927,1554,4305,5859,1.296766,103.871661
436928,1263,1144,2407,1.29727,103.875289
436929,1039,569,1608,1.297411,103.875779
436930,69,32,101,1.297411,103.875779
436931,1785,4302,6087,1.296977,103.872312
436932,1022,1783,2805,1.296749,103.872772
436935,19,192,211,1.297764,103.898404
436950,3073,33431,36504,1.315093,103.894519
436951,5,1561,1566,1.313819,103.8939
436952,2,99,101,1.314286,103.894456
436953,2,1125,1127,1.313677,103.893899
436954,13,13,26,1.313591,103.893723
436955,62,18,80,1.313585,103.893479
436956,41,6,47,1.313502,103.893532
436957,83,201,284,1.313584,103.894529
436958,22,2,24,1.312996,103.893881
436959,15,1423,1438,1.312895,103.89388
436960,123,1095,1218,1.312732,103.893886
436962,12,1592,1604,1.31207,103.893902
436971,7,622,629,1.31176,103.893877
436973,7,177,184,1.311677,103.893887
436974,18,201,219,1.311602,103.893879
436975,4,96,100,1.31151,103.893881
436976,3,192,195,1.311417,103.893873
436977,1,0,1,1.310775,103.895226
436978,1,3,4,1.310976,103.893884
436985,0,98,98,1.309881,103.89408
436986,0,39,39,1.309813,103.894097
436987,6,119,125,1.309761,103.894115
436988,1,200,201,1.309693,103.894142
436989,26,230,256,1.309261,103.894318
436990,94,946,1040,1.309146,103.894368
436991,50,526,576,1.311329,103.894317
436992,11,324,335,1.30802,103.894956
436993,19,751,770,1.310907,103.89429
436994,5,78,83,1.308006,103.894963
436995,6,76,82,1.307979,103.894978
436996,5,93,98,1.307951,103.894992
436997,2,58,60,1.307923,103.895007
436998,5,64,69,1.307896,103.895021
436999,16,195,211,1.307868,103.895036
437000,6,228,234,1.30784,103.89505
437001,1,221,222,1.307813,103.895065
437002,4,141,145,1.307785,103.895079
437003,4,450,454,1.307757,103.895094
437005,9,582,591,1.30773,103.895108
437007,14,378,392,1.307702,103.895123
437009,16,315,331,1.307674,103.895137
437010,3,241,244,1.307647,103.895151
437011,7,217,224,1.307619,103.895166
437012,183,173,356,1.309195,103.894716
437013,10,165,175,1.307125,103.895312
437014,4,304,308,1.307054,103.895342
437015,52,248,300,1.306997,103.895372
437016,4,90,94,1.306978,103.895361
437018,19,521,540,1.306946,103.895391
437020,4,50,54,1.306873,103.895427
437022,5,553,558,1.306825,103.89545
437023,2,40,42,1.308612,103.894849
437024,3,73,76,1.306806,103.895465
437025,1,91,92,1.308539,103.894873
437026,13,491,504,1.306742,103.89548
437027,0,109,109,1.308471,103.894913
437028,9,585,594,1.306519,103.895659
437029,7,410,417,1.308421,103.894938
437030,31,269,300,1.306504,103.895664
437031,17,1,18,1.308366,103.89496
437032,27,176,203,1.306474,103.895674
437033,28,117,145,1.308313,103.894992
437034,25,347,372,1.306444,103.895683
437035,9,10,19,1.308266,103.895027
437036,30,0,30,1.306415,103.895693
437037,7,197,204,1.308216,103.895052
437039,59,4,63,1.308181,103.895114
437040,1,284,285,1.306355,103.895713
437041,14,196,210,1.308166,103.895079
437042,0,168,168,1.306325,103.895723
437043,28,9,37,1.308113,103.895104
437044,15,54,69,1.306295,103.895733
437045,74,191,265,1.308063,103.895141
437046,31,232,263,1.306265,103.895743
437047,25,178,203,1.30801,103.895171
437048,8,50,58,1.306235,103.895752
437049,6,203,209,1.306205,103.895762
437050,230,408,638,1.30782,103.895392
437051,2,114,116,1.306176,103.895772
437052,73,638,711,1.307459,103.895516
437053,20,820,840,1.306146,103.895782
437054,18,459,477,1.307209,103.895519
437056,4,151,155,1.307149,103.895552
437058,5,194,199,1.307104,103.895576
437060,15,106,121,1.307051,103.895596
437062,38,179,217,1.306986,103.895618
437064,10,130,140,1.306926,103.895646
437066,7,164,171,1.306861,103.895668
437068,6,129,135,1.306808,103.895687
437070,19,162,181,1.306743,103.895712
437072,10,103,113,1.306683,103.895739
437074,13,161,174,1.306631,103.895751
437076,8,83,91,1.306565,103.895769
437078,17,336,353,1.3065,103.895786
437080,26,80,106,1.306438,103.895815
437082,10,234,244,1.306378,103.895835
437083,463,994,1457,1.305388,103.895978
437084,19,32,51,1.306328,103.895857
437086,185,172,357,1.306287,103.895877
437088,3,48,51,1.306232,103.895904
437089,49,1010,1059,1.304835,103.896188
437090,1,219,220,1.306169,103.895927
437091,4,140,144,1.304803,103.896199
437092,2,15,17,1.306126,103.895944
437093,3,85,88,1.304738,103.89622
437094,8,149,157,1.306069,103.895956
437095,0,80,80,1.304674,103.896242
437096,11,26,37,1.306021,103.895979
437097,13,79,92,1.304609,103.896263
437098,36,863,899,1.305959,103.896003
437099,1,80,81,1.304544,103.896285
437100,3,66,69,1.30448,103.896307
437101,13,75,88,1.304416,103.896328
437102,1,98,99,1.304351,103.89635
437103,3,67,70,1.304286,103.896371
437104,9,55,64,1.304244,103.896371
437105,15,56,71,1.304184,103.896392
437106,129,295,424,1.304144,103.8964
437107,14,262,276,1.303932,103.896439
437108,6,6,12,1.303913,103.896444
437109,19,205,224,1.303875,103.896455
437110,16,177,193,1.303837,103.896467
437111,3,147,150,1.303799,103.896478
437112,8,262,270,1.303761,103.896489
437113,65,189,254,1.303723,103.8965
437114,7,40,47,1.303685,103.896511
437115,48,192,240,1.303647,103.896522
437116,8,203,211,1.303609,103.896534
437117,15,299,314,1.303571,103.896545
437118,12,252,264,1.303533,103.896556
437119,10,208,218,1.303494,103.896567
437120,20,376,396,1.303456,103.896578
437121,1,15,16,1.303418,103.896589
437122,116,613,729,1.30338,103.896601
437123,38,346,384,1.303101,103.896753
437124,9,0,9,1.303063,103.896764
437125,17,250,267,1.303025,103.896775
437126,11,2,13,1.305448,103.896217
437127,39,66,105,1.302987,103.896786
437128,1268,713,1981,1.303538,103.897537
437129,11,115,126,1.302949,103.896797
437130,305,1475,1780,1.303046,103.896925
437131,9,415,424,1.302911,103.896809
437132,58,10,68,1.302485,103.897063
437133,6,477,483,1.302873,103.89682
437134,70,464,534,1.302237,103.896822
437136,2,62,64,1.301144,103.897063
437137,5,1,6,1.301022,103.897066
437138,1,15,16,1.3009,103.897069
437139,0,94,94,1.300778,103.897071
437140,1,5,6,1.300656,103.897074
437141,1,12,13,1.300534,103.897077
437142,0,3,3,1.310183,103.89473
437143,2,0,2,1.310716,103.89504
437144,2,7,9,1.300167,103.897086
437146,13,15,28,1.299923,103.897091
437147,642,712,1354,1.300156,103.897753
437148,28,1,29,1.299701,103.897058
437149,1,0,1,1.310917,103.893896
437150,0,7,7,1.299628,103.897174
437151,0,2,2,1.300289,103.897083
437152,1,71,72,1.299708,103.897187
437153,1,294,295,1.306503,103.895663
437154,72,185,257,1.310651,103.893934
437155,20,184,204,1.313103,103.893869
437156,3,492,495,1.308593,103.89458
437157,1574,2437,4011,1.314797,103.894603
437158,119,4907,5026,1.31474,103.894641
437159,63,3554,3617,1.31474,103.894641
437168,17,413,430,1.308311,103.894684
437169,2,5,7,1.308559,103.894311
437170,10,2,12,1.308562,103.894222
437171,3,3,6,1.308554,103.894161
437172,1,0,1,1.2996,103.897032
437173,2,12,14,1.308554,103.893991
437174,0,72,72,1.30862,103.894544
437175,15,6,21,1.308405,103.894029
437177,2,2,4,1.308873,103.893879
437178,3,1,4,1.308925,103.893874
437179,0,8,8,1.308986,103.893866
437180,1,3,4,1.309042,103.893864
437183,1,3,4,1.309199,103.893829
437184,3,96,99,1.309249,103.893813
437185,70,1,71,1.308522,103.893829
437186,5,0,5,1.308591,103.893839
437187,0,1,1,1.308548,103.894077
437188,1,1,2,1.299581,103.897162
437193,1,0,1,1.308714,103.893804
437194,0,62,62,1.309165,103.893727
437196,2,0,2,1.308808,103.893789
437197,3,2,5,1.308634,103.893297
437198,20,0,20,1.308373,103.893376
437199,2,1,3,1.300411,103.89708
437201,7,0,7,1.308822,103.893293
437202,25,2,27,1.308364,103.893241
437203,11,6,17,1.308357,103.893212
437204,4,2,6,1.308905,103.893288
437205,0,2,2,1.308545,103.893313
437206,1,1,2,1.308955,103.893277
437208,1,49,50,1.309132,103.893262
437209,1,73,74,1.309135,103.89312
437210,1,8,9,1.309061,103.893122
437211,8,0,8,1.308989,103.893122
437214,0,6,6,1.308362,103.892944
437215,2,0,2,1.309024,103.893272
437216,2,0,2,1.308775,103.893165
437217,5,6,11,1.30846,103.893096
437218,4,7,11,1.308467,103.892835
437219,3,0,3,1.308373,103.893376
437220,48,0,48,1.308373,103.893376
437221,4,0,4,1.308458,103.893018
437234,9,169,178,1.305676,103.899671
437235,147,89,236,1.305807,103.899854
437236,11,112,123,1.305849,103.900055
437237,0,2,2,1.308709,103.89317
437238,16,0,16,1.30598,103.900065
437239,2,1,3,1.308395,103.893629
437240,2,0,2,1.305917,103.900081
437241,6,1,7,1.306102,103.900014
437242,18,2,20,1.306124,103.899977
437243,5,3,8,1.306168,103.899986
437244,3,0,3,1.305931,103.900002
437245,1,0,1,1.30913,103.893739
437247,0,1,1,1.306119,103.900277
437249,2,1,3,1.306233,103.899953
437250,4,0,4,1.306145,103.900342
437253,2,22,24,1.305976,103.900431
437254,5,21,26,1.305976,103.900431
437255,38,0,38,1.30603,103.900562
437257,268,11,279,1.306128,103.900814
437259,376,34,410,1.305412,103.900309
437274,5,0,5,1.306811,103.898996
437275,270,3,273,1.307161,103.899525
437276,224,0,224,1.307164,103.899657
437277,206,1,207,1.306528,103.89978
437278,54,0,54,1.30751,103.899994
437279,1,0,1,1.306118,103.900276
437280,14,0,14,1.307511,103.899992
437282,34,0,34,1.307528,103.900025
437283,6,37,43,1.307014,103.900408
437284,1,0,1,1.306441,103.900021
437285,4,1,5,1.306906,103.900452
437286,113,0,113,1.307131,103.900064
437287,0,5,5,1.306874,103.900447
437288,18,0,18,1.307194,103.900194
437289,5,7,12,1.306765,103.900479
437290,4,0,4,1.307167,103.900158
437291,56,0,56,1.307095,103.900192
437292,111,218,329,1.307146,103.900104
437293,1,2,3,1.306146,103.900343
437294,58,4,62,1.306787,103.900117
437295,2,60,62,1.306802,103.90016
437296,2,7,9,1.306594,103.90029
437297,40,3,43,1.30677,103.899172
437309,2,1,3,1.307123,103.900212
437310,0,5,5,1.311844,103.893681
437311,0,3,3,1.311845,103.893682
437312,3,12,15,1.311844,103.893681
437315,5,5,10,1.31172,103.893369
437316,2,0,2,1.306044,103.900044
437317,9,0,9,1.311702,103.893261
437318,9,1,10,1.311714,103.893177
437319,57,1,58,1.311706,103.893139
437321,60,163,223,1.31198,103.893772
437322,5,0,5,1.311596,103.892969
437323,1,3,4,1.311659,103.892869
437324,1,1,2,1.311696,103.893291
437325,1,3,4,1.311603,103.892718
437326,0,2,2,1.312097,103.893197
437327,32,2,34,1.311847,103.892606
437328,1,14,15,1.312053,103.893008
437330,0,2,2,1.311847,103.892707
437331,12,0,12,1.311878,103.892345
437332,6,0,6,1.311957,103.892921
437333,0,7,7,1.311873,103.892261
437334,1,0,1,1.307532,103.90002
437335,0,11,11,1.31187,103.892145
437336,145,6,151,1.311958,103.892824
437337,0,10,10,1.311955,103.892773
437338,1,1,2,1.311955,103.892976
437339,2,0,2,1.311946,103.892684
437340,6,2,8,1.311946,103.892577
437341,5,1,6,1.311937,103.8925
437342,1,3,4,1.311933,103.892421
437344,0,12,12,1.311954,103.892084
437361,137,3,140,1.310229,103.893829
437363,4,19,23,1.309845,103.893392
437364,1,1,2,1.311943,103.892622
437365,0,16,16,1.310278,103.893443
437366,1,26,27,1.310281,103.893378
437367,5,3,8,1.310367,103.893534
437368,3,0,3,1.311844,103.893681
437369,11,48,59,1.310302,103.893274
437370,144,0,144,1.310392,103.893256
437371,5,0,5,1.31031,103.893192
437372,1,12,13,1.310317,103.893116
437373,384,37,421,1.310682,103.893017
437374,44,0,44,1.310311,103.893057
437375,73,2,75,1.310319,103.893017
437376,103,85,188,1.310693,103.892785
437377,25,9,34,1.310295,103.893159
437378,26,0,26,1.310489,103.89278
437379,0,1,1,1.311957,103.892855
437380,9,0,9,1.310489,103.89278
437381,70,7,77,1.310489,103.89278
437382,2,0,2,1.31037,103.89346
437383,3,0,3,1.310296,103.893318
437384,144,459,603,1.310435,103.893929
437385,1,0,1,1.310388,103.8927
437386,54,1108,1162,1.309993,103.894024
437399,51,11,62,1.301388,103.888088
437400,2,0,2,1.310489,103.89278
437402,0,1,1,1.310311,103.893465
437403,6,0,6,1.301374,103.889093
437404,8,0,8,1.301429,103.888651
437405,0,4,4,1.301699,103.888835
437406,2,0,2,1.301321,103.888344
437407,35,1,36,1.301732,103.888992
437408,11,0,11,1.301414,103.889326
437409,1,7,8,1.301438,103.889406
437410,6,1,7,1.301479,103.889305
437411,31,0,31,1.301459,103.88965
437412,8,4,12,1.301458,103.88965
437413,35,0,35,1.301472,103.889569
437414,129,2,131,1.301469,103.889773
437415,1,2,3,1.310489,103.89278
437416,2,0,2,1.30138,103.889194
437431,4892,570,5462,1.296124,103.867214
437432,45,1112,1157,1.296434,103.867833
437433,4535,64,4599,1.295509,103.866919
437434,3644,419,4063,1.29597,103.866447
437435,376,429,805,1.296547,103.866727
437436,4937,12821,17758,1.29727,103.866958
437437,10698,2624,13322,1.293302,103.871554
437438,572,461,1033,1.299509,103.837
437439,61,322,383,1.299509,103.837
437440,707,665,1372,1.295038,103.867159
437448,5,6,11,1.299496,103.890338
437449,4,0,4,1.300062,103.890002
437450,2,0,2,1.301467,103.889071
437451,2,0,2,1.299277,103.890268
437452,128,7,135,1.299163,103.889934
437453,11,14,25,1.299228,103.889822
437454,59,0,59,1.298509,103.889809
437455,47,0,47,1.29895,103.889742
437456,6,94,100,1.298485,103.889828
437457,35,25,60,1.298677,103.889729
437458,3,4,7,1.29844,103.890072
437459,168,15,183,1.298552,103.889727
437460,2,1,3,1.301489,103.889773
437461,151,2,153,1.298415,103.890288
437462,540,0,540,1.298417,103.889876
437463,8,2,10,1.298356,103.890507
437464,17,21,38,1.298383,103.889986
437465,16,9,25,1.29832,103.890691
437466,7,2,9,1.298337,103.890176
437467,1,6,7,1.298278,103.890919
437468,0,2,2,1.299391,103.889633
437469,38,3,41,1.298261,103.890535
437471,2,1,3,1.298518,103.889745
437472,2,1,3,1.298198,103.890915
437473,35,156,191,1.300062,103.890002
437487,65,0,65,1.307376,103.895092
437488,0,7,7,1.307428,103.894963
437489,1,0,1,1.301429,103.888489
437490,0,18,18,1.307381,103.894758
437491,1,2,3,1.300062,103.890002
437492,0,2,2,1.298297,103.890389
437493,2,1,3,1.307375,103.894657
437494,2,0,2,1.307252,103.894791
437495,6,6,12,1.307228,103.894457
437496,4,1,5,1.307331,103.894303
437498,0,4,4,1.307294,103.894051
437499,3,3,6,1.307293,103.89405
437500,0,3,3,1.307364,103.894548
437501,9,0,9,1.30728,103.893833
437502,0,2,2,1.307361,103.89445
437504,43,1,44,1.307204,103.893963
437505,0,2,2,1.307279,103.893832
437506,2,0,2,1.307266,103.893615
437509,1,22,23,1.307273,103.893412
437510,147,34,181,1.307189,103.893376
437511,4,0,4,1.307173,103.893281
437512,9,1,10,1.307269,103.893243
437513,7,22,29,1.30726,103.893161
437514,1,0,1,1.307335,103.894992
437515,5,0,5,1.307163,103.893132
437516,3,5,8,1.307261,103.893012
437517,1,0,1,1.307167,103.893214
437519,1,2,3,1.307223,103.894265
437520,0,2,2,1.3072,103.893719
437521,3,16,19,1.307203,103.892539
437522,45,2,47,1.307113,103.892546
437523,3,1,4,1.307186,103.892323
437524,15,0,15,1.30712,103.892321
437525,0,3,3,1.307212,103.892647
437526,126,3,129,1.307097,103.892064
437527,2,2,4,1.30715,103.891891
437528,2,10,12,1.307094,103.891901
437529,3,2,5,1.307075,103.891621
437530,1,2,3,1.307168,103.892107
437531,15,0,15,1.307122,103.891134
437532,49,0,49,1.306687,103.890394
437533,5,2,7,1.307069,103.890871
437534,4,1,5,1.30683,103.890574
437535,3,0,3,1.307148,103.891265
437536,12,5,17,1.307335,103.894992
437537,6,3,9,1.307002,103.890762
437538,2,0,2,1.307135,103.892729
437540,0,22,22,1.307163,103.891776
437541,2,7,9,1.307166,103.891699
437542,12,2,14,1.307157,103.8916
437543,10,3,13,1.307167,103.892106
437544,4,1,5,1.307253,103.894685
437545,4,0,4,1.299509,103.837
437546,15,3,18,1.299509,103.837
437547,3,6,9,1.299509,103.837
437551,1,50,51,1.313715,103.89276
437552,5,575,580,1.313957,103.892678
437553,2,0,2,1.307404,103.894893
437554,0,3,3,1.30676,103.890585
437557,0,5,5,1.313556,103.892794
437559,0,1,1,1.30716,103.893093
437561,3,6,9,1.313429,103.892824
437565,1,3,4,1.313183,103.892862
437566,36,0,36,1.313435,103.892862
437567,4,2,6,1.313121,103.892871
437568,2,0,2,1.31366,103.892773
437569,1,1,2,1.313341,103.89288
437570,0,1,1,1.313473,103.892818
437571,1,0,1,1.313247,103.892899
437572,0,6,6,1.313153,103.892917
437573,1,3,4,1.312965,103.89291
437574,0,1,1,1.312999,103.892885
437576,0,5,5,1.312966,103.892954
437577,1,0,1,1.313059,103.892935
437578,0,1,1,1.312823,103.892944
437579,18,0,18,1.312779,103.892965
437580,1,6,7,1.312779,103.892985
437582,40,17,57,1.312687,103.892992
437583,1,0,1,1.312872,103.892972
437584,0,5,5,1.312595,103.893
437585,0,2,2,1.313074,103.892883
437586,0,1,1,1.312595,103.89298
437602,122,3,125,1.297471,103.896171
437603,728,252,980,1.298092,103.895799
437604,5,0,5,1.297507,103.89627
437605,5,0,5,1.297578,103.896466
437606,479,236,715,1.297426,103.896063
437607,14,2,16,1.297648,103.896663
437608,2,41,43,1.29772,103.896774
437609,7,59,66,1.297432,103.896129
437610,47,10,57,1.297784,103.896944
437611,2,4,6,1.297475,103.896237
437612,3,37,40,1.297534,103.896401
437613,0,3,3,1.313914,103.892703
437614,20,4,24,1.297593,103.896565
437615,17,3,20,1.298234,103.89642
437616,54,36,90,1.297652,103.896728
437618,132,8,140,1.297683,103.896853
437619,19,7,26,1.298203,103.896252
437620,67,116,183,1.297727,103.896979
437621,40,4,44,1.298133,103.896049
437622,15,1,16,1.298414,103.896806
437623,17,9,26,1.29807,103.895914
437625,3,1,4,1.298356,103.896637
437626,6,0,6,1.298317,103.896524
437627,25,4,29,1.298278,103.896411
437628,83,3,86,1.298239,103.896297
437629,1,3,4,1.2982,103.896184
437630,7,3,10,1.298161,103.896071
437631,0,3,3,1.298379,103.896761
437632,10,11,21,1.298116,103.895893
437648,3,0,3,1.298122,103.895958
437649,3,7,10,1.306632,103.894992
437650,2,0,2,1.31256,103.892953
437652,213,6,219,1.306554,103.894683
437653,4,0,4,1.306605,103.89465
437654,30,1,31,1.306604,103.894649
437655,1,0,1,1.312513,103.892997
437656,4,4,8,1.306598,103.894553
437657,0,2,2,1.306641,103.894875
437658,134,0,134,1.306583,103.894359
437659,1,1,2,1.306541,103.894344
437660,1,3,4,1.306483,103.89414
437661,7,0,7,1.30654,103.893776
437663,44,4,48,1.306526,103.893582
437664,117,1,118,1.306309,103.893862
437665,2,0,2,1.306555,103.89397
437666,50,4,54,1.306511,103.893387
437667,1,0,1,1.306539,103.894555
437668,1,1,2,1.306512,103.893388
437669,5,4,9,1.306498,103.893193
437671,23,0,23,1.3062,103.893522
437672,3,0,3,1.306588,103.89525
437673,2,8,10,1.306469,103.892805
437674,5,1,6,1.306569,103.894164
437675,51,0,51,1.299509,103.837
437676,0,2,2,1.306198,103.893668
437677,0,2,2,1.299509,103.837
437689,6,0,6,1.304495,103.900428
437690,0,91,91,1.304366,103.900183
437691,0,3,3,1.306483,103.892999
437692,0,10,10,1.304412,103.900305
437693,0,12,12,1.304344,103.900472
437694,20,1,21,1.304305,103.900313
437695,1,3,4,1.304313,103.900357
437696,62,60,122,1.304283,103.900241
437697,1,0,1,1.306218,103.893692
437698,0,1,1,1.304551,103.900624
437699,0,5,5,1.3046,103.900706
437701,0,1,1,1.304381,103.900574
437702,0,5,5,1.304439,103.900694
437703,7,4,11,1.30447,103.900753
437704,1,4,5,1.304504,103.90083
437705,1,1,2,1.299509,103.837
437708,136,1,137,1.304684,103.9009
437709,4,0,4,1.304703,103.90096
437710,4,1,5,1.304722,103.901004
437711,6,0,6,1.304749,103.901086
437712,0,1,1,1.304425,103.900672
437713,1,0,1,1.304766,103.901137
437714,2,1,3,1.304404,103.900231
437715,1,0,1,1.304798,103.901181
437716,1,0,1,1.304832,103.901278
437717,11,1,12,1.304859,103.901348
437718,3,1,4,1.304489,103.900394
437719,3,2,5,1.304532,103.900496
437720,4,98,102,1.304547,103.901046
437721,8,0,8,1.3045,103.901055
437722,0,5,5,1.304441,103.901101
437723,1,1,2,1.30424,103.901006
437724,14,3,17,1.304289,103.901175
437725,0,1,1,1.304853,103.901308
437726,0,14,14,1.304349,103.901138
437727,1,14,15,1.304659,103.901088
437728,1,5,6,1.304684,103.901133
437729,3,3,6,1.304697,103.901163
437730,0,3,3,1.304823,103.901223
437731,19,7,26,1.304732,103.90124
437732,2,4,6,1.304756,103.901284
437733,292,10416,10708,1.302553,103.884269
437734,228,7891,8119,1.302035,103.884384
437735,40,385,425,1.301026,103.88619
437736,89,750,839,1.300484,103.886241
437737,66,123,189,1.300978,103.886659
437738,806,78,884,1.300469,103.886673
437739,1,113,114,1.300845,103.887144
437740,20,3,23,1.300468,103.887126
437741,0,1,1,1.304312,103.901155
437742,2,510,512,1.300771,103.888012
437743,25,353,378,1.30072,103.888244
437744,2,5,7,1.300658,103.888514
437745,182,250,432,1.300588,103.888742
437747,3,0,3,1.304706,103.901189
437749,6,59,65,1.300441,103.889418
437750,5,0,5,1.300234,103.889545
437751,3,0,3,1.300515,103.889059
437752,2,0,2,1.304391,103.901115
437753,22,31,53,1.300127,103.889943
437754,4,1,5,1.300267,103.890117
437756,3,25,28,1.300023,103.890305
437757,4,5,9,1.299888,103.890469
437758,7,418,425,1.300224,103.891304
437760,2,51,53,1.300191,103.891647
437761,225,54,279,1.300284,103.891567
437762,1,181,182,1.300259,103.891901
437763,18,350,368,1.30037,103.89183
437764,96,47,143,1.300426,103.892533
437765,17,95,112,1.300507,103.892274
437766,9,0,9,1.300576,103.892461
437767,8,0,8,1.300576,103.892461
437768,59,323,382,1.300735,103.892678
437770,136,0,136,1.300792,103.892947
437771,130,70,200,1.300792,103.892947
437772,10,0,10,1.300853,103.893112
437773,0,21,21,1.300853,103.893112
437774,7,147,154,1.300753,103.893553
437775,19,14,33,1.300959,103.893454
437776,4,97,101,1.300789,103.893916
437777,6,116,122,1.301065,103.894014
437778,12,39,51,1.300803,103.893965
437779,15,169,184,1.301173,103.894345
437780,6,0,6,1.300832,103.894061
437781,2,0,2,1.300354,103.889766
437782,9,42,51,1.300861,103.894158
437783,1,0,1,1.300816,103.88756
437784,0,5,5,1.30089,103.894255
437785,1,38,39,1.301363,103.89502
437786,2,1,3,1.300183,103.889813
437787,4,15,19,1.301407,103.895179
437788,49,0,49,1.300948,103.894448
437789,0,35,35,1.301454,103.895341
437791,9,5,14,1.300977,103.894545
437792,91,86,177,1.301516,103.895533
437793,0,47,47,1.301516,103.895533
437794,0,10,10,1.301006,103.894641
437795,158,96,254,1.30155,103.895661
437796,9,0,9,1.301035,103.894738
437797,14,373,387,1.301605,103.895843
437798,1,18,19,1.301064,103.894835
437799,15,1,16,1.301675,103.896047
437800,0,17,17,1.301093,103.894931
437801,5,70,75,1.301715,103.8962
437802,0,27,27,1.301122,103.895028
437803,2,78,80,1.301755,103.896318
437804,0,32,32,1.301151,103.895125
437805,1,58,59,1.30118,103.895221
437807,13,17,30,1.30121,103.895318
437808,20,201,221,1.301239,103.895414
437809,114,0,114,1.301268,103.895511
437810,1,22,23,1.301297,103.895608
437811,0,36,36,1.301326,103.895704
437812,1,25,26,1.301355,103.895801
437813,1,46,47,1.301384,103.895898
437814,11,551,562,1.302363,103.897939
437815,5,45,50,1.301413,103.895994
437816,1,12,13,1.302275,103.897786
437817,6,34,40,1.301442,103.896091
437818,94,17,111,1.302691,103.897951
437819,1,15,16,1.301471,103.896188
437821,36,35,71,1.3015,103.896284
437822,1,2,3,1.300919,103.894351
437823,8,80,88,1.301529,103.896381
437824,56,0,56,1.302597,103.898106
437825,2,26,28,1.301558,103.896478
437826,128,661,789,1.302419,103.898341
437827,4,60,64,1.301587,103.896574
437828,2,94,96,1.302529,103.898629
437829,1,133,134,1.301616,103.896671
437830,76,381,457,1.302843,103.898674
437831,353,6,359,1.302996,103.898766
437832,130,1,131,1.3029,103.89885
437833,0,5,5,1.302865,103.898816
437834,1,1,2,1.301262,103.89467
437835,0,1,1,1.301327,103.894894
437836,0,1,1,1.3027,103.899096
437837,30,1845,1875,1.302787,103.899285
437838,161,6,167,1.302901,103.899647
437839,124,50,174,1.302944,103.899739
437840,10,176,186,1.302995,103.899836
437841,3,1,4,1.303058,103.899994
437842,547,382,929,1.303109,103.900112
437843,4,365,369,1.303131,103.900193
437844,393,9787,10180,1.303746,103.901182
437846,16,4,20,1.299908,103.890591
437847,2,1,3,1.302792,103.898018
437849,3,13,16,1.300458,103.892053
437850,7,0,7,1.300458,103.892053
437851,1,19,20,1.301363,103.89502
437852,86,47,133,1.300172,103.890359
437853,62,0,62,1.300507,103.892274
437854,57,0,57,1.300507,103.892274
437855,10,254,264,1.300507,103.892274
437856,16,26,42,1.30004,103.891115
437857,4,0,4,1.299509,103.837
437858,6,0,6,1.299509,103.837
437859,2,58,60,1.299509,103.837
437861,51,692,743,1.298178,103.885858
437862,17,223,240,1.298383,103.88587
437863,1,21,22,1.298561,103.88587
437865,6,62,68,1.298841,103.885885
437866,0,3,3,1.300458,103.892053
437867,11,11,22,1.299024,103.885855
437868,4,26,30,1.298006,103.88658
437869,10,1253,1263,1.297986,103.886657
437870,18,292,310,1.297878,103.886976
437871,586,262,848,1.298065,103.887113
437872,525,1109,1634,1.297891,103.887825
437873,7,14,21,1.297881,103.887887
437874,1829,219,2048,1.297077,103.887543
437875,187,0,187,1.297839,103.887975
437876,740,1128,1868,1.297295,103.887746
437877,2,0,2,1.303071,103.89877
437878,1959,274,2233,1.296971,103.888715
437880,2215,387,2602,1.296564,103.88851
437881,6,232,238,1.297607,103.889083
437882,6,1022,1028,1.297701,103.889088
437883,49,0,49,1.297638,103.889172
437884,12,3,15,1.297716,103.889167
437885,2684,227,2911,1.296797,103.889236
437886,0,1,1,1.302744,103.899205
437888,1,0,1,1.29807,103.889229
437889,0,2,2,1.297883,103.887918
437890,14,0,14,1.298708,103.889338
437891,12,1,13,1.29872,103.889362
437892,3,0,3,1.299058,103.885963
437894,288,450,738,1.297524,103.889639
437895,4,166,170,1.297491,103.889757
437896,3,0,3,1.298713,103.889507
437897,2,0,2,1.298393,103.88929
437898,1541,329,1870,1.297028,103.890098
437899,39,1787,1826,1.29733,103.890326
437900,2,0,2,1.297364,103.89014
437901,1142,280,1422,1.296289,103.890311
437902,4,64,68,1.297301,103.890492
437903,101,293,394,1.297109,103.890503
437904,2,357,359,1.297176,103.891134
437905,1,180,181,1.297223,103.891202
437906,992,1320,2312,1.296294,103.891048
437907,4,1,5,1.297218,103.891368
437908,253,113,366,1.297137,103.891597
437910,818,586,1404,1.296305,103.891665
437911,0,82,82,1.297345,103.891808
437912,31,225,256,1.296291,103.892342
437913,12,1353,1365,1.297555,103.892536
437914,2,0,2,1.297305,103.890385
437915,39,786,825,1.297841,103.893073
437916,219,4,223,1.297922,103.893044
437917,53,7,60,1.298011,103.89301
437918,1595,650,2245,1.296362,103.892876
437919,2,6,8,1.298087,103.892986
437920,3156,329,3485,1.296564,103.893427
437921,17,2,19,1.298231,103.892929
437922,96,2,98,1.298283,103.892913
437923,117,9,126,1.298446,103.892898
437924,44,12,56,1.298393,103.892904
437925,34,9,43,1.298475,103.892856
437926,46,7,53,1.298721,103.893176
437927,90,12,102,1.298768,103.893312
437928,26,13,39,1.298811,103.893433
437929,218,12,230,1.298845,103.893528
437930,158,2,160,1.298541,103.89375
437931,34,6,40,1.298469,103.893767
437932,3027,4031,7058,1.297985,103.894436
437933,40,4,44,1.298412,103.893786
437934,2348,530,2878,1.297092,103.89513
437935,12,8,20,1.298333,103.893809
437936,2339,631,2970,1.296725,103.894179
437937,61,4,65,1.298249,103.893843
437938,56,1817,1873,1.298202,103.893862
437939,9,1335,1344,1.298158,103.893883
437940,2,6,8,1.298411,103.895023
437941,9,24,33,1.298459,103.895095
437942,11,0,11,1.298514,103.895226
437943,4,506,510,1.29855,103.895304
437944,6,50,56,1.298624,103.895386
437945,1,4,5,1.298658,103.895437
437946,2,0,2,1.297656,103.89289
437947,21,29,50,1.298742,103.895576
437948,1,9,10,1.298713,103.89561
437949,22,4,26,1.298743,103.895678
437950,1,6,7,1.298825,103.895794
437951,1,0,1,1.298288,103.889284
437952,11,52,63,1.298844,103.895968
437953,38,0,38,1.298885,103.896084
437954,2,12,14,1.298925,103.8962
437955,33,63,96,1.298734,103.895709
437956,0,4,4,1.298965,103.896315
437957,6,5,11,1.298765,103.895798
437958,6,0,6,1.299006,103.896431
437959,6,3,9,1.298795,103.895916
437960,63,28,91,1.299061,103.896503
437961,1,1,2,1.298717,103.8955
437962,0,12,12,1.299099,103.896583
437963,8,9,17,1.29886,103.896174
437964,0,18,18,1.299124,103.896689
437965,46,11,57,1.298878,103.896293
437966,5,24,29,1.299154,103.896757
437967,0,5,5,1.298931,103.896424
437968,77,19,96,1.299155,103.896911
437969,6,4,10,1.298954,103.896517
437970,1,1,2,1.298811,103.896008
437971,27,44,71,1.29902,103.896623
437972,5,9,14,1.299062,103.896745
437973,37,34,71,1.298578,103.885755
437974,7,11,18,1.298676,103.885806
437978,2968,854,3822,1.297656,103.888176
437979,127,44,171,1.29664,103.888073
437980,2892,621,3513,1.298744,103.897114
437981,2621,742,3363,1.298121,103.897485
437982,16,53,69,1.298391,103.897096
437983,1,0,1,1.298804,103.895852
437985,0,286,286,1.297244,103.891463
437986,943,293,1236,1.297085,103.892571
437987,51,562,613,1.299509,103.837
437988,70,118,188,1.298135,103.886189
437989,40,0,40,1.298376,103.886535
437990,3,1,4,1.29841,103.886533
437991,913,183,1096,1.298595,103.886411
437992,4,0,4,1.298436,103.886524
437993,0,5,5,1.298455,103.886528
437994,2,16,18,1.299113,103.886471
437995,721,153,874,1.298761,103.886533
437997,0,363,363,1.298376,103.886535
438012,13,423,436,1.29758,103.892311
438013,1,1,2,1.299164,103.896919
438014,0,2,2,1.297639,103.892298
438015,9,0,9,1.297899,103.892199
438016,0,9,9,1.297956,103.89229
438017,2,10,12,1.298074,103.892146
438018,14,5,19,1.298161,103.89222
438019,2,0,2,1.297709,103.892275
438020,4,0,4,1.298475,103.892009
438021,8,0,8,1.298627,103.891981
438022,1,2,3,1.29735,103.890178
438023,33,0,33,1.298757,103.89196
438024,3,3,6,1.298494,103.892123
438025,58,3,61,1.298767,103.89197
438026,1,1,2,1.298414,103.89203
438027,13,1,14,1.298318,103.891943
438028,1,2,3,1.298632,103.892072
438039,9,0,9,1.299705,103.88943
438040,4,318,322,1.300045,103.889291
438041,4,34,38,1.299921,103.889267
438042,88,32,120,1.299862,103.88889
438043,1,1,2,1.298169,103.892123
438044,281,61,342,1.299614,103.888716
438045,2,1,3,1.299509,103.837
438046,8,4,12,1.299068,103.889228
438047,2,17,19,1.29941,103.888578
438048,35,108,143,1.298853,103.889138
438049,288,86,374,1.299179,103.888673
438050,22,5,27,1.298638,103.88912
438051,1156,159,1315,1.298766,103.888545
438052,36,1,37,1.298493,103.889083
438053,7,36,43,1.299478,103.888966
438054,0,19,19,1.29834,103.88863
438055,0,1,1,1.297201,103.891331
438056,2,12,14,1.298254,103.888601
438057,43,2,45,1.29814,103.888947
438058,0,24,24,1.298186,103.888609
438059,5,0,5,1.298067,103.888969
438060,2,14,16,1.298131,103.888596
438061,5,1,6,1.298009,103.888957
438062,27,12,39,1.298074,103.88867
438063,0,1,1,1.298292,103.889013
438064,1,11,12,1.29803,103.88866
438065,1,2,3,1.299197,103.889304
438066,1,9,10,1.297993,103.888654
438067,3,0,3,1.297974,103.888715
438068,1,16,17,1.297894,103.888639
438069,6,7,13,1.297811,103.888654
438070,1,338,339,1.297798,103.888631
438071,1,1490,1491,1.297698,103.88865
438072,6,1634,1640,1.29771,103.888602
438073,602,470,1072,1.300132,103.888991
438074,22,20,42,1.29971,103.889249
438075,66,0,66,1.299392,103.889118
438076,21,76,97,1.299549,103.889163
438088,29,20,49,1.302715,103.888106
438089,29,0,29,1.303,103.888067
438090,0,2,2,1.299582,103.889317
438091,1,12,13,1.303421,103.888005
438092,6,0,6,1.303771,103.887914
438093,6,3,9,1.303991,103.88789
438094,16,0,16,1.304625,103.887997
438095,8,2,10,1.304851,103.888003
438096,13,1,14,1.304993,103.88798
438097,2,9,11,1.304316,103.887877
438098,2,6,8,1.304364,103.887881
438099,10,0,10,1.304435,103.887859
438101,1,9,10,1.304599,103.887833
438102,20,0,20,1.304678,103.887751
438104,24,3,27,1.304884,103.887774
438105,28,4,32,1.304914,103.887781
438106,13,3,16,1.305228,103.887902
438107,145,5,150,1.305096,103.887719
438109,6,1,7,1.303523,103.887936
438110,38,1,39,1.303652,103.887914
438111,4,13,17,1.302715,103.888106
438123,8,221,229,1.313512,103.89193
438124,8,43,51,1.313469,103.891934
438125,2,80,82,1.313388,103.89193
438128,144,1,145,1.313322,103.891934
438129,514,0,514,1.313099,103.891936
438130,1,150,151,1.31299,103.891941
438131,0,41,41,1.312917,103.891944
438132,3,218,221,1.313107,103.891916
438133,350,30,380,1.3126,103.891879
438134,0,26,26,1.312488,103.891883
438135,1,22,23,1.312375,103.891888
438137,1,1,2,1.303224,103.887929
438138,1,1,2,1.31244,103.892087
438139,128,2,130,1.312207,103.891895
438140,7,82,89,1.312209,103.89213
438142,1,1,2,1.312263,103.891892
438143,11,11,22,1.311871,103.891908
438145,0,1,1,1.298034,103.888726
438146,1,3,4,1.311534,103.891922
438147,3,11,14,1.299509,103.837
438178,207,1280,1487,1.300615,103.884513
438180,1443,53,1496,1.301013,103.882727
438181,529,297,826,1.299641,103.882321
438216,3,258,261,1.303711,103.899931
438217,1,194,195,1.303886,103.899998
438218,6,1,7,1.303671,103.89986
438219,79,4,83,1.30386,103.899933
438220,2,0,2,1.311927,103.891906
438221,1,19,20,1.303793,103.899828
438222,4,1,5,1.303629,103.899783
438223,0,1,1,1.311758,103.891913
438224,1,0,1,1.30377,103.89977
438225,2,2,4,1.303715,103.899692
438227,4,46,50,1.30369,103.899642
438228,5,0,5,1.303551,103.899631
438229,59,0,59,1.303539,103.89959
438231,3,18,21,1.303492,103.89949
438232,5,0,5,1.303465,103.899418
438233,5,2,7,1.303444,103.899368
438234,584,59,643,1.303444,103.898623
438235,2,33,35,1.305184,103.898504
438236,0,124,124,1.305621,103.898467
438237,0,2,2,1.303647,103.89981
438238,0,1,1,1.303605,103.899737
438240,0,1,1,1.305716,103.898684
438241,2,237,239,1.30585,103.899015
438257,3,140,143,1.299692,103.894353
438258,0,39,39,1.299558,103.894335
438259,9,2,11,1.299719,103.894429
438260,26,0,26,1.299573,103.894391
438262,18,0,18,1.299594,103.894476
438263,1,3,4,1.299783,103.894611
438264,3,3,6,1.29963,103.894584
438265,40,2,42,1.299812,103.894696
438266,5,0,5,1.299654,103.894656
438267,7,0,7,1.299841,103.89478
438268,5,2,7,1.299683,103.894758
438269,1,0,1,1.305806,103.898906
438270,74,2,76,1.299717,103.894848
438271,2,2,4,1.299912,103.894976
438272,3,0,3,1.297869,103.88869
438273,1,0,1,1.299877,103.8949
438274,21,0,21,1.299786,103.895022
438275,13,12,25,1.299959,103.895169
438277,70,0,70,1.299995,103.89526
438278,10,1,11,1.299834,103.895191
438279,32,5,37,1.300012,103.895347
438280,2,0,2,1.305666,103.898585
438281,2,1,3,1.299752,103.894937
438282,0,1,1,1.299936,103.895068
438283,30,0,30,1.300076,103.895494
438284,8,0,8,1.299932,103.895471
438285,1,0,1,1.299897,103.895367
438286,9,5,14,1.29995,103.89555
438287,45,0,45,1.30013,103.895692
438288,8,2,10,1.299993,103.895651
438289,120,36,156,1.300166,103.895779
438290,4,2,6,1.300006,103.895725
438291,25,0,25,1.300188,103.895863
438292,8,1,9,1.300032,103.895823
438293,1,2,3,1.300034,103.895427
438294,14,3,17,1.300048,103.895894
438295,20,0,20,1.300246,103.896059
438296,17,2,19,1.30011,103.896039
438297,23,3,26,1.300275,103.896143
438298,12,0,12,1.300299,103.89623
438299,0,12,12,1.30034,103.896317
438315,4,91,95,1.300354,103.894207
438316,12,69,81,1.300245,103.894203
438317,2,9,11,1.300383,103.894302
438318,41,2,43,1.300267,103.894276
438319,20,1,21,1.300415,103.894399
438320,20,0,20,1.300294,103.894376
438321,13,0,13,1.300439,103.894471
438322,0,8,8,1.300312,103.894457
438323,7,6,13,1.300469,103.894564
438324,2,0,2,1.29987,103.895293
438326,4,1,5,1.300361,103.894617
438327,2,0,2,1.300341,103.894549
438328,2,3,5,1.300393,103.894734
438329,1,1,2,1.300518,103.894718
438330,11,3,14,1.300415,103.894801
438331,13,3,16,1.300562,103.894871
438332,1,1,2,1.300532,103.894779
438333,4,8,12,1.300586,103.894951
438334,25,24,49,1.300472,103.894987
438336,12,7,19,1.300507,103.895134
438337,0,3,3,1.300221,103.895974
438338,96,7,103,1.300547,103.895228
438339,36,0,36,1.300673,103.895236
438341,1,1,2,1.300447,103.894911
438342,10,0,10,1.300599,103.8954
438343,47,0,47,1.300715,103.895416
438344,10,0,10,1.300631,103.895506
438345,1,4,5,1.300738,103.895501
438346,0,1,1,1.300099,103.895601
438347,5,0,5,1.300764,103.895593
438349,160,12,172,1.300784,103.895665
438350,8,0,8,1.300705,103.895766
438351,22,1,23,1.30082,103.895764
438352,0,6,6,1.300734,103.89586
438353,50,13,63,1.300842,103.895848
438354,10,3,13,1.300758,103.895941
438355,12,13,25,1.300873,103.895953
438356,1,0,1,1.30066,103.895578
438357,2,0,2,1.300699,103.895326
438358,9,4,13,1.300815,103.896132
438359,2,0,2,1.300904,103.896023
438360,3,7,10,1.300842,103.89623
438361,37,5,42,1.300948,103.896201
438362,26,9,35,1.300862,103.896291
438363,13,8,21,1.300981,103.896311
438364,2,9,11,1.300161,103.896386
438365,1,1,2,1.300926,103.896129
438366,38,11,49,1.30006,103.896388
438368,0,9,9,1.299636,103.896232
438370,0,8,8,1.299614,103.896161
438371,4,10,14,1.301092,103.896654
438372,25,0,25,1.299593,103.896087
438373,0,2,2,1.301001,103.896387
438374,15,115,130,1.301464,103.896825
438375,1,0,1,1.300787,103.896055
438376,3,2,5,1.301391,103.896815
438377,142,0,142,1.29953,103.895863
438378,1,49,50,1.301304,103.896819
438380,0,5,5,1.301245,103.896817
438381,0,9,9,1.299472,103.895685
438382,7,56,63,1.301181,103.896816
438384,84,105,189,1.301111,103.896816
438385,9,0,9,1.299419,103.895503
438386,35,64,99,1.300877,103.89645
438387,4,4,8,1.299388,103.895406
438388,70,0,70,1.300732,103.89646
438390,15,0,15,1.300654,103.896462
438391,56,0,56,1.299333,103.895237
438392,2,0,2,1.299573,103.896024
438393,2,0,2,1.300546,103.896468
438394,7,0,7,1.300461,103.896474
438395,7,1,8,1.299279,103.895037
438396,4,3,7,1.300361,103.896482
438397,111,13,124,1.299253,103.894949
438398,66,0,66,1.300283,103.896486
438399,3,0,3,1.300633,103.89513
438400,7,2,9,1.300186,103.896483
438401,1,8,9,1.299206,103.894787
438402,10,0,10,1.300108,103.896501
438403,2,1,3,1.299226,103.894857
438404,240,1,241,1.300003,103.896509
438406,4,2,6,1.299915,103.896508
438407,0,119,119,1.299158,103.894595
438408,7,6,13,1.299779,103.896512
438409,58,0,58,1.299682,103.89674
438410,68,0,68,1.299662,103.896662
438411,3,2,5,1.2996,103.896522
438412,2,2,4,1.299579,103.896447
438413,1,6,7,1.29955,103.896356
438414,20,16,36,1.299532,103.896264
438415,1,1,2,1.299306,103.895149
438416,52,1,53,1.299486,103.896128
438417,4,0,4,1.299446,103.896024
438418,0,5,5,1.299423,103.895956
438420,178,0,178,1.299366,103.895764
438421,2,1,3,1.299189,103.894728
438422,1,0,1,1.299547,103.895937
438423,93,3,96,1.299285,103.895485
438424,12,2,14,1.299258,103.895411
438425,201,0,201,1.299226,103.895299
438426,4,2,6,1.299208,103.895239
438427,39,0,39,1.299191,103.895144
438428,1,0,1,1.299316,103.895596
438429,23,0,23,1.299145,103.894968
438430,36,1,37,1.299116,103.894869
438446,2,2,4,1.298434,103.892567
438447,72,4,76,1.298602,103.892695
438448,57,0,57,1.298714,103.892669
438450,3,0,3,1.299336,103.895661
438451,0,5,5,1.298952,103.893693
438452,5,2,7,1.299163,103.894377
438453,28,0,28,1.298713,103.892668
438454,1,0,1,1.299166,103.895057
438455,14,0,14,1.299026,103.893924
438456,50,0,50,1.299099,103.894156
438458,2,0,2,1.299501,103.896197
438459,1,26,27,1.299509,103.837
438468,1,175,176,1.29808,103.89742
438469,0,53,53,1.298071,103.897484
438470,2,42,44,1.2984,103.897371
438471,2,9,11,1.298071,103.897484
438472,2,1,3,1.298804,103.89323
438473,1,7,8,1.298071,103.897484
438489,1,172,173,1.304254,103.89971
438490,4,111,115,1.304312,103.899678
438491,1,5,6,1.304222,103.899616
438492,7,2,9,1.304278,103.899582
438493,52,3,55,1.304178,103.899509
438494,1,4,5,1.304232,103.899489
438495,5,3,8,1.304138,103.899417
438497,165,1,166,1.3041,103.899322
438498,3,0,3,1.298071,103.897484
438499,16,18,34,1.304048,103.899227
438500,0,4,4,1.3041,103.8992
438516,1,699,700,1.297522,103.88892
438517,4,78,82,1.297175,103.888864
438518,4,44,48,1.296819,103.888797
438534,3,194,197,1.304841,103.899453
438535,1,179,180,1.304895,103.899429
438536,0,2,2,1.299509,103.837
438537,28,0,28,1.304864,103.899354
438538,21,0,21,1.304762,103.8993
438539,8,4,12,1.304835,103.899274
438540,4,12,16,1.304723,103.899172
438542,3,7,10,1.304688,103.89908
438543,57,6,63,1.304734,103.899055
438544,3,12,15,1.30464,103.898973
438545,45,10,55,1.304694,103.898954
438561,1,552,553,1.305376,103.899238
438562,1,182,183,1.305441,103.899214
438563,1,3,4,1.305337,103.899147
438564,26,1,27,1.305391,103.899112
438565,1,0,1,1.298713,103.892668
438566,15,6,21,1.305347,103.899019
438568,10,0,10,1.305311,103.898908
438569,5,0,5,1.305228,103.898867
438570,2,0,2,1.304814,103.899376
438571,37,2,39,1.305188,103.898783
438572,0,8,8,1.305201,103.898685
438606,7,37,44,1.311517,103.894336
438607,0,3,3,1.30414,103.899291
438608,2,15,17,1.311547,103.894256
438609,1,3,4,1.311567,103.894657
438610,1088,1,1089,1.311727,103.894781
438611,245,49,294,1.311595,103.894784
438618,0,39,39,1.311629,103.894955
438620,736,142,878,1.311648,103.895053
438622,508,329,837,1.311724,103.895734
438637,1,119,120,1.311773,103.895306
438638,2,69,71,1.311661,103.896093
438639,717,31,748,1.31224,103.896011
438640,0,3,3,1.311535,103.894542
438641,253,154,407,1.312269,103.896047
438642,2,67,69,1.311717,103.896187
438643,8,7,15,1.311821,103.895532
438644,4,0,4,1.311676,103.896249
438645,1,0,1,1.305301,103.899045
438646,900,4,904,1.311888,103.896241
438648,7,673,680,1.311873,103.896174
438650,0,4,4,1.311911,103.896314
438654,4,3037,3041,1.311929,103.896388
438659,0,837,837,1.312009,103.896412
438675,82,1,83,1.311852,103.891035
438676,7,55,62,1.311795,103.89098
438677,21,0,21,1.311432,103.890191
438678,2,16,18,1.311575,103.890734
438679,6,1,7,1.311432,103.890332
438681,1,3,4,1.311434,103.890432
438683,1,0,1,1.311839,103.89562
438685,2,65,67,1.311471,103.890622
438686,328,462,790,1.311694,103.890549
438702,234,16,250,1.310149,103.897955
438703,4,2,6,1.309921,103.898364
438704,6,0,6,1.310174,103.898312
438705,124,0,124,1.310184,103.898322
438706,1,3,4,1.310405,103.898083
438707,8,0,8,1.310254,103.898496
438709,7,1,8,1.310333,103.898681
438710,1,0,1,1.311444,103.890545
438711,1,2,3,1.311639,103.89614
438712,8,2,10,1.310877,103.898359
438714,11,1,12,1.310701,103.898484
438715,43,0,43,1.310615,103.89855
438716,210,0,210,1.310562,103.898548
438717,5,8,13,1.310306,103.898501
438718,4,2,6,1.31033,103.898559
438719,106,593,699,1.310016,103.897621
438720,2,2,4,1.310345,103.898601
438721,19,0,19,1.310376,103.898672
438722,1,10,11,1.310343,103.898671
438734,9,0,9,1.31341,103.895711
438735,4,767,771,1.313302,103.895672
438736,2,228,230,1.31328,103.895704
438737,11,81,92,1.313243,103.895793
438738,4,338,342,1.313197,103.895815
438739,20,64,84,1.313153,103.895827
438740,24,341,365,1.313107,103.89583
438741,13,175,188,1.313054,103.895851
438742,4,872,876,1.313091,103.895896
438744,0,1,1,1.310776,103.897922
438745,0,3,3,1.310939,103.898298
438746,1,594,595,1.312457,103.896139
438747,1,719,720,1.310682,103.896974
438748,79,4,83,1.310762,103.89728
438749,61,6,67,1.310519,103.8974
438750,210,848,1058,1.310314,103.897415
438751,0,3,3,1.312694,103.896093
438756,4,98,102,1.309087,103.89802
438757,1,28,29,1.309021,103.898027
438758,0,26,26,1.308993,103.898049
438759,11,26,37,1.308921,103.898067
438760,78,20,98,1.308938,103.898215
438761,15,178,193,1.308863,103.898253
438762,2,116,118,1.308662,103.898176
438764,10,22,32,1.308583,103.898193
438765,1,1,2,1.305255,103.898798
438767,0,1,1,1.312826,103.896027
438768,215,0,215,1.307996,103.898463
438769,64,261,325,1.307849,103.898563
438770,0,5,5,1.307534,103.898707
438772,77,872,949,1.307039,103.898889
438773,721,291,1012,1.306344,103.898709
438774,58,356,414,1.306874,103.89895
438775,2,925,927,1.30673,103.899023
438776,51,84,135,1.306583,103.899503
438777,5,23,28,1.306491,103.899107
438778,2,13,15,1.306376,103.89915
438779,60,689,749,1.30643,103.89913
438780,4,99,103,1.306313,103.899176
438781,5,146,151,1.306227,103.899215
438782,8,19,27,1.306113,103.89927
438783,10,5,15,1.305635,103.89956
438784,7,4,11,1.304642,103.900115
438785,0,3,3,1.310314,103.897415
438786,1,8,9,1.304535,103.900148
438787,1,16,17,1.30393,103.900325
438789,21,492,513,1.308406,103.898289
438790,1,162,163,1.307266,103.898163
438791,926,359,1285,1.306591,103.898422
438792,23,2,25,1.306313,103.898536
438793,860,122,982,1.306106,103.898642
438794,1258,214,1472,1.305727,103.898061
438795,955,294,1249,1.306345,103.897803
438796,501,139,640,1.308628,103.897257
438797,246,282,528,1.309967,103.897258
438798,815,174,989,1.310036,103.897227
438803,5,1,6,1.308957,103.898386
438804,41,0,41,1.308987,103.898443
438805,20,8,28,1.309033,103.898482
438806,173,7,180,1.309014,103.898447
438807,9,27,36,1.309006,103.898378
438808,7,6,13,1.308851,103.898387
438809,3,2,5,1.309068,103.8986
438810,3,7,10,1.308913,103.898517
438811,28,19,47,1.309062,103.898692
438812,4,0,4,1.308612,103.898893
438813,0,7,7,1.309143,103.898816
438815,3,30,33,1.309179,103.898892
438816,7,1,8,1.309067,103.898799
438818,61,0,61,1.30918,103.899012
438819,6,0,6,1.309256,103.899189
438835,6,5,11,1.307849,103.898563
438837,2,1,3,1.304588,103.900105
438838,1,6,7,1.307848,103.898562
438839,1,279,280,1.307848,103.898562
438840,27,4,31,1.307463,103.899367
438855,5,62,67,1.307992,103.899228
438857,7,0,7,1.308105,103.899154
438858,0,9,9,1.308144,103.899144
438859,67,1,68,1.308012,103.899317
438860,10,15,25,1.308395,103.899034
438861,5,22,27,1.308043,103.899396
438862,1,2,3,1.307848,103.898562
438863,5,33,38,1.308103,103.899553
438864,0,4,4,1.308146,103.899471
438865,97,2,99,1.308164,103.899711
438866,208,4,212,1.308259,103.899609
438867,48,2,50,1.308224,103.899868
438868,1,38,39,1.308154,103.899632
438869,97,0,97,1.308285,103.900026
438870,2,4,6,1.308229,103.899829
438871,2,5,7,1.307959,103.898972
438872,2,1,3,1.308362,103.8991
438873,12,31,43,1.308295,103.900016
438887,5,802,807,1.311205,103.893836
438888,3,3,6,1.31121,103.893736
438889,0,3,3,1.308017,103.898986
438890,1,0,1,1.308205,103.898401
438891,5,3,8,1.311202,103.893484
438892,1,0,1,1.311201,103.893574
438893,0,4,4,1.311343,103.893718
438894,20,0,20,1.311343,103.893718
438896,0,3,3,1.311206,103.89365
438897,1,1,2,1.308532,103.898238
438898,78,101,179,1.311203,103.893043
438899,0,5,5,1.311341,103.893384
438900,2,16,18,1.31134,103.893383
438901,9,2,11,1.31134,103.893383
438902,38,0,38,1.31134,103.893383
438903,30,19,49,1.31134,103.893383
438905,1,2,3,1.311343,103.893718
438906,83,1,84,1.311341,103.892949
438907,8,22,30,1.3112,103.892602
438908,3,2,5,1.311329,103.892824
438909,0,2,2,1.311343,103.893718
438910,3,0,3,1.31117,103.892853
438911,1,3,4,1.311433,103.89265
438912,0,2,2,1.311205,103.892417
438913,1,8,9,1.31135,103.892262
438914,1,2,3,1.311457,103.892751
438915,0,5,5,1.31135,103.892262
438916,20,11,31,1.311205,103.892293
438917,7,0,7,1.311129,103.891543
438919,0,2,2,1.31135,103.892262
438920,242,0,242,1.311202,103.893323
438934,19,1218,1237,1.312586,103.89402
438935,107,6,113,1.312553,103.893815
438936,4,23,27,1.312453,103.893282
438937,2,7,9,1.312463,103.893152
438938,6,20,26,1.312532,103.893672
438940,10,12,22,1.312536,103.893472
438941,5,0,5,1.312547,103.893426
438942,0,1,1,1.311344,103.89372
438944,0,2,2,1.31118,103.892739
438945,65,0,65,1.312548,103.893227
438946,1,16,17,1.312513,103.892997
438947,0,3,3,1.31135,103.892262
438948,45,0,45,1.312397,103.892671
438949,0,1,1,1.312546,103.893425
438950,0,2,2,1.312291,103.893004
438951,367,6,373,1.312468,103.893059
438966,3,0,3,1.31245,103.89273
438967,0,18,18,1.304921,103.895839
438968,64,2,66,1.304823,103.895825
438969,52,9,61,1.304806,103.895646
438970,3,31,34,1.304912,103.895551
438971,29,11,40,1.30479,103.895491
438972,4,1,5,1.304803,103.895206
438973,0,2,2,1.312407,103.892454
438974,1,0,1,1.312373,103.892526
438975,4,11,15,1.304912,103.89536
438976,17,0,17,1.304769,103.894738
438978,49,0,49,1.304761,103.89463
438980,87,4,91,1.30479,103.894757
438981,9,0,9,1.304701,103.894355
438982,12,4,16,1.304784,103.894669
438983,26,2,28,1.304684,103.89414
438984,81,0,81,1.304677,103.894069
438985,0,1,1,1.304777,103.894845
438986,145,0,145,1.30466,103.893854
438987,92,1,93,1.304764,103.894191
438989,0,1,1,1.304757,103.894317
438990,14,0,14,1.304627,103.893424
438991,9,0,9,1.304754,103.89402
438992,6,9,15,1.304747,103.893893
438993,8,0,8,1.304746,103.893792
438994,1,7,8,1.304506,103.8928
438996,4,4,8,1.304492,103.892598
438997,11,2,13,1.304739,103.893605
438998,1,0,1,1.304756,103.894116
438999,166,0,166,1.304494,103.892253
439001,2,1,3,1.304828,103.896003
439002,3,0,3,1.304494,103.892253
439003,6,2,8,1.304468,103.89185
439004,1,3,4,1.304467,103.891849
439005,42,3,45,1.304467,103.891849
439007,2,0,2,1.30489,103.895232
439008,1,0,1,1.304495,103.892254
439010,7,23,30,1.30444,103.891445
439011,8,0,8,1.30444,103.891445
439012,679,24,703,1.305368,103.890726
439013,7,16,23,1.304163,103.891475
439014,16,24,40,1.304205,103.89109
439016,26,4,30,1.304354,103.889666
439017,12,0,12,1.303899,103.88947
439018,7,6,13,1.304007,103.889266
439020,37,0,37,1.303943,103.88911
439021,26,30,56,1.304606,103.890168
439022,6,7,13,1.304011,103.888887
439023,7,0,7,1.304511,103.889867
439024,32,2,34,1.304541,103.889731
439025,13,9,22,1.304505,103.889629
439027,27,0,27,1.304458,103.889403
439028,12,9,21,1.304449,103.889057
439029,6,0,6,1.304407,103.888646
439030,1,0,1,1.304216,103.891855
439031,3,0,3,1.304732,103.893439
439032,1,0,1,1.304406,103.888645
439033,12,3,15,1.304308,103.888319
439034,3,9,12,1.304318,103.888185
439035,6,0,6,1.303875,103.887622
439036,3,0,3,1.304406,103.888645
439037,88,0,88,1.303861,103.887282
439039,156,0,156,1.303805,103.887011
439040,8,6,14,1.304198,103.886962
439041,8,1,9,1.303838,103.886737
439042,3,0,3,1.303896,103.887491
439043,14,0,14,1.303849,103.886568
439044,9,18,27,1.304192,103.886501
439045,2,0,2,1.304717,103.893338
439046,4,0,4,1.303769,103.886457
439047,1,15,16,1.304258,103.886054
439048,6,0,6,1.3038,103.886109
439049,9,0,9,1.30374,103.885941
439050,10,45,55,1.304182,103.885631
439051,39,756,795,1.303907,103.885721
439052,4,134,138,1.30378,103.885763
439053,2604,1000,3604,1.30444,103.885325
439057,3,28,31,1.304454,103.891124
439058,54,0,54,1.304454,103.891124
439059,0,1,1,1.304406,103.888645
439060,2,3,5,1.30476,103.894629
439061,15,0,15,1.304659,103.893853
439063,32,8,40,1.304436,103.890041
439064,81,47,128,1.304406,103.889952
439065,105,92,197,1.304226,103.890668
439066,53,3,56,1.303829,103.886291
439067,0,10,10,1.304419,103.890322
439068,33,3,36,1.304419,103.890322
439069,987,1430,2417,1.300196,103.885147
439075,7,94,101,1.300203,103.885647
439077,14,78,92,1.299584,103.885651
439078,20,0,20,1.299461,103.886176
439079,94,2,96,1.299394,103.886568
439080,1,1,2,1.304194,103.886363
439081,76,7,83,1.299401,103.887288
439082,2,0,2,1.299426,103.886991
439083,19,1238,1257,1.299259,103.885891
439084,33,5,38,1.299313,103.885973
439085,1,8,9,1.299197,103.886459
439086,0,13,13,1.299219,103.886835
439087,1,23,24,1.2992,103.886697
439088,1107,73,1180,1.299534,103.885359
439089,811,404,1215,1.299148,103.884952
439090,9,1739,1748,1.298728,103.885054
439091,1,25,26,1.298741,103.884969
439092,273,0,273,1.298745,103.884906
439093,0,1,1,1.304676,103.894068
439094,1,0,1,1.298751,103.884832
439096,0,2,2,1.299509,103.837
439097,0,9,9,1.298898,103.884655
439098,1,8,9,1.298501,103.884625
439099,0,1,1,1.298751,103.884773
439100,0,1,1,1.298519,103.884701
439103,0,1,1,1.298658,103.884707
439105,0,27,27,1.298585,103.885183
439107,6,65,71,1.299509,103.837
439172,11,99,110,1.29497,103.889913
439173,6,710,716,1.294612,103.87584
439174,35,95,130,1.299509,103.837
439188,12,444,456,1.308683,103.890521
439189,3,324,327,1.308814,103.891209
439190,12,206,218,1.309427,103.893126
439191,1,9,10,1.309454,103.893237
439192,206,179,385,1.309575,103.893739
439193,1125,456,1581,1.309794,103.894641
439196,0,37,37,1.309517,103.894781
439197,1,85,86,1.309517,103.894781
439198,655,156,811,1.309808,103.895054
439199,6,235,241,1.309505,103.894972
439201,18,0,18,1.309507,103.895117
439202,1,0,1,1.298593,103.885047
439203,5,11,16,1.309486,103.895556
439204,529,782,1311,1.309794,103.895512
439205,1,20,21,1.309477,103.895721
439207,2,0,2,1.298866,103.884723
439208,6,3,9,1.310078,103.895956
439209,8,0,8,1.310109,103.89603
439210,1,5,6,1.310123,103.896099
439211,8,0,8,1.310125,103.896184
439212,0,2,2,1.310015,103.895901
439213,5,0,5,1.310167,103.896341
439215,3,4,7,1.310184,103.89641
439216,0,2,2,1.31015,103.896258
439218,0,11,11,1.310184,103.89641
439219,1166,13,1179,1.310132,103.896456
439220,2,75,77,1.310122,103.896413
439221,7,578,585,1.310118,103.896369
439222,2,88,90,1.310109,103.896322
439223,5,198,203,1.310094,103.896256
439224,1,58,59,1.310087,103.896202
439225,3,143,146,1.310076,103.896142
439226,2,59,61,1.310066,103.896099
439227,8,122,130,1.310049,103.896035
439228,4,136,140,1.310025,103.895995
439230,2,296,298,1.309567,103.897899
439231,1,237,238,1.30927,103.898025
439232,8,31,39,1.309543,103.898161
439233,1,29,30,1.309548,103.898451
439234,3,22,25,1.30957,103.898725
439235,28,577,605,1.309387,103.898997
439236,0,30,30,1.309523,103.898976
439237,67,998,1065,1.309248,103.899272
439238,3,848,851,1.309397,103.89955
439239,2,479,481,1.309222,103.900224
439240,2,394,396,1.309694,103.900454
439241,33,355,388,1.309655,103.901081
439242,23,64,87,1.309485,103.893435
439243,3,86,89,1.309493,103.895248
439244,2,0,2,1.310184,103.89641
439245,3,13,16,1.309211,103.900768
439257,4,127,131,1.308932,103.894806
439258,0,7,7,1.308854,103.895017
439259,2,23,25,1.308934,103.895072
439260,1,3,4,1.30887,103.895173
439261,0,8,8,1.308947,103.895312
439262,0,10,10,1.308885,103.895329
439263,4,2,6,1.308953,103.895439
439264,26,1,27,1.3089,103.895484
439265,2,9,11,1.308969,103.895568
439266,0,4,4,1.308915,103.89564
439267,7,0,7,1.308976,103.895665
439268,2,17,19,1.308931,103.895796
439269,58,1,59,1.308976,103.895728
439270,2,1,3,1.304169,103.886644
439271,4,100,104,1.309041,103.89606
439272,7,36,43,1.308631,103.895897
439273,53,9,62,1.308914,103.895639
439274,6,27,33,1.308946,103.895258
439275,67,331,398,1.308832,103.894783
439289,13,28,41,1.298394,103.894714
439290,3,0,3,1.308946,103.895952
439291,64,3,67,1.299742,103.894135
439292,1,0,1,1.309492,103.895396
439293,1,37,38,1.29847,103.894685
439294,21,25,46,1.300127,103.894021
439295,6,28,34,1.298569,103.89467
439296,108,16,124,1.30053,103.893914
439297,3,430,433,1.300636,103.893874
439298,6,24,30,1.298683,103.894628
439299,2,0,2,1.309937,103.891328
439300,9,10,19,1.298788,103.894589
439301,1,89,90,1.298867,103.894567
439302,208,2,210,1.302273,103.893549
439303,1,2,3,1.299626,103.894159
439304,21,0,21,1.302518,103.893564
439305,7,0,7,1.302572,103.893591
439306,11,15,26,1.302691,103.89354
439307,2,5,7,1.302734,103.893524
439308,13,1,14,1.302981,103.893346
439309,1,3,4,1.302992,103.893557
439310,0,25,25,1.303728,103.893193
439311,2,0,2,1.301649,103.893461
439312,50,0,50,1.303472,103.892953
439313,21,19,40,1.303673,103.892846
439314,0,1,1,1.29988,103.89407
439315,0,8,8,1.304802,103.893145
439316,12,0,12,1.304906,103.893125
439317,7,0,7,1.304177,103.892823
439318,38,0,38,1.305098,103.893113
439319,141,0,141,1.305207,103.893112
439320,2,7,9,1.305337,103.893095
439321,26,10,36,1.305392,103.89309
439323,2,0,2,1.303734,103.893279
439324,2,8,10,1.305896,103.89331
439325,2,5,7,1.30607,103.893124
439326,1,1,2,1.305604,103.893091
439327,3,3,6,1.306411,103.893255
439329,0,1,1,1.304762,103.893129
439330,10,0,10,1.306281,103.890455
439331,11,1,12,1.306275,103.890342
439334,3,1,4,1.306752,103.892795
439335,25,3,28,1.306704,103.892634
439336,27,8,35,1.30671,103.892467
439339,1,9,10,1.306663,103.892326
439340,1,0,1,1.30629,103.890559
439342,1,0,1,1.306656,103.892262
439343,1,5,6,1.306505,103.890773
439344,16,5,21,1.306599,103.890771
439345,1,10,11,1.306557,103.890563
439346,0,5,5,1.306512,103.890565
439347,2,6,8,1.306445,103.890551
439348,64,10,74,1.306409,103.890556
439349,2,0,2,1.306268,103.893092
439350,6,1,7,1.306626,103.891547
439351,0,5,5,1.308727,103.892847
439352,4,98,102,1.30897,103.892807
439353,4,1,5,1.308142,103.892638
439354,8,0,8,1.308192,103.892645
439355,159,0,159,1.308249,103.892645
439356,1,4,5,1.308299,103.892627
439357,0,1,1,1.306666,103.891423
439358,0,1,1,1.306675,103.892185
439359,1,7,8,1.308469,103.892634
439360,3,20,23,1.308544,103.892631
439361,25,3,28,1.308598,103.892633
439363,0,1,1,1.306647,103.89209
439364,0,1,1,1.308694,103.892613
439365,2,298,300,1.308806,103.892614
439366,24,4,28,1.306612,103.891836
439367,1,2,3,1.302391,103.893496
439368,0,2,2,1.306652,103.891615
439369,6,3,9,1.306652,103.891939
439370,3,6,9,1.301472,103.893757
439371,3,6,9,1.301645,103.893719
439372,16,1,17,1.304714,103.887175
439373,3,0,3,1.30664,103.891735
439374,7,1,8,1.30488,103.887306
439375,4,1,5,1.304752,103.887321
439376,2,3,5,1.30462,103.887344
439378,3,0,3,1.304857,103.886955
439379,4,4,8,1.304313,103.887314
439380,0,1,1,1.308749,103.892609
439381,6,0,6,1.304475,103.887315
439382,60,3,63,1.305251,103.887183
439383,20,5,25,1.304532,103.887187
439384,3,14,17,1.304369,103.8872
439385,1,0,1,1.304984,103.887183
439386,25,1,26,1.305146,103.88726
439387,6,3,9,1.305189,103.887257
439388,0,1,1,1.305001,103.887277
439398,9,8,17,1.299672,103.892079
439399,3,0,3,1.304389,103.88732
439400,54,0,54,1.299454,103.892141
439401,1,1,2,1.306669,103.89198
439403,6,0,6,1.299335,103.891967
439404,2,3,5,1.299185,103.892013
439406,0,2,2,1.299568,103.891879
439407,7,0,7,1.299462,103.891652
439421,66,91,157,1.311891,103.894991
439422,816,74,890,1.312057,103.895111
439423,1266,311,1577,1.312019,103.895453
439424,565,12,577,1.312519,103.894906
439425,2,24,26,1.312486,103.894868
439426,1,41,42,1.312472,103.894801
439431,423,421,844,1.312656,103.895289
439442,183,106,289,1.312674,103.895673
439443,74,858,932,1.312716,103.895923
439444,414,112,526,1.312505,103.894566
439445,448,260,708,1.312354,103.894609
439459,6,3,9,1.298239,103.891081
439460,21,0,21,1.298305,103.891145
439462,3,3,6,1.297451,103.891216
439463,0,2,2,1.299645,103.891813
439464,1,0,1,1.304951,103.887292
439465,1,1,2,1.297345,103.891157
439466,215,15,230,1.298681,103.89094
439467,6,18,24,1.298725,103.89094
439468,35,3,38,1.298626,103.890949
439469,1,0,1,1.298589,103.891075
439470,4,0,4,1.298783,103.891092
439471,8,20,28,1.299147,103.890917
439472,0,1,1,1.298843,103.890929
439473,24,4,28,1.299276,103.890856
439474,1,1,2,1.298644,103.891075
439475,26,0,26,1.298991,103.891383
439476,199,31,230,1.299809,103.890687
439477,0,2,2,1.299458,103.890588
439479,1,0,1,1.299204,103.89086
439480,18,199,217,1.299711,103.891063
439481,65,64,129,1.300335,103.89097
439482,8,0,8,1.300454,103.890926
439483,58,3,61,1.300597,103.890894
439484,25,3,28,1.300694,103.890872
439485,126,8,134,1.300864,103.890853
439486,12,1,13,1.301188,103.890575
439487,2,8,10,1.30154,103.890812
439488,5,0,5,1.30171,103.890415
439490,1,4,5,1.301955,103.89069
439491,30,3,33,1.303085,103.890101
439494,28,0,28,1.303954,103.889995
439496,5,20,25,1.305215,103.890074
439497,12,5,17,1.305302,103.890389
439498,10,36,46,1.305778,103.89001
439499,1,103,104,1.305851,103.890025
439500,117,52,169,1.305956,103.889999
439501,1236,163,1399,1.305812,103.88968
439502,29,28,57,1.306025,103.889998
439503,10,0,10,1.302925,103.890149
439504,3,1,4,1.303014,103.89061
439505,4,4,8,1.30477,103.889976
439506,2,7,9,1.304018,103.890595
439507,4,1,5,1.302213,103.890322
439508,18,10,28,1.302213,103.890322
439509,8,1,9,1.302593,103.890267
439510,32,29,61,1.302489,103.890332
439511,6,1,7,1.302213,103.890322
439512,5,32,37,1.300376,103.890562
439513,0,1,1,1.299521,103.891105
439514,1,0,1,1.300502,103.890573
439515,53,1,54,1.297735,103.891144
439517,1,0,1,1.300645,103.890515
439518,10,8,18,1.305728,103.890463
439519,0,12,12,1.305611,103.890233
439520,5,0,5,1.305725,103.890517
439522,0,3,3,1.29978,103.891797
439524,7,2,9,1.305722,103.89065
439540,1,6,7,1.304121,103.896009
439541,11,0,11,1.30397,103.89614
439542,2,7,9,1.303927,103.896009
439543,5,0,5,1.303699,103.896006
439544,42,2,44,1.303668,103.895848
439545,12,0,12,1.303909,103.895873
439546,7,18,25,1.304239,103.895805
439547,18,0,18,1.303922,103.895606
439548,13,0,13,1.304084,103.895754
439549,14,4,18,1.303876,103.895362
439551,2,0,2,1.299129,103.891129
439552,7,5,12,1.303859,103.894822
439553,3,1,4,1.304046,103.895429
439554,19,1,20,1.303847,103.894744
439555,9,3,12,1.304017,103.895221
439556,2,0,2,1.303877,103.894947
439558,4,0,4,1.304028,103.894911
439559,3,0,3,1.30573,103.890591
439561,7,18,25,1.304142,103.894807
439562,9,0,9,1.304024,103.894747
439565,171,0,171,1.304033,103.894634
439566,4,2,6,1.304002,103.894505
439567,65,22,87,1.303792,103.89389
439569,28,4,32,1.304131,103.894384
439570,31,0,31,1.30378,103.893752
439571,98,1,99,1.30398,103.894253
439572,1,2,3,1.303816,103.894426
439573,8,0,8,1.303757,103.893574
439574,19,9,28,1.303913,103.894012
439575,1,0,1,1.300811,103.89086
439576,54,28,82,1.304104,103.893913
439578,2,7,9,1.303873,103.893648
439579,7,0,7,1.303931,103.893657
439580,36,0,36,1.304043,103.893546
439581,3,1,4,1.304073,103.893336
439582,1,6,7,1.303843,103.893025
439583,1,0,1,1.303734,103.893367
439584,0,3,3,1.303752,103.893699
439585,2,0,2,1.303808,103.894322
439586,8,0,8,1.303652,103.892387
439588,177,16,193,1.303806,103.892641
439589,7,0,7,1.30365,103.892025
439590,8,7,15,1.303801,103.892342
439591,1,0,1,1.304011,103.892917
439592,3,0,3,1.303668,103.892509
439593,88,0,88,1.303793,103.892215
439594,202,0,202,1.303622,103.891482
439595,2,7,9,1.303761,103.892045
439596,5,3,8,1.30359,103.891352
439597,4,0,4,1.303758,103.891907
439599,37,0,37,1.303568,103.891101
439600,15,0,15,1.303732,103.891669
439601,1,1,2,1.303957,103.89284
439602,1,8,9,1.30351,103.890781
439603,39,0,39,1.303712,103.891409
439604,3,0,3,1.303639,103.891627
439605,1,0,1,1.303566,103.891777
439606,5,0,5,1.303694,103.891106
439607,13,0,13,1.303869,103.890856
439608,7,0,7,1.303693,103.890962
439609,22,0,22,1.303666,103.890524
439611,4,1,5,1.30343,103.889537
439612,2,0,2,1.303724,103.89157
439613,1,7,8,1.303709,103.890187
439614,4,3,7,1.303384,103.8892
439615,2,4,6,1.303714,103.889982
439616,18,8,26,1.30337,103.889005
439617,50,0,50,1.303589,103.889799
439618,12,0,12,1.303362,103.888818
439619,21,2,23,1.303356,103.888652
439620,34,14,48,1.30356,103.889541
439621,0,2,2,1.303417,103.889428
439622,4,4,8,1.303535,103.889247
439623,4,0,4,1.303322,103.888379
439624,2,6,8,1.303086,103.888392
439625,0,1,1,1.30325,103.89069
439626,6,0,6,1.303468,103.888744
439627,25,0,25,1.303417,103.887666
439628,28,0,28,1.303232,103.887663
439629,0,2,2,1.303339,103.888545
439630,21,1,22,1.30357,103.88749
439631,34,0,34,1.302909,103.887415
439632,4,6,10,1.303568,103.88728
439633,4,0,4,1.303174,103.887018
439634,2,2,4,1.303307,103.886988
439635,32,7,39,1.303505,103.886769
439636,3,12,15,1.303205,103.886766
439637,213,7,220,1.303276,103.886494
439638,19,14,33,1.303285,103.886325
439639,58,0,58,1.303172,103.886416
439640,16,6,22,1.303271,103.885961
439641,2,5,7,1.302957,103.886357
439642,10,58,68,1.303468,103.885755
439643,42,7,49,1.302975,103.886069
439644,63,2,65,1.303922,103.893489
439645,52,10,62,1.303646,103.89226
439646,37,0,37,1.303626,103.892149
439647,200,0,200,1.303196,103.886713
439648,10,10,20,1.303195,103.886635
439649,3,2,5,1.303637,103.891948
439652,19,6,25,1.30355,103.890968
439653,42,3,45,1.303485,103.890018
439654,2,0,2,1.30323,103.887524
439655,0,5,5,1.303477,103.890135
439656,22,3,25,1.302961,103.887278
439657,2,0,2,1.303466,103.889871
439658,19,0,19,1.303784,103.892505
439659,22,5,27,1.302381,103.896513
439660,0,35,35,1.302781,103.896451
439661,7,3,10,1.302367,103.896226
439662,1,0,1,1.303509,103.889021
439664,3,3,6,1.302647,103.895913
439665,0,1,1,1.302715,103.896088
439666,1,2,3,1.303709,103.891284
439667,1,0,1,1.302363,103.89593
439669,32,16,48,1.302272,103.895514
439670,0,17,17,1.302625,103.896451
439672,40,19,59,1.302368,103.895311
439674,24,0,24,1.302345,103.895051
439675,8,1,9,1.302218,103.895189
439676,72,1,73,1.302289,103.894796
439677,3,0,3,1.302532,103.895888
439678,1,1,2,1.303276,103.886093
439679,13,0,13,1.302158,103.89488
439680,1,3,4,1.302196,103.894468
439681,3,1,4,1.301981,103.894749
439682,1,0,1,1.302306,103.895767
439683,22,0,22,1.302088,103.894581
439684,8,0,8,1.30215,103.894186
439687,4,0,4,1.302002,103.894195
439688,0,2,2,1.302236,103.894627
439689,80,0,80,1.301975,103.894104
439690,0,3,3,1.302188,103.895039
439691,1,1,2,1.302083,103.893885
439692,14,0,14,1.301582,103.893243
439693,0,2,2,1.301837,103.893762
439694,4,0,4,1.301571,103.893068
439695,59,0,59,1.301891,103.893039
439696,30,1,31,1.301778,103.892836
439698,2,4,6,1.301853,103.892879
439699,1,0,1,1.302121,103.894724
439702,58,10,68,1.301709,103.892538
439703,0,1,1,1.301768,103.892718
439704,7,0,7,1.301632,103.892321
439705,7,1,8,1.301588,103.892012
439706,10,0,10,1.301662,103.891788
439707,1,0,1,1.301822,103.892593
439708,2,0,2,1.302101,103.89314
439709,1,20,21,1.30147,103.89135
439710,14,0,14,1.301579,103.891442
439711,30,3,33,1.301199,103.891314
439712,1,0,1,1.301533,103.891666
439713,0,3,3,1.302164,103.893682
439715,3,1,4,1.301486,103.891015
439716,25,2,27,1.302316,103.894938
439717,16,0,16,1.301747,103.892208
439718,85,1,86,1.301733,103.892072
439719,4,0,4,1.301706,103.891963
439720,12,0,12,1.301609,103.891529
439721,88,1,89,1.301593,103.891478
439722,6,0,6,1.302244,103.891339
439723,21,1,22,1.302221,103.891167
439725,13,1,14,1.301539,103.891254
439726,1,0,1,1.301199,103.891314
439727,0,9,9,1.302259,103.895455
439728,48,0,48,1.302238,103.895372
439729,5,0,5,1.30223,103.895262
439730,0,3,3,1.301515,103.891155
439731,4,0,4,1.305442,103.895666
439732,1,1,2,1.301632,103.891616
439733,4,7,11,1.305848,103.895584
439734,8,0,8,1.30583,103.895515
439736,22,0,22,1.305711,103.895467
439737,11,1,12,1.305779,103.895358
439738,65,2,67,1.305789,103.895197
439739,5,0,5,1.305693,103.895297
439740,13,13,26,1.305754,103.895052
439741,108,0,108,1.305789,103.895303
439742,16,0,16,1.305794,103.895227
439743,1,6,7,1.305541,103.895119
439744,3,3,6,1.305738,103.894846
439745,0,1,1,1.301543,103.891225
439746,17,0,17,1.305679,103.895122
439747,8,0,8,1.305684,103.895159
439748,8,40,48,1.304896,103.894833
439749,32,0,32,1.305019,103.894827
439750,2,0,2,1.305755,103.895542
439751,50,1,51,1.305454,103.894717
439752,7,0,7,1.306093,103.894471
439753,2,1,3,1.301562,103.891825
439754,6,3,9,1.305802,103.894436
439755,2,4,6,1.30579,103.894218
439756,35,1,36,1.305444,103.894461
439757,4,3,7,1.305807,103.894311
439758,2,0,2,1.305799,103.894619
439759,7,0,7,1.305429,103.894283
439760,1,1,2,1.306077,103.894303
439761,9,0,9,1.305412,103.894079
439762,28,9,37,1.305762,103.893555
439763,61,0,61,1.305392,103.893713
439764,6,12,18,1.305675,103.895072
439765,17,0,17,1.305194,103.894225
439766,6,2,8,1.305698,103.895415
439767,54,0,54,1.305696,103.895355
439768,0,17,17,1.305691,103.89525
439769,31,1,32,1.305911,103.893965
439770,84,1,85,1.305892,103.89402
439771,4,1,5,1.305815,103.893563
439772,8,4,12,1.305777,103.895122
439773,2,0,2,1.306046,103.893879
439774,20,0,20,1.305155,103.893938
439775,24,2,26,1.305389,103.89388
439776,2,1,3,1.305345,103.894766
439777,4,0,4,1.305915,103.894129
439778,33,0,33,1.305362,103.893687
439780,20,0,20,1.30514,103.889038
439781,2,4,6,1.305232,103.889028
439782,1,0,1,1.305917,103.894674
439783,14,0,14,1.305299,103.889454
439784,26,0,26,1.305171,103.889335
439785,26,34,60,1.30542,103.889888
439786,26,0,26,1.305186,103.889579
439787,3,0,3,1.30592,103.894291
439788,14,0,14,1.305218,103.889908
439789,18,6,24,1.305288,103.889574
439790,3,2,5,1.305294,103.889693
439791,18,0,18,1.305138,103.888949
439792,0,2,2,1.305395,103.894003
439793,9,4,13,1.305231,103.88916
439794,0,4,4,1.305242,103.889277
439795,6,0,6,1.305176,103.889482
439796,0,5,5,1.299509,103.837
439804,16,0,16,1.305206,103.888491
439805,10,0,10,1.305009,103.888447
439806,2,3,5,1.30479,103.88846
439807,12,73,85,1.301792,103.887873
439810,2,0,2,1.305122,103.888784
439811,3,2,5,1.303755,103.888414
439812,19,19,38,1.30356,103.888414
439813,1,1,2,1.304768,103.888725
439814,4,1,5,1.302801,103.888425
439815,0,1,1,1.304912,103.889255
439816,0,4,4,1.302586,103.888407
439817,4,5,9,1.30232,103.888348
439818,23,6,29,1.302291,103.888156
439819,1,0,1,1.302686,103.888426
439820,1,1,2,1.30253,103.888412
439821,16,0,16,1.302,103.888101
439822,1,0,1,1.302158,103.88814
439823,79,2,81,1.301687,103.888198
439824,42,211,253,1.300469,103.887532
439825,14,10,24,1.301584,103.888048
439826,1722,384,2106,1.299907,103.887896
439827,334,11,345,1.29892,103.887605
439828,132,173,305,1.298608,103.887881
439829,1034,298,1332,1.298909,103.887328
439830,994,140,1134,1.299156,103.88768
439831,18,11,29,1.305217,103.888886
439832,5,7,12,1.305216,103.888832
439833,98,5,103,1.299509,103.837
439834,46,0,46,1.299509,103.837
439845,2206,364,2570,1.299229,103.89848
439846,0,6,6,1.299104,103.897053
439847,0,25,25,1.299081,103.897129
439848,0,7,7,1.299049,103.897216
439850,1,28,29,1.298991,103.8974
439851,1,63,64,1.298974,103.897479
439852,2,37,39,1.299355,103.898205
439853,51,263,314,1.299438,103.89833
439854,638,134,772,1.29911,103.899127
439855,4,105,109,1.29946,103.898494
439856,0,15,15,1.299477,103.898554
439857,991,410,1401,1.299146,103.899208
439859,0,1,1,1.301938,103.888107
439860,2,10,12,1.299492,103.898573
439861,0,10,10,1.299513,103.89867
439862,2,3,5,1.299511,103.898769
439863,102,166,268,1.299389,103.899421
439865,327,190,517,1.299646,103.899783
439866,484,153,637,1.299536,103.898841
439868,36,123,159,1.300017,103.900246
439869,169,118,287,1.29992,103.89903
439870,1071,114,1185,1.300211,103.900423
439871,348,999,1347,1.300382,103.9007
439872,1516,276,1792,1.300646,103.901251
439873,11,1086,1097,1.300627,103.901205
439874,300,70,370,1.300254,103.900178
439875,13,282,295,1.300178,103.900171
439876,108,15,123,1.300382,103.900492
439877,268,79,347,1.300619,103.900898
439878,106,34,140,1.300762,103.901126
439885,243,722,965,1.300792,103.901267
439886,77,42,119,1.302636,103.901821
439887,7,4418,4425,1.301241,103.900679
439888,1673,5670,7343,1.301285,103.900843
439889,2,1191,1193,1.302474,103.900738
439890,1,97,98,1.302474,103.900738
439892,15,345,360,1.302474,103.900738
439893,2556,299,2855,1.302474,103.900738
439894,1994,93,2087,1.303008,103.90138
439895,1518,163,1681,1.303144,103.901622
439897,2602,81,2683,1.303385,103.901966
439899,1,66,67,1.302474,103.900738
439900,1,36,37,1.302474,103.900738
439901,0,44,44,1.302474,103.900738
439902,0,29,29,1.302474,103.900738
439903,1,16,17,1.302474,103.900738
439904,0,6,6,1.302474,103.900738
439905,1,10,11,1.302474,103.900738
439906,0,1,1,1.299482,103.89852
439907,0,2,2,1.302088,103.888117
439908,1,2,3,1.305188,103.889783
439909,1,8,9,1.302474,103.900738
439910,1,32,33,1.302474,103.900738
439911,0,94,94,1.302474,103.900738
439912,0,250,250,1.302474,103.900738
439913,0,448,448,1.302474,103.900738
439915,0,445,445,1.302474,103.900738
439917,0,375,375,1.302474,103.900738
439919,0,145,145,1.302474,103.900738
439920,1,162,163,1.302474,103.900738
439921,0,49,49,1.302474,103.900738
439922,1,78,79,1.302474,103.900738
439923,1,249,250,1.302474,103.900738
439924,2,89,91,1.302474,103.900738
439925,1,17,18,1.302474,103.900738
439926,3,176,179,1.302474,103.900738
439927,8,521,529,1.302474,103.900738
439928,0,130,130,1.302474,103.900738
439929,3,162,165,1.302474,103.900738
439930,4,110,114,1.302474,103.900738
439931,4,209,213,1.302474,103.900738
439932,4,311,315,1.302474,103.900738
439933,6,858,864,1.302474,103.900738
439934,8,1189,1197,1.302474,103.900738
439935,4,2904,2908,1.299936,103.90005
439936,4,2225,2229,1.302474,103.900738
439937,3,1858,1861,1.302474,103.900738
439938,4,990,994,1.302474,103.900738
439939,1,690,691,1.302474,103.900738
439940,0,190,190,1.302474,103.900738
439941,1,1808,1809,1.302695,103.900848
439942,1338,149,1487,1.301144,103.901562
439943,1602,14,1616,1.301479,103.902483
439944,1587,2,1589,1.301759,103.902877
439945,1694,4,1698,1.302359,103.902568
439946,988,6,994,1.302076,103.901966
439947,1105,588,1693,1.301592,103.901225
439948,597,1591,2188,1.301565,103.901325
439949,52,295,347,1.301133,103.902244
439950,231,4,235,1.300562,103.900552
439951,55,34,89,1.334916,103.746876
439952,33,140,173,1.299509,103.837
439957,2313,404,2717,1.301534,103.898474
439958,2673,687,3360,1.301372,103.898779
439959,2642,1010,3652,1.300952,103.898157
439960,2041,214,2255,1.300263,103.899561
439961,1478,189,1667,1.301036,103.899702
439962,4,277,281,1.301609,103.899754
439964,551,476,1027,1.301791,103.900238
439965,700,2508,3208,1.301905,103.900544
439966,1533,365,1898,1.301756,103.899721
439967,1335,2147,3482,1.301884,103.900267
439968,1097,723,1820,1.301904,103.900097
439969,1383,783,2166,1.30232,103.899494
439970,1135,174,1309,1.302506,103.89995
439971,42,151,193,1.302492,103.900252
439972,3599,1215,4814,1.301593,103.897737
439973,172,1324,1496,1.301787,103.898329
439974,2091,374,2465,1.301896,103.898977
439979,693,116,809,1.301574,103.899852
439983,3,584,587,1.302301,103.901259
439984,11,21,32,1.302301,103.901259
440001,502,184,686,1.304871,103.918319
440002,669,392,1061,1.304569,103.918039
440003,705,40,745,1.304197,103.917445
440004,906,221,1127,1.305149,103.917504
440005,815,4168,4983,1.304627,103.916938
440006,788,509,1297,1.303912,103.916295
440007,533,166,699,1.304223,103.917044
440008,410,343,753,1.304454,103.915936
440012,354,2269,2623,1.304686,103.915508
440013,332,100,432,1.304119,103.915318
440014,481,123,604,1.303541,103.915093
440015,379,3556,3935,1.304926,103.91384
440016,222,53,275,1.304433,103.913791
440017,885,86,971,1.303902,103.913902
440018,1335,30,1365,1.303337,103.914032
440019,287,791,1078,1.304402,103.914676
440020,462,458,920,1.303717,103.91481
440027,515,910,1425,1.304086,103.91318
440028,956,137,1093,1.303511,103.913029
440029,119,2202,2321,1.302935,103.912842
440030,1301,205,1506,1.304319,103.911007
440031,659,583,1242,1.303837,103.911205
440032,866,36,902,1.303276,103.911753
440033,1901,3609,5510,1.302815,103.911992
440034,1436,585,2021,1.303763,103.912031
440035,624,168,792,1.303118,103.91258
440043,322,2306,2628,1.305505,103.912895
440044,676,4668,5344,1.304869,103.912857
440045,941,10541,11482,1.304644,103.912262
440046,609,159,768,1.305121,103.91249
440047,601,1385,1986,1.305601,103.912092
440050,41,1938,1979,1.305042,103.915939
440051,493,369,862,1.306362,103.916064
440052,372,464,836,1.305881,103.916157
440053,424,7415,7839,1.305265,103.916178
440054,268,12034,12302,1.305411,103.91469
440055,504,2194,2698,1.305504,103.91385
440056,19,90,109,1.305628,103.915389
440057,358,2357,2715,1.306489,103.915416
440058,498,2216,2714,1.306093,103.913733
440059,951,669,1620,1.30588,103.914506
440060,281,352,633,1.303494,103.908332
440061,292,165,457,1.303173,103.908546
440062,857,67,924,1.302778,103.908816
440063,517,14,531,1.302514,103.90902
440064,870,258,1128,1.302105,103.909392
440065,928,315,1243,1.303517,103.909439
440066,139,55,194,1.303964,103.909269
440067,237,0,237,1.304452,103.909189
440071,448,227,675,1.304611,103.908712
440072,197,2497,2694,1.30432,103.908069
440073,273,461,734,1.303881,103.908027
440074,522,4883,5405,1.303598,103.906901
440075,431,366,797,1.303468,103.907273
440076,349,1014,1363,1.303042,103.907497
440077,1052,480,1532,1.302071,103.908502
440078,986,376,1362,1.301599,103.908412
440079,594,3293,3887,1.301608,103.907701
440080,284,2758,3042,1.302256,103.907597
440081,475,4159,4634,1.30286,103.907111
440082,24,39,63,1.302554,103.906736
440083,371,2345,2716,1.301769,103.906719
440084,68,135,203,1.302245,103.906557
440085,11,58,69,1.302055,103.906589
440086,93,41,134,1.301492,103.906681
440087,474,76197,76671,1.302638,103.905569
440089,177,220,397,1.30138,103.906661
441012,221,158,379,1.304357,103.915241
441014,9,61,70,1.303211,103.915502
441015,3,306,309,1.304837,103.91421
441016,71,172,243,1.30401,103.914144
441017,55,242,297,1.303487,103.914405
441032,16,194,210,1.303723,103.911882
441035,40,798,838,1.303798,103.912893
441043,11,1066,1077,1.305687,103.913325
441044,53,1162,1215,1.305048,103.913227
441047,1,9,10,1.305546,103.912582
441050,62,152,214,1.305719,103.915986
441065,31,347,378,1.302802,103.909526
441076,13,671,684,1.303277,103.907909
441077,121,249,370,1.299509,103.837
445448,2,5,7,1.299509,103.837
448879,238,1123,1361,1.308724,103.928616
448880,434,270,704,1.308378,103.927638
448906,2725,469,3194,1.306339,103.925486
448907,2283,180,2463,1.30604,103.924022
448908,5516,1118,6634,1.307426,103.92348
448909,5975,1314,7289,1.307723,103.925126
448910,66,352,418,1.307426,103.925843
448911,64,48,112,1.307537,103.924261
448912,66,1,67,1.307068,103.923784
449025,965,433,1398,1.305968,103.921169
449026,1328,340,1668,1.305643,103.921753
449027,993,212,1205,1.305923,103.922515
449028,993,230,1223,1.306153,103.922528
449029,363,196,559,1.306834,103.922145
449030,484,300,784,1.307509,103.921955
449031,618,1990,2608,1.307387,103.921618
449032,631,320,951,1.306699,103.921568
449033,1063,365,1428,1.307352,103.921438
449034,23,106,129,1.306286,103.922028
449035,349,143,492,1.306142,103.919825
449036,5,36,41,1.306036,103.919104
449149,207,3257,3464,1.305526,103.917371
449150,301,7017,7318,1.306597,103.917751
449265,1059,45629,46688,1.302814,103.904062
449266,195,123,318,1.299938,103.901878
449267,203,47,250,1.299864,103.901876
449268,126,1134,1260,1.299802,103.901883
449269,12779,25852,38631,1.301072,103.905281
449271,25,4829,4854,1.303337,103.905407
449273,592,3,595,1.3035,103.905561
449274,160,250,410,1.304314,103.906623
449282,439,1324,1763,1.304975,103.909671
449283,166,1208,1374,1.309723,103.927507
449284,896,1480,2376,1.309866,103.9303
449285,585,428,1013,1.309866,103.9303
449286,1347,710,2057,1.309866,103.9303
449287,1048,456,1504,1.309866,103.9303
449288,110,474,584,1.309866,103.9303
449289,289,961,1250,1.309697,103.930985
449290,802,431,1233,1.310052,103.932002
449291,1048,159,1207,1.309528,103.932078
449292,1043,394,1437,1.309172,103.932739
449293,1201,396,1597,1.309452,103.933507
449294,504,292,796,1.310017,103.933861
449295,582,1385,1967,1.310731,103.933412
449296,91,1448,1539,1.306456,103.914692
449297,830,3268,4098,1.301218,103.903849
449298,1019,285,1304,1.301261,103.903962
449300,1786,591,2377,1.300629,103.904605
449301,2886,884,3770,1.300354,103.903907
449302,1051,230,1281,1.30117,103.903837
449303,87,145,232,1.311459,103.933762
449304,13,183,196,1.309309,103.933083
449305,2983,1355,4338,1.299679,103.901741
449306,912,1049,1961,1.299631,103.901739
449307,2057,2,2059,1.299959,103.902858
449308,1849,806,2655,1.299938,103.902841
449309,2,12,14,1.299509,103.837
449310,9,1,10,1.299509,103.837
449311,3,0,3,1.302474,103.900738
449312,25,9,34,1.299509,103.837
449313,181,5,186,1.303548,103.905176
449314,49,44,93,1.299509,103.837
449315,24,2,26,1.299509,103.837
449408,307,523,830,1.301845,103.906223
449409,322,10913,11235,1.301923,103.907432
449410,27,13983,14010,1.303173,103.90667
449411,2205,262,2467,1.30153,103.906984
449412,1319,296,1615,1.301571,103.907039
449524,3,73,76,1.302438,103.903898
449527,58,30,88,1.304404,103.906802
449528,127,61,188,1.304493,103.906903
449529,28,6,34,1.305022,103.906547
449530,2,0,2,1.302474,103.900738
449531,26,0,26,1.305087,103.908009
449532,6,66,72,1.305131,103.90815
449533,0,21,21,1.305157,103.908192
449534,1,30,31,1.305192,103.908211
449536,11365,1939,13304,1.303766,103.902914
449627,15,13,28,1.299509,103.837
449761,490,914,1404,1.304906,103.911434
449874,841,647,1488,1.297597,103.90035
449875,1918,2288,4206,1.298913,103.905838
449876,2928,2954,5882,1.301206,103.91338
449877,1582,1987,3569,1.302508,103.915855
449878,213,508,721,1.302473,103.916065
449879,4,17,21,1.304028,103.923331
449880,6,1,7,1.304038,103.923344
449881,628,17,645,1.30562,103.929882
449882,292,17628,17920,1.305568,103.930223
449883,2052,7,2059,1.305216,103.930657
449884,50,27,77,1.306086,103.931081
449885,213,20,233,1.306253,103.934535
449886,9,8,17,1.306416,103.934628
449887,33,0,33,1.306351,103.934932
449889,43,0,43,1.298322,103.902927
449890,4,106,110,1.303086,103.921572
449891,82,0,82,1.305595,103.931679
449892,403,77,480,1.301427,103.914883
449893,70,1,71,1.302569,103.917722
449894,7,30,37,1.299509,103.837
449895,30,162,192,1.299509,103.837
450001,76,1520,1596,1.311762,103.922973
450002,8,1412,1420,1.311808,103.923062
450003,1,0,1,1.302474,103.900738
450004,0,4,4,1.311883,103.923271
454813,3,0,3,1.299509,103.837
454814,1,0,1,1.31186,103.923147
454820,1,0,1,1.299509,103.837
454822,0,3,3,1.299509,103.837
454827,1,0,1,1.299509,103.837
454828,3,4,7,1.299509,103.837
454837,27,0,27,1.299509,103.837
454838,4,0,4,1.299509,103.837
454840,4,71,75,1.299509,103.837
454842,2,40,42,1.299509,103.837
454847,8,0,8,1.299509,103.837
454852,1047,33,1080,1.318414,103.921288
454853,3,16,19,1.318586,103.920812
454854,23,27,50,1.3187,103.920648
454855,1322,28,1350,1.317776,103.922087
454856,2,1,3,1.299509,103.837
454857,0,7,7,1.310244,103.924399
454858,1,3,4,1.310244,103.924399
454917,1,4,5,1.299509,103.837
454918,21,1,22,1.299509,103.837
454920,0,2,2,1.305092,103.908094
454927,11,0,11,1.319437,103.919712
454932,2,24,26,1.319313,103.919685
454933,7,0,7,1.319292,103.919622
454934,9,0,9,1.319241,103.919602
454935,6,0,6,1.319391,103.91973
454936,16,0,16,1.319365,103.919668
454937,10,0,10,1.313973,103.916053
454939,65,1,66,1.299509,103.837
454940,14,5,19,1.299509,103.837
454941,0,1,1,1.299509,103.837
454942,7,24,31,1.314789,103.922675
454943,777,5,782,1.318414,103.921288
454944,118,10,128,1.318414,103.921288
454945,331,28,359,1.318414,103.921288
454946,571,8,579,1.318414,103.921288
454947,59,16,75,1.318685,103.921656
454948,9,0,9,1.318659,103.921628
454949,2,0,2,1.299509,103.837
454951,0,26,26,1.299509,103.837
454954,0,16,16,1.299509,103.837
454955,0,8,8,1.299509,103.837
454956,0,8,8,1.299509,103.837
454957,18,42,60,1.309117,103.922582
454958,37,1,38,1.309117,103.922582
454959,3,0,3,1.299509,103.837
454960,5,0,5,1.309117,103.922582
454961,7,0,7,1.309117,103.922582
454962,4,0,4,1.309117,103.922582
454963,166,90,256,1.309117,103.922582
454964,4,0,4,1.316121,103.922451
454965,49,73,122,1.317697,103.921742
454966,54,7,61,1.317619,103.921822
454967,35,96,131,1.317528,103.92193
454968,3,23,26,1.313753,103.922988
454969,11,38,49,1.31383,103.922966
454970,7,0,7,1.319719,103.919757
454975,10,36,46,1.314958,103.92764
454976,1,32,33,1.315253,103.925901
454977,3,23,26,1.31515,103.925924
454978,9,4,13,1.315244,103.925955
454979,2,0,2,1.318629,103.921608
454980,137,9,146,1.31524,103.926012
454981,7,2,9,1.315148,103.926046
454982,8,2,10,1.315233,103.926089
454983,1,0,1,1.299509,103.837
454984,17,2,19,1.315231,103.926155
454985,34,5,39,1.315149,103.926183
454986,103,3,106,1.315224,103.926231
454987,4,10,14,1.315149,103.926252
454988,0,3,3,1.309117,103.922582
454989,0,1,1,1.31515,103.926118
454990,18,17,35,1.315214,103.926379
454991,26,24,50,1.315142,103.926376
454992,31,11,42,1.310243,103.925426
454993,11,34,45,1.310312,103.925393
454994,3,8,11,1.310369,103.925366
454995,5,46,51,1.31043,103.925338
454996,5,89,94,1.310488,103.925316
454997,0,20,20,1.314166,103.922862
454998,94,224,318,1.311721,103.924482
454999,24,96,120,1.316848,103.922342
455000,0,148,148,1.316903,103.922314
455001,6,139,145,1.316986,103.922276
455002,0,12,12,1.310928,103.925589
455003,2,46,48,1.314337,103.922807
455004,1,0,1,1.315147,103.926314
455006,7,0,7,1.313299,103.928852
455007,1,15,16,1.313517,103.922642
455008,12,0,12,1.313608,103.922576
455009,6,1,7,1.31381,103.92264
455010,0,1,1,1.310273,103.926647
455011,47,1,48,1.3139,103.922604
455012,5,0,5,1.313887,103.92246
455013,2,9,11,1.313986,103.922563
455015,7,8,15,1.314067,103.922527
455016,88,4,92,1.314071,103.922375
455017,118,14,132,1.314143,103.922505
455018,0,6,6,1.314152,103.922348
455019,9,2,11,1.314242,103.922447
455020,7,3,10,1.314242,103.922447
455021,8,0,8,1.314274,103.922308
455022,5,1,6,1.314337,103.922411
455023,1,9,10,1.314346,103.922276
455024,19,8,27,1.314508,103.922344
455025,141,14,155,1.314449,103.922231
455026,72,3,75,1.314661,103.922272
455027,0,4,4,1.314535,103.922196
455028,3,16,19,1.31485,103.922223
455029,15,0,15,1.314616,103.922155
455030,1,0,1,1.313783,103.922523
455031,0,2,2,1.315146,103.925987
455032,0,17,17,1.314827,103.922061
455033,3,7,10,1.314926,103.922021
455034,1,5,6,1.315016,103.921985
455035,13,1,14,1.315084,103.921962
455036,3,2,5,1.315178,103.921927
455037,1,5,6,1.315259,103.921868
455038,4,0,4,1.315385,103.921864
455040,10,0,10,1.315448,103.921999
455041,9,0,9,1.315484,103.922057
455042,2,2,4,1.315538,103.922187
455043,81,0,81,1.315574,103.922295
455044,0,9,9,1.315623,103.922417
455045,0,1,1,1.314724,103.922101
455046,0,1,1,1.314994,103.922147
455047,3,0,3,1.31522,103.926309
455048,17,1,18,1.314067,103.922527
455055,7,0,7,1.313832,103.929247
455056,23,29,52,1.313852,103.929515
455057,1,0,1,1.314508,103.922344
455058,5,0,5,1.314181,103.9292
455059,89,1,90,1.314298,103.929373
455060,31,0,31,1.314992,103.929397
455061,13,33,46,1.314617,103.929141
455062,4,3,7,1.314617,103.929141
455063,1,9,10,1.314617,103.929141
455064,16,0,16,1.314961,103.929273
455065,2,0,2,1.315133,103.92207
455066,52,0,52,1.314914,103.928907
455069,5,13,18,1.314982,103.929407
455070,1,0,1,1.313973,103.929234
455071,92,0,92,1.314947,103.928683
455072,11,0,11,1.314946,103.928682
455073,0,3,3,1.3139,103.922604
455074,4,1,5,1.3146,103.929344
455075,5,0,5,1.314967,103.928683
455076,10,2,12,1.315003,103.929559
455077,2,1,3,1.314601,103.929345
455079,0,1,1,1.314981,103.929406
455080,1,1,2,1.314941,103.92914
455081,16,1,17,1.315002,103.929407
455082,2,3,5,1.315238,103.929493
455083,0,5,5,1.315237,103.929492
455084,4,0,4,1.315066,103.92942
455085,127,0,127,1.315065,103.929419
455086,0,2,2,1.315114,103.929454
455087,6,5,11,1.31514,103.929443
455088,1,0,1,1.315115,103.929455
455089,2,8,10,1.31556,103.929528
455090,0,3,3,1.315068,103.929546
455091,1,8,9,1.315286,103.929487
455092,0,13,13,1.315936,103.929288
455093,0,3,3,1.315287,103.929488
455094,43,0,43,1.315764,103.929491
455095,6,5,11,1.315763,103.92949
455096,31,14,45,1.315763,103.92949
455097,1,0,1,1.315139,103.929442
455098,2,0,2,1.315361,103.929531
455099,44,0,44,1.315898,103.929487
455100,118,0,118,1.316372,103.928932
455101,1,4,5,1.316428,103.929174
455103,0,2,2,1.31619,103.928921
455104,1,2,3,1.316031,103.929302
455105,4,8,12,1.316722,103.929241
455106,29,4,33,1.316298,103.929474
455107,3,0,3,1.316665,103.929247
455108,7,2,9,1.316615,103.928999
455109,1,1,2,1.316592,103.929248
455110,7,2,9,1.316626,103.92891
455111,0,18,18,1.316565,103.929465
455113,47,9,56,1.316792,103.928872
455114,5,6,11,1.316791,103.928871
455115,3,11,14,1.316832,103.929456
455116,11,0,11,1.316832,103.929266
455117,3,15,18,1.316823,103.929461
455118,73,10,83,1.316822,103.92946
455119,64,5,69,1.316822,103.92946
455120,58,1,59,1.316842,103.929446
455121,1,1,2,1.316645,103.928979
455122,1,0,1,1.316157,103.929213
455123,106,11,117,1.316722,103.930159
455124,1,2,3,1.316616,103.929084
455125,4,3,7,1.316707,103.930222
455126,0,1,1,1.316843,103.92946
455127,3,0,3,1.316843,103.929473
455128,1,1,2,1.316824,103.929476
455129,1,2,3,1.316658,103.93029
455131,198,0,198,1.317045,103.930264
455132,1,3,4,1.316622,103.930496
455133,3,3,6,1.317039,103.930342
455135,6,0,6,1.317037,103.9304
455136,19,4,23,1.316579,103.930627
455137,1,0,1,1.316845,103.929501
455138,5,0,5,1.316578,103.930692
455139,107,1,108,1.31698,103.930553
455141,52,5,57,1.316899,103.930592
455142,0,1,1,1.316949,103.930487
455144,11,0,11,1.316496,103.930935
455145,0,1,1,1.316533,103.930859
455146,0,7,7,1.316491,103.930984
455147,3,0,3,1.317039,103.930229
455148,27,0,27,1.316416,103.931063
455149,2,13,15,1.316815,103.930894
455150,1,1,2,1.316666,103.930347
455151,1,0,1,1.316894,103.930714
455153,0,1,1,1.316814,103.930938
455154,71,9,80,1.316392,103.931216
455157,1,8,9,1.316729,103.931163
455158,16,2,18,1.316341,103.931342
455159,5,1,6,1.31675,103.931223
455161,2,0,2,1.316434,103.931111
455162,3,0,3,1.316798,103.9308
455163,9,1,10,1.316666,103.931415
455164,2,10,12,1.316631,103.931447
455165,3,46,49,1.316831,103.929455
455166,2,0,2,1.316727,103.931292
455169,50,18,68,1.299509,103.837
455175,27,181,208,1.313857,103.919621
455176,10,23,33,1.313875,103.919664
455177,7,1,8,1.313901,103.919715
455179,1,0,1,1.316783,103.931022
455180,1,3,4,1.313976,103.919869
455181,10,0,10,1.313995,103.919911
455183,5,6,11,1.314031,103.919999
455200,129,1004,1133,1.312703,103.925392
455202,8,5,13,1.312705,103.925406
455203,41,442,483,1.312827,103.925492
455204,4,84,88,1.31271,103.925434
455205,9,4,13,1.312828,103.925598
455206,10,1634,1644,1.312828,103.925598
455207,22,938,960,1.312852,103.925738
455208,104,2544,2648,1.312928,103.925965
455209,56,5,61,1.312934,103.926024
455210,27,0,27,1.312945,103.92607
455211,36,767,803,1.313004,103.926356
455212,116,1762,1878,1.312563,103.926563
455213,1677,56,1733,1.312594,103.927021
455214,19,316,335,1.31309,103.926885
455215,31,687,718,1.313103,103.927007
455216,1,2,3,1.316723,103.93135
455217,4,0,4,1.312974,103.926744
455218,279,225,504,1.313071,103.92741
455219,39,451,490,1.313086,103.927506
455220,76,2,78,1.313116,103.927699
455221,156,376,532,1.313146,103.927892
455222,43,2,45,1.313175,103.928086
455223,146,1092,1238,1.313205,103.928279
455224,1,29,30,1.312953,103.928653
455225,36,43,79,1.313265,103.928665
455226,2,8,10,1.312651,103.928652
455227,1,0,1,1.313956,103.919821
455228,6,0,6,1.312827,103.928604
455229,26,260,286,1.312359,103.92866
455230,3,5,8,1.312692,103.92859
455231,43,20,63,1.313271,103.928687
455232,103,5,108,1.312349,103.92867
455233,2,0,2,1.31496,103.929272
455234,1,0,1,1.312971,103.928592
455235,4,0,4,1.31239,103.92858
455236,2,5,7,1.313278,103.928709
455237,27,340,367,1.313245,103.928665
455238,9,0,9,1.313249,103.928681
455239,3,115,118,1.313302,103.928796
455240,8,2,10,1.314385,103.954581
455241,2,1,3,1.31312,103.927121
455242,13,0,13,1.313328,103.928884
455243,18,419,437,1.313402,103.929146
455244,29,161,190,1.313415,103.929189
455245,19,298,317,1.313428,103.929233
455246,3,240,243,1.313931,103.929844
455247,3,20,23,1.313861,103.930084
455248,1,118,119,1.313848,103.93011
455249,2,200,202,1.313795,103.930597
455250,2,0,2,1.31256,103.928607
455251,11,721,732,1.313809,103.930673
455253,38,40,78,1.313866,103.930981
455254,14,298,312,1.313925,103.931486
455255,2,582,584,1.313876,103.931032
455256,34,1389,1423,1.313935,103.93158
455257,4,19,23,1.313935,103.931391
455258,7,50,57,1.313934,103.93139
455259,8,0,8,1.313956,103.931769
455260,5,0,5,1.314811,103.931483
455262,123,2,125,1.314792,103.931596
455263,8,0,8,1.314777,103.931655
455264,1,12,13,1.314719,103.931741
455265,38,357,395,1.313976,103.931958
455266,50,1,51,1.314016,103.932147
455268,0,32,32,1.314015,103.932146
455270,14,846,860,1.313996,103.932147
455272,0,1,1,1.312469,103.928598
455273,276,0,276,1.314017,103.932158
455274,17,425,442,1.313997,103.932154
455275,328,1,329,1.314018,103.932163
455276,0,777,777,1.313997,103.932161
455277,193,352,545,1.314018,103.932169
455278,1,0,1,1.314017,103.932152
455279,6,0,6,1.314019,103.932174
455281,1,522,523,1.31402,103.932185
455282,117,80,197,1.314621,103.933044
455283,252,474,726,1.313607,103.933026
455284,1283,370,1653,1.313319,103.933049
455285,213,24,237,1.313016,103.933071
455286,189,26,215,1.312498,103.933189
455287,920,410,1330,1.31227,103.93341
455288,86,328,414,1.312099,103.933678
455289,18,0,18,1.312971,103.926153
455290,32,0,32,1.312993,103.926249
455291,48,0,48,1.313022,103.926461
455292,17,9,26,1.313039,103.926559
455293,16,0,16,1.31305,103.926657
455294,3,0,3,1.313315,103.92884
455295,10,415,425,1.313104,103.928654
455296,65,1915,1980,1.313272,103.928759
455297,47,0,47,1.313281,103.92879
455298,137,539,676,1.31329,103.928821
455299,2,8,10,1.316603,103.92564
455300,1,18,19,1.316581,103.925636
455301,1,0,1,1.313999,103.932176
455302,5,0,5,1.316595,103.925672
455303,5,1,6,1.31665,103.925764
455305,1,0,1,1.316618,103.925682
455306,1,3,4,1.31665,103.925819
455307,20,2,22,1.316712,103.925929
455308,1,0,1,1.316681,103.925846
455310,4,3,7,1.316706,103.925966
455311,4,0,4,1.316775,103.926094
455312,2,0,2,1.3138,103.930622
455313,1,7,8,1.316806,103.926176
455314,0,18,18,1.316761,103.926112
455315,6,5,11,1.316827,103.926249
455317,2,0,2,1.316734,103.926039
455328,7,27,34,1.317253,103.925443
455329,0,18,18,1.317231,103.925438
455330,8,3,11,1.317266,103.925482
455331,1,1,2,1.316817,103.926259
455332,1,0,1,1.316678,103.925892
455333,3,0,3,1.313076,103.926723
455334,1,0,1,1.317291,103.925562
455335,1,3,4,1.317288,103.925612
455336,2,0,2,1.317242,103.925472
455337,2,2,4,1.31731,103.925681
455339,3,2,5,1.317332,103.92575
455340,8,1,9,1.317394,103.92588
455342,3,1,4,1.31741,103.925949
455343,0,1,1,1.317317,103.925641
455344,4,0,4,1.3174,103.925959
455355,2,152,154,1.317886,103.925273
455356,1,59,60,1.317813,103.925311
455357,2,14,16,1.317907,103.925349
455358,4,0,4,1.317841,103.925382
455359,10,0,10,1.317932,103.92541
455360,4,0,4,1.317857,103.92545
455361,1,4,5,1.317951,103.925471
455362,24,6,30,1.317888,103.925521
455363,0,1,1,1.317377,103.92589
455364,34,0,34,1.317901,103.925575
455365,0,1,1,1.317974,103.925533
455366,1,24,25,1.317922,103.925643
455367,15,11,26,1.318023,103.925674
455368,6,0,6,1.317943,103.925681
455369,71,1,72,1.317957,103.925724
455380,3,30,33,1.318191,103.925128
455381,1,1,2,1.317343,103.925721
455383,0,1,1,1.317995,103.925594
455384,5,0,5,1.318284,103.925382
455395,0,3,3,1.317265,103.925542
455396,5,2,7,1.318569,103.925988
455397,0,2,2,1.318235,103.925229
455398,7,1,8,1.318585,103.926021
455400,10,8,18,1.318616,103.926089
455401,17,3,20,1.318668,103.926156
455402,9,5,14,1.318648,103.926156
455403,12,1,13,1.3187,103.926223
455404,12,0,12,1.31868,103.926223
455405,0,3,3,1.318589,103.925988
455406,0,4,4,1.318711,103.926291
455407,107,1,108,1.318763,103.926358
455408,2,7,9,1.318743,103.926358
455410,5,0,5,1.318775,103.926425
455411,3,1,4,1.318826,103.926493
455412,3,0,3,1.318731,103.926291
455413,2,2,4,1.318858,103.92656
455414,44,0,44,1.318838,103.92656
455415,4,3,7,1.318889,103.926628
455416,6,0,6,1.318869,103.926628
455418,1,0,1,1.31827,103.925328
455421,1,0,1,1.318901,103.926695
455422,33,0,33,1.318964,103.92683
455423,4,0,4,1.319016,103.926897
455424,48,3,51,1.318996,103.926897
455425,1,2,3,1.318806,103.926493
455426,27,0,27,1.319028,103.926964
455427,3,0,3,1.319048,103.926964
455428,1,0,1,1.318984,103.92683
455429,5,6,11,1.319101,103.927089
455430,0,3,3,1.319079,103.927032
455431,10,3,13,1.318112,103.927772
455441,4,10,14,1.316619,103.928267
455442,6,0,6,1.31663,103.928242
455443,3,0,3,1.319091,103.927099
455444,1,0,1,1.319059,103.927032
455445,6,2,8,1.316888,103.928145
455446,0,1,1,1.316731,103.928196
455447,6,1,7,1.316932,103.928105
455450,42,26,68,1.317246,103.927984
455451,2,0,2,1.318605,103.926021
455452,1,22,23,1.317336,103.927923
455453,2,0,2,1.317245,103.927983
455454,0,6,6,1.317425,103.927902
455455,32,0,32,1.317538,103.927833
455456,11,3,14,1.317605,103.927822
455457,11,0,11,1.317604,103.927821
455458,6,0,6,1.31774,103.927742
455459,1,4,5,1.317941,103.927651
455460,6,2,8,1.317964,103.927661
455461,53,0,53,1.318133,103.92757
455462,115,0,115,1.318143,103.92758
455463,5,2,7,1.318153,103.92757
455464,38,0,38,1.318378,103.927454
455466,7,0,7,1.318694,103.927292
455467,36,1,37,1.318776,103.927255
455468,6,0,6,1.318938,103.927182
455469,3,0,3,1.316708,103.928226
455470,7,0,7,1.319167,103.927077
455471,0,1,1,1.31681,103.928212
455472,11,0,11,1.319364,103.92698
455473,19,0,19,1.319495,103.926916
455474,111,6,117,1.319626,103.926851
455475,0,5,5,1.31794,103.92765
455476,79,3,82,1.317784,103.927742
455477,1,0,1,1.319232,103.927044
455478,5,0,5,1.299509,103.837
455485,0,17,17,1.314924,103.923993
455486,8,0,8,1.314873,103.924002
455488,3,0,3,1.319101,103.927109
455489,7,1,8,1.314567,103.924059
455490,167,5,172,1.314298,103.92409
455491,0,1,1,1.318377,103.927453
455492,3,1,4,1.314232,103.924102
455493,5,0,5,1.314373,103.924087
455494,32,2,34,1.314102,103.924128
455495,3,0,3,1.314669,103.92404
455496,1,4,5,1.313971,103.924153
455497,16,18,34,1.314167,103.924135
455498,56,3,59,1.313878,103.924107
455499,276,0,276,1.313981,103.924163
455500,0,2,2,1.317426,103.927903
455501,9,2,11,1.313721,103.924141
455503,0,19,19,1.313765,103.924213
455504,10,2,12,1.313521,103.924156
455505,6,0,6,1.313559,103.924253
455506,21,2,23,1.313445,103.924169
455507,15,2,17,1.31341,103.924412
455508,1,1,2,1.313799,103.924118
455509,0,2,2,1.31339,103.924265
455510,3,0,3,1.314363,103.924097
455512,4,9,13,1.313388,103.924619
455513,7,8,15,1.313431,103.924719
455514,44,16,60,1.313453,103.924796
455515,50,23,73,1.299509,103.837
455525,0,5,5,1.32217,103.923668
455526,1,55,56,1.322422,103.923875
455527,10,3,13,1.322147,103.923625
455528,0,33,33,1.322404,103.923829
455529,0,1,1,1.314465,103.924078
455530,0,47,47,1.322383,103.923766
455531,1,3,4,1.322112,103.92352
455532,2,9,11,1.322362,103.923709
455533,5,0,5,1.322088,103.923467
455534,0,14,14,1.322337,103.923658
455535,0,15,15,1.322067,103.92342
455536,3,1,4,1.322314,103.923616
455537,33,57,90,1.322291,103.923572
455538,4,0,4,1.322017,103.923328
455539,2,4,6,1.322267,103.923513
455541,2,6,8,1.322238,103.923448
455542,4,0,4,1.321982,103.923188
455543,4,171,175,1.322215,103.923408
455544,3,5,8,1.32197,103.923137
455545,0,1,1,1.32213,103.923577
455546,12,0,12,1.32195,103.923082
455547,4,125,129,1.299509,103.837
455548,3,0,3,1.313364,103.924406
455549,13,0,13,1.322159,103.92326
455550,1,0,1,1.322202,103.923363
455551,0,126,126,1.32214,103.923205
455552,3,1,4,1.321898,103.922926
455553,55,55,110,1.322122,103.923138
455554,1,0,1,1.321913,103.922981
455555,0,5,5,1.322109,103.923087
455556,0,2,2,1.313484,103.924766
455557,3,77,80,1.322082,103.923028
455558,1,0,1,1.321871,103.922868
455559,6,18,24,1.322068,103.922975
455560,3,6,9,1.321825,103.922656
455561,30,23,53,1.322043,103.92292
455562,2,0,2,1.321851,103.922816
455563,4,1,5,1.32202,103.922859
455564,8,4,12,1.321793,103.922551
455565,3,521,524,1.322003,103.922804
455566,1,1,2,1.32181,103.922602
455567,0,4,4,1.321987,103.92275
455568,1,2,3,1.321933,103.923034
455569,0,2,2,1.321774,103.922512
455570,0,7,7,1.321751,103.922409
455571,0,17,17,1.321956,103.92267
455573,21,0,21,1.321941,103.922615
455574,13,11,24,1.321713,103.922305
455575,5,514,519,1.321921,103.922537
455576,9,0,9,1.321703,103.922241
455577,20,0,20,1.321904,103.922486
455578,4,14,18,1.321679,103.922194
455579,0,2,2,1.321972,103.92271
455580,1,1,2,1.321883,103.922435
455581,0,5,5,1.321861,103.922381
455582,3,1,4,1.321614,103.922059
455583,2,20,22,1.321844,103.922319
455584,1,1,2,1.321644,103.92212
455585,3,17,20,1.321825,103.922277
455586,15,1,16,1.321539,103.921929
455587,7,65,72,1.321807,103.92222
455588,1,1,2,1.321576,103.921985
455589,0,52,52,1.321794,103.922165
455590,0,1,1,1.321838,103.922714
455591,1,3,4,1.321768,103.922102
455592,0,9,9,1.321332,103.921743
455593,0,1,1,1.321448,103.921812
455594,6,1,7,1.321718,103.92201
455595,1,147,148,1.321685,103.921967
455596,0,8,8,1.321658,103.921915
455597,9,5,14,1.321626,103.921871
455600,2,0,2,1.321493,103.92187
455601,5,25,30,1.321362,103.921639
455602,90,0,90,1.321318,103.92162
455603,1,1,2,1.321422,103.921668
455604,2,2,4,1.321183,103.921566
455615,537,44,581,1.312874,103.929258
455616,6,322,328,1.313379,103.929561
455617,3,0,3,1.321766,103.922466
455618,0,51,51,1.313378,103.92956
455619,0,19,19,1.313378,103.92956
455620,7,11,18,1.312549,103.929237
455621,3,69,72,1.313253,103.929572
455622,7,3,10,1.313252,103.929571
455623,1,22,23,1.312568,103.929272
455624,0,3,3,1.313378,103.92956
455625,8,0,8,1.312534,103.929588
455626,2,14,16,1.31275,103.929618
455627,17,0,17,1.312956,103.92958
455628,31,0,31,1.312818,103.929592
455629,13,0,13,1.312681,103.929605
455630,8,0,8,1.312498,103.929642
455631,13,13,26,1.312406,103.92963
455632,0,2,2,1.321258,103.921597
455633,6,3,9,1.312131,103.929655
455634,6,66,72,1.311994,103.929668
455635,8,4,12,1.312748,103.929618
455637,0,6,6,1.312246,103.929665
455638,1,52,53,1.312004,103.929678
455642,21,0,21,1.312008,103.92951
455643,5,1,6,1.312001,103.929447
455644,3,0,3,1.313001,103.929595
455645,4,1,5,1.311999,103.929334
455646,4,22,26,1.311964,103.929037
455647,236,0,236,1.311964,103.929001
455648,10,90,100,1.311963,103.928929
455649,1,0,1,1.321745,103.922049
455650,61,2,63,1.31196,103.928714
455651,25,0,25,1.311959,103.928642
455652,57,21,78,1.311958,103.928571
455653,1,0,1,1.311962,103.928858
455654,54,7,61,1.311966,103.928437
455665,0,43,43,1.320609,103.920527
455667,5,1,6,1.320259,103.920505
455669,1,0,1,1.311957,103.928499
455670,3,1,4,1.32038,103.920884
455673,8,6,14,1.320334,103.921217
455674,1,0,1,1.320421,103.920807
455675,10,2,12,1.320345,103.921265
455676,1,4,5,1.320269,103.921216
455677,43,0,43,1.320534,103.921642
455678,0,15,15,1.320296,103.921292
455679,3,0,3,1.312001,103.929395
455681,4,1,5,1.320623,103.921864
455682,1,1,2,1.312269,103.929643
455683,116,0,116,1.320649,103.92197
455684,16,2,18,1.320388,103.921609
455685,8,6,14,1.320672,103.922092
455686,17,0,17,1.320424,103.921712
455687,1,3,4,1.320457,103.921828
455689,27,0,27,1.320522,103.922043
455690,25,0,25,1.320313,103.921156
455691,9,0,9,1.32063,103.920722
455692,31,0,31,1.320603,103.920778
455693,3,0,3,1.32058,103.921764
455694,1,0,1,1.320229,103.921141
455695,7,1,8,1.320534,103.921642
455696,23,1,24,1.320502,103.921526
455697,15,0,15,1.320502,103.921526
455698,5,6,11,1.320502,103.921526
455699,9,2,11,1.299509,103.837
455700,333,42,375,1.321011,103.924321
455701,0,4,4,1.322069,103.92406
455702,0,4,4,1.321067,103.924288
455703,1,3,4,1.322069,103.92406
455704,0,1,1,1.320534,103.921642
455705,3,0,3,1.320534,103.921642
455706,2,3,5,1.321182,103.924241
455707,0,3,3,1.322069,103.92406
455708,24,1,25,1.321246,103.924211
455709,5,0,5,1.322069,103.92406
455710,2,2,4,1.321302,103.924184
455711,41,8,49,1.32136,103.924159
455712,6,3,9,1.321411,103.924134
455713,1,1,2,1.320346,103.921497
455714,0,6,6,1.321514,103.92409
455715,8,2,10,1.321562,103.924071
455716,7,3,10,1.321609,103.924044
455717,24,0,24,1.321654,103.924024
455718,0,1,1,1.321134,103.92426
455719,1,4,5,1.321889,103.924014
455721,0,1,1,1.321693,103.924008
455723,22,45,67,1.322051,103.923945
455724,4,0,4,1.322051,103.923945
455725,24,6,30,1.322051,103.923945
455736,15,2,17,1.318087,103.918975
455738,1,0,1,1.321995,103.923967
455739,3,3,6,1.317686,103.919533
455740,1,0,1,1.318434,103.919399
455741,1,1,2,1.321469,103.924118
455742,4,0,4,1.318158,103.919341
455743,3,0,3,1.322069,103.92406
455744,4,1,5,1.318355,103.919423
455745,1,0,1,1.31847,103.919513
455747,1,2,3,1.317652,103.919572
455748,1,2,3,1.317595,103.919618
455749,7,0,7,1.317566,103.919646
455750,14,5,19,1.31802,103.91949
455751,2,1,3,1.318081,103.919402
455756,0,1,1,1.317629,103.919589
455757,1,1,2,1.317669,103.91955
455758,3,0,3,1.317532,103.919681
455759,11,0,11,1.316913,103.920289
455760,22,1,23,1.317751,103.919795
455761,36,2,38,1.317662,103.91984
455762,9,3,12,1.31763,103.919893
455763,6,1,7,1.317544,103.920201
455764,10,0,10,1.317405,103.920096
455766,7,0,7,1.317312,103.920169
455767,10,0,10,1.317266,103.920205
455768,0,4,4,1.317223,103.920233
455769,2,13,15,1.299509,103.837
455780,11,4,15,1.319411,103.916358
455781,29,2,31,1.319494,103.916412
455782,4,0,4,1.319241,103.916414
455783,2,0,2,1.317022,103.920241
455784,5,11,16,1.319232,103.917054
455785,95,0,95,1.319292,103.917207
455786,9,92,101,1.319355,103.917366
455787,1,3,4,1.319378,103.917468
455788,21,1,22,1.319475,103.917793
455789,289,4,293,1.319006,103.917604
455790,5,9,14,1.319487,103.917895
455791,8,0,8,1.319465,103.918003
455792,0,9,9,1.319408,103.91815
455793,48,3,51,1.319362,103.91831
455794,3,10,13,1.319294,103.918532
455795,19,19,38,1.319042,103.919064
455796,4,1,5,1.319155,103.918844
455798,4,3,7,1.319012,103.919152
455799,7,28,35,1.319462,103.917698
455800,174,9,183,1.319462,103.917698
455802,2,0,2,1.31909,103.916723
455803,2,0,2,1.319462,103.917698
455809,9,1,10,1.319671,103.919063
455810,13,23,36,1.319599,103.919032
455811,13,2,15,1.319648,103.919194
455812,1,0,1,1.317789,103.919738
455814,12,0,12,1.31958,103.91923
455815,0,6,6,1.319619,103.919422
455816,9,4,13,1.319541,103.919434
455827,25,0,25,1.319721,103.918782
455828,4,0,4,1.319801,103.918814
455829,5,0,5,1.319612,103.918793
455839,95,457,552,1.309779,103.926095
455840,6,3,9,1.310047,103.926135
455841,0,19,19,1.31008,103.926222
455843,5,19,24,1.310171,103.926422
455844,8,16,24,1.310212,103.92648
455845,3,8,11,1.310251,103.926552
455846,14,47,61,1.310273,103.926647
455847,35,196,231,1.310451,103.926624
455848,3,15,18,1.310415,103.926573
455849,1,2,3,1.317721,103.919823
455850,10,6,16,1.310357,103.926467
455851,0,6,6,1.310318,103.9264
455852,10,2,12,1.31027,103.92629
455853,1,1,2,1.319462,103.917698
455854,13,2,15,1.310219,103.926181
455855,1,0,1,1.319554,103.919202
455856,5,0,5,1.31016,103.926073
455857,5,21,26,1.310119,103.926022
455858,27,582,609,1.310881,103.925405
455859,80,266,346,1.310539,103.925603
455860,4,27,31,1.310899,103.925037
455861,5,77,82,1.310906,103.925504
455862,4,12,16,1.310957,103.924952
455863,1,133,134,1.310932,103.925337
455864,2,7,9,1.31101,103.924899
455865,2,34,36,1.311001,103.925191
455866,1,0,1,1.310181,103.926129
455867,2,1,3,1.310376,103.926531
455868,8,26,34,1.311065,103.924847
455869,2,10,12,1.311219,103.925023
455870,8,56,64,1.31128,103.92464
455871,554,79,633,1.312606,103.92325
455872,3,31,34,1.314091,103.922906
455873,5,5,10,1.31421,103.922857
455874,8,12,20,1.314287,103.922833
455875,0,55,55,1.314462,103.922777
455876,4,50,54,1.314643,103.922742
455877,4,12,16,1.314863,103.922666
455878,0,1,1,1.311089,103.92513
455879,0,3,3,1.311142,103.925078
455880,11,1,12,1.315174,103.922582
455881,22,15,37,1.315338,103.922544
455882,2,27,29,1.315779,103.92251
455883,308,15,323,1.315936,103.92251
455884,1,82,83,1.316285,103.9225
455885,1,0,1,1.314972,103.922641
455886,5,330,335,1.31713,103.922232
455887,2,342,344,1.317256,103.922138
455889,2,48,50,1.317785,103.921661
455890,27,0,27,1.317934,103.921498
455891,1,18,19,1.317873,103.921571
455892,1,12,13,1.318012,103.921447
455893,2,0,2,1.310243,103.926235
455894,39,0,39,1.31823,103.921267
455895,0,1,1,1.316386,103.922468
455896,3,4,7,1.31841,103.921093
455897,32,0,32,1.318372,103.921158
455898,12,29,41,1.318327,103.92121
455899,24,14,38,1.318549,103.920875
455900,61,23,84,1.318649,103.920738
455901,1,35,36,1.318796,103.920587
455902,3,11,14,1.319055,103.92041
455903,7,9,16,1.319153,103.920399
455904,42,7,49,1.319586,103.920522
455905,23,1,24,1.319994,103.92051
455906,1,16,17,1.320814,103.920393
455907,0,2,2,1.318138,103.921347
455908,0,17,17,1.320833,103.920324
455910,2,0,2,1.320653,103.920429
455911,41,14,55,1.321011,103.920171
455912,16,493,509,1.313228,103.923268
455913,0,8,8,1.313312,103.92325
455914,0,5,5,1.313399,103.923226
455915,1,6,7,1.31349,103.923216
455916,0,29,29,1.313584,103.923188
455917,0,6,6,1.313665,103.92316
455918,46,13,59,1.313759,103.923132
455919,4,18,22,1.313829,103.923129
455920,1,0,1,1.318476,103.921015
455921,2,15,17,1.313941,103.92309
455922,2,9,11,1.31399,103.923073
455923,1,41,42,1.31406,103.923063
455925,21,26,47,1.314335,103.92297
455926,0,18,18,1.314447,103.92295
455927,59,17,76,1.314521,103.922925
455928,15,36,51,1.314608,103.922894
455929,60,29,89,1.314835,103.922849
455930,12,3,15,1.314912,103.922828
455931,2,2,4,1.314968,103.922825
455933,2,61,63,1.316679,103.922617
455934,45,733,778,1.317819,103.922368
455935,94,26,120,1.317511,103.922211
455936,148,742,890,1.317511,103.922211
455937,54,19,73,1.317511,103.922211
455938,27,34,61,1.317511,103.922211
455939,752,8,760,1.317511,103.922211
455940,155,8,163,1.317511,103.922211
455941,80,8,88,1.317511,103.922211
455942,254,13,267,1.317511,103.922211
455943,577,23,600,1.317511,103.922211
455944,9,20,29,1.319572,103.920594
455945,14,34,48,1.319682,103.920591
455946,45,0,45,1.319786,103.920606
455947,8,14,22,1.319906,103.920606
455948,6,4,10,1.320014,103.920586
455949,43,11,54,1.320452,103.920852
455950,0,40,40,1.319866,103.920637
455951,0,15,15,1.320994,103.920332
455952,21,76,97,1.321047,103.92029
455953,72,6,78,1.313948,103.922923
455954,5,0,5,1.310273,103.926647
455955,19,0,19,1.310273,103.926647
455957,6,0,6,1.310273,103.926647
455958,3,12,15,1.310273,103.926647
455959,26,2,28,1.310273,103.926647
455961,0,1,1,1.313885,103.923111
455962,2,0,2,1.320945,103.920226
455963,0,8,8,1.31714,103.919618
455964,7,1,8,1.317166,103.919649
455965,14,4,18,1.317189,103.919678
455966,1,0,1,1.310273,103.926647
455967,12,0,12,1.317235,103.919735
455968,180,0,180,1.317264,103.919769
455969,18,0,18,1.317292,103.919803
455970,1,1,2,1.310273,103.926647
455971,0,3,3,1.315059,103.92261
455973,0,2,2,1.317315,103.919831
455974,7,1,8,1.31781,103.920269
455976,1,1,2,1.3177,103.92029
455977,80,0,80,1.317803,103.920428
455978,0,3,3,1.317344,103.919871
455990,9,0,9,1.319389,103.91508
455991,0,179,179,1.319825,103.915037
455992,26,0,26,1.319248,103.915122
455993,0,8,8,1.31895,103.915135
455994,2,6,8,1.319146,103.91536
455995,27,0,27,1.318391,103.91547
455996,0,1,1,1.317212,103.919706
455997,9,0,9,1.318315,103.91558
455998,0,1,1,1.319074,103.915185
455999,0,1,1,1.318921,103.915252
456000,0,1,1,1.31816,103.915792
456001,14,0,14,1.31822,103.91572
456002,0,2,2,1.317888,103.920373
456003,7,1,8,1.31808,103.915937
456004,0,2,2,1.318554,103.915457
456005,2,3,5,1.318166,103.915889
456006,1,0,1,1.318798,103.915314
456007,25,4,29,1.31803,103.91601
456008,2,8,10,1.318196,103.915998
456009,22,0,22,1.31807,103.916071
456010,1,5,6,1.318229,103.91591
456011,15,4,19,1.317881,103.916501
456012,1,33,34,1.318007,103.916452
456013,5,0,5,1.317823,103.916638
456014,13,0,13,1.31795,103.916583
456015,4,5,9,1.317778,103.916775
456016,1,1,2,1.318317,103.915739
456017,8,2,10,1.317703,103.916946
456018,9,1,10,1.317796,103.916901
456019,53,0,53,1.317646,103.917082
456020,2,1,3,1.31799,103.920482
456021,21,5,26,1.317595,103.917259
456022,14,11,25,1.317693,103.917197
456023,8,1,9,1.317526,103.917395
456024,2,2,4,1.31763,103.917323
456025,3,1,4,1.317446,103.917555
456026,2,0,2,1.317876,103.916736
456027,39,1,40,1.317394,103.917708
456028,0,2,2,1.317578,103.917482
456029,5,1,6,1.317331,103.917862
456030,1,0,1,1.318431,103.915587
456033,0,1,1,1.317452,103.917801
456034,0,4,4,1.317294,103.918108
456035,17,2,19,1.316804,103.91872
456036,7,0,7,1.316727,103.918789
456037,13,0,13,1.316503,103.918981
456040,1,0,1,1.317326,103.918042
456041,19,0,19,1.31663,103.918993
456042,4,5,9,1.31614,103.919202
456043,5,0,5,1.316574,103.919023
456046,0,1,1,1.316265,103.91915
456047,3,0,3,1.317755,103.917049
456048,3,1,4,1.3163,103.91923
456049,38,0,38,1.316242,103.919257
456050,134,12,146,1.316175,103.91929
456061,1,1,2,1.317504,103.917653
456062,0,6,6,1.319526,103.916025
456063,10,1,11,1.319567,103.916139
456064,3,0,3,1.316356,103.919181
456065,7,10,17,1.319784,103.91667
456066,14,0,14,1.319661,103.916814
456067,1,0,1,1.316402,103.919148
456068,0,17,17,1.319712,103.916945
456069,1,0,1,1.319853,103.916852
456070,11,7,18,1.319939,103.917074
456071,1,46,47,1.31981,103.91719
456072,20,45,65,1.320002,103.917296
456073,3,0,3,1.319621,103.916672
456074,27,1,28,1.320128,103.917547
456075,95,7,102,1.319913,103.917537
456076,3,6,9,1.320203,103.917729
456078,1,0,1,1.319753,103.917053
456079,0,2,2,1.31948,103.91594
456080,4,6,10,1.320333,103.918348
456081,2,1,3,1.319867,103.917361
456082,10,73,83,1.320299,103.918485
456083,8,2,10,1.320148,103.918209
456084,7,14,21,1.320188,103.918334
456085,567,769,1336,1.320282,103.918695
456086,2,7,9,1.320143,103.918539
456087,19,1,20,1.320259,103.918876
456088,29,19,48,1.320073,103.919121
456089,5,1,6,1.320182,103.919125
456090,2,0,2,1.320051,103.917907
456091,34,2,36,1.320039,103.919366
456092,1,12,13,1.320294,103.920035
456093,1,7,8,1.320016,103.919463
456094,7,2,9,1.32027,103.91995
456095,94,29,123,1.319972,103.919836
456096,5,9,14,1.320167,103.919881
456097,3,8,11,1.320184,103.919488
456098,42,4,46,1.319396,103.915951
456099,26,26,52,1.320216,103.919108
456100,22,46,68,1.320216,103.919108
456101,1,0,1,1.320248,103.917958
456102,52,0,52,1.320216,103.919108
456103,4,30,34,1.320216,103.919108
456107,2,26,28,1.311516,103.92462
456108,12,259,271,1.311502,103.924635
456109,2,10,12,1.311527,103.924651
456110,2,6,8,1.311517,103.924682
456111,7,0,7,1.311548,103.924712
456112,1,10,11,1.311548,103.924774
456113,7,13,20,1.311568,103.924774
456115,2,0,2,1.320051,103.919258
456116,14,8,22,1.311611,103.924959
456117,0,1,1,1.320216,103.919108
456119,20,2,22,1.311652,103.925021
456120,3,3,6,1.311662,103.925052
456121,11,0,11,1.311673,103.925118
456122,0,8,8,1.311682,103.925184
456123,6,4,10,1.311685,103.925494
456124,4,0,4,1.311686,103.925249
456125,13,8,21,1.311689,103.925543
456126,0,1,1,1.31161,103.924898
456127,39,0,39,1.311696,103.92538
456128,4,2,6,1.311702,103.925445
456129,15,107,122,1.311706,103.92551
456130,185,12,197,1.311709,103.925543
456141,142,84,226,1.315844,103.918856
456142,6,4,10,1.315906,103.918979
456143,30,4,34,1.315958,103.919126
456144,16,49,65,1.315985,103.91912
456145,14,2,16,1.316409,103.920066
456146,0,1,1,1.311692,103.925314
456147,3,0,3,1.320114,103.918072
456148,0,1,1,1.316444,103.920129
456150,4,3,7,1.316646,103.92064
456151,12,29,41,1.31604,103.919481
456152,0,2,2,1.311589,103.924836
456153,13,2,15,1.316118,103.919648
456154,43,9,52,1.316089,103.919603
456155,0,2,2,1.31668,103.92073
456157,16,0,16,1.316172,103.919764
456158,6,1,7,1.316811,103.921123
456159,6,1,7,1.316081,103.919736
456160,3,0,3,1.316484,103.920249
456161,5,0,5,1.316125,103.919767
456162,0,2,2,1.316727,103.920871
456163,16,12,28,1.316148,103.919809
456164,24,0,24,1.316948,103.921418
456166,13,2,15,1.316994,103.921499
456167,26,13,39,1.316191,103.919928
456168,1,0,1,1.31653,103.920328
456169,26,22,48,1.316254,103.920039
456170,1,0,1,1.317036,103.921595
456171,3,2,5,1.316319,103.920159
456173,31,11,42,1.316327,103.920217
456174,25,0,25,1.316359,103.920132
456175,1,6,7,1.316372,103.920184
456176,1,0,1,1.317079,103.921676
456177,3,2,5,1.316564,103.92066
456178,2,3,5,1.316583,103.920713
456179,3,2,5,1.31658,103.920762
456181,1,2,3,1.316844,103.921221
456182,0,2,2,1.316892,103.921315
456183,5,0,5,1.316666,103.920942
456184,0,8,8,1.316684,103.920984
456185,5,10,15,1.316996,103.921624
456186,4,0,4,1.317041,103.921713
456187,33,0,33,1.317167,103.921868
456188,1,2,3,1.316632,103.920848
456189,12,0,12,1.316814,103.92123
456190,1,22,23,1.31685,103.921309
456191,27,0,27,1.316923,103.921466
456192,309,1,310,1.315884,103.919134
456193,2,1,3,1.317396,103.922114
456199,2,63,65,1.315669,103.922652
456200,1,3,4,1.315705,103.922724
456201,9,0,9,1.315751,103.922896
456202,3,3,6,1.31578,103.923051
456203,0,7,7,1.31581,103.923206
456204,47,28,75,1.31584,103.92336
456205,89,50,139,1.315869,103.923515
456206,12,0,12,1.315899,103.92367
456207,2,6,8,1.315928,103.923825
456208,6,0,6,1.315938,103.923868
456219,13,0,13,1.318248,103.919923
456220,6,1,7,1.317993,103.919809
456221,48,5,53,1.31832,103.919992
456222,1,2,3,1.317291,103.922003
456223,16,0,16,1.318383,103.920045
456224,39,8,47,1.318173,103.919991
456225,3,1,4,1.318479,103.920169
456226,16,4,20,1.318259,103.920085
456227,12,0,12,1.318441,103.920121
456228,1,5,6,1.318457,103.920314
456229,0,60,60,1.317423,103.920744
456230,8,0,8,1.318406,103.920362
456231,2,2,4,1.317345,103.920666
456232,10,0,10,1.318322,103.920429
456233,1,3,4,1.317314,103.920579
456234,35,1,36,1.318195,103.920539
456235,8,0,8,1.317272,103.920493
456236,0,1,1,1.31637,103.920261
456237,7,11,18,1.318014,103.920698
456238,78,17,95,1.317923,103.920765
456239,3,0,3,1.318078,103.919901
456240,13,0,13,1.317731,103.920926
456242,7,1,8,1.317416,103.920926
456243,6,2,8,1.317373,103.920813
456244,6,15,21,1.317301,103.920731
456246,8,0,8,1.317208,103.920562
456247,4,7,11,1.317101,103.920407
456248,14,1,15,1.317128,103.920496
456249,18,19,37,1.318171,103.919856
456250,6,10,16,1.317932,103.919761
456252,2,0,2,1.316649,103.92089
456258,7,1,8,1.316561,103.919757
456259,1,0,1,1.318097,103.920627
456260,1,1,2,1.299509,103.837
456261,0,18,18,1.316387,103.91983
456262,2,3,5,1.31655,103.919835
456263,9,5,14,1.316548,103.919711
456264,41,1,42,1.316646,103.9198
456265,7,0,7,1.316687,103.919693
456266,14,2,16,1.316726,103.919755
456267,0,2,2,1.316433,103.919801
456270,1,6,7,1.316803,103.919695
456271,5,0,5,1.316784,103.919617
456272,2,0,2,1.316676,103.919657
456273,3,0,3,1.317836,103.920849
456275,56,0,56,1.31691,103.919467
456286,1,0,1,1.316479,103.919784
456287,2,155,157,1.319923,103.915224
456288,1,0,1,1.319674,103.91559
456289,7,0,7,1.319411,103.915677
456290,17,1,18,1.319304,103.915701
456291,5,1,6,1.319193,103.915886
456293,0,1,1,1.319548,103.915623
456294,8,0,8,1.31906,103.91585
456295,0,1,1,1.319094,103.915944
456296,8,3,11,1.318971,103.916093
456297,1,0,1,1.318957,103.915946
456298,17,4,21,1.31885,103.916179
456299,8,0,8,1.318527,103.916651
456302,1,2,3,1.316837,103.919512
456303,0,2,2,1.316858,103.919558
456304,6,0,6,1.318199,103.917465
456305,0,36,36,1.31815,103.917603
456306,45,4,49,1.318073,103.917768
456307,17,10,27,1.318013,103.917921
456308,5,2,7,1.317942,103.918075
456309,2,0,2,1.318259,103.917312
456310,6,0,6,1.317833,103.918361
456311,7,0,7,1.318009,103.917929
456312,6,19,25,1.317963,103.918003
456313,5,2,7,1.319051,103.916013
456314,1,2,3,1.318314,103.917152
456323,3,120,123,1.31413,103.922998
456324,6,0,6,1.314139,103.923039
456325,1,1,2,1.317876,103.918218
456329,23,0,23,1.314223,103.923443
456331,218,1,219,1.314257,103.923605
456332,1,0,1,1.318737,103.916271
456333,0,2,2,1.314156,103.92312
456336,2,0,2,1.314276,103.923685
456337,6,0,6,1.314354,103.924007
456338,1,13,14,1.314373,103.924087
456349,3,9,12,1.314177,103.916088
456350,6,3,9,1.314176,103.916087
456351,1,0,1,1.314267,103.923645
456352,21,1,22,1.314412,103.916423
456353,4,1,5,1.31422,103.916189
456355,14,0,14,1.314193,103.916079
456356,4,1,5,1.314307,103.91639
456357,8,1,9,1.314306,103.916389
456358,6,7,13,1.314232,103.916171
456359,17,0,17,1.314395,103.916591
456360,1,0,1,1.314317,103.916196
456361,22,0,22,1.314482,103.916792
456362,3,11,14,1.314391,103.916536
456363,12,0,12,1.314569,103.916992
456364,1,0,1,1.314312,103.916353
456365,2,0,2,1.314334,103.923926
456366,2,1,3,1.319821,103.915689
456367,115,0,115,1.314743,103.917394
456368,6,0,6,1.314629,103.917084
456369,23,0,23,1.314831,103.917595
456370,38,84,122,1.314708,103.917266
456371,2,10,12,1.314918,103.917796
456372,72,1,73,1.314787,103.917449
456373,41,1,42,1.314786,103.917448
456374,97,6,103,1.315005,103.917997
456375,10,17,27,1.314866,103.917632
456376,0,5,5,1.315061,103.91812
456378,2,86,88,1.315015,103.917987
456379,4,0,4,1.314231,103.91617
456380,8,0,8,1.315117,103.918244
456381,1,1,2,1.314656,103.917193
456382,2,1,3,1.314549,103.916901
456383,1,15,16,1.314917,103.917795
456384,0,5,5,1.314176,103.916087
456385,3,0,3,1.315341,103.918737
456386,23,18,41,1.299509,103.837
456389,39,5,44,1.320542,103.92605
456390,0,24,24,1.320561,103.926049
456391,4,4,8,1.320529,103.926021
456392,14,2,16,1.320547,103.926018
456393,0,2,2,1.315229,103.91849
456395,8,0,8,1.320476,103.925906
456396,2,1,3,1.314176,103.916087
456397,4,4,8,1.32045,103.925848
456398,1,0,1,1.31447,103.916719
456400,27,0,27,1.320437,103.925775
456401,4,0,4,1.32041,103.925714
456403,1,1,2,1.320503,103.925964
456404,0,2,2,1.320382,103.925653
456405,2,0,2,1.320345,103.925617
456406,8,1,9,1.320319,103.925559
456407,35,0,35,1.320327,103.925532
456408,26,0,26,1.320293,103.925502
456409,63,4,67,1.320299,103.925471
456410,10,4,14,1.320267,103.925444
456411,29,4,33,1.320272,103.92541
456412,1,1,2,1.320354,103.925593
456413,1,3,4,1.320244,103.92535
456414,16,0,16,1.320214,103.925328
456415,0,2,2,1.320241,103.925386
456416,35,1,36,1.320188,103.925271
456417,1,1,2,1.320216,103.925289
456418,0,1,1,1.320465,103.925836
456419,1,2,3,1.320492,103.925897
456420,50,0,50,1.320136,103.925155
456421,3,5,8,1.320134,103.925106
456422,3,1,4,1.32011,103.925097
456423,1,0,1,1.320162,103.925213
456424,4,1,5,1.320083,103.92504
456425,5,0,5,1.320079,103.924985
456426,10,3,13,1.320057,103.924982
456427,19,29,48,1.320051,103.924924
456428,0,29,29,1.320041,103.924934
456439,31,14,45,1.312973,103.931095
456441,137,297,434,1.313362,103.930858
456442,289,75,364,1.312434,103.9311
456443,5,2,7,1.313016,103.930985
456444,9,13,22,1.312176,103.9311
456445,5,1,6,1.312723,103.930985
456446,6,1,7,1.312498,103.931009
456448,453,425,878,1.313604,103.931062
456458,14,51,65,1.313838,103.930506
456459,1,2,3,1.320161,103.925167
456460,3,0,3,1.313905,103.930503
456461,0,1,1,1.320106,103.925046
456462,4,0,4,1.31446,103.930428
456463,0,1,1,1.314047,103.93051
456464,26,0,26,1.314451,103.930321
456465,1,0,1,1.314189,103.930607
456466,14,6,20,1.314445,103.930199
456468,6,1,7,1.314432,103.930073
456469,0,1,1,1.314445,103.930263
456470,0,1,1,1.314429,103.930002
456471,2,0,2,1.320189,103.925228
456472,4,1,5,1.314368,103.929786
456473,3,7,10,1.314352,103.929719
456474,1,22,23,1.314339,103.929667
456475,4,2,6,1.31448,103.930682
456476,0,3,3,1.313976,103.930504
456478,30,4,34,1.314313,103.929561
456479,5,0,5,1.314297,103.929519
456480,3,3,6,1.314287,103.929474
456481,1,0,1,1.314413,103.929925
456482,27,13,40,1.314242,103.929473
456483,0,19,19,1.314381,103.929451
456484,7,1,8,1.314508,103.930901
456486,10,0,10,1.314566,103.931066
456487,4,0,4,1.314654,103.931108
456488,174,6,180,1.314595,103.931143
456489,7,0,7,1.314435,103.929767
456492,1,0,1,1.314271,103.929432
456493,7,0,7,1.314563,103.93085
456494,97,0,97,1.31449,103.929999
456496,2,86,88,1.314948,103.930493
456497,1,13,14,1.314548,103.930489
456499,1,2,3,1.314483,103.930724
456500,114,12,126,1.315025,103.930709
456501,13,0,13,1.314693,103.930483
456502,3,3,6,1.315016,103.930619
456503,4,1,5,1.314783,103.930457
456504,3,2,5,1.315006,103.93049
456506,3,0,3,1.314629,103.930483
456507,3,17,20,1.314945,103.930426
456508,0,6,6,1.315,103.930184
456510,2,2,4,1.314283,103.930611
456511,0,1,1,1.314551,103.930743
456512,0,14,14,1.314464,103.930598
456520,1,14,15,1.313596,103.930208
456521,32,158,190,1.313596,103.930296
456522,9,0,9,1.313512,103.930245
456524,185,0,185,1.313223,103.930273
456525,22,3,25,1.313072,103.93028
456526,18,0,18,1.312747,103.930274
456527,38,1,39,1.312574,103.930294
456529,0,3,3,1.314993,103.930323
456530,0,1,1,1.314383,103.930601
456531,0,1,1,1.312821,103.930151
456532,31,170,201,1.313395,103.930095
456534,3,2,5,1.312448,103.930175
456535,10,2,12,1.312902,103.930277
456543,0,15,15,1.321079,103.925757
456544,3,2,5,1.321343,103.926179
456545,1,2,3,1.312505,103.930169
456546,12,0,12,1.321319,103.926123
456547,2,26,28,1.321025,103.925642
456548,0,1,1,1.313042,103.930134
456549,4,20,24,1.321006,103.925603
456550,10,0,10,1.32126,103.925994
456551,22,3,25,1.321004,103.925576
456552,1,1,2,1.31439,103.929854
456553,1,12,13,1.320985,103.925552
456555,8,2,10,1.321195,103.925859
456556,0,3,3,1.32104,103.925684
456557,0,12,12,1.32115,103.925761
456558,2,3,5,1.320939,103.925444
456559,1,9,10,1.321112,103.925674
456561,41,7,48,1.321077,103.925601
456562,0,4,4,1.320897,103.925368
456563,42,17,59,1.321025,103.9255
456564,8,2,10,1.320882,103.925328
456565,0,5,5,1.320998,103.925453
456566,25,7,32,1.32086,103.925286
456567,0,3,3,1.320961,103.925498
456568,21,2,23,1.320843,103.925251
456569,7,1,8,1.320954,103.925344
456571,29,5,34,1.320933,103.925298
456572,0,1,1,1.321291,103.926061
456573,3,3,6,1.320905,103.925265
456574,0,3,3,1.320962,103.925393
456575,2,2,4,1.320878,103.925218
456576,1,1,2,1.321241,103.925953
456577,1,8,9,1.320859,103.92516
456578,3,3,6,1.320755,103.925038
456579,5,1,6,1.320834,103.925109
456580,38,9,47,1.320734,103.924991
456581,99,4,103,1.320813,103.925063
456582,112,26,138,1.320706,103.924933
456583,1,2,3,1.320798,103.925123
456584,8,2,10,1.320772,103.92498
456585,1,1,2,1.320779,103.925084
456586,24,1,25,1.320732,103.924888
456587,11,0,11,1.320707,103.924842
456588,2,16,18,1.320685,103.924781
456599,9,0,9,1.313725,103.93222
456600,0,26,26,1.313759,103.932254
456601,10,92,102,1.313631,103.932088
456602,2,1,3,1.320794,103.925024
456603,11,1,12,1.313612,103.932028
456604,3,0,3,1.313665,103.932013
456605,8,2,10,1.313628,103.931964
456606,126,0,126,1.313571,103.931986
456607,32,5,37,1.313529,103.932016
456610,17,16,33,1.312927,103.932248
456611,2,67,69,1.31301,103.93227
456614,0,3,3,1.31356,103.932054
456615,1,4,5,1.312803,103.93225
456616,1,0,1,1.320815,103.925163
456618,0,1,1,1.31278,103.932296
456620,0,3,3,1.313036,103.932161
456621,1,9,10,1.312659,103.93225
456622,1,7,8,1.312671,103.9323
456623,26,8,34,1.312629,103.932296
456624,0,1,1,1.312806,103.932341
456626,2,50,52,1.312456,103.932325
456627,16,0,16,1.312456,103.932382
456628,2,2,4,1.312459,103.932442
456629,10,10,20,1.312459,103.932491
456633,1,12,13,1.312482,103.932694
456634,1,1,2,1.320753,103.924932
456636,12,18,30,1.312347,103.932325
456637,53,32,85,1.31261,103.932187
456638,0,12,12,1.31255,103.932161
456639,5,2,7,1.31261,103.93213
456640,4,27,31,1.312222,103.932294
456641,3,31,34,1.312214,103.932343
456642,11,4,15,1.312305,103.932197
456643,151,4,155,1.312343,103.93216
456644,155,4331,4486,1.311529,103.933081
456645,24,18,42,1.31194,103.932324
456646,68,12,80,1.31197,103.932373
456647,8,0,8,1.311906,103.932365
456648,1,0,1,1.31275,103.932179
456649,1,0,1,1.311936,103.93241
456650,62,1548,1610,1.311256,103.932694
456651,6,40,46,1.311819,103.93225
456652,0,1,1,1.312076,103.932227
456654,1,2,3,1.312904,103.932135
456656,2,1,3,1.311628,103.932105
456657,5,0,5,1.311609,103.931789
456658,2,0,2,1.312693,103.932183
456660,1,2,3,1.311612,103.931932
456661,2,5,7,1.311304,103.932059
456662,0,5,5,1.311304,103.932123
456663,3,6,9,1.311307,103.932176
456664,23,122,145,1.311311,103.932232
456665,19,694,713,1.311239,103.932258
456666,7,3,10,1.311228,103.932197
456667,3,1,4,1.311225,103.932044
456668,2,0,2,1.311289,103.931837
456669,0,5,5,1.312554,103.932096
456679,3,26,29,1.321167,103.924544
456680,0,49,49,1.321151,103.924553
456681,1,0,1,1.31166,103.932257
456682,3,0,3,1.311296,103.931984
456683,0,1,1,1.321182,103.924576
456684,19,0,19,1.32118,103.924628
456685,17,19,36,1.321212,103.924637
456686,25,4,29,1.321195,103.924657
456687,9,2,11,1.321237,103.92468
456688,54,1,55,1.321207,103.924683
456689,4,0,4,1.321249,103.924719
456690,24,1,25,1.321221,103.92471
456691,1,0,1,1.3212,103.924608
456693,5,0,5,1.321255,103.924788
456694,7,1,8,1.321274,103.924779
456695,11,0,11,1.321276,103.924839
456697,1,0,1,1.321236,103.924742
456698,8,0,8,1.321313,103.924849
456700,1,0,1,1.321296,103.924867
456701,33,0,33,1.321326,103.92493
456702,3,3,6,1.321343,103.92491
456704,3,0,3,1.321165,103.924594
456705,4,0,4,1.321374,103.925032
456706,46,6,52,1.321397,103.925021
456708,2,0,2,1.311206,103.931949
456710,1,0,1,1.321331,103.924881
456712,11,8,19,1.321475,103.925187
456713,1,0,1,1.32145,103.925134
456714,2,2,4,1.321512,103.925277
456715,0,1,1,1.321495,103.925295
456716,0,5,5,1.32153,103.925309
456717,5,1,6,1.321525,103.925358
456718,12,1,13,1.321537,103.925384
456719,1,0,1,1.32151,103.925329
456720,0,5,5,1.321566,103.925443
456721,5,0,5,1.321585,103.925489
456722,1,1,2,1.321433,103.925082
456733,9,1,10,1.320981,103.920518
456734,13,2,15,1.321007,103.920552
456735,4,10,14,1.321002,103.920518
456736,3,0,3,1.321368,103.924953
456737,1,78,79,1.32111,103.920649
456738,3,5,8,1.321114,103.92076
456739,2,0,2,1.321614,103.925481
456740,1,1,2,1.321134,103.92076
456741,24,0,24,1.321089,103.921041
456742,1,1,2,1.321069,103.921041
456743,2,5,7,1.32112,103.921045
456745,0,1,1,1.321551,103.925411
456746,32,36,68,1.321242,103.921087
456747,0,3,3,1.32109,103.920649
456748,4,0,4,1.321323,103.921116
456749,174,0,174,1.321014,103.921348
456750,38,1,39,1.321404,103.921144
456751,0,1,1,1.321039,103.921188
456752,6,0,6,1.321486,103.921172
456754,2,36,38,1.321567,103.9212
456755,5,1,6,1.32105,103.921534
456756,4,3,7,1.321114,103.921063
456759,0,1,1,1.321021,103.921385
456760,6,2,8,1.321218,103.921099
456761,1,0,1,1.32108,103.921652
456762,2,7,9,1.321288,103.921123
456763,21,0,21,1.321124,103.921782
456764,2,0,2,1.321062,103.921078
456765,1,0,1,1.321094,103.921696
456767,1,73,74,1.321497,103.921196
456768,1,67,68,1.321557,103.92121
456769,19,1,20,1.321014,103.921348
456770,10,10,20,1.299509,103.837
456779,18,11,29,1.311867,103.921301
456780,1,0,1,1.321153,103.921869
456781,23,0,23,1.31203,103.921236
456782,2,0,2,1.321358,103.921148
456783,7,0,7,1.312324,103.921122
456784,26,5,31,1.31251,103.921058
456785,63,4,67,1.312084,103.921207
456786,9,0,9,1.312245,103.921149
456787,83,2,85,1.312378,103.921091
456795,50,27,77,1.315315,103.922719
456796,1,73,74,1.315307,103.922692
456797,13,0,13,1.315333,103.922814
456798,0,4,4,1.315315,103.922739
456799,0,1,1,1.311939,103.921262
456800,0,2,2,1.312175,103.92118
456803,5,0,5,1.315437,103.92338
456804,20,1,21,1.315367,103.923023
456805,15,2,17,1.315471,103.923569
456806,44,0,44,1.315385,103.923117
456807,0,1,1,1.315367,103.923003
456810,3,1,4,1.315419,103.923306
456811,9,1,10,1.315577,103.923936
456812,0,2,2,1.315333,103.922834
456813,0,1,1,1.315506,103.923758
456814,48,0,48,1.315454,103.923495
456816,1,0,1,1.315678,103.92396
456817,0,2,2,1.315437,103.9234
456820,1,1,2,1.315921,103.9239
456821,0,1,1,1.315471,103.923589
456823,0,3,3,1.321024,103.921261
456824,15,0,15,1.315557,103.923936
456825,5,0,5,1.315953,103.923912
456836,14,6,20,1.315751,103.929435
456837,3,0,3,1.315831,103.923931
456840,11,0,11,1.315765,103.92934
456841,1,2,3,1.31575,103.929434
456842,5,1,6,1.315755,103.929199
456843,7,0,7,1.315736,103.929207
456844,6,0,6,1.315746,103.929058
456845,2,0,2,1.315506,103.923778
456846,3,0,3,1.315742,103.929299
456847,148,0,148,1.315736,103.928916
456848,33,7,40,1.315736,103.928916
456849,0,9,9,1.315724,103.929025
456850,6,0,6,1.315728,103.928776
456852,29,0,29,1.315712,103.928843
456853,7,1,8,1.315709,103.928495
456854,1,14,15,1.315706,103.928752
456855,14,1,15,1.3157,103.928354
456856,5,1,6,1.3157,103.92866
456857,3,0,3,1.315737,103.928917
456858,22,4,26,1.315688,103.928478
456859,1,0,1,1.315698,103.92396
456860,28,6,34,1.315676,103.928296
456861,72,2,74,1.31567,103.928205
456862,28,1,29,1.315691,103.928213
456863,9,0,9,1.315681,103.928072
456864,19,0,19,1.315672,103.927931
456865,2,1,3,1.315694,103.928569
456872,2,2,4,1.31761,103.926434
456874,5,0,5,1.317659,103.926536
456875,20,0,20,1.317693,103.926604
456876,3,6,9,1.317726,103.926672
456877,2,0,2,1.31573,103.929116
456878,1,0,1,1.315682,103.928387
456879,11,6,17,1.317826,103.926877
456880,4,1,5,1.317859,103.926945
456881,3,2,5,1.317882,103.927003
456883,8,2,10,1.317929,103.927093
456884,0,1,1,1.317795,103.926807
456886,1,0,1,1.317967,103.927172
456887,6,0,6,1.318078,103.927411
456888,1,0,1,1.318041,103.927331
456889,3,11,14,1.318143,103.92756
456900,8,0,8,1.316346,103.927661
456901,11,0,11,1.316358,103.927676
456902,14,1,15,1.316437,103.927623
456903,7,2,9,1.316459,103.927633
456905,4,3,7,1.316662,103.927546
456906,30,2,32,1.316798,103.927468
456907,11,0,11,1.316866,103.927459
456908,86,1,87,1.316979,103.92739
456909,2,2,4,1.316978,103.927389
456910,2,2,4,1.317069,103.927372
456911,12,4,16,1.317272,103.927284
456912,19,3,22,1.31734,103.927235
456913,30,5,35,1.317476,103.927197
456914,43,2,45,1.317521,103.927158
456915,7,3,10,1.31752,103.927157
456916,7,2,9,1.317679,103.92711
456917,2,0,2,1.317759,103.926741
456918,30,3,33,1.317882,103.927023
456919,152,0,152,1.317159,103.927313
456920,2,5,7,1.316436,103.927622
456921,0,17,17,1.317872,103.927013
456929,22,3,25,1.316721,103.918114
456930,69,79,148,1.31689,103.91819
456931,5,16,21,1.317024,103.918157
456932,5,2,7,1.31747,103.918504
456933,2,4,6,1.317757,103.918656
456934,16,5,21,1.318418,103.919084
456935,197,6,203,1.318502,103.919143
456936,0,3,3,1.315652,103.927931
456937,5,0,5,1.318711,103.919285
456938,38,0,38,1.31877,103.919317
456939,2,0,2,1.317701,103.92708
456940,11,0,11,1.318904,103.919403
456941,64,0,64,1.319011,103.919453
456942,0,11,11,1.319501,103.919999
456943,19,1,20,1.31995,103.919724
456945,2,8,10,1.320395,103.919587
456946,47,21,68,1.320226,103.919649
456947,116,3,119,1.32052,103.919524
456949,21,0,21,1.320315,103.919633
456950,0,38,38,1.320492,103.919601
456951,11,40,51,1.320669,103.919569
456952,8,80,88,1.320793,103.919652
456953,5,27,32,1.320839,103.919761
456954,80,4,84,1.318635,103.919222
456955,1,1,2,1.318827,103.919368
456956,14,4,18,1.317173,103.918342
456957,3,1,4,1.317258,103.918397
456958,1,1,2,1.320614,103.919482
456959,3,0,3,1.318571,103.919198
456960,2,7,9,1.317258,103.918397
456961,0,7,7,1.317547,103.918551
456963,20,2,22,1.317547,103.918551
456964,0,3,3,1.317258,103.918397
456965,4,1,5,1.309567,103.919717
456966,7,0,7,1.309519,103.919727
456967,0,9,9,1.309551,103.919679
456968,0,1,1,1.318116,103.92749
456970,7,0,7,1.309457,103.919563
456971,1,1,2,1.317258,103.918397
456974,15,0,15,1.309391,103.919409
456975,7,0,7,1.309419,103.91937
456976,1,0,1,1.30949,103.919641
456977,2,0,2,1.309485,103.919524
456978,68,4,72,1.309325,103.919254
456980,1,4,5,1.309299,103.919197
456982,0,5,5,1.308781,103.919399
456983,24,3,27,1.309303,103.919096
456984,0,1,1,1.309358,103.919331
456985,1,0,1,1.308774,103.919444
456987,0,1,1,1.309285,103.919054
456989,4,55,59,1.309225,103.918896
456991,20,3,23,1.309257,103.919151
456992,8,0,8,1.308923,103.919804
456993,0,3,3,1.309518,103.919754
456995,1,3,4,1.309142,103.919194
456996,7,1,8,1.309001,103.91998
456997,2,0,2,1.309386,103.919292
456998,9,9,18,1.309011,103.920014
456999,1,0,1,1.30925,103.91897
457000,10,1,11,1.308913,103.919278
457001,8,19,27,1.308836,103.919307
457002,0,9,9,1.30877,103.919325
457003,2,0,2,1.309066,103.919222
457004,44,0,44,1.308754,103.919444
457005,1,0,1,1.308989,103.91925
457007,1,0,1,1.308785,103.919539
457008,0,2,2,1.308761,103.919399
457009,1,0,1,1.308835,103.919651
457010,0,6,6,1.308935,103.919875
457011,3,0,3,1.309219,103.919165
457012,0,3,3,1.308968,103.919949
457023,0,157,157,1.310096,103.928803
457024,0,1107,1107,1.310164,103.929222
457025,0,1,1,1.308901,103.9198
457026,44,2,46,1.310163,103.929221
457027,1,0,1,1.310163,103.929221
457028,5,774,779,1.310119,103.929099
457029,2,5,7,1.310721,103.929187
457030,1,5,6,1.310162,103.929187
457031,16,10,26,1.310845,103.929178
457033,1,5,6,1.31097,103.929168
457034,1,2,3,1.309001,103.920024
457035,0,36,36,1.311219,103.929149
457036,4,0,4,1.310155,103.92901
457037,32,83,115,1.311467,103.929131
457038,1,17,18,1.311716,103.929112
457039,12,0,12,1.310148,103.928869
457040,0,15,15,1.311965,103.929093
457041,0,2,2,1.308868,103.919726
457042,4,1,5,1.310142,103.928728
457043,1,2,3,1.310158,103.929081
457044,0,1,1,1.310163,103.929221
457045,0,6,6,1.310532,103.929182
457046,44,6,50,1.310438,103.929189
457047,1,0,1,1.310627,103.929174
457048,4,0,4,1.310249,103.929204
457049,4,3,7,1.310154,103.929212
457050,3,0,3,1.310674,103.929171
457051,94,2,96,1.310713,103.929079
457052,1,0,1,1.310343,103.929197
457054,1,2,3,1.310717,103.929123
457055,2,2,4,1.310693,103.928735
457057,73,8,81,1.310969,103.929167
457058,183,159,342,1.299509,103.837
457066,4,16,20,1.312954,103.921224
457067,34,13,47,1.312957,103.92136
457068,7,1,8,1.313069,103.921185
457069,3,2,5,1.313083,103.92132
457070,15,3,18,1.313303,103.921068
457071,50,0,50,1.313262,103.921243
457072,5,2,7,1.313417,103.921011
457073,1,0,1,1.310706,103.92899
457074,2,4,6,1.313575,103.920951
457075,3,1,4,1.31353,103.921115
457076,0,1,1,1.313392,103.921182
457077,5,1,6,1.313745,103.920863
457078,2,2,4,1.313689,103.92104
457081,17,8,25,1.313846,103.920831
457082,4,6,10,1.314028,103.920877
457083,3,2,5,1.313941,103.920803
457084,52,1,53,1.314144,103.920821
457085,31,0,31,1.314112,103.920723
457086,8,1,9,1.314281,103.92077
457087,1,3,4,1.314427,103.92059
457088,1,1,2,1.310145,103.928799
457089,5,0,5,1.314519,103.920557
457090,19,1,20,1.314598,103.920644
457091,6,1,7,1.314601,103.920527
457092,36,1,37,1.314745,103.920578
457093,16,1,17,1.314702,103.920464
457094,2,0,2,1.314391,103.920741
457095,14,0,14,1.314768,103.920443
457096,3,0,3,1.310691,103.928813
457097,15,2,17,1.314827,103.920416
457098,0,2,2,1.314877,103.92054
457099,3,1,4,1.314902,103.92039
457100,9,1,10,1.315314,103.92034
457101,3,4,7,1.314996,103.920358
457103,16,1,17,1.315101,103.920327
457104,1,4,5,1.315553,103.92023
457105,1,0,1,1.313743,103.92088
457106,1,0,1,1.315198,103.920282
457107,2,1,3,1.315038,103.920463
457108,1,2,3,1.315388,103.920193
457109,7,36,43,1.315545,103.920124
457110,18,3,21,1.313962,103.920909
457112,70,12,82,1.315614,103.920203
457113,30,6,36,1.313192,103.921125
457114,0,1,1,1.315285,103.920241
457115,1,0,1,1.314506,103.920691
457116,2,5,7,1.299509,103.837
457117,5,0,5,1.299509,103.837
457120,197,690,887,1.313723,103.928344
457121,75,19,94,1.313908,103.928492
457123,2,4,6,1.314,103.928425
457124,5,7,12,1.314059,103.928177
457125,1,0,1,1.312937,103.921112
457126,0,2,2,1.315195,103.920405
457127,3,0,3,1.315466,103.920166
457128,33,0,33,1.314114,103.928054
457129,0,1,1,1.314082,103.928138
457130,9,0,9,1.314168,103.927951
457131,1,0,1,1.31415,103.927996
457132,1,1,2,1.3141,103.928098
457133,0,1,1,1.314135,103.928305
457134,8,6,14,1.31424,103.928328
457135,1,0,1,1.314273,103.927873
457136,38,1,39,1.314428,103.928488
457137,3,0,3,1.314077,103.928364
457138,4,0,4,1.314569,103.928599
457139,23,13,36,1.314625,103.928648
457140,0,1,1,1.314338,103.928434
457141,25,1,26,1.314427,103.9278
457142,0,15,15,1.314253,103.928207
457146,1,0,1,1.314353,103.927847
457147,2,0,2,1.31423,103.927915
457148,1,14,15,1.314492,103.928412
457150,4,9,13,1.314601,103.928492
457151,19,0,19,1.314649,103.928527
457152,7,5,12,1.314468,103.927952
457154,66,0,66,1.31452,103.927748
457155,87,3,90,1.314599,103.927729
457156,11,46,57,1.314575,103.927929
457157,19,0,19,1.314631,103.927913
457158,7,0,7,1.31466,103.927903
457159,6,2,8,1.314686,103.927711
457160,4,2,6,1.31471,103.927898
457161,2,0,2,1.314448,103.928376
457162,2,0,2,1.314749,103.927885
457163,21,7,28,1.314816,103.927863
457164,15,2,17,1.31487,103.927847
457165,1,2,3,1.31449,103.928542
457166,2,7,9,1.314987,103.927824
457167,4,24,28,1.315039,103.928096
457168,6,5,11,1.315052,103.928161
457172,5,1,6,1.315078,103.928362
457174,0,2,2,1.314735,103.927697
457175,3,1,4,1.315223,103.928584
457176,13,0,13,1.315222,103.928484
457177,0,1,1,1.314406,103.928347
457179,0,7,7,1.315212,103.927896
457180,80,7,87,1.315255,103.927776
457182,2,17,19,1.315106,103.927623
457183,34,0,34,1.315492,103.927728
457184,99,57,156,1.31554,103.927718
457185,10,18,28,1.315606,103.927685
457186,5,19,24,1.315293,103.92758
457187,0,101,101,1.315393,103.927538
457188,6,8,14,1.315503,103.927516
457189,2,0,2,1.315233,103.928645
457190,12,1,13,1.315665,103.92766
457191,9,22,31,1.315768,103.927392
457192,5,2,7,1.315837,103.927358
457193,30,0,30,1.315899,103.92733
457194,185,3,188,1.315968,103.927296
457195,26,22,48,1.314958,103.92764
457196,1,0,1,1.31522,103.928415
457197,4,0,4,1.314958,103.92764
457198,108,0,108,1.314958,103.92764
457199,4,0,4,1.314958,103.92764
457200,20,17,37,1.313127,103.925778
457201,1,19,20,1.313184,103.925772
457202,4,3,7,1.313241,103.925766
457203,2,5,7,1.313299,103.925761
457205,1,6,7,1.31335,103.925755
457206,14,23,37,1.313541,103.925892
457207,0,5,5,1.313402,103.925743
457208,4,0,4,1.313447,103.925738
457209,0,4,4,1.313493,103.925732
457210,3,14,17,1.314465,103.926157
457211,7,44,51,1.314466,103.926282
457212,45,2,47,1.313572,103.925738
457213,0,4,4,1.313631,103.925746
457214,7,25,32,1.314656,103.926029
457215,0,3,3,1.314935,103.927839
457217,1,0,1,1.314958,103.92764
457218,1,0,1,1.314672,103.926216
457219,0,9,9,1.314666,103.926415
457220,3,0,3,1.314661,103.926082
457221,3,0,3,1.313697,103.925768
457222,1,6,7,1.313866,103.92583
457223,2,0,2,1.3156,103.92747
457226,8,1,9,1.313999,103.925907
457227,3,5,8,1.314065,103.925937
457229,16,2,18,1.314182,103.925981
457230,8,0,8,1.314252,103.926003
457231,1,31,32,1.314453,103.925999
457232,15,0,15,1.314517,103.925973
457235,2,1,3,1.31376,103.92579
457236,13,0,13,1.314622,103.925876
457237,0,5,5,1.314661,103.925847
457238,3,0,3,1.314564,103.925934
457239,1,4,5,1.315936,103.92585
457240,37,0,37,1.314745,103.925787
457241,0,5,5,1.316012,103.925838
457242,1,7,8,1.314803,103.925769
457243,9,0,9,1.314853,103.925771
457245,1,1,2,1.31394,103.92586
457246,3,12,15,1.316168,103.925799
457248,2,2,4,1.316237,103.925787
457249,5,4,9,1.315723,103.925667
457250,12,6,18,1.315808,103.925657
457251,13,0,13,1.315917,103.925636
457252,60,31,91,1.316003,103.925622
457253,29,7,36,1.316096,103.925598
457254,24,16,40,1.316182,103.925581
457255,15,9,24,1.316739,103.92541
457256,96,1,97,1.316713,103.925329
457257,60,0,60,1.316687,103.925245
457258,50,12,62,1.316669,103.925149
457259,7,2,9,1.316648,103.925053
457262,1,1,2,1.315561,103.925681
457263,85,5,90,1.317297,103.925292
457264,660,78,738,1.318053,103.925026
457265,472,33,505,1.317542,103.924241
457266,902,97,999,1.318023,103.923993
457267,575,29,604,1.318468,103.923889
457268,483,139,622,1.318053,103.925026
457269,614,95,709,1.313887,103.926115
457271,2,38,40,1.313656,103.925875
457279,4,6,10,1.322572,103.925094
457280,4,287,291,1.322731,103.925133
457281,2,0,2,1.317166,103.925333
457282,9,3,12,1.322719,103.925098
457284,0,111,111,1.322695,103.925059
457285,2,4,6,1.322504,103.92494
457288,0,6,6,1.322642,103.92497
457289,1,0,1,1.314668,103.926344
457290,5,332,337,1.32262,103.924921
457291,3,0,3,1.314698,103.9258
457292,14,1,15,1.322426,103.924785
457294,15,0,15,1.322408,103.924738
457295,5,1,6,1.322528,103.924729
457296,1,0,1,1.322456,103.924823
457297,13,7,20,1.32245,103.924468
457299,1,0,1,1.322362,103.92466
457302,1,1,2,1.322557,103.925043
457305,1,305,306,1.322671,103.924353
457306,7,0,7,1.322238,103.924387
457307,1,308,309,1.322647,103.924263
457308,0,1,1,1.322508,103.924444
457309,0,2,2,1.322286,103.924496
457310,4,1,5,1.322187,103.924256
457311,0,1,1,1.322209,103.924315
457312,0,1,1,1.322578,103.9243
457314,2,0,2,1.322614,103.924281
457316,1,4,5,1.322104,103.924071
457328,0,6,6,1.315497,103.930201
457329,1,0,1,1.322159,103.924197
457331,3,0,3,1.322593,103.924867
457332,1,1,2,1.322132,103.924137
457334,2,1,3,1.314935,103.929873
457336,1,1,2,1.315507,103.930412
457337,0,1,1,1.314832,103.929845
457338,1,0,1,1.31533,103.929964
457339,1,1,2,1.315639,103.930532
457340,4,0,4,1.315639,103.93027
457341,5,0,5,1.315639,103.930191
457342,0,1,1,1.315639,103.930447
457343,46,5,51,1.315639,103.930105
457345,44,3,47,1.316264,103.930065
457346,6,0,6,1.31644,103.929937
457348,112,1,113,1.316206,103.930276
457349,2,0,2,1.315639,103.930356
457350,32,0,32,1.316162,103.930448
457351,2,0,2,1.316185,103.930359
457352,38,2,40,1.316124,103.930612
457353,54,0,54,1.316101,103.930677
457354,2,1,3,1.315511,103.930491
457355,96,2,98,1.316175,103.931022
457356,8,7,15,1.316183,103.93091
457357,3,5,8,1.316198,103.930824
457358,5,1,6,1.316205,103.930731
457359,0,3,3,1.316156,103.93113
457360,2,2,4,1.316264,103.930533
457361,2,0,2,1.316137,103.930508
457362,1,3,4,1.316316,103.930351
457363,10,4,14,1.316342,103.930264
457364,13,0,13,1.316382,103.930158
457365,72,11,83,1.316409,103.930076
457366,52,6,58,1.299509,103.837
457367,14,0,14,1.299509,103.837
457376,5,2,7,1.312365,103.927388
457377,1,7,8,1.312339,103.927259
457378,46,5,51,1.312286,103.927276
457379,1,10,11,1.312234,103.927294
457380,2,17,19,1.312181,103.927311
457382,0,1,1,1.316127,103.929883
457383,3,0,3,1.316231,103.930632
457384,24,3,27,1.312105,103.92744
457385,9,42,51,1.31204,103.92748
457386,2,32,34,1.311961,103.927443
457387,79,1,80,1.311938,103.927446
457389,1,0,1,1.312235,103.927409
457390,116,0,116,1.311982,103.927553
457392,19,0,19,1.311993,103.927603
457393,18,0,18,1.311965,103.927618
457395,2,0,2,1.316287,103.930448
457396,1,0,1,1.311942,103.927506
457398,2153,63,2216,1.311078,103.927984
457399,800,7,807,1.310455,103.928321
457400,1446,61,1507,1.310184,103.928122
457401,1083,158,1241,1.310547,103.926955
457402,1045,165,1210,1.310547,103.926955
457403,617,56,673,1.310547,103.926955
457404,669,23,692,1.311152,103.926495
457405,32,68,100,1.310547,103.926955
457406,786,198,984,1.311711,103.927466
457408,0,1,1,1.312007,103.927718
457409,0,2,2,1.311974,103.927678
457410,2,0,2,1.309926,103.920461
457411,1,0,1,1.309927,103.920485
457413,0,2,2,1.309914,103.920452
457414,14,3,17,1.309858,103.920321
457415,0,4,4,1.309849,103.920279
457416,18,1,19,1.309831,103.920255
457417,1,6,7,1.309819,103.920206
457418,3,5,8,1.309804,103.920189
457419,35,0,35,1.309788,103.920132
457420,0,1,1,1.30991,103.920425
457421,1,0,1,1.309758,103.920059
457423,2,0,2,1.30988,103.920352
457425,4,1,5,1.309694,103.919926
457426,4,0,4,1.309676,103.91985
457427,0,3,3,1.312164,103.927422
457438,3,5,8,1.310595,103.920308
457439,1,12,13,1.310543,103.920332
457440,1,0,1,1.309748,103.920057
457442,1,1,2,1.309721,103.919992
457443,19,0,19,1.31058,103.92042
457444,12,5,17,1.310666,103.920443
457445,0,16,16,1.310602,103.920463
457446,0,18,18,1.310807,103.920724
457448,12,0,12,1.310805,103.920696
457449,2,11,13,1.310639,103.920545
457450,2,2,4,1.310709,103.920702
457451,5,0,5,1.310796,103.920682
457452,3,0,3,1.309666,103.91986
457453,2,1,3,1.310681,103.92063
457454,5,115,120,1.310791,103.920669
457465,1,1,2,1.310636,103.920399
457466,3,1,4,1.309533,103.920793
457467,2,0,2,1.30957,103.920766
457469,0,6,6,1.309614,103.920855
457470,6,5,11,1.309571,103.920886
457471,3,0,3,1.310791,103.920669
457472,0,5,5,1.309593,103.920931
457474,16,0,16,1.309614,103.920978
457476,2,1,3,1.309638,103.920904
457477,70,1,71,1.309731,103.921071
457478,22,2,24,1.309659,103.921075
457479,8,2,10,1.309754,103.921122
457480,7,2,9,1.309682,103.921124
457491,63,1,64,1.319258,103.922306
457492,21,13,34,1.319661,103.922396
457494,12,3,15,1.319657,103.922458
457495,6,0,6,1.319748,103.922298
457496,259,4,263,1.319648,103.922582
457497,0,2,2,1.309591,103.92081
457499,0,1,1,1.310615,103.920346
457500,1,2,3,1.309638,103.921018
457502,38,3,41,1.319607,103.923161
457503,14,1,15,1.319611,103.923099
457504,1,1,2,1.319639,103.922706
457505,0,1,1,1.31962,103.922955
457506,120,1,121,1.319639,103.922726
457507,5,6,11,1.319648,103.922602
457508,37,1,38,1.319657,103.922478
457509,9,22,31,1.319676,103.922344
457510,6,7,13,1.320181,103.922479
457511,3,6,9,1.320176,103.92254
457512,3,1,4,1.320168,103.922661
457513,10,3,13,1.320159,103.922783
457515,22,4,26,1.320141,103.923027
457516,12,0,12,1.320133,103.923148
457517,5,1,6,1.320114,103.92328
457518,1,2,3,1.319611,103.923079
457519,37,0,37,1.320134,103.923148
457520,1,2,3,1.320129,103.923219
457521,2,1,3,1.320144,103.923006
457522,0,2,2,1.31962,103.922975
457523,37,6,43,1.320175,103.92258
457524,17,1,18,1.321486,103.92306
457535,0,38,38,1.309853,103.918818
457536,1,7,8,1.309803,103.918826
457537,1,0,1,1.319629,103.922851
457538,6,2,8,1.30982,103.918877
457539,3,12,15,1.309904,103.918938
457540,1,0,1,1.30988,103.918877
457543,7,1,8,1.309955,103.91905
457544,0,12,12,1.309888,103.919045
457545,0,4,4,1.309975,103.919102
457546,1,0,1,1.309841,103.918936
457548,2,0,2,1.320165,103.922722
457549,3,0,3,1.320155,103.922864
457550,0,6,6,1.309965,103.919247
457551,0,5,5,1.310053,103.919289
457553,1,0,1,1.309918,103.919112
457554,2,2,4,1.310024,103.919377
457555,1,2,3,1.310026,103.919215
457556,21,8,29,1.310043,103.919432
457557,1,0,1,1.310079,103.919344
457558,8,1,9,1.310071,103.919495
457559,0,1,1,1.310114,103.919435
457560,19,3,22,1.31016,103.919553
457561,11,3,14,1.310126,103.919651
457562,5,0,5,1.310185,103.919601
457563,6,0,6,1.310148,103.919699
457564,2,3,5,1.310212,103.91966
457565,10,10,20,1.310173,103.919756
457566,96,0,96,1.310231,103.919712
457567,3,0,3,1.310091,103.919374
457568,0,2,2,1.309943,103.919188
457570,2,0,2,1.310266,103.91979
457571,2,0,2,1.310299,103.91985
457572,1,2,3,1.31022,103.919815
457573,0,2,2,1.310271,103.919934
457575,3,0,3,1.31033,103.919921
457576,3,0,3,1.310322,103.920037
457577,3,3,6,1.310347,103.92009
457578,3,0,3,1.31039,103.920064
457579,2,2,4,1.310375,103.920167
457580,26,15,41,1.310441,103.920158
457591,27,37,64,1.31277,103.925375
457592,13,0,13,1.312769,103.925374
457594,4,2,6,1.313312,103.925058
457595,4,8,12,1.313389,103.925046
457596,35,1,36,1.312709,103.925367
457597,0,3,3,1.310422,103.920116
457598,13,20,33,1.312709,103.925367
457599,1,6,7,1.312709,103.925367
457600,2,5,7,1.312709,103.925367
457601,268,1575,1843,1.312709,103.925367
457602,68,725,793,1.31283,103.925362
457603,4,0,4,1.312829,103.925361
457605,0,1,1,1.310138,103.919489
457606,1,0,1,1.313428,103.92521
457607,2,3,5,1.314135,103.925063
457609,0,1,1,1.312949,103.925336
457610,1,8,9,1.313308,103.925257
457611,17,18,35,1.313428,103.92523
457612,22,0,22,1.313426,103.92523
457613,13,6,19,1.313547,103.925204
457614,5,1,6,1.313667,103.925178
457615,15,4,19,1.313666,103.925177
457617,20,56,76,1.313906,103.925126
457618,11,0,11,1.314025,103.925099
457619,258,4,262,1.314145,103.925073
457628,3,4,7,1.310107,103.920551
457629,2,5,7,1.31002,103.920584
457630,0,3,3,1.312709,103.925367
457631,2,0,2,1.310297,103.91999
457632,2,0,2,1.310038,103.920624
457633,9,0,9,1.310057,103.920672
457634,1,4,5,1.310164,103.920699
457637,3,0,3,1.310125,103.920609
457638,5,2,7,1.310205,103.920798
457640,2,10,12,1.310227,103.920851
457641,0,2,2,1.310147,103.92065
457643,10,0,10,1.310158,103.920882
457654,61,0,61,1.309112,103.920993
457655,15,1,16,1.309122,103.921029
457657,6,0,6,1.309143,103.921112
457658,3,2,5,1.309152,103.92116
457659,1,3,4,1.309165,103.921206
457660,0,2,2,1.310138,103.920836
457661,2,0,2,1.309114,103.921318
457662,4,1,5,1.309105,103.921258
457663,10,1,11,1.309189,103.921323
457664,2,0,2,1.309182,103.921283
457665,5,1,6,1.309046,103.921466
457666,0,1,1,1.313188,103.925283
457667,115,1,116,1.30909,103.92115
457669,22,0,22,1.309079,103.921081
457670,1,2,3,1.310101,103.920756
457671,0,2,2,1.309097,103.921216
457672,1,0,1,1.308973,103.921479
457673,33,1786,1819,1.308612,103.921757
457674,0,1,1,1.309053,103.920986
457675,2,800,802,1.308601,103.92166
457676,29,0,29,1.309014,103.920841
457677,0,853,853,1.308581,103.921506
457678,1,2,3,1.308695,103.921684
457679,10,110,120,1.308563,103.921402
457680,1,0,1,1.30904,103.920934
457681,17,79,96,1.308514,103.921225
457682,0,1,1,1.30899,103.92072
457683,4,3,7,1.308484,103.921091
457684,24,0,24,1.308958,103.920598
457685,1,456,457,1.30845,103.920956
457686,38,0,38,1.308946,103.92055
457688,1,0,1,1.308971,103.920661
457689,0,220,220,1.308395,103.920686
457690,3,5,8,1.308916,103.920389
457691,0,157,157,1.308365,103.920552
457692,7,0,7,1.308885,103.920286
457693,1,8,9,1.308338,103.920394
457694,1,0,1,1.308928,103.920476
457695,3,63,66,1.308315,103.920272
457696,1,2,3,1.309003,103.92078
457697,0,146,146,1.308272,103.920074
457698,17,0,17,1.308394,103.920342
457699,4,67,71,1.308237,103.91986
457700,5,0,5,1.308404,103.9204
457701,2,39,41,1.308203,103.919702
457702,3,0,3,1.308382,103.920288
457703,3,99,102,1.308173,103.919511
457704,25,0,25,1.308433,103.920517
457705,5,9,14,1.308446,103.920591
457706,6,0,6,1.308461,103.920665
457707,1,0,1,1.30887,103.920208
457708,2,0,2,1.309066,103.921031
457709,17,0,17,1.308255,103.919656
457710,1,0,1,1.308473,103.92073
457711,2,1,3,1.308416,103.92046
457712,4,0,4,1.308487,103.920794
457713,10,1,11,1.30836,103.920129
457714,28,0,28,1.308431,103.920127
457716,6,0,6,1.308528,103.920115
457717,44,0,44,1.308593,103.920109
457718,2,1,3,1.308279,103.919771
457719,7,1,8,1.308516,103.920916
457720,29,1,30,1.308934,103.920207
457721,36,2,38,1.308528,103.920964
457722,11,0,11,1.308537,103.921016
457723,13,0,13,1.309012,103.920544
457724,5,0,5,1.308554,103.921073
457726,1,1,2,1.308245,103.919603
457727,7,2,9,1.308596,103.921262
457728,42,0,42,1.308617,103.921329
457730,3,2,5,1.308652,103.921457
457741,1,4,5,1.322137,103.925322
457742,0,17,17,1.322156,103.92532
457743,9,0,9,1.322122,103.925292
457744,1,1,2,1.308579,103.921194
457745,1,0,1,1.308267,103.919705
457746,1,0,1,1.322094,103.925232
457747,3,0,3,1.308505,103.920858
457748,1,3,4,1.32208,103.925161
457749,4,0,4,1.322036,103.925111
457750,2,0,2,1.322141,103.925288
457751,0,4,4,1.322007,103.925051
457752,1,3,4,1.322019,103.925034
457753,0,21,21,1.321989,103.924971
457754,30,6,36,1.32195,103.924931
457755,0,2,2,1.32205,103.925098
457756,0,1,1,1.32211,103.925225
457757,3,2,5,1.321928,103.924844
457758,1,1,2,1.321959,103.924907
457760,3,0,3,1.322065,103.925171
457761,0,3,3,1.321864,103.92475
457763,3,0,3,1.321868,103.924716
457764,69,6,75,1.321806,103.924629
457765,10,6,16,1.321807,103.924589
457766,1,0,1,1.321921,103.92487
457767,1,0,1,1.321777,103.924569
457768,30,1,31,1.321749,103.924509
457769,37,66,103,1.321746,103.924462
457770,9,0,9,1.32172,103.924449
457771,4,0,4,1.321716,103.924399
457773,2,0,2,1.321892,103.92481
457774,87,1,88,1.321662,103.924328
457775,13,2,15,1.321655,103.924272
457776,4,1,5,1.321634,103.924268
457777,9,20,29,1.321625,103.924208
457778,2,35,37,1.321615,103.924218
457789,10,19,29,1.320857,103.924374
457790,13,3,16,1.320776,103.924106
457791,46,1,47,1.320828,103.924326
457792,0,2,2,1.321686,103.924335
457793,16,3,19,1.320802,103.924277
457794,34,0,34,1.320735,103.924004
457795,2,1,3,1.321837,103.924653
457796,0,1,1,1.321777,103.924526
457797,3,0,3,1.320769,103.92422
457798,0,3,3,1.320742,103.924162
457799,0,1,1,1.32071,103.923943
457800,3,1,4,1.320666,103.923829
457801,14,0,14,1.320646,103.923779
457802,0,1,1,1.32072,103.924109
457803,4,0,4,1.32065,103.923974
457804,1,0,1,1.32068,103.924031
457805,60,2,62,1.320602,103.923881
457806,9,0,9,1.320577,103.923832
457807,13,0,13,1.320547,103.923785
457808,1,7,8,1.32053,103.923738
457809,1,0,1,1.320625,103.923926
457810,2,0,2,1.320762,103.924053
457811,7,1,8,1.32045,103.923588
457812,5,0,5,1.320427,103.923544
457813,1,0,1,1.320497,103.923681
457814,1,0,1,1.320412,103.923489
457815,5,2,7,1.320373,103.923387
457817,72,0,72,1.320332,103.923288
457818,0,4,4,1.320643,103.923564
457819,0,11,11,1.320715,103.92357
457820,58,0,58,1.320788,103.923576
457822,22,3,25,1.320914,103.923584
457823,17,0,17,1.320981,103.923582
457824,1,1,2,1.320477,103.923633
457825,8,2,10,1.321116,103.923588
457826,41,0,41,1.321181,103.92359
457827,19,0,19,1.321252,103.923601
457828,1,3,4,1.321314,103.923607
457830,3,2,5,1.321426,103.923611
457831,21,4,25,1.321489,103.923614
457832,20,0,20,1.321538,103.923618
457833,3,0,3,1.320687,103.923887
457835,1,0,1,1.320394,103.923442
457837,1,0,1,1.321666,103.923694
457838,54,0,54,1.321732,103.923829
457849,1,4,5,1.309419,103.920594
457851,4,2,6,1.309372,103.920493
457853,7,1,8,1.309331,103.920396
457855,1,0,1,1.321719,103.923797
457856,1,0,1,1.309284,103.920252
457857,8,0,8,1.309241,103.920152
457858,1,2,3,1.321585,103.92363
457869,1,0,1,1.309262,103.920201
457871,1,1,2,1.321045,103.923585
457872,10,0,10,1.316127,103.91624
457873,4,1,5,1.316429,103.916639
457874,7,2,9,1.316079,103.916103
457875,3,0,3,1.309216,103.920104
457878,2,0,2,1.316619,103.916463
457879,2,1,3,1.316336,103.916732
457881,0,4,4,1.316135,103.916512
457882,2,4,6,1.315833,103.915556
457883,3,6,9,1.316075,103.916397
457884,5,0,5,1.315765,103.915393
457885,3,0,3,1.316176,103.916603
457886,16,3,19,1.315703,103.915281
457888,4,1,5,1.315673,103.915186
457889,3,4,7,1.315927,103.91604
457890,4,1,5,1.315907,103.915952
457891,1,0,1,1.31619,103.916401
457892,9,0,9,1.315821,103.915748
457893,2,0,2,1.315954,103.915828
457894,30,1,31,1.315717,103.915527
457895,2,0,2,1.315782,103.915634
457896,0,5,5,1.315636,103.91533
457897,26,2,28,1.315596,103.915266
457908,542,67,609,1.313686,103.927061
457909,420,5,425,1.314352,103.926636
457910,693,63,756,1.313725,103.92724
457911,969,996,1965,1.314801,103.926734
457912,640,26,666,1.314554,103.927044
457923,2,4,6,1.312712,103.916839
457924,36,1,37,1.31274,103.916908
457925,4,4,8,1.313073,103.917363
457926,10,6,16,1.313234,103.917288
457927,4,10,14,1.313395,103.917234
457928,9,2,11,1.313476,103.917198
457929,22,3,25,1.313557,103.917155
457930,34,12,46,1.31364,103.917125
457931,12,0,12,1.313695,103.917089
457934,3,0,3,1.316036,103.916303
457935,4,5,9,1.313932,103.917196
457936,21,0,21,1.313898,103.917232
457937,5,9,14,1.313971,103.917345
457938,6,10,16,1.313933,103.917357
457939,9,0,9,1.313984,103.917505
457940,76,0,76,1.313923,103.917531
457942,156,2,158,1.313859,103.917612
457943,0,2,2,1.315674,103.915391
457945,3,2,5,1.31358,103.917686
457947,16,2,18,1.313414,103.917737
457948,26,0,26,1.313435,103.917769
457949,32,11,43,1.313235,103.918068
457950,15,0,15,1.313329,103.918298
457951,3,0,3,1.313887,103.917147
457953,1,15,16,1.313322,103.918472
457954,65,0,65,1.313291,103.918384
457955,3,12,15,1.313167,103.918096
457957,15,3,18,1.312886,103.917979
457958,10,0,10,1.312687,103.918093
457959,2,0,2,1.313704,103.917635
457960,7,13,20,1.312571,103.918175
457961,34,17,51,1.312393,103.918207
457962,2,1,3,1.313412,103.918478
457963,5,0,5,1.312306,103.918233
457964,20,0,20,1.312224,103.918223
457965,75,2,77,1.312194,103.918154
457966,7,0,7,1.312166,103.918094
457967,7,1,8,1.312142,103.918034
457968,1,1,2,1.312542,103.918143
457969,27,0,27,1.312068,103.917803
457970,34,0,34,1.312114,103.917761
457971,1,0,1,1.31587,103.915845
457972,79,0,79,1.312147,103.917711
457973,1,0,1,1.312174,103.917743
457974,2,0,2,1.312098,103.917922
457975,1,0,1,1.312369,103.917652
457976,2,3,5,1.31245,103.91761
457977,1,0,1,1.312511,103.917609
457978,1,0,1,1.312607,103.917564
457979,1,6,7,1.312797,103.917425
457980,15,2,17,1.312754,103.917491
457981,2,0,2,1.312331,103.91763
457982,0,7,7,1.312665,103.916877
457983,21,2,23,1.312723,103.91811
457984,5,2,7,1.312721,103.917004
457985,6,1,7,1.313353,103.918382
457986,33,7,40,1.312807,103.917021
457988,1,4,5,1.299509,103.837
457989,0,2,2,1.31275,103.917103
457993,0,1,1,1.312671,103.917537
457996,13,1,14,1.317248,103.914624
457997,3,3,6,1.317222,103.914737
457998,2,1,3,1.312429,103.918223
458009,2,53,55,1.318819,103.914257
458010,11,9,20,1.319112,103.914979
458011,1,0,1,1.317457,103.915101
458012,0,9,9,1.319112,103.914919
458013,3,0,3,1.317131,103.914492
458014,1,0,1,1.318781,103.91414
458015,2,1,3,1.318705,103.913905
458016,0,1,1,1.319086,103.914868
458018,0,3,3,1.318639,103.913681
458019,68,0,68,1.319043,103.914689
458020,0,4,4,1.319017,103.914629
458021,0,1,1,1.319069,103.914834
458022,2,42,44,1.318974,103.914561
458023,0,62,62,1.318866,103.914339
458024,1,3,4,1.318854,103.914304
458025,74,3,77,1.318831,103.914233
458026,0,1,1,1.318992,103.914595
458027,3,1,4,1.318786,103.914093
458028,2,2,4,1.318763,103.914022
458029,4,1,5,1.31874,103.913952
458030,0,1,1,1.318809,103.914163
458032,0,1,1,1.318717,103.913882
458033,47,0,47,1.318649,103.913671
458044,4,3,7,1.316649,103.91606
458045,40,6,46,1.316577,103.91589
458046,4,7,11,1.316589,103.916106
458047,49,1,50,1.316625,103.915657
458048,1,0,1,1.318672,103.913741
458049,8,11,19,1.316411,103.915514
458050,3,0,3,1.319052,103.914731
458051,2,0,2,1.299509,103.837
458052,2,4,6,1.316346,103.915658
458053,4,0,4,1.316252,103.915128
458054,41,0,41,1.316296,103.915516
458055,29,1,30,1.316169,103.91497
458056,4,0,4,1.316233,103.915355
458057,5,0,5,1.316172,103.915205
458059,13,0,13,1.316027,103.914911
458060,20,57,77,1.316896,103.916393
458061,1,1,2,1.316324,103.915323
458070,26,54,80,1.31209,103.920413
458071,8,47,55,1.312013,103.920421
458072,1,2,3,1.31644,103.915833
458073,48,3,51,1.312048,103.920493
458075,1,0,1,1.316518,103.916016
458076,53,3,56,1.312153,103.920578
458078,0,1,1,1.312066,103.920557
458079,5,1,6,1.312112,103.920678
458080,9,0,9,1.312198,103.920697
458093,14,45,59,1.317136,103.915787
458095,19,25,44,1.317132,103.915675
458096,1,3,4,1.316921,103.915467
458097,5,8,13,1.316985,103.915389
458099,27,13,40,1.316887,103.915233
458100,19,2,21,1.316748,103.915103
458101,2,0,2,1.316136,103.914859
458102,0,2,2,1.3168,103.915019
458103,4,5,9,1.316699,103.914833
458104,0,3,3,1.312111,103.920455
458105,6,0,6,1.317052,103.91571
458106,4,1,5,1.316984,103.915568
458107,1,11,12,1.316544,103.914669
458108,18,47,65,1.317085,103.915589
458115,3,22,25,1.318124,103.914445
458116,0,78,78,1.318251,103.914502
458117,1,0,1,1.312178,103.920643
458118,19,0,19,1.318188,103.914388
458119,1,1,2,1.316676,103.914936
458120,0,2,2,1.318043,103.914217
458132,8,81,89,1.318717,103.914564
458133,6,51,57,1.318126,103.914888
458134,0,10,10,1.318227,103.914806
458135,1,2,3,1.316609,103.914806
458136,44,7,51,1.318028,103.91496
458137,0,23,23,1.317725,103.914999
458138,14,22,36,1.317952,103.915033
458139,0,19,19,1.317672,103.915086
458140,36,1,37,1.317842,103.915173
458141,0,22,22,1.317453,103.91549
458142,50,31,81,1.317419,103.915594
458143,0,9,9,1.317757,103.915306
458144,9,8,17,1.317135,103.916027
458145,1,3,4,1.317694,103.915495
458146,10,45,55,1.317027,103.916221
458147,55,2,57,1.317624,103.915649
458148,62,15,77,1.316845,103.916698
458149,0,2,2,1.318148,103.91428
458150,8,23,31,1.316948,103.916694
458151,25,23,48,1.31755,103.915869
458152,1,10,11,1.316861,103.916903
458153,23,25,48,1.317389,103.916141
458154,0,16,16,1.316769,103.91711
458155,12,19,31,1.31666,103.917388
458156,2,43,45,1.317337,103.916284
458157,36,34,70,1.316717,103.917273
458158,14,6,20,1.317263,103.916466
458159,3,64,67,1.316601,103.917485
458160,4,75,79,1.316601,103.917485
458161,0,4,4,1.317194,103.916602
458162,34,93,127,1.316402,103.917913
458163,4,8,12,1.317131,103.916739
458164,4,24,28,1.316304,103.918114
458165,7,0,7,1.316304,103.918114
458166,9,5,14,1.317074,103.916887
458167,2,53,55,1.315955,103.918379
458168,2,8,10,1.317017,103.917046
458169,7,6,13,1.315805,103.918458
458170,3,1,4,1.316942,103.917223
458171,12,15,27,1.315641,103.918523
458172,6,14,20,1.316891,103.917342
458173,1,0,1,1.318095,103.914394
458174,27,91,118,1.316828,103.917508
458175,0,13,13,1.316776,103.917667
458176,22,103,125,1.315034,103.918766
458177,20,67,87,1.314874,103.918834
458178,12,163,175,1.3147,103.918883
458179,26,37,63,1.316312,103.918361
458180,28,54,82,1.314566,103.919017
458181,97,15,112,1.314547,103.918993
458182,6,10,16,1.316111,103.91852
458183,5,13,18,1.315978,103.918588
458184,0,32,32,1.31439,103.919081
458185,0,18,18,1.314381,103.919052
458186,1,19,20,1.31624,103.918174
458187,5,0,5,1.314291,103.919141
458188,3,48,51,1.314174,103.919205
458189,2,33,35,1.31396,103.91928
458190,9,0,9,1.313926,103.919256
458191,44,21,65,1.313742,103.919378
458192,9,85,94,1.315565,103.918778
458193,9,3,12,1.313595,103.919425
458194,25,75,100,1.31554,103.918823
458195,0,8,8,1.313326,103.919467
458197,14,118,132,1.315423,103.91885
458198,144,12,156,1.313303,103.919561
458200,61,11,72,1.31548,103.918954
458201,0,5,5,1.313177,103.919595
458202,37,0,37,1.313214,103.919596
458203,17,0,17,1.313068,103.919632
458204,1,29,30,1.313101,103.919646
458206,0,1,1,1.315543,103.918585
458207,9,19,28,1.312866,103.919739
458208,4,13,17,1.312786,103.919771
458209,57,171,228,1.315146,103.918956
458210,44,73,117,1.312662,103.919829
458211,27,23,50,1.315081,103.918994
458212,43,22,65,1.312557,103.919842
458213,0,5,5,1.315269,103.91904
458214,2,30,32,1.312001,103.920042
458215,52,99,151,1.314973,103.919052
458216,13,13,26,1.311838,103.920122
458217,3,0,3,1.317804,103.914903
458218,1,14,15,1.311703,103.920213
458219,3,35,38,1.314865,103.919113
458220,14,36,50,1.31481,103.919135
458221,173,19,192,1.314778,103.919167
458222,39,154,193,1.314645,103.919191
458223,17,67,84,1.314594,103.919206
458224,98,164,262,1.314595,103.919259
458225,21,70,91,1.314496,103.919255
458226,8,59,67,1.314444,103.91926
458227,4,11,15,1.314397,103.919309
458228,33,114,147,1.314339,103.919305
458229,32,9,41,1.314285,103.919346
458230,91,104,195,1.314232,103.919364
458231,20,3,23,1.314177,103.919379
458232,16,5,21,1.314129,103.919407
458233,5,30,35,1.313605,103.919649
458234,7,60,67,1.313502,103.919675
458235,56,0,56,1.313402,103.919729
458236,7,50,57,1.313276,103.919778
458237,0,9,9,1.313237,103.919808
458238,3,7,10,1.313109,103.919878
458239,1,29,30,1.31304,103.919918
458240,18,34,52,1.312885,103.920018
458241,42,43,85,1.312885,103.920018
458242,2,3,5,1.312781,103.920079
458243,10,40,50,1.312772,103.92003
458244,1,4,5,1.312594,103.920091
458245,53,11,64,1.312896,103.919962
458246,4,9,13,1.312866,103.919739
458247,8,9,17,1.31183,103.920055
458248,12,0,12,1.299509,103.837
458249,3,19,22,1.299509,103.837
458250,4,81,85,1.299509,103.837
458255,2,20,22,1.313993,103.924227
458256,1,11,12,1.313983,103.924276
458257,3,0,3,1.314921,103.919072
458258,0,1,1,1.31292,103.919691
458259,1,1,2,1.317603,103.915717
458260,1,2,3,1.314006,103.924292
458261,0,2,2,1.314031,103.92442
458262,0,3,3,1.314048,103.924613
458264,0,3,3,1.314092,103.924838
458266,0,1,1,1.314004,103.924388
458267,3,3,6,1.314155,103.925063
458269,14,1,15,1.31409,103.924837
458278,2260,567,2827,1.313111,103.923488
458279,7,0,7,1.313117,103.92355
458281,0,44,44,1.313134,103.92367
458282,33,0,33,1.313139,103.923711
458283,0,2,2,1.314056,103.924549
458284,121,21,142,1.313275,103.923791
458285,1,12,13,1.313329,103.923787
458286,10,7,17,1.313399,103.923779
458287,15,290,305,1.313327,103.923714
458288,3,5,8,1.313478,103.923765
458289,1,3,4,1.313454,103.923699
458290,3,0,3,1.314135,103.925063
458291,0,2,2,1.313141,103.923728
458292,0,1,1,1.31413,103.924934
458293,0,1,1,1.313622,103.923741
458294,1,2,3,1.313555,103.923752
458295,2,0,2,1.313544,103.923685
458296,0,1,1,1.313635,103.923669
458297,2,0,2,1.313718,103.923653
458298,4,2,6,1.313807,103.92371
458299,13,1,14,1.313869,103.923624
458300,21,0,21,1.313883,103.923695
458301,16,2,18,1.313944,103.923611
458302,0,1,1,1.313752,103.92372
458304,109,2,111,1.314017,103.923672
458305,6,24,30,1.314074,103.923593
458307,6,0,6,1.314148,103.923583
458308,2,0,2,1.313791,103.923641
458309,1,13,14,1.314203,103.923572
458310,24,0,24,1.314209,103.923643
458311,6,3,9,1.314234,103.923697
458322,121,71,192,1.315647,103.925867
458323,1,0,1,1.313949,103.923684
458324,8,0,8,1.316167,103.926251
458325,8,1,9,1.316195,103.926235
458326,5,1,6,1.316218,103.926225
458329,15,36,51,1.315846,103.926435
458330,5,1,6,1.315862,103.926938
458331,2,0,2,1.31415,103.923651
458332,2,2,4,1.316203,103.926313
458333,6,0,6,1.316224,103.926304
458334,2,3,5,1.316247,103.926295
458335,2,1,3,1.313691,103.923731
458336,40,0,40,1.315878,103.926973
458337,2,0,2,1.316181,103.926324
458338,15,0,15,1.315915,103.927054
458340,11,5,16,1.316072,103.927204
458342,1,2,3,1.316267,103.92629
458344,10,8,18,1.316172,103.927419
458346,5,3,8,1.316229,103.927563
458347,0,11,11,1.316044,103.927345
458348,0,6,6,1.316324,103.927763
458349,5,0,5,1.316068,103.92739
458350,0,5,5,1.316379,103.927866
458352,0,4,4,1.316435,103.92799
458353,3,0,3,1.316127,103.927313
458354,4,8,12,1.316498,103.928128
458357,1,0,1,1.315827,103.926853
458358,1,2,3,1.316105,103.927496
458359,1,8,9,1.316206,103.927703
458360,71,0,71,1.316228,103.92775
458361,13,0,13,1.316258,103.927807
458362,29,3,32,1.316285,103.927865
458363,13,0,13,1.316313,103.927921
458364,6,0,6,1.31634,103.927983
458365,2,6,8,1.316366,103.928031
458366,59,0,59,1.316388,103.928083
458367,1,0,1,1.316168,103.927627
458368,0,3,3,1.316187,103.927668
458369,11,0,11,1.31646,103.928231
458370,2,2,4,1.316482,103.928282
458371,63,0,63,1.316515,103.928343
458376,1,0,1,1.316411,103.928129
458380,62,0,62,1.316707,103.928768
458382,20,1,21,1.315743,103.926678
458383,0,10,10,1.315718,103.926622
458384,1,6,7,1.315695,103.926549
458387,10,6,16,1.299509,103.837
458391,5,10,15,1.319537,103.926757
458392,1,6,7,1.319496,103.926417
458393,39,4,43,1.319519,103.926714
458394,0,1,1,1.316614,103.92857
458395,5,2,7,1.3195,103.926645
458396,0,3,3,1.316434,103.928177
458397,0,1,1,1.319467,103.926376
458398,7,0,7,1.319413,103.926278
458400,1,0,1,1.319469,103.926587
458401,14,0,14,1.319403,103.926456
458403,6,10,16,1.319372,103.926384
458406,2,2,4,1.319314,103.926051
458407,28,0,28,1.319308,103.926256
458408,1,1,2,1.315894,103.927015
458409,40,8,48,1.319275,103.926192
458410,241,0,241,1.319252,103.925921
458411,0,1,1,1.319392,103.926223
458412,60,1,61,1.319225,103.925868
458414,7,0,7,1.319194,103.925818
458415,0,3,3,1.31944,103.926332
458416,0,2,2,1.31928,103.925989
458417,1,1,2,1.319175,103.925765
458419,7,8,15,1.31913,103.925901
458420,0,1,1,1.319246,103.926141
458421,4,5,9,1.319104,103.925866
458423,0,4,4,1.319081,103.925822
458424,0,1,1,1.319126,103.925688
458425,2,11,13,1.319046,103.925782
458426,20,0,20,1.318827,103.925355
458427,0,4,4,1.318794,103.925378
458429,1,13,14,1.318858,103.925314
458430,3,18,21,1.319013,103.925474
458431,29,47,76,1.318863,103.925217
458432,46,26,72,1.318871,103.925129
458433,9,73,82,1.318876,103.925036
458434,2,6,8,1.318881,103.924947
458435,1,21,22,1.31889,103.924861
458436,882,68,950,1.319773,103.923725
458437,1,1,2,1.31915,103.925962
458438,0,5,5,1.319112,103.923128
458439,1,15,16,1.318898,103.924713
458440,117,20,137,1.31912,103.923058
458441,2,11,13,1.318906,103.924636
458442,4,0,4,1.319129,103.922974
458443,0,7,7,1.318913,103.924558
458444,9,7,16,1.319133,103.922893
458445,194,31,225,1.318919,103.924478
458446,27,10,37,1.31914,103.922808
458447,7,0,7,1.318928,103.924404
458448,0,4,4,1.319149,103.922723
458449,3,14,17,1.31893,103.924345
458450,1,1,2,1.318896,103.924783
458451,2,15,17,1.31893,103.924273
458452,10,27,37,1.319151,103.922465
458453,6,103,109,1.318938,103.924197
458454,4,2,6,1.31894,103.92414
458455,5,1,6,1.318941,103.92408
458456,8,56,64,1.318943,103.924031
458457,1,30,31,1.318952,103.92397
458458,0,16,16,1.318958,103.923892
458459,26,18,44,1.318965,103.923841
458460,9,1,10,1.318969,103.923781
458461,7,0,7,1.318971,103.923729
458462,14,21,35,1.31898,103.923664
458463,4,1,5,1.31899,103.923593
458464,1,8,9,1.318997,103.923526
458465,0,2,2,1.319139,103.922579
458466,7,2,9,1.319004,103.923402
458467,12,10,22,1.31901,103.923332
458468,1,5,6,1.319016,103.92325
458469,0,2,2,1.319002,103.923463
458470,13,14,27,1.319024,103.923109
458471,0,25,25,1.319029,103.923049
458472,4,6,10,1.319033,103.922966
458473,45,2,47,1.31904,103.922871
458474,0,18,18,1.319181,103.922216
458475,4,6,10,1.319046,103.922794
458476,3,0,3,1.319183,103.926018
458477,14,2,16,1.319049,103.922702
458478,19,2,21,1.319216,103.921828
458479,6,14,20,1.319053,103.922639
458480,14,5,19,1.31941,103.921742
458481,0,1,1,1.319069,103.925585
458482,3,2,5,1.319922,103.921777
458483,66,1,67,1.319799,103.921812
458485,1,0,1,1.319059,103.922537
458487,2,0,2,1.31902,103.923178
458488,26,0,26,1.319857,103.921676
458490,19,10,29,1.319065,103.922431
458491,4,0,4,1.319717,103.921724
458492,40,10,50,1.31907,103.922355
458493,217,3,220,1.319547,103.921696
458494,50,2,52,1.319077,103.922244
458495,5,0,5,1.319628,103.921268
458496,12,0,12,1.319656,103.921234
458497,10,0,10,1.319616,103.921219
458498,24,32,56,1.31909,103.922105
458499,2,1,3,1.319207,103.92203
458500,5,0,5,1.319573,103.921286
458501,4,1,5,1.319519,103.921303
458502,1,0,1,1.319872,103.921792
458504,8,0,8,1.319409,103.921361
458505,111,20,131,1.319357,103.921379
458506,47,1,48,1.318795,103.921858
458507,0,1,1,1.318976,103.921936
458508,33,41,74,1.319301,103.921384
458509,24,1,25,1.318514,103.921673
458510,19,2,21,1.318483,103.921648
458511,0,2,2,1.319899,103.921674
458512,11,1,12,1.318415,103.92158
458514,6,9,15,1.318358,103.921542
458515,0,20,20,1.31833,103.921522
458518,10,12,22,1.318974,103.921716
458519,0,11,11,1.319151,103.92144
458520,0,6,6,1.319126,103.921235
458521,5,1,6,1.319093,103.9212
458522,28,0,28,1.318891,103.920979
458523,0,3,3,1.319581,103.921241
458524,0,4,4,1.318924,103.921011
458525,0,5,5,1.318895,103.921011
458526,16,16,32,1.318953,103.921038
458527,69,19,88,1.319673,103.921674
458528,6,33,39,1.319618,103.921669
458529,4,11,15,1.319699,103.921792
458530,73,4,77,1.319631,103.921777
458531,3,0,3,1.318979,103.921061
458532,51,24,75,1.319337,103.921468
458533,34,1,35,1.319387,103.921458
458534,6,59,65,1.309682,103.924541
458535,5,24,29,1.310144,103.924308
458536,20,0,20,1.309694,103.924608
458538,11,18,29,1.309712,103.924663
458539,8,2,10,1.310053,103.924337
458540,1,0,1,1.318754,103.921826
458541,1,2,3,1.319277,103.921475
458542,8,47,55,1.309747,103.924765
458543,1,5,6,1.309942,103.924374
458544,1,0,1,1.309729,103.92471
458546,9,29,38,1.309782,103.924876
458547,208,26,234,1.309817,103.924416
458548,25,0,25,1.309804,103.924935
458549,26,7,33,1.309767,103.924427
458550,5,8,13,1.309823,103.924993
458551,1,5,6,1.309723,103.924448
458552,3,37,40,1.309679,103.924468
458553,477,325,802,1.309606,103.924617
458554,310,1083,1393,1.309636,103.92469
458555,696,0,696,1.309659,103.924748
458556,532,0,532,1.30968,103.924809
458557,5,111,116,1.309706,103.924873
458558,1,0,1,1.30977,103.924818
458559,7,8,15,1.309858,103.925118
458568,35,5,40,1.312588,103.921271
458569,18,1,19,1.312735,103.921346
458570,2,7,9,1.313082,103.921721
458571,14,0,14,1.312789,103.921478
458572,5,1,6,1.313219,103.921665
458573,27,0,27,1.312839,103.921595
458574,8,0,8,1.313371,103.921612
458575,1,0,1,1.309844,103.925054
458576,11,0,11,1.312892,103.921718
458577,1,1,2,1.31845,103.921603
458578,168,3,171,1.313294,103.921815
458579,13,0,13,1.312996,103.921974
458580,6,10,16,1.313161,103.92187
458581,7,2,9,1.313049,103.922105
458582,54,40,94,1.313305,103.922175
458583,0,6,6,1.313106,103.922225
458584,1,24,25,1.313418,103.922117
458585,2,0,2,1.312938,103.921841
458586,9,3,12,1.313529,103.922069
458587,20,0,20,1.31319,103.922467
458588,126,3,129,1.313577,103.922158
458590,10,12,22,1.313459,103.922221
458591,11,2,13,1.313314,103.922728
458592,58,41,99,1.313335,103.922271
458593,9,3,12,1.313367,103.922846
458594,0,43,43,1.313454,103.923003
458595,14,6,20,1.313526,103.922798
458597,0,4,4,1.313392,103.92291
458598,0,5,5,1.299509,103.837
458607,0,21,21,1.320042,103.926265
458608,5,17,22,1.32009,103.926201
458609,5,0,5,1.320016,103.926213
458610,15,1,16,1.320065,103.926139
458611,13,0,13,1.31999,103.926171
458614,0,1,1,1.313415,103.921721
458615,0,1,1,1.320013,103.926034
458616,4,1,5,1.319987,103.925985
458618,0,2,2,1.313154,103.922356
458619,0,1,1,1.319939,103.92606
458620,20,0,20,1.31987,103.925932
458621,0,1,1,1.319941,103.925888
458622,1,1,2,1.319965,103.925939
458623,2,1,3,1.309998,103.924357
458625,0,3,3,1.319888,103.925781
458626,13,1,14,1.319784,103.925761
458627,2,2,4,1.319838,103.925673
458628,76,4,80,1.319758,103.925718
458629,0,7,7,1.31981,103.925612
458630,5,7,12,1.319732,103.925659
458631,75,9,84,1.319785,103.925557
458632,16,0,16,1.319707,103.925607
458633,0,13,13,1.319756,103.925495
458634,4,6,10,1.319681,103.925548
458635,4,8,12,1.319733,103.925444
458636,1,0,1,1.319912,103.92583
458637,0,8,8,1.319717,103.925403
458638,0,4,4,1.319621,103.925437
458639,0,3,3,1.319867,103.925731
458640,2,0,2,1.319844,103.925872
458641,3,1,4,1.319671,103.925303
458642,2,0,2,1.319595,103.925385
458643,114,13,127,1.319636,103.925235
458644,8,11,19,1.319543,103.925283
458655,11,62,73,1.312037,103.931384
458656,131,9,140,1.312036,103.931383
458657,4,7,11,1.312037,103.931364
458658,15,3,18,1.31197,103.93139
458659,2,2,4,1.31197,103.93137
458660,158,2,160,1.311836,103.931403
458661,2,1,3,1.319688,103.925352
458663,30,1,31,1.311702,103.931395
458664,3,2,5,1.311568,103.931427
458665,5,2,7,1.311568,103.931407
458666,3,0,3,1.311836,103.931383
458667,1,4,5,1.311434,103.93142
458668,0,1,1,1.319646,103.925488
458669,2,1,3,1.311434,103.93144
458670,2,1,3,1.311167,103.931464
458671,17,2,19,1.311033,103.931476
458672,4,0,4,1.311033,103.931456
458673,28,0,28,1.310899,103.931489
458674,7,3,10,1.310899,103.931469
458675,9,3,12,1.310775,103.931491
458676,0,150,150,1.310765,103.931481
458677,5,7,12,1.312036,103.931383
458686,220,57,277,1.310783,103.930032
458688,1,0,1,1.311301,103.931432
458690,3,22,25,1.312019,103.929956
458691,1,0,1,1.311986,103.929709
458693,20,1,21,1.312035,103.930235
458694,11,15,26,1.312053,103.930514
458695,2,0,2,1.319569,103.925334
458696,36,142,178,1.312069,103.930793
458697,4,14,18,1.312068,103.930792
458698,70,12,82,1.312085,103.931072
458699,5,28,33,1.312084,103.931071
458700,0,51,51,1.311997,103.929895
458701,0,5,5,1.311998,103.929926
458702,0,33,33,1.312,103.929957
458703,371,19,390,1.311489,103.930917
458704,451,33,484,1.311471,103.930626
458705,439,24,463,1.31124,103.930645
458706,191,7,198,1.310958,103.930644
458707,208,4,212,1.310729,103.930679
458708,244,2717,2961,1.310483,103.930669
458709,472,69,541,1.310612,103.931003
458710,327,5,332,1.310988,103.931017
458711,53,0,53,1.311227,103.931026
458712,0,3,3,1.311167,103.931444
458713,0,7,7,1.31202,103.930298
458714,0,2,2,1.312052,103.930513
458716,0,3,3,1.312018,103.930267
458717,1,3,4,1.312027,103.930421
458718,3,6,9,1.312029,103.930452
458719,4,6,10,1.312031,103.930483
458720,0,5,5,1.312033,103.930514
458721,2,1,3,1.312025,103.93039
458722,0,5,5,1.312036,103.930576
458723,0,2,2,1.312022,103.930329
458724,1,2,3,1.312034,103.930545
458725,0,3,3,1.31204,103.930638
458728,1,6,7,1.312047,103.930762
458729,0,3,3,1.312042,103.930669
458731,0,3,3,1.312049,103.930793
458732,0,5,5,1.312054,103.930886
458733,1,5,6,1.312056,103.930917
458734,52,2,54,1.312035,103.930235
458735,3,137,140,1.312058,103.930948
458736,3,1,4,1.31206,103.930979
458737,10,1,11,1.312061,103.93101
458738,106,0,106,1.312063,103.931041
458739,0,3,3,1.312052,103.930855
458745,1,2,3,1.312065,103.931072
458746,4,0,4,1.315615,103.925081
458747,1,0,1,1.312019,103.929956
458748,31,0,31,1.315604,103.925
458749,0,3,3,1.31515,103.925245
458750,14,0,14,1.315592,103.924919
458751,1,0,1,1.31522,103.925234
458754,7,0,7,1.315569,103.924758
458755,5,0,5,1.315685,103.925166
458757,48,5,53,1.315546,103.924596
458758,2,1,3,1.315359,103.925214
458759,8,12,20,1.315534,103.924515
458760,6,2,8,1.315926,103.925136
458761,68,12,80,1.315561,103.924561
458762,5,0,5,1.316022,103.925123
458763,15,0,15,1.315567,103.924607
458764,3,1,4,1.316119,103.925111
458765,4,2,6,1.315581,103.9247
458766,4,7,11,1.316215,103.925099
458767,22,0,22,1.315594,103.924792
458768,1,4,5,1.316312,103.925567
458769,8,1,9,1.316311,103.925566
458771,7,0,7,1.316294,103.925472
458772,1,0,1,1.315498,103.925193
458774,39,0,39,1.31626,103.92528
458775,77,0,77,1.316259,103.925279
458776,0,3,3,1.31583,103.925148
458777,31,0,31,1.316225,103.925089
458778,5,0,5,1.315647,103.925162
458779,5,0,5,1.316225,103.925089
458780,10,0,10,1.316224,103.925088
458781,0,1,1,1.316293,103.925471
458783,7,0,7,1.316185,103.924832
458784,4,7,11,1.316194,103.925016
458787,2,4,6,1.316146,103.924575
458788,3,0,3,1.315634,103.92507
458789,1,1,2,1.312038,103.930607
458791,4,0,4,1.316172,103.924869
458792,1,4,5,1.316512,103.924507
458793,2,0,2,1.316324,103.924546
458794,3,0,3,1.316183,103.924942
458795,11,4,15,1.316887,103.924428
458796,7,1,8,1.316886,103.924427
458797,2,14,16,1.316149,103.924723
458798,9,2,11,1.317262,103.924349
458799,4,9,13,1.317261,103.924348
458800,2,6,8,1.316138,103.924649
458801,8,1,9,1.317182,103.924346
458802,2,0,2,1.316511,103.924506
458803,7,1,8,1.316127,103.924576
458804,2,1,3,1.31616,103.924796
458805,1,0,1,1.316199,103.925052
458806,5,0,5,1.316941,103.924397
458807,2,0,2,1.317181,103.924345
458808,9,0,9,1.316619,103.924464
458809,124,0,124,1.316458,103.924498
458810,2,0,2,1.31678,103.924431
458811,1,1,2,1.316298,103.924532
458812,0,3,3,1.317101,103.924363
458818,0,1,1,1.3171,103.924362
458822,6,0,6,1.31474,103.922824
458823,12,0,12,1.314722,103.92283
458824,0,5,5,1.314749,103.922863
458825,10,0,10,1.314731,103.922875
458827,3,0,3,1.299509,103.837
458828,6,0,6,1.314783,103.923022
458829,2,6,8,1.31477,103.923058
458830,4,1,5,1.314799,103.923101
458832,15,3,18,1.314816,103.92318
458833,1,0,1,1.299509,103.837
458836,0,2,2,1.316137,103.924566
458837,9,8,17,1.314848,103.923424
458838,2,0,2,1.31485,103.923339
458839,2,1,3,1.314751,103.922967
458840,19,0,19,1.314884,103.923497
458841,39,0,39,1.314887,103.923607
458842,9,6,15,1.314901,103.923577
458843,6,7,13,1.314907,103.923699
458844,46,0,46,1.314918,103.923656
458846,2,4,6,1.314934,103.923735
458847,0,1,1,1.314809,103.923241
458848,1,5,6,1.314951,103.923814
458849,0,8,8,1.314965,103.923973
458851,18,0,18,1.31498,103.924058
458852,42,3,45,1.314985,103.923973
458853,15,0,15,1.314995,103.924144
458855,4,0,4,1.315025,103.924315
458856,3,0,3,1.314868,103.923516
458857,0,40,40,1.315032,103.924414
458858,3,0,3,1.315015,103.924144
458859,17,0,17,1.315027,103.924592
458861,7,0,7,1.315027,103.924637
458862,2,2,4,1.315047,103.924592
458863,1,4,5,1.315028,103.924682
458865,1,11,12,1.315028,103.924863
458866,2,0,2,1.314867,103.923418
458867,33,0,33,1.314518,103.92556
458868,48,0,48,1.314534,103.92545
458870,14,0,14,1.315028,103.924952
458871,69,0,69,1.315028,103.924952
458872,2,0,2,1.315029,103.924953
458873,5,0,5,1.315028,103.924952
458874,0,1,1,1.314946,103.923882
458875,32,5,37,1.31504,103.925026
458876,4,1,5,1.315047,103.924618
458877,6,0,6,1.31505,103.925099
458878,33,7,40,1.315047,103.924644
458879,1,0,1,1.315034,103.92499
458880,0,1,1,1.31506,103.925172
458881,3,0,3,1.315045,103.924315
458882,40,4,44,1.315048,103.924747
458883,2,0,2,1.315028,103.924952
458884,4,0,4,1.315048,103.924798
458885,1,1,2,1.315081,103.925294
458886,63,3,66,1.315048,103.92485
458888,2,0,2,1.31509,103.925342
458889,20,0,20,1.315129,103.925537
458890,0,2,2,1.315049,103.924901
458891,1,1,2,1.315049,103.924953
458892,3,4,7,1.315099,103.925287
458893,11,0,11,1.315168,103.925732
458894,1,0,1,1.315048,103.924695
458895,23,5,28,1.315187,103.925829
458897,0,4,4,1.315141,103.925495
458898,7,0,7,1.315157,103.925579
458899,4,0,4,1.315174,103.925662
458900,3,0,3,1.315071,103.925245
458901,1,20,21,1.315207,103.925829
458912,1,0,1,1.315108,103.925328
458913,34,0,34,1.31039,103.921436
458916,0,2,2,1.315148,103.925634
458917,103,0,103,1.310492,103.921697
458918,0,9,9,1.310809,103.922248
458919,17,18,35,1.310836,103.922298
458920,49,6,55,1.310769,103.922723
458921,7,2,9,1.310769,103.922723
458922,44,1,45,1.310855,103.922343
458923,16,0,16,1.310644,103.922781
458924,0,1,1,1.310451,103.921372
458925,10,1,11,1.310547,103.922829
458926,3,2,5,1.310556,103.922908
458927,2,0,2,1.310613,103.921593
458928,3,0,3,1.31519,103.925746
458929,10,5,15,1.310799,103.922831
458931,70,0,70,1.311018,103.923077
458932,0,1,1,1.310644,103.922781
458933,2,1,3,1.310678,103.922866
458934,5,0,5,1.310932,103.922557
458935,2,0,2,1.310879,103.922405
458938,5,2,7,1.310965,103.922638
458939,4,0,4,1.310985,103.922702
458941,5,0,5,1.311037,103.922809
458942,0,1,1,1.310914,103.922511
458944,6,0,6,1.311098,103.922986
458945,21,3,24,1.31114,103.923061
458946,4,9,13,1.311171,103.923458
458947,3,0,3,1.311057,103.923172
458949,424,3,427,1.311323,103.923744
458950,475,10,485,1.311521,103.923983
458951,2,0,2,1.311112,103.923292
458952,0,75,75,1.31156,103.924104
458953,0,1,1,1.311051,103.922853
458955,4,104,108,1.311248,103.923643
458965,200,470,670,1.310091,103.91829
458966,1315,91,1406,1.309733,103.917797
458967,90,27,117,1.309495,103.9186
458968,1705,223,1928,1.309495,103.9186
458969,1664,593,2257,1.308451,103.91838
458970,1858,501,2359,1.308261,103.919021
458972,9,44,53,1.310351,103.918754
458973,1,362,363,1.310372,103.918811
458974,3,133,136,1.31039,103.918868
458976,0,53,53,1.310458,103.918987
458977,1,27,28,1.310487,103.919061
458978,0,32,32,1.310516,103.91913
458979,1,57,58,1.310544,103.919198
458980,1,0,1,1.31156,103.924104
458981,1,9,10,1.310607,103.919323
458982,0,201,201,1.310642,103.919386
458983,3,0,3,1.311194,103.923526
458984,19,352,371,1.310696,103.91949
458985,10,20,30,1.310705,103.919532
458986,26,4,30,1.310722,103.919577
458987,8,98,106,1.310745,103.919612
458988,7,0,7,1.310768,103.91965
458989,1,41,42,1.310781,103.919697
458990,6,0,6,1.310795,103.919727
458991,5,0,5,1.310818,103.919763
458992,4,647,651,1.310835,103.919803
458993,2,0,2,1.31156,103.924104
458994,4,50,54,1.310872,103.919893
458995,38,514,552,1.311115,103.920374
458996,45,193,238,1.311332,103.920777
458997,5,0,5,1.311337,103.92083
458998,25,2,27,1.311344,103.920921
458999,3,2,5,1.311357,103.920996
459000,78,32,110,1.31136,103.921078
459001,30,45,75,1.311375,103.921125
459002,2,39,41,1.311395,103.921224
459003,8,77,85,1.311372,103.921352
459004,0,19,19,1.311136,103.921556
459005,1,3,4,1.311407,103.921439
459007,5,885,890,1.311431,103.921614
459008,2,40,42,1.311355,103.921908
459009,8,1,9,1.311357,103.921911
459010,109,0,109,1.311359,103.921917
459012,19,565,584,1.311365,103.92193
459013,1,343,344,1.310178,103.917867
459015,1,0,1,1.310573,103.919266
459016,2,0,2,1.310849,103.919852
459017,7,37,44,1.310373,103.918256
459018,3,27,30,1.311373,103.921948
459019,7,2,9,1.310409,103.918363
459020,5,44,49,1.311376,103.921954
459021,3,67,70,1.310451,103.918447
459022,7,5,12,1.311378,103.92196
459023,17,204,221,1.310548,103.918658
459024,9,9,18,1.311452,103.92264
459025,1,34,35,1.310659,103.91891
459026,0,13,13,1.311499,103.922693
459027,2,0,2,1.31137,103.921942
459028,2,19,21,1.311495,103.922708
459029,62,89,151,1.310821,103.919292
459030,26,2,28,1.311532,103.922785
459031,9,0,9,1.310874,103.919388
459032,0,72,72,1.311559,103.922822
459033,0,31,31,1.310903,103.919477
459034,18,27,45,1.310949,103.9195
459035,4,57,61,1.311575,103.922888
459036,1,17,18,1.31095,103.919587
459037,0,11,11,1.310987,103.919634
459038,2,6,8,1.31103,103.919753
459039,3,68,71,1.311064,103.919792
459041,10,0,10,1.311069,103.919842
459042,1,0,1,1.310219,103.917943
459043,2,0,2,1.310726,103.919058
459044,4,176,180,1.311289,103.920255
459045,3,120,123,1.311397,103.920683
459046,13,0,13,1.311409,103.920767
459047,1,50,51,1.311415,103.920848
459048,1,0,1,1.311087,103.919907
459049,0,17,17,1.311424,103.920993
459050,29,17,46,1.311757,103.921004
459051,6,452,458,1.311476,103.921326
459052,16,61,77,1.311833,103.921574
459053,1,0,1,1.31142,103.920918
459054,86,503,589,1.3118,103.921656
459055,60,0,60,1.311818,103.921744
459056,25,237,262,1.311549,103.921646
459057,91,1515,1606,1.311589,103.92185
459058,23,224,247,1.311634,103.921975
459059,122,491,613,1.311679,103.92209
459060,163,401,564,1.311697,103.922154
459061,44,0,44,1.311731,103.922229
459062,61,2385,2446,1.31178,103.922376
459063,84,13,97,1.31181,103.922462
459064,70,1883,1953,1.31176,103.922297
459065,39,0,39,1.311832,103.922528
459066,17,117,134,1.311856,103.922583
459067,29,290,319,1.311889,103.922644
459068,11,270,281,1.312248,103.922694
459069,36,329,365,1.311944,103.922778
459070,15,2,17,1.311917,103.922713
459071,226,0,226,1.311991,103.922903
459072,69,1514,1583,1.312032,103.922996
459073,13,866,879,1.312307,103.922976
459080,28,0,28,1.31273,103.924794
459082,1,654,655,1.312622,103.923612
459084,5,0,5,1.312625,103.923672
459088,6,0,6,1.31265,103.923778
459090,0,2,2,1.311134,103.920013
459092,12,92,104,1.312892,103.923977
459094,14,261,275,1.312673,103.923899
459096,21,223,244,1.31269,103.92399
459098,12,137,149,1.312724,103.924052
459100,84,63,147,1.312726,103.924202
459102,17,67,84,1.31276,103.924365
459104,17,18,35,1.312699,103.924046
459106,19,457,476,1.312734,103.924261
459107,530,296,826,1.312747,103.924313
459108,234,1152,1386,1.312499,103.924427
459109,92,214,306,1.312531,103.924661
459111,21,2008,2029,1.312551,103.924714
459113,35,685,720,1.31256,103.924765
459114,4,0,4,1.312569,103.924818
459115,74,1830,1904,1.312579,103.924869
459116,1,0,1,1.311568,103.921788
459117,38,1580,1618,1.312594,103.924974
459118,24,1321,1345,1.312613,103.925018
459119,2,31,33,1.312015,103.924781
459120,0,3,3,1.310653,103.919448
459121,3,11,14,1.312015,103.924781
459122,9,0,9,1.312015,103.924781
459123,9,4,13,1.312015,103.924781
459124,126,1,127,1.312015,103.924781
459125,43,0,43,1.312049,103.924956
459126,0,4,4,1.312049,103.924956
459128,2,515,517,1.312049,103.924956
459129,27,100,127,1.312095,103.925121
459130,0,8,8,1.310266,103.918012
459132,0,16,16,1.310322,103.918167
459133,34,37,71,1.310587,103.918747
459134,3,55,58,1.310497,103.918531
459135,401,146,547,1.309929,103.918611
459140,53,4,57,1.310856,103.922005
459141,1,9,10,1.310597,103.922307
459142,0,4,4,1.310618,103.922139
459143,2,0,2,1.312655,103.923835
459144,2,5,7,1.310473,103.922344
459145,6,0,6,1.310439,103.922197
459146,34,0,34,1.310345,103.922229
459147,1,7,8,1.310333,103.922398
459148,1,0,1,1.312588,103.924926
459149,1,0,1,1.310257,103.922255
459150,3,1,4,1.310096,103.922468
459151,8,0,8,1.31004,103.922333
459152,7,9,16,1.309988,103.9225
459153,2,1,3,1.312015,103.924781
459154,4,16,20,1.30988,103.922532
459155,0,46,46,1.309798,103.922417
459156,7,3,10,1.309799,103.92257
459157,9,24,33,1.30967,103.922472
459158,1,10,11,1.309707,103.922602
459159,2,3,5,1.310209,103.922441
459160,14,0,14,1.299509,103.837
459161,11,1,12,1.299509,103.837
459162,3,0,3,1.309937,103.922374
459168,303,0,303,1.299509,103.837
459170,467,27,494,1.309294,103.922101
459172,35,0,35,1.30974,103.923171
459173,31,0,31,1.309764,103.922927
459175,13,0,13,1.309764,103.922927
459176,2,8,10,1.30945,103.922443
459177,1,0,1,1.31018,103.922284
459178,1,0,1,1.30983,103.923386
459179,2,1,3,1.299509,103.837
459180,5,1,6,1.308633,103.923032
459181,4,1,5,1.308632,103.923031
459182,1,5,6,1.308632,103.923031
459183,32,393,425,1.308632,103.923031
459184,4,2560,2564,1.308754,103.923208
459185,38,0,38,1.308803,103.923158
459186,0,2,2,1.310533,103.922171
459187,173,5,178,1.309051,103.92302
459188,6,0,6,1.309459,103.922452
459189,1,0,1,1.309117,103.922582
459190,1,14,15,1.309519,103.922613
459191,9,7,16,1.309518,103.922612
459192,2,0,2,1.308961,103.923068
459193,0,1,1,1.309459,103.922452
459194,1,11,12,1.30972,103.923171
459195,0,2,2,1.309518,103.922612
459196,2,1,3,1.30991,103.923592
459197,0,1,1,1.309518,103.922612
459198,4,3,7,1.309073,103.923236
459199,53,1,54,1.308989,103.923286
459201,4,895,899,1.308758,103.923348
459202,0,8,8,1.30973,103.923181
459203,74,2,76,1.309729,103.92318
459204,12,0,12,1.309729,103.92318
459205,0,1,1,1.309719,103.92317
459206,1,3,4,1.30918,103.923582
459207,2,0,2,1.309719,103.92317
459208,1,0,1,1.309729,103.92318
459209,0,142,142,1.308829,103.923701
459210,3,11,14,1.3099,103.923602
459211,4,9,13,1.309899,103.923601
459212,8,1,9,1.309276,103.923709
459213,0,4,4,1.309206,103.923781
459214,7,82,89,1.308843,103.92393
459215,5,276,281,1.308882,103.924005
459216,2,411,413,1.308895,103.924149
459217,7,0,7,1.308949,103.924168
459218,3,835,838,1.308962,103.924229
459219,10,1955,1965,1.308992,103.924296
459220,20,3,23,1.309211,103.924086
459221,4,0,4,1.309268,103.924102
459222,1,0,1,1.308922,103.923713
459224,18,1,19,1.309027,103.923988
459225,12,1,13,1.309026,103.923987
459226,1,3,4,1.309026,103.923987
459227,1,4,5,1.309026,103.923987
459228,55,2,57,1.30991,103.923612
459230,4,44,48,1.310029,103.923701
459231,8,8,16,1.310213,103.924374
459232,246,4,250,1.31009,103.923676
459233,28,7,35,1.310233,103.924419
459234,6,6,12,1.310211,103.923625
459235,1,0,1,1.309337,103.924082
459236,10,0,10,1.310323,103.923584
459237,3,5,8,1.310314,103.924602
459238,1,0,1,1.310273,103.924511
459239,10,0,10,1.310354,103.924693
459240,28,16,44,1.310211,103.923645
459241,9,4,13,1.310394,103.924785
459242,73,0,73,1.31009,103.923696
459243,49,0,49,1.310434,103.924876
459244,13,3,16,1.309978,103.923737
459245,3,0,3,1.309719,103.92317
459246,257,2,259,1.310245,103.9244
459249,1,0,1,1.310272,103.92362
459250,0,18,18,1.310402,103.924759
459253,1,0,1,1.310339,103.924615
459254,8,251,259,1.310645,103.925323
459255,32,0,32,1.309909,103.923611
459256,5,4,9,1.309909,103.923611
459257,43,21,64,1.309909,103.923611
459258,0,2,2,1.309077,103.923606
459259,117,2,119,1.310595,103.925242
459260,7,1,8,1.310635,103.925333
459261,34,1,35,1.309117,103.922582
459262,9,0,9,1.309117,103.922582
459263,4,0,4,1.309117,103.922582
459264,7,0,7,1.309117,103.922582
459265,5,338,343,1.310297,103.917557
459266,3,2,5,1.310158,103.917768
459267,3,2,5,1.310737,103.917638
459268,18,0,18,1.310787,103.917592
459269,0,4,4,1.310839,103.917574
459270,3,5,8,1.310906,103.91758
459271,5,10,15,1.31098,103.917554
459272,120,40,160,1.310996,103.917529
459273,1,0,1,1.310592,103.925189
459275,12,0,12,1.310547,103.91744
459276,2,1,3,1.310474,103.924968
459277,13,0,13,1.31132,103.917287
459278,24,0,24,1.311401,103.917245
459279,2,0,2,1.310555,103.92515
459280,21,2,23,1.310757,103.917356
459281,18,10,28,1.311484,103.917202
459282,1,2,3,1.310606,103.917416
459283,4,0,4,1.311679,103.917148
459284,35,0,35,1.311734,103.917118
459285,24,1,25,1.310875,103.917314
459286,177,0,177,1.310999,103.917256
459287,12,0,12,1.31179,103.917077
459288,1,5,6,1.311096,103.917243
459289,22,6,28,1.311166,103.917203
459290,15,5,20,1.311905,103.917021
459291,2,0,2,1.310706,103.917371
459292,1,0,1,1.31039,103.917499
459293,7,0,7,1.312035,103.916952
459294,0,2,2,1.311253,103.917132
459295,47,13,60,1.311485,103.91701
459296,2,4,6,1.312137,103.916916
459298,3,24,27,1.311678,103.916957
459299,2,0,2,1.311438,103.917027
459300,0,3,3,1.311545,103.917183
459301,18,0,18,1.312022,103.916839
459302,89,0,89,1.31249,103.916899
459303,0,6,6,1.312439,103.916928
459304,4,8,12,1.312133,103.916773
459305,7,0,7,1.312187,103.916752
459308,240,0,240,1.313015,103.91667
459309,17,4,21,1.313105,103.91663
459310,0,4,4,1.313172,103.916562
459311,132,3,135,1.31233,103.916719
459312,2,0,2,1.312229,103.91683
459313,4,0,4,1.313263,103.91651
459314,22,1,23,1.312483,103.916643
459315,47,0,47,1.31257,103.916581
459316,8,0,8,1.313445,103.916424
459317,7,1,8,1.312669,103.916577
459318,1,0,1,1.311362,103.917086
459319,5,7,12,1.31359,103.916395
459320,7,0,7,1.312773,103.916505
459321,1,0,1,1.312723,103.916548
459322,27,0,27,1.313672,103.916282
459323,71,2,73,1.313719,103.916263
459325,10,0,10,1.313028,103.916389
459326,2,0,2,1.312363,103.916693
459327,23,0,23,1.313119,103.916368
459328,15,6,21,1.314007,103.916082
459329,16,8,24,1.314007,103.916082
459330,7,2,9,1.313247,103.916308
459331,6,1,7,1.313331,103.916262
459332,2,1,3,1.311989,103.916864
459333,48,1,49,1.314143,103.915998
459335,1,1,2,1.313891,103.916194
459336,7,25,32,1.314905,103.915873
459337,23,0,23,1.313428,103.916226
459338,6,0,6,1.314952,103.915756
459339,9,0,9,1.314952,103.915756
459340,2,0,2,1.314862,103.915892
459341,2,1,3,1.314143,103.915998
459342,0,2,2,1.31362,103.916156
459343,2,0,2,1.313803,103.916128
459344,2,0,2,1.315088,103.916051
459345,23,0,23,1.315178,103.916248
459346,1,0,1,1.312846,103.916479
459347,26,0,26,1.314133,103.915988
459348,2,0,2,1.313973,103.916053
459349,10,0,10,1.314272,103.915923
459350,24,0,24,1.315358,103.916642
459352,2,4,6,1.315449,103.916838
459353,4,0,4,1.314659,103.915758
459354,14,0,14,1.314659,103.915758
459355,28,0,28,1.315539,103.917035
459356,0,2,2,1.315268,103.916445
459358,5,0,5,1.315629,103.917232
459359,4,0,4,1.314917,103.915648
459360,9,0,9,1.314917,103.915648
459363,2,1,3,1.314997,103.915855
459364,1,7,8,1.31581,103.917625
459365,34,0,34,1.314968,103.915747
459366,4,0,4,1.315009,103.915837
459368,4,0,4,1.314885,103.918042
459369,1,0,1,1.314133,103.915988
459370,22,0,22,1.315173,103.916194
459371,2,6,8,1.314754,103.918097
459372,65,0,65,1.314754,103.918097
459373,6,1,7,1.315255,103.916373
459374,16,0,16,1.315255,103.916373
459377,72,13,85,1.315337,103.916552
459379,2,4,6,1.314234,103.918317
459380,3,0,3,1.315231,103.915491
459381,7,0,7,1.313973,103.918427
459382,2,0,2,1.314907,103.915658
459383,2,1,3,1.31542,103.916731
459384,7,10,17,1.313712,103.918537
459385,1,0,1,1.314885,103.918042
459386,1,0,1,1.313712,103.918537
459387,7,13,20,1.315666,103.917267
459389,0,1,1,1.315584,103.917089
459390,70,3,73,1.313282,103.918719
459392,51,0,51,1.313111,103.918791
459393,25,3,28,1.315729,103.917672
459394,4,0,4,1.312941,103.918863
459395,3,0,3,1.315502,103.91691
459396,5,1,6,1.315629,103.917718
459397,9,0,9,1.31277,103.918935
459398,81,1,82,1.315428,103.917811
459400,1,0,1,1.315748,103.917446
459401,4,3,7,1.312599,103.919007
459403,4,1,5,1.312429,103.91908
459404,36,0,36,1.315025,103.917997
459405,9,0,9,1.312259,103.919152
459406,2,0,2,1.313973,103.918427
459407,26,12,38,1.314937,103.91804
459408,2,0,2,1.314937,103.91804
459409,79,0,79,1.314859,103.918073
459410,2,0,2,1.312088,103.919224
459411,3,0,3,1.315629,103.917718
459412,1,0,1,1.312599,103.919007
459413,0,3,3,1.311918,103.919296
459414,1,0,1,1.314702,103.918139
459415,1,16,17,1.314234,103.918337
459416,4,0,4,1.314077,103.918403
459417,2,11,13,1.313921,103.918469
459419,51,0,51,1.313765,103.918535
459420,49,0,49,1.313764,103.918534
459423,3,1,4,1.313462,103.918657
459424,26,6,32,1.313461,103.918656
459425,39,5,44,1.313375,103.918699
459426,37,0,37,1.313299,103.918732
459427,4,4,8,1.313145,103.918797
459428,25,0,25,1.313144,103.918796
459429,23,1,24,1.312992,103.918862
459430,3,0,3,1.314546,103.918205
459431,6,0,6,1.312838,103.918927
459432,2,0,2,1.314859,103.918073
459433,0,1,1,1.31439,103.918271
459435,34,22,56,1.312378,103.919121
459436,90,11,101,1.312225,103.919186
459437,2,1,3,1.312991,103.918861
459438,25,1,26,1.311928,103.919306
459439,2,9,11,1.313452,103.918647
459440,1,19,20,1.313452,103.918647
459441,2,0,2,1.312837,103.918926
459442,3,3,6,1.315091,103.916016
459443,1,0,1,1.312685,103.918992
459444,3,3,6,1.313481,103.916199
459445,7,1,8,1.313374,103.918698
459447,0,6,6,1.315025,103.917997
459448,5,0,5,1.315226,103.917904
459449,0,22,22,1.316735,103.921167
459450,1,0,1,1.315268,103.916445
459451,6,0,6,1.316611,103.921216
459452,5,0,5,1.316528,103.921248
459453,2,0,2,1.315346,103.918118
459454,0,3,3,1.312071,103.919251
459455,1,1,2,1.316444,103.921281
459456,60,290,350,1.316205,103.921368
459463,6,12,18,1.319532,103.926547
459466,1,0,1,1.316694,103.921183
459467,4,4,8,1.31976,103.926448
459469,5,2,7,1.319891,103.926392
459470,2,0,2,1.316278,103.921346
459471,14,4,18,1.320022,103.926335
459472,1,10,11,1.320087,103.926307
459473,5,3,8,1.320114,103.926295
459475,40,1,41,1.320193,103.926259
459476,58,10,68,1.320246,103.926234
459477,1,0,1,1.319695,103.926476
459479,7,1,8,1.320406,103.926162
459480,2,0,2,1.319956,103.926363
459481,17,5,22,1.320512,103.926113
459482,1,2,3,1.316361,103.921313
459483,2,2,4,1.320606,103.926071
459484,7,0,7,1.320647,103.926053
459485,89,4,93,1.320729,103.926016
459486,22,3,25,1.320811,103.92598
459487,1,1,2,1.320459,103.926137
459488,1,2,3,1.320565,103.926089
459489,14,1,15,1.321057,103.92587
459490,62,4,66,1.321139,103.925834
459491,80,1,81,1.321685,103.925581
459492,0,3,3,1.320975,103.925907
459493,0,2,2,1.320893,103.925943
459494,2,0,2,1.321795,103.925531
459495,3,9,12,1.321941,103.925463
459497,0,1,1,1.320299,103.92621
459498,105,0,105,1.322161,103.925362
459499,2,0,2,1.321868,103.925497
459501,0,1,1,1.322088,103.925396
459502,5,0,5,1.322308,103.925296
459503,5,1,6,1.322357,103.925274
459504,0,4,4,1.322406,103.925252
459505,2,0,2,1.322186,103.925351
459506,3,0,3,1.321721,103.925564
459507,2,1,3,1.322504,103.925209
459508,2,1,3,1.322553,103.925187
459509,7,209,216,1.322651,103.925143
459520,7,11,18,1.319732,103.926979
459521,5,5,10,1.319735,103.926998
459522,4,3,7,1.319763,103.926965
459523,6,3,9,1.319768,103.926983
459524,1,6,7,1.319824,103.926938
459525,9,0,9,1.319834,103.926953
459526,11,0,11,1.319885,103.92691
459527,43,7,50,1.3199,103.926923
459528,7,0,7,1.319946,103.926882
459529,26,0,26,1.319965,103.926893
459530,2,2,4,1.320007,103.926855
459531,23,0,23,1.320063,103.926823
459534,6,1,7,1.320097,103.926834
459535,7,4,11,1.320129,103.926799
459536,0,3,3,1.322602,103.925165
459537,3,0,3,1.320163,103.926804
459538,1,0,1,1.322259,103.925318
459539,0,1,1,1.320229,103.926774
459540,18,0,18,1.320295,103.926744
459541,0,1,1,1.320251,103.926744
459542,1,5,6,1.32036,103.926714
459544,0,2,2,1.322455,103.925231
459545,6,0,6,1.320434,103.926661
459546,0,1,1,1.320312,103.926716
459547,15,1,16,1.320495,103.926633
459548,2,0,2,1.320426,103.926684
459549,4,0,4,1.320555,103.926606
459550,7,1,8,1.320624,103.926595
459551,6,6,12,1.320616,103.926578
459552,1,2,3,1.32019,103.926772
459553,10,2,12,1.320677,103.92655
459554,17,2,19,1.320755,103.926535
459558,16,3,19,1.320887,103.926475
459559,11,7,18,1.32086,103.926467
459560,4,0,4,1.320953,103.926445
459561,2,0,2,1.320558,103.926625
459562,6,0,6,1.321019,103.926415
459563,0,1,1,1.320492,103.926654
459565,2,3,5,1.321043,103.926384
459566,4,3,7,1.32115,103.926356
459567,0,1,1,1.320982,103.926412
459569,3,0,3,1.32069,103.926565
459570,0,2,2,1.320921,103.92644
459572,17,4,21,1.321348,103.926266
459573,1,0,1,1.321104,103.926357
459574,22,5,27,1.321338,103.926256
459585,5,0,5,1.311356,103.917803
459586,1,7,8,1.31122,103.917464
459587,0,4,4,1.31127,103.917635
459588,4,5,9,1.311408,103.917955
459589,2,0,2,1.321282,103.926296
459591,17,11,28,1.311478,103.91814
459593,9,0,9,1.311549,103.918284
459594,46,0,46,1.311287,103.917903
459595,232,0,232,1.311604,103.918419
459596,20,16,36,1.311341,103.918113
459597,2,0,2,1.310935,103.917788
459598,1,0,1,1.321287,103.926274
459599,13,0,13,1.311398,103.91816
459601,15,5,20,1.311444,103.918285
459602,5,0,5,1.311714,103.918671
459604,19,0,19,1.311484,103.918386
459605,28,17,45,1.31137,103.918679
459606,64,11,75,1.311799,103.918849
459607,4,0,4,1.311536,103.91856
459608,21,0,21,1.311566,103.918626
459609,2,1,3,1.321165,103.926329
459611,1,0,1,1.311706,103.918607
459612,2,7,9,1.311857,103.919043
459613,13,0,13,1.311527,103.919066
459614,3,0,3,1.311808,103.918932
459615,3,9,12,1.311884,103.919145
459617,17,0,17,1.311808,103.919156
459618,76,0,76,1.311873,103.919283
459619,25,1,26,1.311939,103.919437
459621,4,0,4,1.312025,103.919652
459622,4,13,17,1.312176,103.919826
459623,1,0,1,1.311648,103.91885
459624,23,4,27,1.311323,103.918063
459625,18,3,21,1.312149,103.919432
459626,4,9,13,1.311998,103.919383
459634,3,0,3,1.311724,103.918983
459637,1,0,1,1.311876,103.920166
459638,3,0,3,1.315574,103.919718
459639,11,0,11,1.315632,103.919908
459640,74,7,81,1.315649,103.919948
459642,25,3,28,1.315705,103.920086
459643,32,9,41,1.315719,103.920139
459644,1,0,1,1.315609,103.919829
459645,2,0,2,1.311672,103.918576
459646,1,0,1,1.315733,103.920183
459649,1,0,1,1.315768,103.920245
459650,3,21,24,1.31606,103.920877
459651,5,0,5,1.316068,103.920911
459652,20,21,41,1.31608,103.920945
459653,4,0,4,1.316091,103.920979
459654,19,51,70,1.316103,103.921014
459655,4,0,4,1.316114,103.921053
459656,29,89,118,1.316131,103.921093
459657,12,28,40,1.316149,103.921133
459658,10,115,125,1.316166,103.921179
459661,40,18,58,1.316205,103.921368
459663,1984,3,1987,1.315898,103.920899
459664,4,38,42,1.316459,103.92192
459665,2,2,4,1.316458,103.92192
459666,0,7,7,1.316693,103.922473
459667,17,2,19,1.316703,103.922463
459668,127,18,145,1.316565,103.922354
459670,0,3,3,1.31562,103.919868
459680,134,6,140,1.31829,103.926146
459681,2,5,7,1.318286,103.926559
459682,23,1,24,1.318296,103.926179
459683,1,0,1,1.315819,103.920359
459684,2,0,2,1.315751,103.920211
459685,3,0,3,1.316692,103.922472
459686,10,0,10,1.3182,103.926334
459687,10,0,10,1.318117,103.926393
459688,17,0,17,1.318222,103.926384
459689,1,12,13,1.318144,103.926462
459690,22,1,23,1.318242,103.926445
459691,0,1,1,1.318058,103.926262
459694,6,0,6,1.318266,103.926501
459695,1,0,1,1.318242,103.926445
459696,7,0,7,1.318319,103.926612
459697,5,0,5,1.318261,103.92671
459698,2,1,3,1.318083,103.926332
459699,11,0,11,1.318518,103.927279
459700,18,0,18,1.318375,103.926717
459701,0,9,9,1.318314,103.926832
459702,0,1,1,1.318236,103.926651
459703,2,0,2,1.31818,103.926273
459704,15,0,15,1.318422,103.926831
459705,2,0,2,1.318339,103.926896
459706,6,2,8,1.31845,103.926893
459707,2,0,2,1.318356,103.926952
459709,4,3,7,1.318425,103.927052
459710,1,0,1,1.318403,103.926773
459711,3,1,4,1.318445,103.927118
459712,7,1,8,1.31854,103.927068
459714,1,8,9,1.318565,103.927132
459715,0,9,9,1.318286,103.92676
459726,3,17,20,1.316128,103.926991
459727,7,0,7,1.316048,103.927023
459728,4,1,5,1.316115,103.926856
459729,30,2,32,1.316509,103.926834
459730,4,0,4,1.316238,103.926778
459731,6,0,6,1.31647,103.92702
459732,17,0,17,1.316358,103.926712
459733,8,2,10,1.316578,103.92695
459734,0,1,1,1.318509,103.927018
459737,1,1,2,1.318395,103.926996
459738,1,0,1,1.316233,103.926941
459739,47,0,47,1.316509,103.926834
459740,27,0,27,1.317121,103.926545
459742,17,0,17,1.317196,103.92667
459743,5,0,5,1.316806,103.926697
459744,9,13,22,1.317341,103.926584
459745,4,1,5,1.317272,103.926467
459746,3,2,5,1.317463,103.926514
459747,0,1,1,1.316915,103.926798
459748,5,4,9,1.31753,103.926596
459750,3,0,3,1.318356,103.926654
459751,3,1,4,1.317572,103.926336
459752,179,0,179,1.317697,103.926264
459753,78,1,79,1.317756,103.926236
459754,10,0,10,1.317892,103.926175
459755,47,0,47,1.317979,103.926144
459756,4,0,4,1.31811,103.926087
459757,21,0,21,1.318202,103.926047
459758,0,1,1,1.317376,103.926254
459759,1,0,1,1.318338,103.925983
459760,59,0,59,1.318541,103.925868
459761,1,0,1,1.318435,103.92595
459762,2,0,2,1.316915,103.926798
459763,6,21,27,1.318825,103.925764
459764,11,63,74,1.318916,103.925543
459765,0,2,2,1.31874,103.925796
459766,2,0,2,1.316367,103.926874
459767,12,2,14,1.317121,103.926545
459768,14,7,21,1.317068,103.926734
459769,9,10,19,1.316233,103.926941
459775,12,13,25,1.316012,103.920651
459776,3,0,3,1.317663,103.926061
459777,50,3,53,1.316125,103.920611
459778,5,0,5,1.316181,103.920585
459779,1,0,1,1.318764,103.925608
459780,5,0,5,1.316374,103.920509
459781,3,0,3,1.316074,103.920635
459782,1,4,5,1.316496,103.920475
459793,5,16,21,1.312232,103.921407
459794,1,25,26,1.312161,103.921418
459795,0,2,2,1.316965,103.926628
459796,0,1,1,1.3163,103.920542
459798,1,0,1,1.312179,103.921473
459799,61,1,62,1.312332,103.921607
459800,0,33,33,1.312219,103.921575
459801,1,3,4,1.312365,103.921684
459802,18,0,18,1.312239,103.921629
459803,0,2,2,1.312263,103.921488
459805,0,3,3,1.316443,103.920486
459806,4,0,4,1.312287,103.921736
459807,53,7,60,1.312445,103.921874
459808,2,2,4,1.312308,103.921775
459809,0,5,5,1.312494,103.921959
459810,123,2,125,1.312335,103.921837
459811,6,12,18,1.31253,103.922052
459812,3,0,3,1.31226,103.921671
459813,11,10,21,1.312569,103.922148
459814,22,2,24,1.312368,103.921933
459815,21,9,30,1.312617,103.922263
459816,26,8,34,1.312394,103.921982
459817,122,23,145,1.31266,103.922361
459818,11,2,13,1.312428,103.922053
459819,8,0,8,1.312705,103.922448
459820,0,2,2,1.312411,103.921785
459821,0,11,11,1.312749,103.922535
459822,1,4,5,1.312484,103.922184
459823,0,3,3,1.312356,103.921882
459824,2,3,5,1.312511,103.922254
459825,2,10,12,1.312816,103.922711
459826,1,7,8,1.312533,103.922308
459827,4,50,54,1.312865,103.922836
459828,1,6,7,1.312556,103.922373
459829,17,24,41,1.312908,103.922953
459830,33,23,56,1.312584,103.922427
459831,25,500,525,1.312938,103.923016
459832,0,3,3,1.312779,103.92262
459833,0,5,5,1.312637,103.922554
459835,1,4,5,1.312691,103.922659
459836,3,1,4,1.312713,103.922714
459837,273,40,313,1.312738,103.922759
459838,87,50,137,1.312755,103.922801
459839,38,112,150,1.312778,103.922852
459850,1,0,1,1.312203,103.921529
459851,8,10,18,1.31284,103.920742
459852,5,1,6,1.312821,103.920663
459853,44,4,48,1.313011,103.920693
459854,31,4,35,1.312938,103.920633
459855,0,4,4,1.313246,103.920587
459856,7,2,9,1.313025,103.920567
459857,3,5,8,1.313339,103.920531
459858,60,0,60,1.313139,103.920518
459859,20,12,32,1.31345,103.920494
459860,0,3,3,1.312613,103.922497
459861,4,2,6,1.313573,103.920449
459862,1,0,1,1.312701,103.920715
459863,2,7,9,1.313676,103.920401
459864,2,0,2,1.312448,103.922104
459865,0,1,1,1.313375,103.920426
459866,1,0,1,1.313769,103.920342
459867,8,2,10,1.313867,103.92031
459868,27,0,27,1.31375,103.920271
459870,0,1,1,1.313615,103.920309
459871,196,4,200,1.31425,103.920155
459872,2,1,3,1.313261,103.920471
459873,86,0,86,1.314408,103.920071
459874,2,2,4,1.314419,103.919967
459875,18,13,31,1.314517,103.920061
459876,67,17,84,1.314486,103.919947
459877,11,2,13,1.314536,103.920026
459878,0,1,1,1.313884,103.920195
459879,29,15,44,1.314677,103.919983
459880,1,6,7,1.314615,103.919892
459881,15,8,23,1.314675,103.919945
459882,0,2,2,1.313489,103.92036
459883,0,1,1,1.314557,103.919918
459884,2,9,11,1.314744,103.919847
459885,2,2,4,1.314802,103.919901
459887,4,3,7,1.314921,103.919882
459888,2,3,5,1.314852,103.91979
459889,6,0,6,1.314954,103.919841
459890,3,0,3,1.314387,103.920122
459891,1,1,2,1.314672,103.919867
459894,2,3,5,1.315058,103.919692
459895,20,1,21,1.315206,103.919754
459896,8,1,9,1.315106,103.919676
459897,2,0,2,1.315074,103.919787
459898,4,4,8,1.315178,103.919669
459899,0,2,2,1.315244,103.919722
459900,0,3,3,1.314924,103.91975
459901,1,3,4,1.315367,103.919667
459902,9,0,9,1.315229,103.91962
459903,2,2,4,1.315286,103.919583
459904,4,2,6,1.315324,103.919589
459905,1,3,4,1.315279,103.919613
459906,0,2,2,1.315311,103.919694
459907,1,2,3,1.315248,103.919582
459908,7,5,12,1.315179,103.919603
459909,1,1,2,1.315378,103.919561
459910,12,1,13,1.312939,103.92071
459911,4,0,4,1.313011,103.920693
459912,2,0,2,1.31315,103.920635
459913,4,13,17,1.299509,103.837
459919,4,9,13,1.316865,103.928792
459920,0,1,1,1.31479,103.919942
459921,26,0,26,1.317072,103.928687
459922,60,6,66,1.317186,103.928646
459923,1,1,2,1.317095,103.928774
459925,3,2,5,1.317289,103.928615
459926,1,0,1,1.316985,103.928731
459927,26,0,26,1.317301,103.928685
459928,14,0,14,1.317397,103.928641
459929,6,0,6,1.317506,103.928537
459930,3,2,5,1.317482,103.928603
459932,0,6,6,1.31762,103.928479
459933,10,2,12,1.31766,103.928522
459934,10,6,16,1.317737,103.928483
459935,0,8,8,1.317746,103.928437
459936,14,11,25,1.317813,103.928452
459937,2,4,6,1.317882,103.928419
459938,21,2,23,1.317857,103.92837
459939,0,4,4,1.317949,103.928387
459940,13,0,13,1.318175,103.928238
459941,32,1,33,1.318376,103.928154
459943,3,4,7,1.31826,103.928256
459944,2,0,2,1.317095,103.928774
459945,2,33,35,1.318478,103.928152
459946,37,0,37,1.318662,103.928039
459947,3,10,13,1.3186,103.9281
459948,5,1,6,1.318747,103.928
459949,5,2,7,1.318826,103.927967
459950,3,1,4,1.318897,103.927933
459951,4,11,15,1.318831,103.927993
459952,0,6,6,1.318967,103.927895
459953,0,1,1,1.317392,103.928563
459954,0,26,26,1.319096,103.92784
459955,3,74,77,1.318933,103.927943
459956,10,0,10,1.319171,103.927801
459958,18,1,19,1.319366,103.927704
459959,42,1,43,1.319468,103.927654
459961,7,10,17,1.319623,103.927567
459963,5,3,8,1.319762,103.927505
459964,84,6,90,1.319831,103.927478
459965,1,5,6,1.319968,103.927395
459966,3,0,3,1.315459,103.919511
459967,1,0,1,1.319031,103.92787
459968,3,3,6,1.320131,103.92731
459969,3,1,4,1.320183,103.927284
459970,1,0,1,1.320062,103.927335
459971,1,0,1,1.320251,103.927259
459973,4,0,4,1.320432,103.927182
459974,3,0,3,1.320011,103.927361
459976,4,0,4,1.320621,103.927088
459977,1,0,1,1.32032,103.927233
459978,0,1,1,1.320672,103.927053
459979,4,4,8,1.320793,103.926994
459981,9,4,13,1.320913,103.926942
459983,1,0,1,1.320732,103.927028
459984,1,0,1,1.32105,103.9269
459985,4,1,5,1.321179,103.92684
459987,1,0,1,1.32111,103.926865
459988,5,2,7,1.321351,103.926754
459989,1,2,3,1.3205,103.927147
459990,5,2,7,1.318043,103.928355
459991,1,2,3,1.321394,103.926729
459992,9,225,234,1.319032,103.927891
459993,2,2,4,1.318272,103.928202
459994,21,3,24,1.317965,103.92832
459996,1,2,3,1.318127,103.928323
460001,171,115,286,1.320942,103.933542
460002,834,4331,5165,1.321429,103.933116
460003,764,318,1082,1.322,103.933021
460004,655,69,724,1.322552,103.933145
460005,512,306,818,1.322229,103.934136
460006,115,44,159,1.322318,103.934763
460007,1073,230,1303,1.32287,103.935202
460008,619,145,764,1.322928,103.935787
460009,1098,3470,4568,1.323113,103.936623
460011,639,208,847,1.327006,103.924472
460012,41,1,42,1.321211,103.936784
460013,172,2586,2758,1.320537,103.936675
460014,416,225,641,1.321498,103.935885
460015,599,197,796,1.321074,103.935303
460016,51,31,82,1.320549,103.935555
460017,92,9769,9861,1.320175,103.935554
460018,713,783,1496,1.320332,103.934572
460019,447,15877,16324,1.319944,103.933951
460020,574,559,1133,1.320128,103.933498
460021,717,3169,3886,1.320276,103.932909
460022,90,17,107,1.322974,103.932668
460023,307,1485,1792,1.323396,103.932578
460024,155,5336,5491,1.32485,103.922454
460025,161,55,216,1.323809,103.924236
460026,301,9603,9904,1.323386,103.923543
460027,239,5891,6130,1.324199,103.923423
460028,232,27,259,1.323708,103.934401
460029,471,322,793,1.324834,103.924372
460030,121,3277,3398,1.324727,103.924682
460031,414,263,677,1.323129,103.937816
460032,440,3194,3634,1.322691,103.937489
460033,896,561,1457,1.322884,103.938884
460034,806,22,828,1.322105,103.938057
460035,480,63,543,1.322376,103.939523
460036,404,172,576,1.321729,103.938193
460037,609,163,772,1.32201,103.939568
460038,126,3087,3213,1.320958,103.938516
460039,413,539,952,1.321341,103.939327
460040,620,3447,4067,1.321011,103.939468
460041,86,2669,2755,1.321135,103.94071
460042,157,405,562,1.32155,103.94065
460043,321,380,701,1.32164,103.941673
460044,336,1340,1676,1.321235,103.941739
460046,288,285,573,1.32275,103.942591
460047,116,237,353,1.322173,103.943018
460048,182,527,709,1.322649,103.943049
460049,128,308,436,1.323119,103.943137
460050,333,363,696,1.323625,103.943234
460051,628,3019,3647,1.328901,103.921965
460052,677,5730,6407,1.328779,103.920846
460053,793,3109,3902,1.328538,103.919901
460054,899,302,1201,1.329573,103.921377
460055,1191,2297,3488,1.326577,103.919335
460056,340,255,595,1.326351,103.919976
460057,14,130,144,1.325977,103.920274
460058,634,360,994,1.325893,103.919809
460059,1225,397,1622,1.324789,103.920347
460060,106,305,411,1.324652,103.921212
460061,1232,389,1621,1.325129,103.920653
460062,468,122,590,1.32546,103.921224
460063,338,184,522,1.32609,103.921393
460064,462,381,843,1.324302,103.939816
460065,592,17652,18244,1.324722,103.939674
460066,307,48,355,1.318575,103.943793
460067,361,4870,5231,1.319069,103.943989
460068,350,203,553,1.318851,103.943286
460069,346,364,710,1.319371,103.943589
460070,274,218,492,1.320025,103.94284
460071,242,4806,5048,1.320438,103.942822
460072,602,4174,4776,1.320391,103.943611
460073,102,779,881,1.319786,103.94406
460074,581,15,596,1.327473,103.941764
460075,814,265,1079,1.327872,103.941682
460076,499,351,850,1.328248,103.941615
460077,518,64,582,1.328635,103.94152
460078,367,1836,2203,1.32736,103.94087
460079,500,1916,2416,1.327771,103.940645
460080,493,663,1156,1.328522,103.940547
460081,385,2674,3059,1.328984,103.940377
460082,570,2236,2806,1.329549,103.940299
460084,237,1971,2208,1.331431,103.939424
460085,248,10397,10645,1.331981,103.938751
460086,43,63,106,1.332541,103.938978
460087,195,205,400,1.332874,103.938525
460088,366,13922,14288,1.332656,103.939444
460089,126,13011,13137,1.333055,103.938284
460090,569,342,911,1.332192,103.940321
460091,469,235,704,1.332569,103.940246
460092,29,2,31,1.332513,103.941238
460093,741,12,753,1.332937,103.941196
460094,8,88,96,1.333463,103.941989
460095,168,5969,6137,1.333879,103.941981
460096,281,7689,7970,1.33329,103.940197
460097,562,1468,2030,1.333,103.939922
460098,246,939,1185,1.33435,103.939687
460099,359,3764,4123,1.333988,103.939319
460100,447,24,471,1.334289,103.938127
460101,432,904,1336,1.334513,103.937435
460102,640,580,1220,1.334002,103.937209
460103,454,1836,2290,1.333586,103.937266
460104,559,31,590,1.33338,103.936558
460105,750,79,829,1.333825,103.936473
460106,561,490,1051,1.334534,103.936829
460107,798,7157,7955,1.332415,103.936064
460108,557,565,1122,1.332795,103.936
460109,562,2206,2768,1.332156,103.934706
460110,1220,613,1833,1.332529,103.934642
460111,645,7015,7660,1.331513,103.935252
460112,494,251,745,1.33113,103.935349
460113,385,3473,3858,1.330468,103.93501
460114,325,1450,1775,1.330627,103.935695
460115,624,2756,3380,1.331422,103.93646
460116,747,16,763,1.331014,103.937702
460117,74,3,77,1.330753,103.938308
460118,1311,682,1993,1.330541,103.937125
460119,514,399,913,1.330252,103.938415
460120,734,2774,3508,1.330029,103.937243
460121,447,539,986,1.329732,103.938541
460122,503,552,1055,1.32897,103.937724
460123,307,8096,8403,1.329592,103.937359
460124,122,2575,2697,1.329297,103.93884
460125,284,1861,2145,1.328878,103.938952
460126,366,485,851,1.328294,103.938667
460127,284,2485,2769,1.32811,103.937706
460128,352,2265,2617,1.32785,103.9387
460129,437,4606,5043,1.327659,103.937699
460130,486,716,1202,1.327289,103.936538
460131,697,1283,1980,1.327103,103.93559
460132,614,1292,1906,1.327816,103.936436
460133,446,2664,3110,1.327608,103.935474
460134,603,273,876,1.328412,103.936229
460135,721,243,964,1.328765,103.936185
460136,362,4502,4864,1.328263,103.935139
460137,575,1181,1756,1.32896,103.935275
460138,545,3572,4117,1.329911,103.936053
460139,968,1884,2852,1.329478,103.935154
460140,440,1681,2121,1.329951,103.935663
460155,4,41,45,1.318507,103.946107
460156,371,1226,1597,1.318315,103.945449
460157,487,194,681,1.318728,103.945665
460158,128,2102,2230,1.318719,103.945177
460159,303,369,672,1.319058,103.945563
460160,316,256,572,1.319285,103.945241
460161,151,224,375,1.31959,103.945785
460162,41,242,283,1.31972,103.946132
460163,397,478,875,1.319775,103.946651
460164,771,102,873,1.320091,103.946567
460165,562,378,940,1.320307,103.946095
460166,362,391,753,1.320033,103.945187
460167,445,1610,2055,1.319671,103.945012
460168,172,5781,5953,1.320062,103.94457
460169,201,246,447,1.320385,103.945072
460170,387,1025,1412,1.320704,103.946107
460171,384,395,779,1.320926,103.945541
460172,112,913,1025,1.320671,103.944743
460180,1048,6865,7913,1.326827,103.940635
460181,841,65,906,1.326799,103.941195
460182,509,555,1064,1.327039,103.941541
460183,844,25,869,1.326423,103.941774
460184,27,245,272,1.326054,103.941668
460185,848,2959,3807,1.326167,103.940836
460186,3,3502,3505,1.299509,103.837
460187,0,26,26,1.299509,103.837
460188,0,14,14,1.299509,103.837
460201,1121,5382,6503,1.326276,103.928048
460202,501,273,774,1.325751,103.928222
460203,180,800,980,1.325738,103.928851
460204,158,505,663,1.326535,103.929898
460205,86,156,242,1.326049,103.930752
460206,29,54,83,1.326604,103.931008
460207,4,15,19,1.325297,103.930374
460208,22,47,69,1.325718,103.930844
460209,1818,10359,12177,1.324672,103.930879
460210,742,52409,53151,1.324715,103.931685
460211,19,140,159,1.325522,103.931788
460212,123,114,237,1.325906,103.931513
460213,241,359,600,1.326304,103.932572
460214,160,307,467,1.326024,103.93243
460215,186,2721,2907,1.326057,103.93348
460216,199,3649,3848,1.32735,103.933263
460217,159,448,607,1.326825,103.933924
460218,324,8365,8689,1.327492,103.933686
460219,74,2080,2154,1.324961,103.932968
460220,56,3141,3197,1.325624,103.935085
460221,20,1122,1142,1.325148,103.935218
460401,201,6416,6617,1.331083,103.93337
460402,1089,819,1908,1.330604,103.933495
460403,712,904,1616,1.32988,103.933629
460404,859,1359,2218,1.329426,103.933741
460405,1031,703,1734,1.328867,103.933898
460406,935,2906,3841,1.32834,103.934172
460407,668,1184,1852,1.328623,103.933398
460408,908,482,1390,1.328626,103.932641
460409,88,4981,5069,1.32819,103.932712
460410,141,4153,4294,1.327972,103.931597
460411,486,296,782,1.328399,103.931526
460412,412,4177,4589,1.330059,103.930712
460413,688,1918,2606,1.330344,103.930816
460414,594,3603,4197,1.330091,103.929637
460415,606,2223,2829,1.329702,103.930016
460416,969,6673,7642,1.328566,103.930534
460417,676,4958,5634,1.327724,103.930211
460418,536,2018,2554,1.328627,103.92989
460419,1649,1756,3405,1.327174,103.927769
460420,945,345,1290,1.327804,103.928446
460421,1016,773,1789,1.328309,103.92881
460422,879,532,1411,1.328781,103.928803
460423,519,300,819,1.328045,103.927549
460424,1042,1524,2566,1.328485,103.927315
460425,791,776,1567,1.329354,103.928574
460426,924,2662,3586,1.32979,103.928503
460427,1690,681,2371,1.32928,103.928138
460428,602,3837,4439,1.329688,103.928049
460501,462,403,865,1.331315,103.931002
460502,147,963,1110,1.331688,103.930917
460503,241,2317,2558,1.331581,103.932273
460504,2111,863,2974,1.33196,103.932152
460505,827,1335,2162,1.33194,103.933025
460506,704,2867,3571,1.332255,103.93343
460507,1713,1007,2720,1.33299,103.932184
460508,954,311,1265,1.333421,103.932077
460509,146,1681,1827,1.333349,103.931215
460510,611,684,1295,1.332105,103.930618
460511,165,2499,2664,1.333244,103.930561
460512,436,10870,11306,1.333385,103.929034
460513,454,43,497,1.333018,103.92913
460514,353,310,663,1.332372,103.928765
460515,260,11725,11985,1.332008,103.929827
460516,1061,4257,5318,1.331143,103.929824
460517,636,361,997,1.331182,103.928983
460518,459,399,858,1.331656,103.928913
460519,1814,1088,2902,1.330964,103.927871
460520,154,3858,4012,1.330503,103.927958
460521,142,2710,2852,1.330344,103.92689
460522,1620,10623,12243,1.33076,103.926812
460523,857,1329,2186,1.334473,103.930484
460524,700,646,1346,1.334876,103.930446
460525,1571,516,2087,1.334743,103.928896
460526,351,2256,2607,1.334331,103.929053
460527,462,10020,10482,1.333916,103.928342
460528,978,1011,1989,1.334979,103.927824
460529,1246,301,1547,1.334282,103.926494
460530,887,1867,2754,1.333838,103.926882
460531,514,5636,6150,1.333222,103.926193
460532,1591,450,2041,1.334085,103.925149
460533,1787,674,2461,1.333639,103.924036
460534,1031,8114,9145,1.33317,103.924645
460535,825,9866,10691,1.332792,103.923453
460536,1289,591,1880,1.333427,103.922986
460537,316,444,760,1.331769,103.924253
460538,32,192,224,1.331798,103.924861
460539,498,5836,6334,1.331305,103.925109
460540,1217,312,1529,1.331194,103.922128
460541,760,5694,6454,1.331362,103.923018
460542,1264,281,1545,1.330766,103.922706
460543,1042,429,1471,1.330359,103.923196
460544,550,7671,8221,1.330634,103.924149
460545,679,661,1340,1.330153,103.924015
460546,442,2021,2463,1.330868,103.925367
460547,1420,600,2020,1.330388,103.925242
460548,1014,3845,4859,1.331392,103.926712
460549,1143,16023,17166,1.33179,103.926643
460550,1186,6866,8052,1.332623,103.926411
460551,175,291,466,1.332324,103.926959
460552,497,71,568,1.331904,103.92729
460553,551,492,1043,1.33151,103.927364
460554,927,681,1608,1.33285,103.928014
460556,400,406,806,1.332513,103.92278
460557,829,76,905,1.33292,103.922051
460803,346,5900,6246,1.324196,103.922528
460804,341,142,483,1.324303,103.922035
460805,871,342,1213,1.32439,103.921684
460806,18,1656,1674,1.299509,103.837
460807,15,108,123,1.299509,103.837
461001,185,2793,2978,1.328023,103.922616
461002,287,166,453,1.326906,103.922627
461010,269,250,519,1.322559,103.936094
461012,3,174,177,1.320737,103.93657
461013,48,5560,5608,1.320785,103.935984
461019,663,300,963,1.327363,103.922252
461020,363,4550,4913,1.32635,103.922814
461021,269,71,340,1.325758,103.922426
461022,265,619,884,1.325333,103.921774
461023,317,9302,9619,1.325334,103.922588
461024,1038,6837,7875,1.323912,103.933262
461025,50,1089,1139,1.323408,103.924153
461026,59,5979,6038,1.323695,103.923658
461027,61,6156,6217,1.32394,103.92344
461029,566,1071,1637,1.324592,103.924035
461030,22,50,72,1.323676,103.936141
461031,438,47,485,1.324335,103.924574
461032,445,812,1257,1.323866,103.924796
461033,532,502,1034,1.324147,103.92569
461034,864,1244,2108,1.324281,103.926274
461035,1077,706,1783,1.324938,103.92616
461036,515,1361,1876,1.325447,103.925329
461037,462,265,727,1.325543,103.926152
461038,335,112,447,1.325945,103.926027
461039,64,2143,2207,1.326357,103.926094
461040,319,422,741,1.326088,103.926364
461041,809,1889,2698,1.327448,103.925916
461042,786,739,1525,1.327988,103.925596
461043,698,713,1411,1.328442,103.925493
461044,695,1842,2537,1.329038,103.925536
461045,1034,4932,5966,1.32877,103.924633
461050,945,269,1214,1.329404,103.922215
461051,498,665,1163,1.323477,103.942084
461052,272,126,398,1.323909,103.942212
461053,421,60,481,1.324342,103.942121
461054,312,0,312,1.324914,103.942397
461055,463,7017,7480,1.325137,103.941945
461056,172,11476,11648,1.325364,103.941535
461057,726,1026,1752,1.324351,103.941506
461058,181,0,181,1.324313,103.941176
461059,324,1367,1691,1.324047,103.940685
461060,234,273,507,1.322465,103.941272
461061,717,742,1459,1.322795,103.940602
461062,920,850,1770,1.323355,103.939931
461063,408,113,521,1.323821,103.939871
461084,9,9465,9474,1.299509,103.837
461085,1,1948,1949,1.299509,103.837
461086,0,176,176,1.332495,103.938577
461094,200,5401,5601,1.333893,103.94284
461114,51,157,208,1.330504,103.935766
461115,26,5915,5941,1.331893,103.937337
461116,20,311,331,1.330979,103.937243
461121,12,494,506,1.329622,103.938735
461122,2,223,225,1.299509,103.837
461134,9,359,368,1.299509,103.837
461184,66,2784,2850,1.326156,103.942121
461186,16,702,718,1.299509,103.837
461187,0,111,111,1.299509,103.837
461188,0,3,3,1.318369,103.928198
461201,63,3072,3135,1.326043,103.927338
461207,2,112,114,1.325371,103.930401
461208,8,189,197,1.32548,103.931249
461211,7,40,47,1.325529,103.931512
461214,19,460,479,1.325717,103.932503
461215,39,555,594,1.326316,103.934199
461217,6,17,23,1.299509,103.837
461219,928,635,1563,1.32566,103.933191
461220,358,529,887,1.325546,103.93468
461221,929,909,1838,1.325097,103.934872
461408,10,983,993,1.299509,103.837
461503,6,911,917,1.299509,103.837
461509,1,64,65,1.332904,103.930989
461511,10,11,21,1.332989,103.930706
461513,8,249,257,1.332343,103.929337
461515,10,10981,10991,1.299509,103.837
461536,9,5966,5975,1.299509,103.837
461538,0,15,15,1.33163,103.924584
461539,56,6386,6442,1.332698,103.925662
461556,6,85,91,1.299509,103.837
461557,6,109,115,1.299509,103.837
461807,837,249,1086,1.327578,103.923212
461808,864,500,1364,1.327088,103.923737
462002,6,310,316,1.321744,103.933969
462010,10,104,114,1.32209,103.936247
462019,19,247,266,1.320482,103.934187
462021,10,105,115,1.325845,103.922359
462023,4,52,56,1.325315,103.922127
462025,63,64,127,1.323454,103.93345
462026,51,900,951,1.323363,103.934204
462027,1147,7060,8207,1.324115,103.934326
462029,6,81,87,1.32395,103.923881
462030,8,198,206,1.323196,103.934971
462032,14,4680,4694,1.323415,103.924679
462033,11,11,22,1.323205,103.939249
462034,520,476,996,1.321869,103.938637
462035,35,711,746,1.324536,103.926702
462055,8,235,243,1.299509,103.837
462057,33,118,151,1.323705,103.941309
462086,3,1,4,1.299509,103.837
462094,185,169,354,1.333678,103.942565
462186,2,7,9,1.332542,103.939749
462187,0,2516,2516,1.299509,103.837
462188,0,1,1,1.321291,103.92678
462208,38,607,645,1.324528,103.930678
462219,593,306,899,1.325327,103.932964
462220,545,785,1330,1.325513,103.934364
462221,890,637,1527,1.325015,103.934526
462509,108,3453,3561,1.333804,103.930231
462538,1,53,54,1.331735,103.9246
462807,359,300,659,1.327607,103.923349
462808,320,1271,1591,1.327578,103.923212
463010,497,147,644,1.322012,103.936258
463029,21,96,117,1.324283,103.924307
463035,255,456,711,1.322575,103.939784
463057,421,153,574,1.322991,103.941499
463062,2,56,58,1.299509,103.837
463086,2,0,2,1.318564,103.928071
463094,125,1704,1829,1.333671,103.941233
463188,0,35,35,1.299509,103.837
463208,2,27,29,1.299509,103.837
463219,162,1235,1397,1.325346,103.933254
463220,415,249,664,1.32541,103.933974
463221,666,3802,4468,1.324947,103.93417
463509,5,3202,3207,1.333057,103.930583
463538,1,346,347,1.331692,103.924549
463807,835,997,1832,1.327621,103.922453
463808,1058,2264,3322,1.327578,103.923212
464010,520,1685,2205,1.321749,103.93671
464029,110,2983,3093,1.324016,103.936086
464086,2,0,2,1.299509,103.837
464094,143,2497,2640,1.333472,103.940742
464188,0,457,457,1.299509,103.837
464208,1,66,67,1.299509,103.837
464219,229,2432,2661,1.324854,103.933814
465010,344,4729,5073,1.322267,103.936678
465086,6,0,6,1.299509,103.837
465407,59,93,152,1.326517,103.947449
465408,20,184,204,1.299509,103.837
465409,6,2,8,1.299509,103.837
465410,95,171,266,1.299509,103.837
465411,104,1076,1180,1.32735,103.949178
465417,248,585,833,1.32772,103.944667
465418,67,123,190,1.299509,103.837
465419,77,15228,15305,1.299509,103.837
465420,310,180,490,1.299509,103.837
465421,101,121,222,1.299509,103.837
465422,120,90,210,1.299509,103.837
465423,178,604,782,1.299509,103.837
465424,201,209,410,1.327774,103.944518
465425,308,213,521,1.299509,103.837
465426,88,53,141,1.299509,103.837
465427,179,299,478,1.299509,103.837
465434,0,1,1,1.299509,103.837
465436,0,4,4,1.299509,103.837
465438,0,1,1,1.299509,103.837
465439,0,1,1,1.299509,103.837
465440,2,6,8,1.299509,103.837
465443,0,1,1,1.299509,103.837
465449,1,0,1,1.299509,103.837
465452,0,5,5,1.299509,103.837
465457,16,0,16,1.299509,103.837
465458,39,0,39,1.323507,103.945003
465459,27,2719,2746,1.323242,103.944599
465460,55,90,145,1.299509,103.837
465468,2,1,3,1.299509,103.837
465469,1,16,17,1.299509,103.837
465470,0,1,1,1.299509,103.837
465471,0,1,1,1.299509,103.837
465472,0,1,1,1.299509,103.837
465473,2,0,2,1.299509,103.837
465475,1,0,1,1.299509,103.837
465487,1,0,1,1.299509,103.837
465488,18,1,19,1.299509,103.837
465489,13,1402,1415,1.299509,103.837
465490,32,2095,2127,1.299509,103.837
465491,34,1283,1317,1.299509,103.837
465492,6,49,55,1.299509,103.837
465493,1,40,41,1.299509,103.837
465494,272,93,365,1.299509,103.837
465495,194,64,258,1.324433,103.929224
465496,555,33,588,1.325105,103.929255
465497,468,103,571,1.299509,103.837
465498,186,773,959,1.299509,103.837
465499,150,194,344,1.299509,103.837
465500,222,118265,118487,1.299509,103.837
465501,75,1461,1536,1.299509,103.837
465504,5,9,14,1.299509,103.837
465505,2,5,7,1.299509,103.837
465506,3,0,3,1.299509,103.837
465507,5,3,8,1.299509,103.837
465509,37,804,841,1.299509,103.837
465513,20,1589,1609,1.299509,103.837
465514,272,174,446,1.328421,103.946948
465515,249,102,351,1.327887,103.946411
465516,69,31,100,1.328173,103.946362
465517,506,19,525,1.328677,103.94677
465518,194,245,439,1.328766,103.946702
465519,4,54,58,1.318224,103.952727
465520,414,151,565,1.314159,103.937738
465521,360,19,379,1.313728,103.937804
465522,360,77,437,1.314126,103.937471
465523,189,11,200,1.313883,103.937489
465524,757,44,801,1.32958,103.94608
465525,913,7,920,1.329689,103.945412
465526,508,0,508,1.329645,103.945211
465527,679,3,682,1.32957,103.944982
465528,101,6,107,1.328796,103.94539
465529,1132,1020,2152,1.32958,103.94608
465530,554,7,561,1.329189,103.945433
465531,616,108,724,1.329152,103.945172
465532,549,263,812,1.328973,103.946299
465533,789,6,795,1.328843,103.946126
465534,461,13,474,1.328692,103.945889
465535,426,33,459,1.32859,103.945677
465536,335,99,434,1.328584,103.945479
465538,193,778,971,1.328332,103.947011
465540,45,9,54,1.314975,103.943427
465541,8,1,9,1.319157,103.952159
465542,14,36,50,1.319157,103.952159
465543,9,1,10,1.319157,103.952159
465544,14,3,17,1.319157,103.952159
465545,10,0,10,1.330601,103.945039
465546,2,0,2,1.299509,103.837
465547,14,3,17,1.330578,103.944955
465548,17,7,24,1.330551,103.944888
465549,7,772,779,1.31799,103.952688
465550,26,55,81,1.318814,103.952243
465551,2,63,65,1.318833,103.952325
465552,4,4,8,1.319018,103.952421
465554,53,0,53,1.319354,103.952881
465555,3,0,3,1.299509,103.837
465556,643,356,999,1.317967,103.953951
465557,26,0,26,1.317966,103.953978
465558,1143,510,1653,1.328157,103.94446
465559,1564,157,1721,1.329049,103.943799
465560,1317,212,1529,1.328594,103.944558
465561,438,772,1210,1.315759,103.947167
465562,2,42,44,1.330394,103.944121
465564,1,2,3,1.319354,103.952881
465565,1,0,1,1.299509,103.837
465566,35,0,35,1.330206,103.944299
465567,1,4,5,1.330152,103.944219
465568,7,0,7,1.330146,103.944325
465569,1,1,2,1.330596,103.944996
465571,1,0,1,1.330225,103.944189
465572,26,0,26,1.329916,103.944314
465573,33,0,33,1.329844,103.944345
465574,0,35,35,1.329794,103.944358
465575,182,72,254,1.331306,103.945299
465576,0,2,2,1.330096,103.944243
465577,32,9,41,1.331186,103.945369
465578,37,2,39,1.331124,103.945384
465579,0,1,1,1.329959,103.944292
465580,1,0,1,1.331076,103.945396
465581,7,1,8,1.330978,103.945435
465582,6,2,8,1.330927,103.945451
465583,1,6,7,1.330876,103.945482
465584,3,3,6,1.330819,103.945503
465585,13,10,23,1.330729,103.945537
465586,0,4,4,1.330668,103.945553
465587,8,4,12,1.330624,103.945569
465588,1,4,5,1.330576,103.945592
465589,0,9,9,1.330519,103.945599
465590,9,1,10,1.330468,103.94563
465591,9,3,12,1.330416,103.945645
465592,13,9,22,1.330347,103.945672
465593,6,13,19,1.330298,103.945681
465594,8,53,61,1.330236,103.945697
465595,33,0,33,1.33037,103.944787
465596,2,45,47,1.330747,103.945087
465597,6,0,6,1.330282,103.944821
465598,2,1,3,1.330275,103.944162
465600,3,0,3,1.330754,103.945136
465601,1,2,3,1.330648,103.945179
465602,10,30,40,1.329478,103.943751
465604,2,22,24,1.329507,103.943835
465605,52,1,53,1.329526,103.943889
465606,3,7,10,1.329545,103.943933
465607,2,1,3,1.330629,103.945112
465608,9,2,11,1.329597,103.944035
465609,10,8,18,1.329623,103.9441
465610,9,12,21,1.32964,103.944149
465612,8,2,10,1.32989,103.94467
465613,1,0,1,1.331026,103.945417
465614,1,1,2,1.331251,103.94533
465615,1,0,1,1.329943,103.944685
465616,2,3,5,1.32999,103.944841
465617,5,1,6,1.330006,103.944892
465618,1,6,7,1.330071,103.94507
465619,26,1,27,1.330091,103.945142
465620,0,3,3,1.329575,103.94399
465621,1,0,1,1.329983,103.9448
465622,3,2,5,1.330126,103.945321
465623,1,0,1,1.330108,103.945264
465624,21,1,22,1.330143,103.945436
465625,1,8,9,1.33005,103.943684
465626,24,1,25,1.330037,103.943635
465627,1,40,41,1.330021,103.943573
465628,34,95,129,1.331589,103.945467
465629,4,1,5,1.331616,103.945502
465631,1,0,1,1.330133,103.945374
465632,32,7,39,1.331623,103.945496
465633,2,0,2,1.329964,103.944746
465634,7,1,8,1.331501,103.945618
465635,0,3,3,1.330102,103.945209
465636,32,10,42,1.331526,103.945641
465637,5,1,6,1.331519,103.94564
465638,3,0,3,1.331529,103.945645
465640,2,1,3,1.331523,103.945651
465641,29,0,29,1.331382,103.94573
465642,3,0,3,1.33138,103.945733
465645,9,1,10,1.331408,103.945703
465646,5,0,5,1.33141,103.945733
465647,8,0,8,1.331341,103.945862
465649,1,0,1,1.331616,103.945476
465650,3,1,4,1.331341,103.945833
465651,9,0,9,1.331343,103.945866
465652,1,7,8,1.331202,103.945946
465653,4,0,4,1.331197,103.945906
465654,10,2,12,1.331203,103.945913
465655,47,0,47,1.331224,103.945907
465656,3,0,3,1.331407,103.945728
465657,3,9,12,1.331093,103.945999
465658,14,0,14,1.331094,103.946002
465659,8,0,8,1.331085,103.946003
465660,2,8,10,1.331087,103.946029
465661,2,9,11,1.33112,103.946026
465662,6,18,24,1.330975,103.946083
465663,58,10,68,1.330971,103.946118
465665,0,1,1,1.331336,103.945838
465667,0,16,16,1.33076,103.946364
465669,12,0,12,1.330761,103.946348
465670,3,10,13,1.330784,103.946371
465671,4,0,4,1.330753,103.946374
465672,23,0,23,1.330601,103.945967
465673,11,1,12,1.330758,103.946365
465674,55,0,55,1.33078,103.946372
465675,6,15,21,1.330416,103.946418
465676,4,15,19,1.330444,103.946391
465677,22,0,22,1.330425,103.946419
465678,18,0,18,1.330451,103.946419
465679,2,0,2,1.331523,103.945616
465680,4,0,4,1.330451,103.946394
465681,3,1,4,1.330444,103.94639
465682,6,0,6,1.330422,103.946394
465683,26,11,37,1.330318,103.946448
465684,4,0,4,1.330299,103.946474
465685,0,1,1,1.330976,103.946113
465686,4,4,8,1.330295,103.946437
465687,5,0,5,1.330322,103.946475
465688,5,0,5,1.330294,103.946442
465690,0,6,6,1.330323,103.946462
465691,2,4,6,1.330183,103.946581
465692,89,0,89,1.330185,103.946577
465693,1,0,1,1.330313,103.946435
465694,9,0,9,1.330211,103.946568
465696,7,0,7,1.330184,103.946548
465698,3,0,3,1.331222,103.945914
465700,14,3,17,1.329469,103.946509
465701,2,0,2,1.33045,103.946425
465702,0,2,2,1.329469,103.946509
465704,64,0,64,1.329469,103.946509
465705,44,2,46,1.329469,103.946509
465706,20,0,20,1.329469,103.946509
465707,34,0,34,1.329469,103.946509
465708,73,0,73,1.329469,103.946509
465709,4,2,6,1.329469,103.946509
465710,3,0,3,1.330206,103.946578
465711,0,1,1,1.330213,103.946542
465714,26,0,26,1.329469,103.946509
465715,24,4,28,1.329469,103.946509
465716,2,1,3,1.329469,103.946509
465717,65,7,72,1.329469,103.946509
465718,4,0,4,1.329469,103.946509
465719,7,1,8,1.329469,103.946509
465721,1,5,6,1.329469,103.946509
465722,0,4,4,1.329469,103.946509
465723,2,3,5,1.329469,103.946509
465724,0,1,1,1.329469,103.946509
465725,4,32,36,1.329469,103.946509
465726,4,5,9,1.329469,103.946509
465728,14,1,15,1.329469,103.946509
465729,1,0,1,1.329469,103.946509
465730,2,0,2,1.329469,103.946509
465731,24,0,24,1.329469,103.946509
465732,2,10,12,1.329469,103.946509
465733,7,0,7,1.329469,103.946509
465735,7,0,7,1.329469,103.946509
465736,0,4,4,1.329469,103.946509
465737,2,0,2,1.329469,103.946509
465738,12,2,14,1.329469,103.946509
465739,28,110,138,1.329469,103.946509
465740,18,0,18,1.329469,103.946509
465742,1,0,1,1.329469,103.946509
465743,7,0,7,1.329469,103.946509
465744,161,0,161,1.329469,103.946509
465745,0,19,19,1.329469,103.946509
465746,1,0,1,1.329469,103.946509
465747,17,1,18,1.329469,103.946509
465748,31,35,66,1.329469,103.946509
465749,12,0,12,1.329469,103.946509
465750,0,2,2,1.329469,103.946509
465754,2,0,2,1.329896,103.946278
465755,41,3,44,1.329469,103.946509
465758,21,2,23,1.329469,103.946509
465759,6,0,6,1.329469,103.946509
465760,17,4,21,1.3306,103.945977
465761,6,0,6,1.330585,103.945947
465762,1,39,40,1.329469,103.946509
465763,2,0,2,1.329469,103.946509
465764,1,3,4,1.330584,103.945942
465766,2,0,2,1.330583,103.945939
465767,9,0,9,1.330579,103.945974
465769,1,0,1,1.329469,103.946509
465771,6,0,6,1.330605,103.945977
465772,1,0,1,1.330602,103.945967
465773,0,7,7,1.330987,103.945689
465776,34,1,35,1.331107,103.945635
465777,20,12,32,1.331115,103.945618
465778,7,25,32,1.33054,103.945836
465779,6,0,6,1.33057,103.945806
465780,16,0,16,1.330571,103.945832
465781,23,0,23,1.330543,103.94581
465782,44,0,44,1.330569,103.945815
465784,25,0,25,1.330544,103.945812
465785,6,0,6,1.330536,103.94584
465786,10,0,10,1.330567,103.945835
465787,40,0,40,1.33054,103.945843
465788,12,0,12,1.330564,103.945806
465791,66,5,71,1.329469,103.946509
465792,1,0,1,1.330585,103.945966
465793,25,0,25,1.329469,103.946509
465794,1,0,1,1.329469,103.946509
465795,9,204,213,1.329469,103.946509
465797,4,0,4,1.329469,103.946509
465799,40,3,43,1.329469,103.946509
465800,5,0,5,1.329469,103.946509
465801,5,0,5,1.329469,103.946509
465802,3,0,3,1.329469,103.946509
465803,53,0,53,1.31989,103.948604
465804,2,0,2,1.33061,103.945943
465805,4,0,4,1.324695,103.949724
465806,7,3,10,1.324632,103.949758
465808,0,1,1,1.329469,103.946509
465810,6,0,6,1.324369,103.949923
465811,3,0,3,1.329469,103.946509
465812,3,2,5,1.32426,103.949986
465813,2,0,2,1.324747,103.949701
465814,0,2,2,1.324209,103.950009
465816,0,3,3,1.324312,103.949957
465818,0,1,1,1.324506,103.949843
465819,0,2,2,1.324199,103.950204
465820,1,0,1,1.324096,103.950289
465823,7,1,8,1.323985,103.95014
465825,14,0,14,1.323928,103.950168
465826,3,2,5,1.324568,103.949419
465827,0,2,2,1.324071,103.950071
465830,0,1,1,1.324056,103.950335
465833,1,0,1,1.324499,103.949465
465834,5,2,7,1.324413,103.949516
465835,7,1,8,1.32434,103.949411
465836,1,0,1,1.324397,103.949383
465837,2,0,2,1.324535,103.949326
465838,1,4,5,1.32431,103.949561
465839,9,3,12,1.324225,103.94948
465840,1,0,1,1.324368,103.949539
465841,0,5,5,1.324179,103.94952
465842,1,3,4,1.324213,103.949624
465843,2,8,10,1.323994,103.949553
465844,0,2,2,1.324283,103.949446
465845,1,0,1,1.324259,103.949596
465846,0,2,2,1.324173,103.949658
465847,12,3,15,1.323937,103.949604
465848,13,0,13,1.324058,103.949721
465849,10,0,10,1.323902,103.949627
465850,0,3,3,1.324148,103.950244
465851,6,2,8,1.323862,103.94965
465852,3,1,4,1.323967,103.949784
465853,1,0,1,1.323965,103.949576
465854,0,3,3,1.324007,103.949749
465855,32,3,35,1.323794,103.949707
465857,5,1,6,1.323812,103.949869
465859,2,0,2,1.32411,103.949704
465860,14,7,21,1.32043,103.948148
465861,4,3,7,1.319484,103.950239
465862,50,7,57,1.319508,103.950278
465863,6,1,7,1.319969,103.951385
465864,2,0,2,1.323703,103.949926
465866,8,0,8,1.320214,103.949125
465867,10,1,11,1.320179,103.949067
465868,1,1,2,1.317943,103.948539
465869,5,3,8,1.3196,103.95042
465870,12,2,14,1.319498,103.949952
465871,2,19,21,1.319626,103.949301
465872,87,5,92,1.3196,103.94924
465873,4,3,7,1.319323,103.948812
465877,21,0,21,1.314664,103.942043
465878,3,0,3,1.323909,103.949812
465879,24,0,24,1.314696,103.942049
465880,3,0,3,1.314693,103.942043
465882,5,0,5,1.314663,103.942079
465884,129,4,133,1.313249,103.937667
465885,16,10,26,1.320764,103.950007
465886,131,0,131,1.320793,103.949956
465887,160,11,171,1.320804,103.949911
465888,5,0,5,1.320822,103.949842
465889,0,6,6,1.320839,103.94979
465890,0,2,2,1.319585,103.950386
465891,0,2,2,1.320856,103.949739
465892,5,2,7,1.319074,103.949587
465893,63,1,64,1.31916,103.949767
465894,3,2,5,1.319234,103.949851
465895,71,0,71,1.319263,103.949893
465896,1,2,3,1.31467,103.942047
465897,0,2,2,1.319002,103.949476
465898,13,0,13,1.31931,103.949635
465899,46,16,62,1.320391,103.948314
465900,0,1,1,1.323828,103.949672
465901,4,0,4,1.320109,103.948643
465902,7,7,14,1.320497,103.949268
465903,4,49,53,1.320474,103.949226
465904,6,0,6,1.320279,103.948896
465905,1,5,6,1.320234,103.948854
465906,4,0,4,1.319954,103.948404
465907,1,2,3,1.319315,103.949984
465908,48,3,51,1.32004,103.94959
465909,6,7,13,1.319787,103.949189
465910,38,14,52,1.319758,103.949137
465911,10,0,10,1.321412,103.949794
465912,52,15,67,1.321478,103.949819
465913,3,1,4,1.321642,103.950006
465914,17,2,19,1.321505,103.949991
465915,7,5,12,1.321415,103.949969
465916,19,0,19,1.321367,103.94995
465917,4,0,4,1.321288,103.949921
465918,1,1,2,1.319248,103.949546
465919,0,1,1,1.318971,103.94921
465920,0,2,2,1.321239,103.949903
465921,4,0,4,1.321131,103.949696
465922,27,0,27,1.321202,103.949723
465923,0,1,1,1.321146,103.949856
465925,0,4,4,1.31968,103.949389
465926,44,37,81,1.319722,103.949447
465927,1,1,2,1.321099,103.949843
465928,5,0,5,1.319967,103.95044
465929,1,3,4,1.32046,103.950156
465930,0,2,2,1.320015,103.950463
465931,68,1,69,1.320765,103.948949
465932,8,0,8,1.320685,103.948806
465933,0,1,1,1.321283,103.94974
465934,14,11,25,1.318817,103.950013
465935,2,1,3,1.320094,103.949671
465936,1,4,5,1.318741,103.949884
465937,2,0,2,1.320403,103.950138
465938,2,2,4,1.319144,103.949739
465939,87,5,92,1.318506,103.948118
465940,6,67,73,1.318833,103.948554
465941,1,0,1,1.318843,103.95005
465942,1,0,1,1.318833,103.948554
465943,17,0,17,1.318587,103.948084
465944,10,0,10,1.318604,103.948072
465945,3,0,3,1.318757,103.949926
465947,1,3,4,1.318661,103.94805
465948,8,0,8,1.318678,103.94805
465949,1,0,1,1.318564,103.948095
465950,117,0,117,1.318684,103.948004
465952,5,92,97,1.317918,103.948532
465954,42,0,42,1.317955,103.948532
465955,0,39,39,1.317943,103.948529
465956,1,1,2,1.319097,103.949625
465957,0,8,8,1.318758,103.948158
465958,4,55,59,1.318833,103.948554
465960,18,0,18,1.318833,103.948554
465962,13,54,67,1.318821,103.948266
465963,5,0,5,1.318833,103.948283
465964,9,0,9,1.318833,103.948311
465965,52,0,52,1.31881,103.948323
465966,56,0,56,1.318833,103.948554
465967,122,0,122,1.318787,103.948351
465968,2,0,2,1.317922,103.948507
465969,5,0,5,1.318833,103.948554
465970,14,0,14,1.318833,103.948554
465972,19,31,50,1.318833,103.948554
465973,0,3,3,1.318833,103.948554
465976,7,0,7,1.319556,103.948817
465978,56,10,66,1.318821,103.949134
465979,5,12,17,1.318909,103.9491
465980,11,2,13,1.320324,103.950567
465981,24,0,24,1.320257,103.950547
465982,0,2,2,1.318776,103.948363
465983,67,0,67,1.320126,103.950497
465984,78,0,78,1.319822,103.950389
465985,3,7,10,1.319787,103.950351
465986,7,0,7,1.319642,103.950202
465987,10,2,12,1.319624,103.950157
465988,5,2,7,1.319569,103.950078
465989,128,6,134,1.319548,103.950035
465990,158,2,160,1.319548,103.950035
465991,5,1,6,1.319467,103.949902
465992,3,9,12,1.319419,103.949807
465993,2,0,2,1.320176,103.950519
465994,13,5,18,1.319334,103.949673
465996,3,4,7,1.319777,103.94957
465997,1,0,1,1.318678,103.948027
465998,0,2,2,1.319392,103.949769
465999,61,0,61,1.319921,103.949774
466000,3,1,4,1.31995,103.949832
466001,18,0,18,1.320007,103.949903
466002,55,0,55,1.320039,103.949952
466003,1,0,1,1.319844,103.949641
466004,6,6,12,1.320187,103.950046
466005,10,1,11,1.32029,103.950084
466006,1,9,10,1.320325,103.950107
466007,13,4,17,1.320324,103.94898
466008,3,1,4,1.320356,103.949019
466009,0,3,3,1.318759,103.94838
466011,91,0,91,1.320672,103.949418
466012,9,2,11,1.320731,103.949433
466013,77,4,81,1.320498,103.948699
466014,5,14,19,1.32061,103.948693
466016,24,0,24,1.320685,103.948806
466017,4,0,4,1.320765,103.948949
466018,0,13,13,1.320828,103.949023
466019,10,25,35,1.319844,103.949273
466020,2,0,2,1.31986,103.949696
466021,4,5,9,1.319934,103.94938
466022,14,0,14,1.319934,103.94938
466023,5,0,5,1.31996,103.949448
466024,6,0,6,1.320018,103.949541
466025,2,2,4,1.320126,103.949729
466026,6,0,6,1.320284,103.949871
466027,4,2,6,1.320083,103.948931
466028,7,2,9,1.320128,103.948992
466030,3,11,14,1.320297,103.949245
466031,2,0,2,1.319886,103.949312
466032,38,57,95,1.320365,103.949361
466033,9,0,9,1.320464,103.949471
466034,2,6,8,1.32051,103.949471
466035,7,11,18,1.320692,103.949617
466036,2,0,2,1.32051,103.949471
466037,2,6,8,1.320582,103.949904
466038,38,20,58,1.320557,103.949972
466039,13,45,58,1.318652,103.949632
466040,1,0,1,1.320116,103.95001
466041,4,1,5,1.319661,103.951241
466042,9,4,13,1.319757,103.95114
466043,4,1,5,1.320003,103.951326
466044,6,0,6,1.319923,103.951544
466045,65,8,73,1.319084,103.951938
466047,1,0,1,1.319591,103.951715
466050,1,0,1,1.321657,103.949562
466051,2,0,2,1.320657,103.949727
466053,3,0,3,1.3204,103.949109
466054,7,1,8,1.321708,103.949502
466056,1,0,1,1.32172,103.949375
466057,2,0,2,1.321657,103.949562
466058,1,0,1,1.321755,103.949482
466060,3,0,3,1.3217,103.949444
466061,2,0,2,1.321657,103.949562
466062,4,0,4,1.321657,103.949562
466063,6,0,6,1.321657,103.949562
466064,10,0,10,1.321657,103.949562
466065,38,30,68,1.321698,103.949576
466066,8,0,8,1.321698,103.949576
466067,1,0,1,1.321657,103.949562
466068,38,0,38,1.321698,103.949576
466070,6,0,6,1.321698,103.949576
466072,213,0,213,1.321698,103.949576
466074,4,0,4,1.321698,103.949576
466075,12,0,12,1.321698,103.949576
466076,36,0,36,1.321698,103.949576
466077,6,1,7,1.321698,103.949576
466078,4,1,5,1.321698,103.949576
466079,1,0,1,1.321698,103.949576
466080,6,12,18,1.319442,103.949077
466081,2,1,3,1.321741,103.949392
466082,78,1,79,1.319659,103.948933
466083,22,1,23,1.320109,103.948643
466084,5,3,8,1.319974,103.948721
466085,39,13,52,1.319024,103.949321
466086,4,114,118,1.299509,103.837
466087,9,7,16,1.320466,103.94845
466088,6,1,7,1.32034,103.948206
466089,42,17,59,1.31942,103.95015
466090,61,2,63,1.31934,103.950027
466091,98,1,99,1.320993,103.949375
466092,3,2,5,1.320976,103.949415
466093,38,0,38,1.320948,103.949463
466094,0,1,1,1.319376,103.948946
466095,52,0,52,1.320909,103.949573
466096,1,8,9,1.320887,103.949625
466097,0,5,5,1.320873,103.949671
466098,7,2,9,1.320736,103.950109
466100,124,0,124,1.320672,103.950303
466101,1,2,3,1.319495,103.948694
466102,7,1,8,1.320619,103.950467
466103,6,8,14,1.320639,103.949788
466104,26,4,30,1.320582,103.949904
466105,6,10,16,1.318565,103.94984
466106,2,12,14,1.318457,103.949562
466107,17,24,41,1.318565,103.94984
466108,1,5,6,1.318457,103.949562
466109,32,5,37,1.318565,103.94984
466110,5,45,50,1.318565,103.94984
466111,6,1,7,1.318457,103.949562
466112,0,3,3,1.320656,103.950377
466113,4,6,10,1.318565,103.94984
466114,24,25,49,1.318565,103.94984
466115,5,3,8,1.318565,103.94984
466116,24,6,30,1.318457,103.949562
466117,13,7,20,1.318565,103.94984
466118,7,8,15,1.318359,103.949255
466119,4,8,12,1.31837,103.949201
466120,69,13,82,1.318457,103.949562
466121,221,5,226,1.318244,103.949036
466122,30,3,33,1.318457,103.949562
466123,5,5,10,1.318457,103.949562
466124,21,3,24,1.318457,103.949562
466125,17,4,21,1.318457,103.949562
466126,23,14,37,1.318457,103.949562
466127,9,47,56,1.318457,103.949562
466128,31,4,35,1.318051,103.949315
466129,37,7,44,1.318457,103.949562
466130,0,18,18,1.318457,103.949562
466131,1,2,3,1.318565,103.94984
466132,23,15,38,1.318457,103.949562
466133,4,10,14,1.318457,103.949562
466134,1,19,20,1.318457,103.949562
466135,1,1,2,1.321657,103.949562
466136,154,16,170,1.318565,103.94984
466137,0,3,3,1.318457,103.949562
466138,13,12,25,1.318565,103.94984
466139,12,1,13,1.318457,103.949562
466140,17,13,30,1.318565,103.94984
466141,86,6,92,1.318565,103.94984
466142,1,11,12,1.318457,103.949562
466143,81,11,92,1.318457,103.949562
466144,105,33,138,1.318301,103.950218
466145,4,10,14,1.318295,103.950277
466146,6,142,148,1.318331,103.950316
466147,33,104,137,1.318349,103.950371
466148,1,4,5,1.318376,103.950448
466149,11,146,157,1.318361,103.950523
466150,2,2,4,1.318379,103.95055
466151,19,48,67,1.318392,103.950607
466153,10,65,75,1.31842,103.950704
466154,9,0,9,1.318442,103.950764
466155,4,55,59,1.318473,103.950806
466156,67,2,69,1.318494,103.95087
466157,107,75,182,1.318483,103.950922
466158,9,0,9,1.318533,103.950996
466159,15,41,56,1.318502,103.951016
466160,15,0,15,1.318563,103.95109
466161,30,58,88,1.318568,103.951111
466162,8,1,9,1.318564,103.951163
466163,17,81,98,1.318592,103.951213
466164,23,1,24,1.318621,103.951274
466165,2,36,38,1.318597,103.951348
466166,5,1,6,1.318648,103.95141
466167,3,20,23,1.318658,103.951422
466168,49,0,49,1.318745,103.951327
466169,35,1,36,1.318796,103.951343
466170,178,0,178,1.318874,103.951302
466171,1,0,1,1.320936,103.9495
466172,4,0,4,1.31895,103.95127
466173,48,0,48,1.319011,103.951256
466174,37,1,38,1.319065,103.951237
466175,9,0,9,1.31912,103.95124
466177,27,2,29,1.31916,103.950786
466178,33,2,35,1.318708,103.951179
466179,8,0,8,1.318761,103.951118
466180,24,1,25,1.318752,103.951053
466181,3,0,3,1.318457,103.949562
466182,31,6,37,1.318807,103.950927
466183,18,7,25,1.319013,103.951014
466184,8,6,14,1.318843,103.950758
466185,21,4,25,1.318979,103.951117
466186,0,3,3,1.318811,103.950965
466187,2,3,5,1.319021,103.951007
466188,9,6,15,1.319058,103.950976
466189,19,4,23,1.319069,103.950905
466190,5,3,8,1.319074,103.950834
466191,1,1,2,1.318565,103.94984
466192,58,1,59,1.31916,103.950786
466193,3,3,6,1.31916,103.950786
466194,18,0,18,1.31895,103.950652
466195,10,3,13,1.318917,103.950635
466196,1,5,6,1.318898,103.950594
466197,54,2,56,1.318613,103.950896
466198,21,1,22,1.318622,103.950812
466199,6,3,9,1.31916,103.950786
466201,76,3,79,1.318699,103.950616
466202,36,2,38,1.318736,103.950555
466203,5,2,7,1.31852,103.950564
466204,32,1,33,1.318552,103.950491
466205,151,4,155,1.318559,103.950412
466206,6,13,19,1.318569,103.950315
466207,38,6,44,1.31916,103.950786
466208,0,2,2,1.31916,103.950786
466209,16,4,20,1.318782,103.950372
466210,2,1,3,1.31916,103.950786
466211,2,4,6,1.318755,103.950302
466212,4,2,6,1.318712,103.950264
466213,18,8,26,1.318668,103.950225
466214,21,8,29,1.318665,103.95017
466215,14,13,27,1.318632,103.950102
466216,11,81,92,1.318457,103.949562
466217,11,6,17,1.322104,103.948552
466218,7,2,9,1.322104,103.948552
466220,4,3,7,1.322104,103.948552
466221,42,23,65,1.318696,103.94974
466222,2,3,5,1.318713,103.949785
466223,38,3,41,1.319407,103.950847
466224,10,0,10,1.319436,103.950876
466225,13,0,13,1.319546,103.950917
466226,10,0,10,1.319604,103.950944
466227,38,2,40,1.320029,103.950646
466228,26,2,28,1.319986,103.950626
466229,2,0,2,1.31916,103.950786
466230,6,3,9,1.319834,103.95058
466231,3,12,15,1.320333,103.95074
466232,107,0,107,1.320316,103.950791
466233,40,4,44,1.320293,103.950863
466234,5,0,5,1.320276,103.950934
466235,19,2,21,1.32026,103.951012
466236,8,1,9,1.320243,103.95108
466237,4,42,46,1.321661,103.94813
466239,0,1,1,1.318903,103.951315
466240,68,0,68,1.32151,103.948232
466243,6,9,15,1.321368,103.948312
466244,13,1,14,1.319226,103.950663
466245,2,3,5,1.319245,103.950718
466246,29,20,49,1.319704,103.950965
466247,57,0,57,1.319758,103.95099
466248,25,0,25,1.319838,103.95103
466249,1,0,1,1.321556,103.948205
466250,6,2,8,1.320291,103.947988
466251,0,2,2,1.319892,103.9506
466252,5,0,5,1.320221,103.947889
466253,27,0,27,1.320195,103.947855
466254,3,0,3,1.31916,103.950786
466255,0,2,2,1.320264,103.947954
466256,2,0,2,1.320146,103.947761
466257,0,1,1,1.319892,103.95103
466259,2,269,271,1.320047,103.947575
466260,3,160,163,1.319858,103.947557
466261,2,0,2,1.320127,103.947714
466263,0,3,3,1.320168,103.947801
466264,1,0,1,1.320108,103.947683
466265,2,2,4,1.320016,103.947801
466266,1,0,1,1.319978,103.947746
466267,1,0,1,1.320042,103.947844
466268,1,0,1,1.32007,103.947892
466269,0,4,4,1.320142,103.948007
466270,3,3,6,1.319718,103.948151
466271,1,2,3,1.319959,103.947703
466272,2,1,3,1.319689,103.948104
466273,0,1,1,1.320099,103.947946
466274,8,0,8,1.319602,103.947963
466275,1,4,5,1.319576,103.947924
466276,4,0,4,1.319541,103.94787
466277,16,63,79,1.319497,103.947791
466278,3,30,33,1.319458,103.947739
466279,1,0,1,1.31963,103.948006
466280,0,7,7,1.319367,103.947849
466281,3,0,3,1.319656,103.94805
466282,0,10,10,1.319427,103.94798
466283,31,0,31,1.31946,103.948025
466284,0,14,14,1.319519,103.948099
466285,2,19,21,1.319073,103.948283
466286,0,2,2,1.319886,103.947611
466287,2,0,2,1.319047,103.948222
466288,44,195,239,1.318931,103.948055
466289,2,0,2,1.318962,103.948103
466290,13,0,13,1.321186,103.948104
466291,0,4,4,1.321164,103.948064
466292,1,0,1,1.319331,103.947801
466293,0,6,6,1.321106,103.947971
466294,58,0,58,1.321068,103.947907
466295,0,7,7,1.320685,103.947741
466296,184,0,184,1.321044,103.947869
466298,10,0,10,1.32102,103.947821
466299,0,1,1,1.321129,103.948014
466300,18,1,19,1.320997,103.947792
466301,2,0,2,1.31982,103.948491
466302,15,1,16,1.320915,103.94768
466303,27,16,43,1.320569,103.947564
466304,0,1,1,1.32062,103.947651
466305,2,0,2,1.320596,103.947608
466306,10,3,13,1.320867,103.947597
466307,2,17,19,1.320517,103.947471
466308,1,9,10,1.32201,103.948626
466309,1,2,3,1.319399,103.947914
466310,0,2,2,1.320541,103.947517
466311,19,0,19,1.32182,103.948744
466312,21,2,23,1.321771,103.948776
466313,17,0,17,1.321722,103.948809
466314,5,4,9,1.321678,103.948831
466315,17,0,17,1.321625,103.948866
466316,0,2,2,1.321869,103.948716
466317,2,0,2,1.321674,103.947539
466318,39,1,40,1.321728,103.947678
466319,6,0,6,1.321786,103.947689
466320,144,1,145,1.321833,103.947808
466321,8,0,8,1.321842,103.947809
466322,56,0,56,1.320837,103.947549
466323,1,0,1,1.320893,103.947635
466324,36,2,38,1.320808,103.947492
466325,43,21,64,1.320465,103.947384
466327,10,1640,1650,1.320438,103.947329
466328,8,59,67,1.320759,103.947394
466329,9,3,12,1.32043,103.948148
466330,25,3,28,1.32043,103.948148
466331,9,1,10,1.32043,103.948148
466332,0,13,13,1.32043,103.948148
466333,6,0,6,1.320502,103.948251
466334,5,7,12,1.320568,103.948381
466335,2,0,2,1.32169,103.947575
466336,0,5,5,1.320743,103.948598
466337,34,1,35,1.320817,103.948738
466338,84,40,124,1.320877,103.948844
466339,4,10,14,1.320977,103.948953
466340,1,10,11,1.321388,103.948763
466341,6,0,6,1.321356,103.948714
466342,0,7,7,1.32133,103.94866
466343,2,0,2,1.320658,103.948485
466344,0,6,6,1.321262,103.948573
466345,184,0,184,1.321227,103.948534
466346,32,4,36,1.321174,103.948436
466347,3,0,3,1.321953,103.948668
466348,0,2,2,1.3213,103.948619
466349,1,0,1,1.32049,103.947433
466350,0,2,2,1.321111,103.948351
466351,1,0,1,1.321084,103.948301
466352,21,3,24,1.320956,103.948103
466353,1,0,1,1.320998,103.948181
466354,2,2,4,1.320899,103.948
466355,18,0,18,1.320872,103.947948
466356,2,4,6,1.320822,103.947876
466357,3,3,6,1.320806,103.94784
466358,46,3,49,1.31891,103.950153
466359,6,0,6,1.318932,103.950184
466360,129,4,133,1.318994,103.950275
466361,0,1,1,1.320926,103.948052
466362,2,6,8,1.31907,103.950406
466363,2,2,4,1.319093,103.950439
466364,143,2,145,1.319223,103.95036
466365,1,0,1,1.319015,103.950306
466366,3,2,5,1.319485,103.951421
466367,6,0,6,1.319508,103.951647
466368,13,0,13,1.319636,103.951499
466369,27,1,28,1.319739,103.950531
466370,16,0,16,1.3197,103.950502
466371,1,1,2,1.321038,103.948244
466372,7,4,11,1.318883,103.949255
466373,15,3,18,1.318857,103.94924
466374,75,3,78,1.319413,103.951015
466375,123,2,125,1.319378,103.951186
466376,110,92,202,1.317776,103.941447
466377,1,5,6,1.31779,103.941449
466378,1,6,7,1.317721,103.94135
466379,20,5,25,1.317674,103.941573
466380,2,6,8,1.317585,103.941496
466381,3,0,3,1.321148,103.948394
466382,3,18,21,1.317506,103.941597
466383,0,1,1,1.319158,103.950581
466384,0,10,10,1.317406,103.941749
466385,12,3,15,1.31742,103.941875
466386,0,9,9,1.317172,103.941999
466387,2,0,2,1.318915,103.949348
466401,127,213,340,1.313894,103.934617
466402,1106,110,1216,1.313894,103.934617
466403,176,282,458,1.313894,103.934617
466404,46,594,640,1.314539,103.934276
466405,2,87,89,1.314633,103.934633
466406,11,0,11,1.314614,103.934754
466407,4,56,60,1.31464,103.934787
466410,3,77,80,1.314587,103.934907
466411,3,15,18,1.314605,103.934995
466412,4,362,366,1.314103,103.935081
466413,8,11,19,1.314611,103.935128
466414,1,83,84,1.314155,103.93526
466415,1,22,23,1.314635,103.935178
466416,1,212,213,1.314137,103.935363
466418,3,349,352,1.314146,103.935623
466419,1,0,1,1.31752,103.941744
466420,7,275,282,1.314155,103.935768
466421,0,22,22,1.314672,103.935346
466422,15,199,214,1.314207,103.935915
466424,3,87,90,1.314171,103.936001
466425,0,36,36,1.314686,103.935488
466427,0,11,11,1.31468,103.935583
466428,20,50,70,1.314697,103.935839
466429,1,0,1,1.314642,103.935297
466430,3,9,12,1.314726,103.936163
466431,54,74,128,1.314172,103.936212
466432,4,45,49,1.314777,103.936253
466433,16,261,277,1.314178,103.936282
466434,4,49,53,1.314801,103.936475
466435,0,7,7,1.314816,103.936565
466436,3,4,7,1.314801,103.936672
466437,1,18,19,1.314791,103.936742
466438,183,185,368,1.314245,103.937022
466439,0,1,1,1.314697,103.935892
466440,200,11,211,1.313533,103.936999
466441,4,15,19,1.314827,103.936951
466442,116,18,134,1.313152,103.937244
466443,0,3,3,1.317605,103.941657
466444,262,3,265,1.313524,103.937269
466445,0,103,103,1.314856,103.937163
466446,8,0,8,1.314904,103.937274
466447,3,194,197,1.314848,103.937328
466448,0,17,17,1.314869,103.937491
466449,0,70,70,1.314861,103.93756
466450,5,210,215,1.314836,103.93769
466451,6,1,7,1.314924,103.937724
466452,408,5,413,1.313347,103.937875
466453,0,31,31,1.314913,103.937883
466454,0,71,71,1.314959,103.93795
466455,349,12,361,1.313598,103.937553
466456,609,978,1587,1.313706,103.938066
466457,10,786,796,1.314401,103.938228
466458,1,5,6,1.314339,103.938247
466459,0,2,2,1.317324,103.942
466460,1,1,2,1.314253,103.938287
466461,1,2,3,1.314822,103.937069
466462,0,2,2,1.314213,103.938294
466463,0,3,3,1.314119,103.938314
466464,0,3,3,1.313999,103.938308
466465,12,22,34,1.31384,103.938336
466466,1,2,3,1.313946,103.938344
466467,7,2,9,1.313742,103.938395
466468,13,0,13,1.313683,103.938399
466469,2,0,2,1.314083,103.938299
466470,3,1,4,1.313563,103.938424
466471,1,18,19,1.313504,103.938433
466472,100,123,223,1.314198,103.938602
466473,153,7,160,1.313737,103.938707
466474,0,84,84,1.313617,103.93893
466475,1,0,1,1.31483,103.936905
466477,1171,6,1177,1.31362,103.93891
466480,0,5,5,1.313619,103.93893
466482,5,595,600,1.314405,103.939103
466483,3,192,195,1.313828,103.939274
466484,264,4,268,1.314406,103.939505
466485,2,47,49,1.315068,103.939316
466486,0,76,76,1.314464,103.936831
466487,0,19,19,1.315062,103.939356
466488,670,9,679,1.314019,103.939754
466489,11,127,138,1.315066,103.939411
466491,3,49,52,1.315098,103.939479
466493,2,127,129,1.315072,103.939538
466494,2,59,61,1.315089,103.93963
466495,6,60,66,1.31513,103.939733
466496,2,87,89,1.315124,103.939833
466497,36,79,115,1.314115,103.940605
466498,2,1,3,1.313772,103.938344
466499,429,915,1344,1.31537,103.940794
466500,131,39,170,1.314428,103.94119
466501,182,145,327,1.315904,103.940653
466502,120,127,247,1.316341,103.940661
466503,1049,103,1152,1.316246,103.941358
466504,755,42,797,1.316803,103.941465
466505,19,1081,1100,1.314917,103.94136
466506,528,17,545,1.316722,103.940776
466507,477,334,811,1.31577,103.941451
466508,228,800,1028,1.314616,103.941616
466509,14,16,30,1.315594,103.941933
466510,7,2,9,1.314504,103.941878
466511,19,21,40,1.315624,103.942075
466512,8,0,8,1.314765,103.941792
466513,0,4,4,1.315678,103.942225
466514,61,42,103,1.314789,103.941888
466515,1,409,410,1.314485,103.937017
466516,1,199,200,1.314486,103.937023
466517,0,1,1,1.313582,103.938898
466518,0,1,1,1.314486,103.937029
466519,422,8,430,1.315204,103.942858
466520,292,11,303,1.314722,103.942721
466521,42,92,134,1.314983,103.943015
466522,6,228,234,1.315204,103.943164
466523,80,12,92,1.315726,103.943154
466525,3,14,17,1.315731,103.943197
466526,138,534,672,1.315199,103.943359
466527,5,0,5,1.315753,103.943233
466528,57,14,71,1.315799,103.943287
466529,4,13,17,1.315781,103.943352
466530,1,20,21,1.315815,103.943403
466531,31,385,416,1.315339,103.943605
466532,2,8,10,1.315808,103.943421
466533,1,2,3,1.31413,103.940857
466534,0,13,13,1.315842,103.94347
466535,2,2,4,1.315259,103.94363
466536,4,128,132,1.315851,103.943463
466537,14,1,15,1.315196,103.943625
466538,1,0,1,1.314487,103.937035
466539,0,111,111,1.315729,103.943679
466540,18,4,22,1.315066,103.943674
466541,1,174,175,1.315961,103.944053
466542,38,0,38,1.315195,103.944023
466543,6,0,6,1.31601,103.944154
466544,4,68,72,1.31601,103.944154
466545,2,1,3,1.315303,103.943614
466546,8,287,295,1.31605,103.944246
466547,1,18,19,1.316049,103.944245
466548,54,5,59,1.315329,103.943961
466549,55,16,71,1.316078,103.944322
466550,0,20,20,1.316077,103.944321
466551,3,1,4,1.315356,103.943967
466552,4,275,279,1.316134,103.944475
466553,5,2,7,1.315411,103.94395
466554,1,2,3,1.315276,103.944007
466555,0,2,2,1.313611,103.938381
466556,5,0,5,1.316179,103.944616
466557,3,1,4,1.317131,103.944407
466558,1,178,179,1.315493,103.943935
466559,1,1,2,1.31618,103.944617
466560,54,1,55,1.316189,103.944627
466561,27,1,28,1.31712,103.944473
466562,6,563,569,1.31619,103.944628
466563,0,17,17,1.316189,103.944627
466564,0,3,3,1.315339,103.944129
466565,0,555,555,1.317184,103.944667
466567,1,66,67,1.317182,103.944694
466568,0,55,55,1.315551,103.944136
466569,19,1,20,1.315555,103.9442
466570,0,9,9,1.315593,103.944255
466571,1,1,2,1.31619,103.944628
466572,0,3,3,1.317154,103.944591
466573,5,0,5,1.31564,103.944404
466574,1,6,7,1.315634,103.944459
466576,0,5,5,1.315665,103.944602
466578,2,70,72,1.314512,103.937255
466579,0,18,18,1.314513,103.937261
466580,468,11,479,1.315819,103.944865
466581,467,391,858,1.315778,103.945214
466582,0,81,81,1.314515,103.937278
466583,2,27,29,1.314515,103.937284
466584,187,327,514,1.316054,103.945695
466585,3,81,84,1.316512,103.945863
466586,2,7,9,1.316513,103.945867
466587,1,51,52,1.316514,103.945874
466588,432,5,437,1.316516,103.945881
466589,0,38,38,1.316518,103.945887
466590,2,86,88,1.316519,103.945894
466591,5,36,41,1.316489,103.946744
466592,1,0,1,1.315146,103.943643
466593,0,31,31,1.316556,103.946985
466594,4,0,4,1.316567,103.947073
466595,2,136,138,1.316592,103.947121
466596,18,132,150,1.318,103.94879
466599,12,202,214,1.319255,103.953572
466600,60,0,60,1.31933,103.953635
466601,11,10,21,1.319406,103.954169
466602,0,6,6,1.319794,103.954072
466603,3,103,106,1.319284,103.954146
466604,11,0,11,1.319304,103.954184
466605,1,94,95,1.319343,103.954262
466606,5,228,233,1.319382,103.954339
466607,9,2,11,1.31942,103.954417
466608,53,168,221,1.32009,103.954919
466609,49,0,49,1.320092,103.954949
466610,6,0,6,1.320094,103.954909
466611,3,0,3,1.315623,103.944374
466613,10,1049,1059,1.319653,103.954881
466614,35,0,35,1.319692,103.954958
466615,2,0,2,1.315593,103.944286
466616,162,27,189,1.32049,103.954726
466617,33,0,33,1.320461,103.954721
466618,6,0,6,1.320459,103.954756
466619,7,0,7,1.320492,103.954719
466620,167,0,167,1.320471,103.954724
466621,3,0,3,1.319576,103.954726
466622,0,15,15,1.318862,103.952421
466623,0,2,2,1.319731,103.955036
466624,26,246,272,1.319139,103.953211
466625,47,0,47,1.31914,103.953231
466626,93,161,254,1.31919,103.953311
466627,21,4,25,1.31921,103.953337
466628,3,61,64,1.319207,103.953418
466629,26,109,135,1.319216,103.953433
466630,1,27,28,1.316414,103.946578
466631,16,0,16,1.31645,103.946661
466632,1,0,1,1.316559,103.94697
466633,0,17,17,1.316541,103.946881
466634,129,3,132,1.317913,103.953986
466636,0,8,8,1.329511,103.948027
466637,1,6,7,1.329487,103.947946
466638,17,0,17,1.32945,103.947852
466639,1,0,1,1.316474,103.946818
466640,35,1,36,1.329443,103.947805
466641,1,5,6,1.329399,103.947354
466642,34,0,34,1.329381,103.947668
466643,18,0,18,1.329361,103.947232
466644,3,3,6,1.329354,103.947612
466646,4,1,5,1.329301,103.947469
466647,1,3,4,1.329287,103.947423
466648,0,1,1,1.329445,103.947501
466663,549,831,1380,1.327073,103.943526
466664,793,402,1195,1.326444,103.942543
466665,1202,24,1226,1.327117,103.942765
466666,11,250,261,1.326757,103.943015
466668,1,4,5,1.322882,103.946091
466670,3,10,13,1.322343,103.946409
466671,315,8,323,1.3219,103.946688
466672,1,14,15,1.321332,103.947143
466673,0,7,7,1.321405,103.947303
466674,1,0,1,1.329215,103.947272
466675,1,2,3,1.320492,103.954749
466676,4,1,5,1.321666,103.947771
466677,0,4,4,1.321717,103.94788
466678,2,1,3,1.321575,103.947651
466679,8,6,14,1.321403,103.947624
466680,41,2,43,1.321309,103.947433
466681,0,21,21,1.321187,103.947231
466682,10,7,17,1.321717,103.94788
466683,3,47,50,1.329889,103.943556
466684,202,0,202,1.329871,103.943652
466685,61,3,64,1.329882,103.943687
466686,196,1,197,1.329894,103.943719
466687,32,6,38,1.329924,103.943813
466688,7,1,8,1.329943,103.943867
466689,12,1,13,1.329969,103.943916
466690,6,4,10,1.330002,103.943983
466691,24,1,25,1.330129,103.943921
466692,0,5,5,1.330115,103.943868
466693,0,5,5,1.330108,103.943835
466694,1,0,1,1.321485,103.947474
466696,12,56,68,1.319467,103.93801
466697,3,5,8,1.319395,103.93807
466698,1,13,14,1.319474,103.938046
466699,5,4,9,1.319401,103.938135
466701,2,1,3,1.32114,103.947527
466702,2,7,9,1.319503,103.93816
466703,2,2,4,1.319452,103.938433
466704,0,4,4,1.319518,103.93823
466705,6,0,6,1.319478,103.938581
466706,5,6,11,1.319533,103.938274
466709,5,0,5,1.319529,103.938879
466710,11,0,11,1.319549,103.938389
466711,0,3,3,1.319427,103.938284
466712,6,2,8,1.319557,103.938455
466713,10,0,10,1.31958,103.939177
466714,1,2,3,1.319554,103.939028
466715,8,60,68,1.319605,103.939326
466716,0,3,3,1.319561,103.938494
466717,3,3,6,1.319631,103.939475
466718,17,0,17,1.319599,103.938648
466719,48,0,48,1.319656,103.939623
466721,9,0,9,1.319682,103.939772
466722,1,10,11,1.319618,103.938764
466723,0,1,1,1.330089,103.943789
466724,22,351,373,1.319627,103.938811
466725,1,0,1,1.319707,103.939921
466726,30,0,30,1.319636,103.938857
466728,1,12,13,1.319645,103.938903
466729,10,0,10,1.319748,103.9402
466730,8,49,57,1.319657,103.938953
466732,20,73,93,1.319668,103.939005
466733,0,3,3,1.319587,103.938602
466734,2,3,5,1.319702,103.939145
466735,1,0,1,1.319734,103.940049
466736,2,1,3,1.31969,103.939095
466737,18,521,539,1.319736,103.939324
466738,6,2,8,1.319744,103.939369
466739,0,1,1,1.319714,103.939217
466740,0,3,3,1.319719,103.939256
466741,1,1,2,1.318877,103.95253
466743,1,877,878,1.319793,103.939686
466744,14,1,15,1.319805,103.93974
466745,0,3,3,1.319765,103.93948
466746,1,0,1,1.319753,103.939429
466747,10,0,10,1.319838,103.939926
466748,3,6,9,1.319852,103.939991
466749,3,234,237,1.319863,103.940057
466750,5,0,5,1.319889,103.940172
466751,1,5,6,1.319894,103.940222
466752,51,1,52,1.319904,103.94028
466753,5,1292,1297,1.319918,103.940335
466754,17,873,890,1.319925,103.940389
466755,0,1,1,1.319825,103.939864
466756,0,5,5,1.319939,103.940508
466757,11,0,11,1.319942,103.940573
466758,3,5,8,1.319947,103.940628
466759,0,1478,1478,1.319947,103.940689
466760,4,480,484,1.319948,103.940739
466776,0,158,158,1.315053,103.939047
466777,0,10,10,1.315158,103.939018
466778,6,5,11,1.315204,103.939016
466779,4,27,31,1.315263,103.939011
466781,363,47,410,1.315771,103.938335
466782,2,9,11,1.315784,103.938894
466783,1,4,5,1.315899,103.938866
466784,27,3,30,1.316443,103.938648
466785,1,32,33,1.316189,103.938815
466786,17,1,18,1.316616,103.938573
466787,0,1,1,1.319937,103.940441
466788,1,6,7,1.316286,103.938792
466789,26,0,26,1.316788,103.938567
466790,0,4,4,1.316838,103.938545
466791,0,1,1,1.316675,103.93857
466792,1,0,1,1.316471,103.93881
466794,2,1,3,1.319814,103.939795
466796,2,0,2,1.319775,103.93959
466797,2,0,2,1.317262,103.93848
466798,3,12,15,1.317347,103.938451
466799,14,0,14,1.317413,103.938448
466800,2,0,2,1.317306,103.938467
466805,54,2,56,1.317946,103.938305
466806,1,5,6,1.317201,103.938642
466807,3,0,3,1.316676,103.938746
466808,3,6,9,1.317272,103.938632
466809,16,16,32,1.317411,103.938607
466810,3,1,4,1.31748,103.938584
466812,13,2,15,1.317676,103.938541
466813,0,1,1,1.316579,103.938774
466814,3,3,6,1.319227,103.93785
466815,4,0,4,1.318691,103.938194
466816,1,3,4,1.319279,103.93785
466817,0,4,4,1.319342,103.937849
466818,3,7,10,1.319405,103.937838
466819,22,0,22,1.319474,103.937844
466820,7,0,7,1.319537,103.937838
466821,4,0,4,1.319588,103.937832
466822,3,357,360,1.319634,103.937827
466823,36,3,39,1.318397,103.938321
466824,6,0,6,1.318464,103.938306
466825,7,9,16,1.315322,103.938996
466827,16,45,61,1.315463,103.938996
466828,0,33,33,1.315553,103.938965
466829,1,2,3,1.318366,103.938193
466830,10,19,29,1.315945,103.938855
466831,14,3,17,1.316499,103.93862
466832,8,1,9,1.318672,103.938284
466833,0,2,2,1.316907,103.938702
466834,1,1,2,1.318733,103.938297
466835,64,5,69,1.318827,103.93824
466837,6,9,15,1.31827,103.93736
466839,2,0,2,1.318801,103.93826
466840,35,3,38,1.318222,103.937602
466841,32,1,33,1.318157,103.937301
466842,5,1,6,1.318291,103.937501
466843,14,4,18,1.318082,103.937262
466844,2,0,2,1.318232,103.93734
466845,13,5,18,1.318007,103.937223
466846,4,3,7,1.318394,103.937325
466848,2,0,2,1.318319,103.93745
466849,5,11,16,1.318129,103.937177
466850,3,0,3,1.315835,103.938881
466852,0,3,3,1.317188,103.937166
466853,6,0,6,1.318032,103.937103
466854,12,1,13,1.317632,103.937026
466855,40,2,42,1.31798,103.937074
466857,1,1,2,1.318423,103.937279
466858,3,8,11,1.317481,103.936948
466859,14,1,15,1.317871,103.937
466860,8,0,8,1.317814,103.936966
466861,4,0,4,1.317774,103.936938
466863,47,2,49,1.317641,103.936921
466864,2,1,3,1.317707,103.937066
466865,1,1,2,1.317928,103.937034
466866,11,1,12,1.317559,103.936865
466867,5,0,5,1.31752,103.936835
466868,12,1,13,1.317467,103.93681
466870,0,1,1,1.317753,103.938532
466871,3,2,5,1.317324,103.936724
466872,24,7,31,1.317267,103.936689
466873,1,0,1,1.317371,103.936748
466874,0,2,2,1.317606,103.936896
466875,13,0,13,1.318234,103.937536
466876,0,3,3,1.317756,103.93685
466889,195,0,195,1.317682,103.937841
466890,2,8,10,1.317787,103.9382
466891,3,0,3,1.318234,103.937536
466892,3,1,4,1.317811,103.93796
466893,0,2,2,1.317159,103.936632
466894,1,1,2,1.317557,103.937694
466895,2,14,16,1.317862,103.937694
466896,17,0,17,1.317425,103.93777
466897,8,0,8,1.317781,103.937639
466899,3,1,4,1.317649,103.937554
466900,6,1,7,1.31718,103.9379
466901,5,0,5,1.317582,103.937533
466903,8,0,8,1.317497,103.937482
466904,1,2,3,1.317629,103.937753
466905,2,34,36,1.316674,103.938026
466906,11,3,14,1.317426,103.93749
466907,10,0,10,1.316582,103.938029
466908,6,6,12,1.316522,103.938047
466909,3,0,3,1.31673,103.938011
466910,6,0,6,1.316404,103.938085
466911,1,0,1,1.317215,103.936664
466912,10,0,10,1.316385,103.937991
466914,2,2,4,1.316492,103.937924
466915,4,3,7,1.316529,103.937922
466916,5,3,8,1.317034,103.937762
466917,10,0,10,1.316631,103.937883
466918,23,0,23,1.316867,103.937805
466919,14,0,14,1.316641,103.937512
466920,4,0,4,1.316626,103.937436
466921,3,1,4,1.316776,103.937386
466922,2,0,2,1.317437,103.937715
466923,7,0,7,1.316521,103.936786
466924,15,1,16,1.31673,103.937202
466925,13,0,13,1.316598,103.937209
466926,2,0,2,1.3166,103.937302
466927,3,0,3,1.317321,103.937578
466928,40,5,45,1.316711,103.937042
466929,29,1,30,1.316559,103.937037
466931,46,1,47,1.316685,103.936907
466933,19,0,19,1.3165,103.936732
466934,3,0,3,1.316576,103.937126
466935,17,0,17,1.316489,103.936643
466936,1,0,1,1.317234,103.937625
466937,5,6,11,1.316628,103.936658
466938,42,1,43,1.316607,103.93653
466939,3,2,5,1.316429,103.936417
466940,7,1,8,1.316589,103.936411
466941,0,1,1,1.316457,103.936495
466942,5,26,31,1.316572,103.936316
466943,25,0,25,1.316398,103.936229
466944,37,2,39,1.316552,103.936177
466945,7,1,8,1.316379,103.936125
466946,1,1,2,1.316717,103.93712
466947,3,0,3,1.316661,103.936812
466948,2,1,3,1.31637,103.936034
466949,2,5,7,1.316368,103.935958
466950,1,6,7,1.316509,103.93585
466951,12,0,12,1.316368,103.935893
466952,10,0,10,1.316378,103.935834
466953,6,3,9,1.316413,103.935776
466954,2,0,2,1.316535,103.936073
466955,5,0,5,1.316537,103.935687
466956,0,7,7,1.316661,103.93565
466957,17,2,19,1.316683,103.937872
466958,4,0,4,1.317345,103.93785
466960,2,1,3,1.316529,103.935945
466961,0,13,13,1.317656,103.938233
466962,2,0,2,1.316457,103.935724
466963,83,0,83,1.317674,103.938046
466966,0,1,1,1.316418,103.9363
466967,0,1,1,1.299509,103.837
466971,6,1,7,1.318117,103.938463
466972,1,14,15,1.317983,103.938445
466973,7,0,7,1.318157,103.938547
466974,4,9,13,1.318076,103.938802
466976,21,0,21,1.318121,103.938925
466977,9,0,9,1.318238,103.938879
466978,2,0,2,1.317674,103.93815
466979,0,5,5,1.318331,103.939174
466981,2,3,5,1.318175,103.938597
466982,1,0,1,1.299509,103.837
466983,1,1,2,1.318314,103.939109
466985,9,9,18,1.318003,103.938524
466986,1,18,19,1.31802,103.938572
466987,14,1,15,1.318134,103.938981
466988,34,14,48,1.318146,103.939041
466990,10,0,10,1.318258,103.938931
466991,3,4,7,1.318277,103.939003
466992,96,0,96,1.31803,103.938618
466993,8,42,50,1.318041,103.938665
466995,5,0,5,1.316127,103.93903
466996,5,7,12,1.316066,103.939058
466997,0,7,7,1.31615,103.939104
466998,2,0,2,1.318225,103.93881
467010,630,7515,8145,1.327006,103.924472
467013,8,0,8,1.316859,103.935394
467014,3,1,4,1.316891,103.935479
467015,0,12,12,1.316948,103.935604
467016,71,17,88,1.316994,103.935667
467017,31,3,34,1.317045,103.935735
467018,6,1,7,1.317126,103.93586
467019,10,3,13,1.317271,103.936227
467021,112,40,152,1.317282,103.936232
467022,18,0,18,1.317194,103.935955
467023,1,0,1,1.318215,103.938742
467024,1,1,2,1.316068,103.939137
467026,33,0,33,1.317324,103.936255
467027,2,0,2,1.317306,103.936064
467028,1,3,4,1.317344,103.936266
467029,0,7,7,1.317457,103.936178
467031,7,0,7,1.317517,103.936205
467032,1,0,1,1.317303,103.936243
467033,0,1,1,1.317386,103.936288
467034,2,2,4,1.317407,103.9363
467035,3,0,3,1.31669,103.936966
467036,3,3,6,1.317428,103.936311
467037,1,1,2,1.317409,103.936146
467038,0,2,2,1.317673,103.936288
467039,3,2,5,1.317747,103.936323
467040,8,2,10,1.31747,103.936333
467041,18,1,19,1.317804,103.936346
467042,7,0,7,1.317491,103.936345
467043,21,0,21,1.317854,103.93638
467044,9,0,9,1.318031,103.936739
467045,3,1,4,1.317928,103.936415
467046,0,24,24,1.318082,103.93679
467047,2,2,4,1.317969,103.936443
467048,16,0,16,1.318128,103.936809
467049,3,2,5,1.31802,103.936477
467050,1,1,2,1.317449,103.936322
467051,7,3,10,1.318077,103.9365
467052,10,0,10,1.318211,103.936887
467053,1,0,1,1.317565,103.936233
467055,9,0,9,1.318181,103.936557
467056,0,1,1,1.318123,103.936523
467057,1,0,1,1.318317,103.936925
467058,1,8,9,1.318383,103.936985
467060,3,0,3,1.317628,103.936265
467061,2,18,20,1.318353,103.936671
467063,11,0,11,1.318461,103.936674
467064,22,3,25,1.318746,103.937255
467065,9,1,10,1.31853,103.936708
467066,38,21,59,1.318832,103.937288
467067,1,2,3,1.318579,103.937125
467068,5,1,6,1.318976,103.937345
467069,5,0,5,1.318633,103.936771
467070,63,0,63,1.318991,103.937357
467071,20,3,23,1.31869,103.936805
467072,1,1,2,1.318162,103.936836
467073,28,5,33,1.318742,103.936828
467074,1,0,1,1.318232,103.936597
467075,7,4,11,1.318805,103.936867
467076,1,2,3,1.318582,103.936737
467077,2,0,2,1.318981,103.937639
467078,117,1,118,1.318664,103.937468
467079,0,26,26,1.318891,103.936913
467080,0,2,2,1.318834,103.936879
467081,0,7,7,1.318931,103.936949
467082,19,2,21,1.31862,103.937809
467083,0,1,1,1.318929,103.937606
467084,0,2,2,1.318516,103.937746
467085,1,0,1,1.31914,103.936932
467088,3,7,10,1.319356,103.936967
467089,18,3,21,1.319165,103.937114
467090,89,11,100,1.318624,103.938589
467091,26,3,29,1.319238,103.937218
467092,1,2,3,1.318792,103.937492
467093,18,0,18,1.319263,103.937345
467094,12,8,20,1.31864,103.938812
467095,5,1,6,1.319254,103.937424
467096,1,0,1,1.319165,103.937114
467098,1,7,8,1.318702,103.939028
467099,10,5,15,1.319323,103.940269
467100,3,1,4,1.319044,103.938123
467101,114,0,114,1.319332,103.94036
467102,32,2,34,1.318961,103.938378
467103,1,2,3,1.318653,103.93866
467104,4,1,5,1.318961,103.938563
467105,1,0,1,1.318646,103.938916
467106,0,4,4,1.318969,103.938641
467109,1,1,2,1.318756,103.937878
467110,19,3,22,1.318997,103.938863
467111,20,0,20,1.319732,103.940712
467112,11,0,11,1.319014,103.938961
467113,0,2,2,1.3196,103.940643
467114,8,0,8,1.319025,103.939076
467115,1,0,1,1.319443,103.940558
467116,0,1,1,1.319919,103.940859
467118,29,3,32,1.319067,103.939294
467119,0,3,3,1.319474,103.94043
467120,5,0,5,1.319104,103.939487
467121,4,2,6,1.319118,103.939549
467122,1,0,1,1.319051,103.93921
467123,10,0,10,1.319158,103.939714
467124,0,26,26,1.320111,103.941075
467126,0,657,657,1.320174,103.941204
467127,1,0,1,1.319146,103.93964
467128,0,26,26,1.320159,103.941285
467129,11,3,14,1.319563,103.940233
467130,0,282,282,1.320051,103.941388
467131,9,12,21,1.319623,103.940363
467133,2,2,4,1.320122,103.941631
467134,0,1,1,1.31937,103.940036
467135,0,863,863,1.299509,103.837
467136,3,3715,3718,1.299509,103.837
467149,5,1,6,1.321098,103.951307
467150,31,1,32,1.321286,103.951646
467151,26,1,27,1.321098,103.951245
467152,4,1,5,1.321292,103.951572
467153,32,2,34,1.321121,103.951154
467154,0,3,3,1.320058,103.94102
467155,44,0,44,1.321121,103.951097
467156,0,4,4,1.321321,103.95143
467158,3,0,3,1.321309,103.951498
467159,9,2,11,1.321126,103.950943
467160,1,1,2,1.319813,103.940774
467161,5,1,6,1.321126,103.950875
467162,0,1,1,1.320117,103.941691
467163,12,0,12,1.321138,103.950784
467164,2,0,2,1.321332,103.951191
467166,16,1,17,1.321372,103.950986
467167,2,3,5,1.321137,103.950652
467168,4,0,4,1.321372,103.950917
467169,200,0,200,1.321538,103.950481
467170,3,58,61,1.321506,103.950876
467171,182,13,195,1.321487,103.950679
467172,6,1,7,1.321699,103.950975
467174,3,1,4,1.321772,103.950988
467175,0,1,1,1.321343,103.951122
467176,19,2,21,1.32187,103.951038
467177,5,9,14,1.3219,103.951048
467178,1,0,1,1.321799,103.951002
467179,13,0,13,1.321998,103.951086
467180,2,0,2,1.321355,103.951054
467181,15,4,19,1.32212,103.951142
467196,5,14,19,1.31635,103.943487
467197,41,0,41,1.316338,103.943354
467198,2,13,15,1.316316,103.943127
467199,9,2,11,1.316316,103.943147
467200,6,43,49,1.31632,103.942622
467201,8,13,21,1.316293,103.942921
467202,519,162,681,1.31632,103.942602
467203,219,239,458,1.315722,103.942694
467204,9,4,13,1.315843,103.942618
467205,797,82,879,1.316556,103.942075
467221,9,3,12,1.316402,103.942443
467222,6,11,17,1.316566,103.942085
467235,3,3,6,1.31577,103.935275
467236,33,2,35,1.315872,103.935152
467237,1,1,2,1.322067,103.95111
467238,2,2,4,1.315872,103.935084
467240,2,1,3,1.321338,103.951367
467241,3,1,4,1.315769,103.935121
467242,5,2,7,1.315872,103.934936
467245,0,4,4,1.315769,103.935013
467246,3,0,3,1.315872,103.93501
467247,0,4,4,1.315768,103.934967
467251,4,4,8,1.315769,103.934842
467252,0,2,2,1.315769,103.935224
467255,1,0,1,1.32195,103.951064
467257,41,3,44,1.315769,103.934706
467258,30,0,30,1.315872,103.934344
467259,4,1,5,1.315778,103.934508
467260,0,8,8,1.315872,103.934287
467261,0,19,19,1.315778,103.934446
467263,1,3,4,1.315778,103.934321
467264,2,5,7,1.315778,103.934264
467279,18,19,37,1.316523,103.943533
467280,11,4,15,1.31686,103.943505
467281,7,2,9,1.316329,103.943631
467282,118,0,118,1.316896,103.94331
467283,0,1,1,1.315769,103.93474
467284,2,0,2,1.315872,103.934554
467285,0,8,8,1.31643,103.943625
467286,8,4,12,1.316832,103.942856
467287,20,4,24,1.316491,103.943617
467288,15,4,19,1.316817,103.94261
467289,0,5,5,1.316537,103.943614
467290,1,3,4,1.316812,103.942365
467291,34,4,38,1.316601,103.943608
467292,35,1,36,1.316972,103.942365
467293,0,2,2,1.316869,103.94308
467294,1,2,3,1.315872,103.934782
467295,4,3,7,1.316812,103.943583
467296,0,3,3,1.316754,103.943591
467297,0,9,9,1.316977,103.943568
467298,992,127,1119,1.317956,103.943309
467299,188,28,216,1.317097,103.943551
467301,449,9,458,1.31669,103.944052
467302,661,42,703,1.317192,103.943535
467303,741,54,795,1.318091,103.943099
467304,415,31,446,1.3179,103.943041
467305,2,7,9,1.318597,103.942663
467306,6,2,8,1.318596,103.942605
467307,26,0,26,1.318601,103.942541
467308,3,0,3,1.31687,103.943586
467309,1,3,4,1.318595,103.942421
467310,2,0,2,1.316682,103.9436
467311,30,7,37,1.3186,103.94232
467312,3,0,3,1.318602,103.942488
467313,7,0,7,1.318522,103.942199
467314,12,0,12,1.318598,103.94217
467316,7,19,26,1.318749,103.942263
467317,3,0,3,1.318601,103.942282
467319,0,1,1,1.316384,103.943625
467321,10,0,10,1.318731,103.942565
467324,0,3,3,1.318754,103.942356
467325,2,2,4,1.318998,103.942799
467326,4,0,4,1.319067,103.942799
467327,0,2,2,1.318598,103.942384
467328,0,3,3,1.318713,103.942725
467329,10,0,10,1.316995,103.942658
467330,38,5,43,1.317018,103.94295
467331,10,0,10,1.319247,103.942821
467332,0,4,4,1.316826,103.942456
467333,0,5,5,1.316786,103.942427
467334,2,15,17,1.317009,103.943579
467335,0,7,7,1.31626,103.943636
467338,0,2,2,1.3191,103.942804
467340,1,3,4,1.299509,103.837
467341,0,12,12,1.299509,103.837
467342,3,112,115,1.299509,103.837
467344,2,6,8,1.323566,103.936478
467345,27,21,48,1.325001,103.929549
467346,11,1847,1858,1.323128,103.92597
467347,857,21698,22555,1.323794,103.930218
467350,7,549,556,1.325244,103.932204
467351,1050,1313,2363,1.324516,103.932292
467352,549,5464,6013,1.324349,103.935899
467353,3,2,5,1.32368,103.938907
467354,41,1408,1449,1.325737,103.942859
467355,80,663,743,1.325056,103.936754
467356,694,1298,1992,1.327337,103.946551
467359,5,249,254,1.328201,103.948317
467360,5358,72,5430,1.324112,103.928743
467371,3,196,199,1.324652,103.952393
467372,8,440,448,1.324813,103.952274
467374,2,9,11,1.324773,103.952229
467375,3,2,5,1.324589,103.952319
467376,1,0,1,1.318751,103.942463
467377,2,0,2,1.299509,103.837
467378,8,1,9,1.324693,103.952149
467379,0,1,1,1.324733,103.952183
467382,0,2,2,1.324549,103.952284
467383,1,0,1,1.324446,103.952171
467384,1,0,1,1.324371,103.952102
467385,65,1,66,1.324337,103.952068
467386,0,1,1,1.324584,103.952035
467388,31,0,31,1.324503,103.951956
467389,0,1,1,1.324544,103.951995
467390,3,2,5,1.324463,103.95191
467393,3,2,5,1.324051,103.95204
467394,1,0,1,1.323994,103.952137
467397,2,0,2,1.324624,103.952075
467400,1,0,1,1.324377,103.951825
467401,0,4,4,1.324131,103.951864
467402,8,1,9,1.324211,103.951665
467403,3,3,6,1.323899,103.951588
467405,0,13,13,1.323864,103.951633
467406,0,2,2,1.324103,103.951949
467409,26,7,33,1.323819,103.951747
467410,6,4,10,1.324056,103.951506
467411,14,0,14,1.323784,103.951804
467412,2,2,4,1.324022,103.951472
467413,0,6,6,1.32375,103.951867
467414,8,3,11,1.323993,103.951438
467415,1,2,3,1.319194,103.942815
467417,6,0,6,1.323698,103.951992
467418,4,1,5,1.323857,103.95145
467433,1,1,2,1.324137,103.95158
467434,1,12,13,1.316759,103.939666
467435,12,21,33,1.316623,103.939775
467436,1,23,24,1.316819,103.93966
467438,3,0,3,1.323727,103.95193
467440,3,2,5,1.317004,103.939628
467441,7,0,7,1.316567,103.939418
467442,66,0,66,1.317103,103.939621
467444,23,22,45,1.317205,103.939594
467446,0,3,3,1.316919,103.939647
467448,0,1,1,1.324251,103.951705
467451,4,0,4,1.316783,103.939548
467452,15,4,19,1.317683,103.939532
467453,4,6,10,1.316866,103.939529
467454,1,5,6,1.317753,103.939546
467456,1,0,1,1.317461,103.939571
467457,2,0,2,1.316635,103.939855
467458,0,8,8,1.31794,103.939588
467459,37,1,38,1.317166,103.939483
467461,4,8,12,1.317246,103.939464
467462,90,17,107,1.318172,103.939668
467463,0,2,2,1.31707,103.939496
467464,1,0,1,1.317881,103.939568
467465,2,0,2,1.317374,103.939431
467466,36,0,36,1.318346,103.939802
467467,8,0,8,1.317502,103.939263
467468,4,2,6,1.318436,103.939861
467469,14,2,16,1.317506,103.939094
467470,1,0,1,1.318277,103.939757
467471,11,1,12,1.317608,103.93908
467472,0,2,2,1.317461,103.939439
467473,3,4,7,1.317604,103.939208
467474,1,0,1,1.318505,103.93992
467475,0,1,1,1.318652,103.940091
467476,1,2,3,1.317317,103.939582
467477,1,0,1,1.317702,103.939447
467479,7,0,7,1.317918,103.939461
467480,5,1,6,1.318924,103.940352
467481,6,0,6,1.317983,103.939488
467482,53,4,57,1.318088,103.939527
467483,3,0,3,1.318739,103.940183
467484,23,0,23,1.318258,103.939598
467485,2,0,2,1.318614,103.940031
467486,1,6,7,1.318417,103.939675
467487,1,0,1,1.317791,103.939451
467488,121,9,130,1.31856,103.939796
467489,10,0,10,1.318602,103.939842
467490,7,4,11,1.318736,103.939915
467491,3,0,3,1.318163,103.939536
467492,1,1,2,1.318313,103.939638
467493,29,2,31,1.318913,103.940091
467508,35,0,35,1.318222,103.941147
467509,46,0,46,1.318384,103.941189
467510,1,1,2,1.318856,103.940028
467511,10,1,11,1.318409,103.941149
467512,1,0,1,1.318465,103.939721
467513,3,0,3,1.318774,103.93995
467514,2,0,2,1.318294,103.941095
467515,3,0,3,1.318535,103.941037
467516,5,0,5,1.318515,103.940891
467517,4,0,4,1.318695,103.940886
467518,49,1,50,1.318566,103.940831
467519,1,0,1,1.318365,103.941023
467521,10,1,11,1.318851,103.940743
467522,14,11,25,1.31914,103.94026
467523,52,1,53,1.318883,103.940698
467524,0,2,2,1.318432,103.94096
467539,3,99,102,1.315185,103.94017
467541,9,10,19,1.315166,103.940347
467542,42,5,47,1.315513,103.940022
467544,9,4,13,1.315505,103.939952
467545,13,0,13,1.315505,103.939952
467546,13,0,13,1.315505,103.939952
467547,2,0,2,1.319208,103.940205
467548,15,1385,1400,1.315257,103.940336
467549,0,1,1,1.318722,103.940854
467550,2,1,3,1.318585,103.941003
467551,15,1,16,1.315396,103.940318
467552,3,3,6,1.315448,103.940321
467553,7,2,9,1.315542,103.940301
467554,220,4,224,1.315596,103.940294
467555,28,6,34,1.315686,103.940275
467556,262,5,267,1.315738,103.94027
467557,20,33,53,1.315834,103.940251
467558,1,17,18,1.315882,103.940242
467559,1,3,4,1.315988,103.94022
467560,0,2,2,1.315294,103.939281
467561,7,0,7,1.315448,103.939589
467562,0,2,2,1.316032,103.940213
467563,1,4,5,1.315542,103.939457
467564,1,9,10,1.316137,103.940163
467565,4,0,4,1.315593,103.939802
467566,2,5,7,1.316195,103.940164
467567,1,38,39,1.315605,103.940002
467568,5,7,12,1.3163,103.940131
467569,49,5,54,1.316055,103.939948
467571,0,2,2,1.316072,103.940137
467572,1,8,9,1.316506,103.9401
467573,1,0,1,1.31547,103.939786
467574,5,2,7,1.316596,103.940094
467575,2,2,4,1.316011,103.939667
467576,8,6,14,1.316767,103.940042
467577,39,1,40,1.315992,103.939549
467578,12,12,24,1.317076,103.940119
467579,4,5,9,1.31599,103.939452
467580,44,5,49,1.317115,103.940202
467581,2,12,14,1.316122,103.939479
467582,138,15,153,1.317174,103.940298
467583,2,0,2,1.31605,103.939863
467584,19,3,22,1.317203,103.940376
467585,0,1,1,1.316031,103.939736
467586,10,23,33,1.317251,103.940491
467587,19,4,23,1.31615,103.939758
467588,200,7,207,1.317278,103.940571
467589,3,0,3,1.315468,103.939721
467590,1,3,4,1.317328,103.940662
467591,5,4,9,1.316182,103.939951
467592,0,6,6,1.317363,103.940728
467593,1,16,17,1.317159,103.939957
467594,77,33,110,1.317416,103.940827
467595,1,0,1,1.316132,103.939674
467596,3,22,25,1.317456,103.940908
467597,5,2,7,1.317268,103.940128
467599,1,0,1,1.317204,103.940021
467601,0,5,5,1.317347,103.94033
467603,11,12,23,1.317377,103.94039
467605,23,3,26,1.317423,103.940476
467607,3,4,7,1.31746,103.940554
467609,3,7,10,1.317509,103.940663
467611,7,12,19,1.317523,103.940723
467613,25,8,33,1.317613,103.940945
467614,38,20,58,1.31808,103.941938
467615,125,19,144,1.317648,103.941003
467616,2,0,2,1.316122,103.939562
467617,3,1,4,1.317724,103.941108
467618,34,0,34,1.318074,103.94227
467620,19,1,20,1.318069,103.942492
467621,0,11,11,1.317877,103.941275
467622,2,28,30,1.317941,103.941326
467623,12,11,23,1.317995,103.94147
467624,30,1,31,1.318015,103.941502
467625,7,0,7,1.318048,103.941551
467626,23,1,24,1.318082,103.941602
467627,68,6,74,1.318098,103.941663
467628,8,6,14,1.318106,103.941757
467629,0,4,4,1.318106,103.941757
467630,3,4,7,1.318106,103.941757
467631,2,1,3,1.316158,103.939859
467632,3,1,4,1.318142,103.941981
467633,6,1,7,1.318147,103.942165
467634,1,6,7,1.318157,103.942364
467635,0,11,11,1.318154,103.942567
467636,1,0,1,1.317305,103.940201
467637,13,3,16,1.318055,103.942723
467650,2,0,2,1.318078,103.942048
467651,7,32,39,1.318426,103.941882
467652,0,8,8,1.318741,103.941461
467653,0,22,22,1.318478,103.94188
467656,2,3,5,1.318846,103.941361
467657,0,3,3,1.318135,103.941915
467658,0,6,6,1.318878,103.94131
467659,2,1,3,1.318586,103.941881
467661,1,6,7,1.318717,103.941894
467662,1,2,3,1.318646,103.941896
467663,1,1,2,1.318691,103.941531
467664,1,1,2,1.318959,103.941227
467666,0,4,4,1.318887,103.941901
467668,1,1,2,1.318816,103.941897
467669,1,0,1,1.315434,103.939497
467670,1,0,1,1.319105,103.941085
467671,0,1,1,1.319137,103.941051
467672,9,2,11,1.319227,103.940969
467673,2,2,4,1.319017,103.940585
467674,1,0,1,1.319199,103.941005
467675,1,1,2,1.319075,103.941117
467676,2,0,2,1.319104,103.940654
467677,3,0,3,1.318754,103.941896
467678,3,0,3,1.319192,103.940733
467681,3,0,3,1.319222,103.940773
467682,0,12,12,1.319744,103.941939
467683,2,0,2,1.319128,103.940684
467684,28,0,28,1.319829,103.941943
467685,3,0,3,1.319313,103.940873
467686,1,0,1,1.319055,103.940605
467688,3,0,3,1.319409,103.940963
467689,3,1,4,1.319487,103.94105
467691,9,3,12,1.319546,103.941103
467692,3,0,3,1.319944,103.941944
467693,47,2,49,1.319572,103.941132
467694,0,16,16,1.320098,103.941958
467696,0,1,1,1.3199,103.941944
467697,0,1,1,1.320143,103.941951
467699,0,2,2,1.319381,103.940939
467700,4,2,6,1.320244,103.941954
467701,19,1,20,1.31975,103.941418
467702,3,0,3,1.320052,103.941955
467703,0,11,11,1.319752,103.941515
467704,52,0,52,1.319751,103.941578
467705,5,7,12,1.319753,103.941623
467706,1,0,1,1.319658,103.941225
467707,3,2,5,1.319749,103.941734
467708,1,2,3,1.319751,103.941469
467723,4,0,4,1.317902,103.94063
467724,29,0,29,1.317887,103.94081
467725,113,0,113,1.317965,103.940581
467726,8,0,8,1.317937,103.940764
467727,2,0,2,1.319752,103.941377
467728,1,1,2,1.318117,103.940339
467729,5,3,8,1.318043,103.940258
467730,1,1,2,1.318046,103.94068
467731,29,1,30,1.317819,103.940183
467732,8,2,10,1.318178,103.940552
467733,2,2,4,1.31769,103.940125
467734,4,0,4,1.318262,103.94048
467735,3,0,3,1.31975,103.941777
467736,19,6,25,1.317675,103.940011
467737,13,0,13,1.317784,103.940024
467738,1,2,3,1.317558,103.939996
467739,67,0,67,1.317974,103.940074
467740,36,2,38,1.318026,103.940099
467742,2,0,2,1.318089,103.940636
467743,0,2,2,1.318182,103.940244
467744,2,0,2,1.318262,103.94032
467745,9,0,9,1.318421,103.940474
467746,1,0,1,1.319748,103.941699
467747,1,1,2,1.318328,103.940381
467748,3,1,4,1.318624,103.940666
467763,57,9,66,1.322973,103.950688
467764,15,2,17,1.322828,103.950809
467765,47,5,52,1.323185,103.950666
467766,25,1,26,1.323029,103.950849
467767,23,2,25,1.323248,103.950666
467768,3,1,4,1.323172,103.950877
467769,7,0,7,1.323306,103.95066
467770,2,2,4,1.323212,103.950871
467771,22,0,22,1.323363,103.950654
467772,0,13,13,1.32327,103.950871
467773,18,0,18,1.323414,103.950637
467774,4,0,4,1.323315,103.950871
467775,37,0,37,1.323466,103.950631
467776,7,0,7,1.323384,103.950865
467777,25,2,27,1.323517,103.95062
467778,7,2,9,1.323436,103.950865
467779,2,0,2,1.318576,103.940617
467780,68,0,68,1.323482,103.950865
467781,4,0,4,1.323621,103.950603
467782,0,2,2,1.323569,103.950614
467783,2,0,2,1.323539,103.95086
467785,22,1,23,1.323724,103.950586
467786,3,0,3,1.317835,103.940031
467787,7,0,7,1.323711,103.950854
467803,1,8,9,1.322772,103.951345
467804,0,4,4,1.322286,103.95131
467805,2,0,2,1.323672,103.950597
467806,4,0,4,1.322331,103.951329
467808,4,12,16,1.322421,103.951368
467809,7,1,8,1.322591,103.951315
467810,117,0,117,1.322511,103.951407
467811,1,0,1,1.318476,103.94053
467812,2,0,2,1.322492,103.9513
467813,4,2,6,1.322807,103.951428
467815,1,3,4,1.32268,103.951335
467816,6,9,15,1.322782,103.951524
467817,1,0,1,1.32266,103.951367
467818,1,1,2,1.322601,103.951446
467819,7,0,7,1.322888,103.951432
467821,108,7,115,1.323143,103.951571
467822,7,0,7,1.323052,103.951641
467823,8,1,9,1.323188,103.95147
467824,86,0,86,1.323154,103.951657
467825,6,0,6,1.323224,103.951359
467826,0,1,1,1.32273,103.951345
467827,1,2,3,1.323653,103.95086
467828,4,0,4,1.323255,103.951546
467829,35,0,35,1.323239,103.951319
467830,17,0,17,1.323298,103.95146
467831,3,8,11,1.323255,103.951279
467832,0,1,1,1.323211,103.951633
467834,3,2,5,1.323341,103.951327
467835,2,7,9,1.323341,103.951327
467837,2,2,4,1.323341,103.951327
467838,2,2,4,1.323341,103.951327
467839,0,4,4,1.323341,103.951327
467840,3,0,3,1.323204,103.951416
467841,3,1,4,1.323341,103.951327
467842,9,0,9,1.323341,103.951327
467858,24,8,32,1.322143,103.949627
467859,4,13,17,1.322049,103.949865
467860,0,2,2,1.322872,103.951563
467861,34,1,35,1.321544,103.949997
467862,1,2,3,1.323341,103.951327
467863,6,0,6,1.32202,103.949968
467864,1,1,2,1.321678,103.950021
467865,45,9,54,1.322009,103.950064
467866,37,13,50,1.322238,103.949403
467868,1,3,4,1.322269,103.949308
467870,25,15,40,1.322308,103.949216
467871,0,1,1,1.323342,103.951373
467873,2,2,4,1.321912,103.950389
467874,12,5,17,1.322181,103.94917
467875,39,6,45,1.321872,103.950497
467876,2,2,4,1.322345,103.948748
467877,1,0,1,1.321923,103.950304
467879,3,6,9,1.321837,103.950674
467880,37,0,37,1.322431,103.948845
467881,1,4,5,1.321814,103.950776
467882,9,5,14,1.322483,103.948902
467883,1,18,19,1.321993,103.950872
467885,2,0,2,1.322216,103.949459
467887,14,1,15,1.322027,103.95069
467888,6,23,29,1.322626,103.949078
467889,0,1,1,1.32186,103.950577
467890,2,1,3,1.322179,103.949566
467891,4,1,5,1.322084,103.950479
467892,1,2,3,1.32254,103.949139
467893,8,1,9,1.322107,103.9504
467894,24,3,27,1.322488,103.949293
467895,1,6,7,1.322142,103.95032
467896,22,7,29,1.322466,103.949372
467897,7,0,7,1.322187,103.950234
467899,0,5,5,1.322205,103.950149
467900,4,4,8,1.322403,103.949537
467901,18,1,19,1.322233,103.950058
467902,8,12,20,1.322385,103.949617
467903,1,19,20,1.322262,103.949973
467904,0,5,5,1.323104,103.949895
467905,119,26,145,1.32229,103.949882
467906,4,0,4,1.323121,103.949821
467907,12,2,14,1.32295,103.950056
467908,28,0,28,1.323133,103.949752
467909,3,11,14,1.322915,103.95018
467911,0,3,3,1.322511,103.949219
467912,52,5,57,1.323167,103.94961
467913,12,1,13,1.322772,103.950674
467914,4,0,4,1.322771,103.950673
467915,15,0,15,1.322771,103.950673
467916,0,6,6,1.322771,103.950673
467917,3,0,3,1.322843,103.950427
467918,153,1,154,1.322947,103.950286
467919,2,0,2,1.322016,103.950764
467920,3,0,3,1.323179,103.949542
467921,2,0,2,1.322586,103.951
467922,2,0,2,1.323452,103.949511
467923,8,0,8,1.32344,103.949585
467924,0,1,1,1.322044,103.950593
467925,9,4,13,1.323412,103.949671
467926,9,3,12,1.323045,103.950041
467928,2,4,6,1.323383,103.949824
467929,2,2,4,1.323349,103.949904
467930,5,0,5,1.323331,103.949979
467931,3,0,3,1.322653,103.950938
467932,2,1,3,1.323463,103.950065
467933,4,0,4,1.323463,103.950065
467934,0,1,1,1.323022,103.950115
467935,118,0,118,1.323313,103.950055
467936,21,22,43,1.322257,103.94898
467937,2,7,9,1.322201,103.948883
467938,1,5,6,1.321616,103.947894
467939,1,5,6,1.321548,103.947778
467940,8,0,8,1.322217,103.948751
467941,46,2,48,1.322217,103.948751
467943,85,1,86,1.322217,103.948751
467944,7,0,7,1.322217,103.948751
467946,34,0,34,1.322217,103.948751
467947,40,3,43,1.322217,103.948751
467948,16,0,16,1.321914,103.947958
467949,25,1,26,1.321877,103.947896
467950,68,16,84,1.319003,103.952182
467951,86,2,88,1.31908,103.952487
467952,9,91,100,1.319236,103.952923
467953,21,3,24,1.319236,103.952923
467955,5,2,7,1.319236,103.952923
467956,3,4,7,1.319327,103.952743
467957,19,1,20,1.319237,103.952528
467958,5,0,5,1.319191,103.952293
467959,0,6,6,1.319157,103.952159
467960,22,1,23,1.319823,103.951883
467961,4,17,21,1.319822,103.951882
467962,14,0,14,1.319879,103.952134
467963,1,0,1,1.323365,103.950077
467964,2,1,3,1.323463,103.950065
467966,4,1,5,1.320002,103.952172
467968,11,2,13,1.319933,103.952001
467969,6,6,12,1.319904,103.951939
467971,69,1,70,1.320347,103.951914
467972,63,0,63,1.320473,103.951868
467973,58,0,58,1.320662,103.951783
467975,9,1,10,1.320679,103.951339
467976,119,8,127,1.320339,103.951604
467977,0,17,17,1.320339,103.951547
467978,1,0,1,1.319945,103.952395
467979,1,5,6,1.320339,103.951428
467981,17,0,17,1.320339,103.951302
467982,12,5,17,1.320344,103.951245
467983,0,6,6,1.320488,103.950958
467985,1,0,1,1.320339,103.95149
467986,3,1,4,1.320666,103.951003
467987,12,0,12,1.320723,103.95102
467990,122,14,136,1.320654,103.950803
467991,9,14,23,1.320585,103.950815
467992,1,1,2,1.322993,103.950195
467993,6,13,19,1.31895,103.951947
467994,10,9,19,1.318906,103.951752
467995,5,35,40,1.318872,103.951652
467996,5,0,5,1.321047,103.949233
467997,1,0,1,1.320609,103.950981
467998,6,0,6,1.321231,103.949103
467999,11,2,13,1.32128,103.949074
468000,1,0,1,1.32118,103.949128
468001,6,0,6,1.32136,103.949021
468002,18,0,18,1.321409,103.948998
468003,16,1,17,1.321457,103.948962
468004,6,1,7,1.321504,103.948933
468005,0,5,5,1.321555,103.948903
468006,7,179,186,1.330314,103.942891
468007,7,2,9,1.33029,103.942901
468008,7,94,101,1.330349,103.94276
468009,20,14,34,1.330248,103.94291
468010,0,5,5,1.330308,103.942765
468011,51,0,51,1.330182,103.942928
468012,2,2,4,1.330261,103.942783
468013,1,0,1,1.321319,103.949049
468014,1,2,3,1.320065,103.952326
468015,8,1,9,1.330072,103.942962
468016,0,7,7,1.330162,103.942825
468017,1,0,1,1.330116,103.942947
468018,160,2,162,1.330093,103.94284
468019,1,6,7,1.330035,103.942856
468020,52,0,52,1.329982,103.942975
468021,6,0,6,1.32997,103.942872
468022,45,1,46,1.329945,103.942971
468023,10,7,17,1.32991,103.942895
468024,3,1,4,1.32988,103.94299
468025,1,0,1,1.330037,103.942962
468026,2,0,2,1.318991,103.951595
468027,2,0,2,1.329811,103.943017
468028,2,4,6,1.329744,103.943025
468029,10,0,10,1.329723,103.942947
468030,7,1,8,1.329684,103.943054
468034,2,1,3,1.330233,103.942796
468036,9,0,9,1.329487,103.943103
468037,18,3,21,1.329477,103.943022
468038,11,0,11,1.32943,103.943121
468039,55,0,55,1.329388,103.943044
468040,18,3,21,1.329346,103.943138
468041,1,0,1,1.329851,103.942915
468042,0,2,2,1.329785,103.942934
468043,23,13,36,1.32929,103.943082
468044,0,4,4,1.329214,103.943187
468045,0,33,33,1.329224,103.943089
468047,2,0,2,1.329278,103.943164
468048,2,1,3,1.329546,103.943086
468049,3,0,3,1.329064,103.943245
468050,4,15,19,1.328991,103.94326
468052,30,0,30,1.328861,103.943309
468053,7,1,8,1.329029,103.943151
468054,34,0,34,1.32888,103.943378
468055,1,6,7,1.32899,103.943157
468056,0,1,1,1.329339,103.943058
468057,11,0,11,1.328945,103.943164
468058,1,1,2,1.329162,103.943109
468064,104,71,175,1.299509,103.837
468078,2,0,2,1.328869,103.943178
468079,4,0,4,1.314895,103.936255
468080,13,0,13,1.31506,103.93617
468081,5,1,6,1.315135,103.93615
468082,44,0,44,1.315234,103.93614
468083,1,20,21,1.31533,103.936099
468085,33,6,39,1.315508,103.936044
468087,1,1,2,1.314704,103.936336
468088,3,0,3,1.32912,103.943118
468089,56,1,57,1.315785,103.936096
468090,4,27,31,1.315648,103.936229
468091,17,0,17,1.315809,103.936181
468092,7,1,8,1.315662,103.936307
468093,3,1,4,1.315826,103.936287
468094,2,11,13,1.315669,103.93641
468095,9,0,9,1.315826,103.936383
468096,74,0,74,1.315682,103.936512
468097,1,4,5,1.31584,103.936465
468098,45,0,45,1.315693,103.936611
468100,29,29,58,1.315713,103.936721
468101,2,3,5,1.315847,103.936639
468103,17,4,21,1.315857,103.936724
468104,8,2,10,1.315727,103.936892
468105,40,6,46,1.315864,103.93682
468106,2,2,4,1.315723,103.936997
468107,130,0,130,1.315864,103.936909
468108,7,0,7,1.315741,103.93709
468109,1,4,5,1.315891,103.937018
468110,10,1,11,1.315751,103.937189
468111,9,0,9,1.315901,103.937124
468113,13,0,13,1.315925,103.937237
468114,1,4,5,1.314876,103.93611
468115,0,1,1,1.328905,103.943448
468116,40,0,40,1.31506,103.936037
468117,4,0,4,1.315128,103.936022
468118,13,1,14,1.31528,103.936019
468119,47,7,54,1.315317,103.93598
468120,51,17,68,1.315452,103.935918
468121,45,7,52,1.315523,103.935915
468122,3,1,4,1.315604,103.935842
468123,93,0,93,1.315676,103.935832
468124,1,0,1,1.314983,103.936088
468125,59,0,59,1.315712,103.936036
468139,7,205,212,1.3155,103.936216
468140,1,2,3,1.315761,103.935956
468141,1,7,8,1.315575,103.93632
468142,0,3,3,1.315948,103.93615
468143,0,5,5,1.3155,103.936413
468144,29,3,32,1.315967,103.936327
468145,17,0,17,1.31557,103.936481
468146,2,4,6,1.315934,103.936486
468147,1,1,2,1.315655,103.935979
468148,137,5,142,1.315971,103.936524
468149,1,1,2,1.315524,103.93664
468150,1,3,4,1.316001,103.936646
468151,0,1,1,1.315838,103.935739
468152,0,4,4,1.315999,103.936707
468153,15,4,19,1.315657,103.93692
468154,4,2,6,1.315998,103.936861
468155,0,10,10,1.315657,103.937019
468156,6,1,7,1.316016,103.936898
468157,20,3,23,1.315676,103.937076
468158,14,1,15,1.316007,103.937048
468159,2,1,3,1.315944,103.936304
468160,6,1,7,1.316028,103.937093
468161,5,15,20,1.315707,103.937282
468162,32,2,34,1.316059,103.937228
468163,24,0,24,1.315706,103.937437
468164,69,3,72,1.313031,103.936822
468179,2,0,2,1.315638,103.936684
468180,8,2,10,1.322825,103.9466
468181,9,6,15,1.322918,103.946472
468182,19,0,19,1.322871,103.946701
468183,5,0,5,1.322975,103.94657
468184,3,0,3,1.315678,103.937221
468185,11,0,11,1.323015,103.946637
468188,1,0,1,1.315619,103.936806
468189,7,0,7,1.323079,103.946843
468191,2,0,2,1.322895,103.946388
468193,1,0,1,1.322981,103.947007
468194,7,0,7,1.323071,103.947273
468195,2,0,2,1.323105,103.946949
468196,1,0,1,1.323121,103.947011
468198,2,0,2,1.323166,103.947113
468203,24,1,25,1.323336,103.947387
468204,16,9,25,1.323046,103.947443
468205,0,7,7,1.323364,103.947467
468206,10,0,10,1.323098,103.947557
468207,3,0,3,1.322918,103.946802
468208,6,0,6,1.323127,103.947648
468209,41,0,41,1.323433,103.947661
468210,2,0,2,1.323148,103.947467
468211,5,0,5,1.323467,103.947752
468212,73,0,73,1.323213,103.947842
468213,4,2,6,1.323502,103.947826
468214,2,0,2,1.323172,103.947751
468215,63,0,63,1.323542,103.947911
468216,114,1,115,1.323304,103.948086
468217,1,0,1,1.32312,103.947375
468218,1,1,2,1.323258,103.947978
468219,0,3,3,1.323389,103.947574
468220,0,14,14,1.323459,103.948428
468221,7,8,15,1.323725,103.948241
468223,1,0,1,1.323576,103.947996
468224,5,0,5,1.323511,103.948599
468225,2,1,3,1.323611,103.948065
468227,2,0,2,1.323344,103.948189
468228,2,1,3,1.323779,103.948531
468230,16,0,16,1.323608,103.948889
468232,5,17,22,1.323637,103.948997
468234,38,0,38,1.323671,103.949094
468235,5,2,7,1.323973,103.948965
468236,33,0,33,1.323734,103.949213
468237,14,0,14,1.324012,103.949068
468239,5,0,5,1.324048,103.949155
468240,0,5,5,1.322719,103.946301
468254,0,5,5,1.324367,103.946617
468255,1,5,6,1.324157,103.946661
468256,6,1,7,1.324396,103.946691
468257,0,1,1,1.323748,103.948321
468258,2,0,2,1.323806,103.948595
468259,14,0,14,1.324198,103.946796
468260,0,3,3,1.323574,103.948792
468261,109,0,109,1.324183,103.946884
468262,6,1,7,1.324487,103.946936
468263,5,0,5,1.324218,103.946964
468265,1,0,1,1.32412,103.946725
468267,1,0,1,1.324246,103.947044
468268,8,5,13,1.324591,103.947238
468269,21,0,21,1.324315,103.947209
468270,2,0,2,1.32443,103.946771
468271,1,0,1,1.324275,103.947118
468272,13,3,16,1.324642,103.947386
468275,1,0,1,1.324355,103.947294
468276,4,0,4,1.3247,103.947556
468277,1,17,18,1.324453,103.947573
468278,5,0,5,1.32474,103.947659
468279,77,0,77,1.324482,103.947653
468281,2,0,2,1.324619,103.947306
468282,0,9,9,1.324803,103.947818
468283,10,0,10,1.324568,103.947869
468284,7,0,7,1.324837,103.947903
468285,11,0,11,1.324608,103.947949
468286,14,2,16,1.324872,103.947983
468287,10,0,10,1.324671,103.948091
468288,6,2,8,1.324912,103.948063
468289,10,0,10,1.324711,103.948216
468290,21,0,21,1.324952,103.948142
468292,7,0,7,1.324992,103.948228
468293,6,0,6,1.324791,103.948455
468294,1,1,2,1.324516,103.947761
468295,1,2,3,1.324459,103.946856
468296,1,2,3,1.324872,103.94858
468298,1,0,1,1.32443,103.947505
468299,4,0,4,1.324963,103.948757
468300,3,0,3,1.325187,103.948689
468301,13,1,14,1.325003,103.948819
468304,2,1,3,1.325233,103.948774
468305,10,0,10,1.325066,103.948933
468307,0,1,1,1.32521,103.948729
468308,1,1,2,1.325021,103.948308
468309,1,0,1,1.325089,103.949007
468310,0,1,1,1.325124,103.949202
468311,1,0,1,1.325084,103.949231
468312,1,6,7,1.324981,103.949276
468313,30,1,31,1.324923,103.949305
468314,17,7,24,1.324872,103.949339
468315,2,3,5,1.324797,103.949373
468330,137,0,137,1.323316,103.945875
468331,3,0,3,1.325285,103.948854
468332,5,1,6,1.323354,103.945972
468333,3,0,3,1.323315,103.945874
468334,0,1,1,1.325032,103.949248
468335,23,0,23,1.323429,103.946164
468336,30,0,30,1.323223,103.946075
468338,1,3,4,1.323505,103.946358
468339,5,0,5,1.323258,103.946195
468340,0,2,2,1.325348,103.948956
468342,1,3,4,1.323286,103.94628
468343,7,0,7,1.323648,103.946736
468344,3,10,13,1.323647,103.946735
468345,12,0,12,1.323315,103.946388
468346,12,0,12,1.323344,103.946462
468347,2,0,2,1.323582,103.946552
468348,12,5,17,1.323401,103.946656
468349,17,0,17,1.32343,103.946764
468350,1,0,1,1.32343,103.946165
468351,0,6,6,1.323765,103.946785
468352,1,0,1,1.323453,103.946844
468353,3,2,5,1.323799,103.946861
468356,1,0,1,1.323516,103.946963
468357,0,1,1,1.323613,103.947157
468358,11,0,11,1.323642,103.947231
468359,24,0,24,1.3239,103.947105
468361,3,8,11,1.323948,103.947165
468362,0,3,3,1.323353,103.945971
468363,45,16,61,1.323989,103.947239
468365,1,1,2,1.323367,103.946582
468366,22,1,23,1.323831,103.947714
468368,6,6,12,1.323883,103.947823
468369,6,1,7,1.324115,103.947552
468370,0,1,1,1.323865,103.947035
468371,4,0,4,1.324149,103.947626
468372,12,2,14,1.32394,103.948005
468373,4,9,13,1.324178,103.947717
468374,198,6,204,1.324026,103.948221
468375,10,0,10,1.324207,103.947797
468376,99,0,99,1.324061,103.948295
468377,18,2,20,1.324229,103.947888
468378,5,1,6,1.324112,103.948397
468379,59,0,59,1.324264,103.947979
468380,11,0,11,1.324141,103.948471
468381,1,0,1,1.323911,103.947908
468382,8,0,8,1.324181,103.948591
468383,10,0,10,1.32435,103.948184
468384,6,0,6,1.324204,103.948665
468385,6,0,6,1.324384,103.948298
468386,50,1,51,1.324256,103.948779
468387,0,7,7,1.324419,103.948377
468388,13,0,13,1.324261,103.948853
468389,79,1,80,1.324447,103.948486
468391,9,8,17,1.324488,103.948577
468393,11,5,16,1.324545,103.948685
468394,2,0,2,1.324017,103.947359
468408,7,3,10,1.323999,103.945904
468409,2,0,2,1.323227,103.945982
468410,4,0,4,1.323791,103.945954
468411,2,0,2,1.324031,103.946035
468412,2,1,3,1.323716,103.947424
468413,0,2,2,1.323839,103.945928
468414,6,0,6,1.324042,103.945868
468415,0,1,1,1.324298,103.948093
468418,6,1,7,1.324172,103.94582
468419,29,0,29,1.324172,103.945819
468420,1,0,1,1.323984,103.945882
468421,0,1,1,1.324259,103.945788
468422,2,0,2,1.323901,103.945907
468424,0,2,2,1.324258,103.945787
468425,0,3,3,1.323989,103.945894
468426,3,0,3,1.324983,103.946201
468427,10,0,10,1.32497,103.946166
468429,131,0,131,1.324917,103.946023
468430,13,4,17,1.324891,103.945951
468431,3,0,3,1.324982,103.9462
468432,3,0,3,1.324865,103.94588
468433,35,0,35,1.324812,103.945737
468434,3,0,3,1.324838,103.945808
468436,1,0,1,1.324258,103.945787
468437,14,0,14,1.324707,103.945451
468438,11,0,11,1.324691,103.94539
468439,4,15,19,1.324827,103.945204
468440,1,7,8,1.324825,103.945264
468442,1,3,4,1.324847,103.945391
468444,10,0,10,1.324902,103.945497
468445,3,1,4,1.324929,103.945546
468447,6,3,9,1.324979,103.945695
468448,5,1,6,1.32498,103.945756
468449,0,5,5,1.324982,103.945834
468450,0,1,1,1.324734,103.945523
468451,4,1,5,1.325062,103.945934
468452,151,8,159,1.325049,103.945992
468454,15,4,19,1.325124,103.946089
468469,1,28,29,1.322181,103.946695
468470,0,34,34,1.322201,103.946771
468471,8,0,8,1.322221,103.946847
468472,0,1,1,1.325047,103.945875
468474,43,2,45,1.322246,103.946916
468475,18,0,18,1.322246,103.946916
468476,103,16,119,1.322313,103.946706
468477,11,1,12,1.32227,103.946995
468478,0,50,50,1.32227,103.946995
468480,2,0,2,1.324335,103.945765
468481,2,0,2,1.322291,103.947067
468482,0,1,1,1.299509,103.837
468483,12,0,12,1.322358,103.947246
468484,1,4,5,1.322387,103.947308
468485,1,4,5,1.322423,103.947378
468486,2,0,2,1.32232,103.947131
468487,0,14,14,1.322469,103.947481
468488,0,3,3,1.324786,103.945666
468489,4,14,18,1.322486,103.947533
468491,7,0,7,1.322522,103.947625
468493,5,0,5,1.32261,103.947836
468494,9,11,20,1.322561,103.947431
468495,21,0,21,1.322631,103.947909
468496,1,0,1,1.322364,103.94689
468497,51,0,51,1.322667,103.948006
468499,10,0,10,1.322696,103.94808
468500,0,1,1,1.322588,103.94752
468501,16,0,16,1.322721,103.948156
468502,1,6,7,1.322688,103.947796
468503,13,0,13,1.32275,103.948229
468504,5,0,5,1.322723,103.947878
468505,57,2,59,1.322763,103.948285
468506,35,4,39,1.322751,103.947971
468507,15,0,15,1.322769,103.948031
468508,0,1,1,1.322643,103.947694
468509,8,0,8,1.322819,103.948132
468510,2,1,3,1.322439,103.947075
468511,2,30,32,1.322795,103.948361
468512,3,0,3,1.32284,103.948194
468514,5,9,14,1.322869,103.948522
468515,4,0,4,1.322863,103.948262
468516,9,2,11,1.322889,103.948313
468517,0,7,7,1.322908,103.948363
468518,12,21,33,1.322931,103.948417
468519,16,1,17,1.322934,103.948656
468520,42,3,45,1.323029,103.948603
468521,2,0,2,1.3224,103.946982
468522,18,7,25,1.323063,103.948699
468523,0,2,2,1.322965,103.948736
468524,1,0,1,1.322795,103.948082
468525,51,0,51,1.323041,103.948938
468526,4,3,7,1.323118,103.948865
468527,13,4,17,1.323075,103.949042
468528,70,0,70,1.323165,103.94898
468529,2,1,3,1.322827,103.948419
468530,1,3,4,1.323195,103.949056
468531,3,0,3,1.323108,103.949119
468532,66,2,68,1.323231,103.949157
468533,143,0,143,1.323184,103.949332
468534,11,0,11,1.323252,103.949232
468536,2,1,3,1.323139,103.949218
468537,4,14,18,1.322246,103.946916
468538,17,1,18,1.32227,103.946995
468539,4,9,13,1.322341,103.947193
468552,1,1,2,1.322998,103.948842
468553,1,0,1,1.323092,103.948791
468554,4,7,11,1.325491,103.949477
468556,2,1,3,1.323315,103.949411
468558,18,1,19,1.32562,103.949383
468559,20,0,20,1.325416,103.949054
468560,0,2,2,1.325343,103.949414
468562,0,1,1,1.325284,103.949134
468563,0,2,2,1.325691,103.949346
468564,16,6,22,1.325926,103.949213
468566,3,0,3,1.325563,103.949427
468567,0,4,4,1.326124,103.948955
468568,14,0,14,1.326117,103.949109
468569,2,0,2,1.325502,103.948997
468571,6,0,6,1.326231,103.948897
468572,2,3,5,1.326264,103.949014
468573,1,1,2,1.326191,103.948931
468574,103,0,103,1.326321,103.948997
468576,10,0,10,1.326378,103.948974
468577,9,2,11,1.326374,103.9488
468578,1,1,2,1.326271,103.948863
468580,0,2,2,1.32643,103.948946
468581,4,0,4,1.32646,103.948737
468582,13,2,15,1.326516,103.948889
468583,88,8,96,1.326509,103.948737
468584,11,33,44,1.326243,103.950396
468585,477,868,1345,1.324809,103.950977
468597,0,9,9,1.315166,103.936321
468598,3,31,34,1.315084,103.936393
468599,0,1,1,1.325785,103.949295
468600,0,1,1,1.315186,103.936391
468601,1,0,1,1.315108,103.936473
468602,0,1,1,1.31521,103.936475
468603,0,3,3,1.325988,103.949168
468604,2,2,4,1.315133,103.936667
468605,5,0,5,1.315229,103.936665
468606,2,10,12,1.315159,103.936776
468607,29,11,40,1.315237,103.936742
468608,0,2,2,1.326476,103.948923
468609,35,4,39,1.315167,103.936875
468611,0,5,5,1.315169,103.936965
468612,2,0,2,1.315242,103.93684
468613,2,1,3,1.315222,103.936546
468614,114,1,115,1.315264,103.937118
468615,3,1,4,1.31519,103.937173
468616,4,5,9,1.315272,103.937223
468617,1,1,2,1.315258,103.937045
468619,15,2,17,1.315209,103.937362
468620,49,0,49,1.315291,103.937426
468621,0,5,5,1.315212,103.937436
468623,2,2,4,1.315237,103.937544
468624,0,4,4,1.31531,103.937612
468625,4,23,27,1.315246,103.937641
468626,12,0,12,1.315315,103.937684
468627,8,6,14,1.315253,103.93777
468628,3,2,5,1.315322,103.937787
468630,6,2,8,1.315324,103.937871
468646,5,68,73,1.32377,103.953035
468647,2,23,25,1.323708,103.952972
468648,2,0,2,1.315193,103.93726
468649,5,2,7,1.323668,103.952895
468650,0,4,4,1.323582,103.952799
468652,5,2,7,1.323494,103.952692
468653,0,1,1,1.315124,103.936583
468655,3,0,3,1.315181,103.937045
468656,1,0,1,1.323603,103.952688
468657,2,0,2,1.323708,103.952972
468658,1,0,1,1.323712,103.952884
468660,1,0,1,1.323808,103.953058
468661,10,0,10,1.323304,103.952332
468663,2,2,4,1.32327,103.952312
468664,8,4,12,1.323466,103.952592
468665,1,1,2,1.323357,103.952323
468666,22,0,22,1.323377,103.952323
468667,26,1,27,1.323184,103.952259
468668,0,2,2,1.323228,103.952294
468669,1,1,2,1.323483,103.952168
468670,1,0,1,1.3235,103.95259
468671,15,0,15,1.323035,103.95218
468672,2,1,3,1.323712,103.952884
468673,4,0,4,1.323051,103.952112
468675,0,3,3,1.322992,103.952129
468676,8,0,8,1.323208,103.952196
468677,292,3,295,1.32327,103.952224
468678,0,2,2,1.323141,103.952251
468697,5,3,8,1.313957,103.935479
468698,433,19,452,1.313129,103.935822
468699,6,12,18,1.313848,103.935509
468700,149,0,149,1.313244,103.935794
468701,22,2,24,1.313723,103.935548
468702,119,2,121,1.313347,103.935778
468703,1,7,8,1.313626,103.935568
468704,935,33,968,1.312754,103.935996
468705,4,12,16,1.313455,103.935583
468706,113,219,332,1.313525,103.935729
468707,0,11,11,1.313301,103.935628
468708,5,169,174,1.312928,103.935629
468709,8,0,8,1.312919,103.935581
468710,40,12,52,1.31288,103.935472
468711,2,21,23,1.312868,103.935421
468714,1,7,8,1.312732,103.935481
468715,2,1,3,1.323143,103.952171
468716,12,16,28,1.312647,103.93524
468717,5,11,16,1.312635,103.935173
468718,3,2,5,1.312611,103.935095
468719,0,36,36,1.312581,103.935049
468721,276,3,279,1.312505,103.934995
468722,4,73,77,1.312543,103.934849
468724,6,38,44,1.31249,103.934688
468725,11,575,586,1.31246,103.934544
468726,2511,1742,4253,1.312807,103.935242
468727,0,4,4,1.313552,103.935573
468740,1,1,2,1.323319,103.952243
468741,0,1,1,1.3231,103.952218
468742,26,190,216,1.319412,103.953943
468743,2,0,2,1.319255,103.954097
468744,27,0,27,1.319937,103.953607
468745,22,12,34,1.319947,103.953597
468746,28,2,30,1.319586,103.9531
468748,6,2,8,1.319561,103.95311
468749,5,0,5,1.319584,103.953083
468750,2,3,5,1.320165,103.9534
468751,68,6,74,1.319684,103.952911
468752,2,0,2,1.319412,103.953943
468754,0,1,1,1.319412,103.953943
468755,1,0,1,1.319933,103.952875
468756,40,0,40,1.319901,103.952893
468759,1,0,1,1.31993,103.952873
468760,25,0,25,1.319961,103.953537
468761,120,5,125,1.319961,103.953537
468762,0,7,7,1.319961,103.953537
468763,2,23,25,1.320713,103.952876
468764,16,0,16,1.320215,103.95335
468765,1,0,1,1.319933,103.952897
468766,9,1,10,1.320812,103.952782
468768,0,2,2,1.319704,103.952934
468769,11,3,14,1.32101,103.952595
468770,4,8,12,1.320414,103.95315
468772,1,0,1,1.320215,103.95335
468773,1,0,1,1.321207,103.952406
468774,8,3,11,1.320198,103.952491
468775,14,0,14,1.320197,103.952524
468776,14,0,14,1.320195,103.952488
468777,1,0,1,1.321207,103.952406
468780,6,0,6,1.320172,103.95249
468781,4,0,4,1.32017,103.952519
468782,5,0,5,1.320179,103.952516
468783,94,7,101,1.321218,103.952397
468784,3,7,10,1.320604,103.95296
468785,18,1,19,1.321326,103.952299
468786,1,1,2,1.320314,103.953249
468787,41,0,41,1.320613,103.952949
468790,0,1,1,1.32017,103.952494
468791,10,0,10,1.321198,103.952397
468792,1,0,1,1.321445,103.95219
468794,2,0,2,1.320614,103.95295
468795,5,4,9,1.321512,103.952119
468796,10,0,10,1.321512,103.952118
468797,16,3,19,1.321512,103.952118
468798,2,0,2,1.321197,103.952396
468799,35,3,38,1.321198,103.952397
468800,1,1,2,1.321512,103.952118
468801,2,2,4,1.321197,103.952396
468802,6,3,9,1.321197,103.952396
468803,79,0,79,1.321197,103.952396
468805,7,7,14,1.320887,103.952058
468806,0,1,1,1.321197,103.952396
468807,103,1,104,1.320886,103.952057
468809,81,0,81,1.321715,103.951907
468810,4,0,4,1.321714,103.951906
468812,4,0,4,1.321197,103.952396
468813,0,6,6,1.321197,103.952396
468815,68,3,71,1.32185,103.951766
468816,3,9,12,1.321072,103.951973
468817,21,0,21,1.321094,103.952008
468818,10,5,15,1.32112,103.95206
468819,2,0,2,1.321197,103.952396
468820,10,4,14,1.321239,103.952135
468822,3,0,3,1.312674,103.935339
468823,7,2,9,1.321444,103.952169
468824,22,2,24,1.321444,103.952169
468825,11,8,19,1.321444,103.952169
468826,4,6,10,1.321975,103.951614
468827,4,3,7,1.321822,103.951626
468829,5,0,5,1.321657,103.951562
468830,2,0,2,1.321203,103.952114
468832,1,0,1,1.320886,103.952057
468833,10,0,10,1.321638,103.95139
468834,4,6,10,1.321674,103.951413
468835,0,3,3,1.321445,103.95217
468838,1,0,1,1.321584,103.951377
468839,0,4,4,1.321949,103.951512
468840,1,4,5,1.320776,103.953044
468841,187,1,188,1.320842,103.952971
468842,1,1,2,1.321586,103.95153
468843,7,2,9,1.321009,103.952594
468844,1,0,1,1.321901,103.951501
468845,0,4,4,1.320023,103.953282
468846,4,4,8,1.320023,103.953282
468847,58,0,58,1.320023,103.953282
468848,1,7,8,1.320023,103.953282
468854,53,275,328,1.322073,103.954405
468855,7,711,718,1.322169,103.954338
468856,0,20,20,1.322197,103.95421
468857,0,5,5,1.322209,103.95409
468858,0,3,3,1.321748,103.951433
468859,4,15,19,1.322209,103.95397
468860,2,9,11,1.322197,103.953862
468861,0,3,3,1.322203,103.954045
468862,60,0,60,1.322009,103.953625
468864,2,1,3,1.322039,103.953588
468865,3,28,31,1.322117,103.953669
468878,30,29,59,1.315078,103.934677
468879,11,1,12,1.314763,103.934462
468880,27,6,33,1.315078,103.934739
468881,20,0,20,1.31518,103.934562
468882,33,5,38,1.315078,103.934802
468883,0,9,9,1.315237,103.934562
468884,1,0,1,1.321009,103.952594
468885,2,0,2,1.320912,103.952905
468886,0,3,3,1.322163,103.95376
468887,136,1,137,1.315351,103.934562
468888,3,1,4,1.315078,103.934984
468889,5,3,8,1.315078,103.935047
468890,2,0,2,1.315294,103.934562
468891,9,0,9,1.315078,103.935104
468892,1,5,6,1.315078,103.935161
468896,0,3,3,1.315078,103.934921
468897,5,5,10,1.315208,103.934981
468898,3,3,6,1.315208,103.934919
468899,3,0,3,1.315208,103.935044
468900,66,0,66,1.315208,103.934793
468901,4,3,7,1.315207,103.934737
468902,1,10,11,1.315207,103.934685
468903,2,3,5,1.314805,103.934459
468904,61,5,66,1.314854,103.934461
468905,22,29,51,1.315002,103.934474
468906,8,8,16,1.315053,103.93447
468907,0,5,5,1.315097,103.934474
468917,8,0,8,1.314916,103.935605
468918,0,1,1,1.315078,103.934865
468919,5,1,6,1.314997,103.935585
468920,0,3,3,1.315208,103.934856
468922,1,1,2,1.315443,103.934562
468923,2,0,2,1.315111,103.935687
468924,22,1,23,1.315192,103.935652
468925,1,0,1,1.314894,103.935761
468926,0,2,2,1.31518,103.935519
468927,2,1,3,1.314985,103.935727
468928,0,1,1,1.315335,103.935457
468930,36,2,38,1.315552,103.935516
468932,38,2,40,1.315638,103.935481
468936,3,0,3,1.315415,103.935434
468938,1,0,1,1.31542,103.935557
468940,6,6,12,1.316102,103.935305
468942,1,0,1,1.316011,103.93535
468943,5,1,6,1.316275,103.935046
468944,0,1,1,1.31624,103.935253
468960,1872,6623,8495,1.30668,103.935039
468961,918,637,1555,1.311754,103.95224
468962,159,446,605,1.312359,103.953985
468963,1089,348,1437,1.315317,103.96189
468964,29,181,210,1.310275,103.944295
468965,11,246,257,1.314115,103.960188
468979,174,3159,3333,1.328776,103.923433
468980,230,54,284,1.326674,103.920663
468981,887,5139,6026,1.325118,103.919094
468982,377,782,1159,1.328242,103.920786
468984,73,6401,6474,1.299509,103.837
469000,2797,3821,6618,1.323678,103.922137
469001,2440,11124,13564,1.322995,103.922194
469002,562,1345,1907,1.323535,103.920741
469003,348,48,396,1.32347,103.921272
469004,1361,553,1914,1.322589,103.920965
469005,819,206,1025,1.323731,103.920747
469010,131,2800,2931,1.327006,103.924472
469020,7,345,352,1.328484,103.919121
469021,2392,173,2565,1.330369,103.920183
469022,645,1279,1924,1.330727,103.91955
469023,1,23,24,1.328137,103.918431
469024,7,104,111,1.328886,103.918539
469025,193,56,249,1.328797,103.917711
469026,431,196,627,1.329277,103.917232
469027,76,695,771,1.329507,103.918117
469028,832,236,1068,1.329383,103.91751
469029,1555,470,2025,1.330703,103.918215
469030,72,6089,6161,1.327926,103.919458
469031,525,890,1415,1.329372,103.919612
469032,1269,419,1688,1.330125,103.916355
469044,730,188,918,1.32259,103.919824
469045,28,462,490,1.323685,103.919725
469059,20,1124,1144,1.325803,103.924323
469060,11,98,109,1.325988,103.926176
469075,3,177,180,1.322673,103.953939
469076,2,0,2,1.31534,103.935601
469077,0,10,10,1.322587,103.953795
469078,83,0,83,1.322547,103.953729
469081,3,0,3,1.315879,103.935413
469082,1,0,1,1.316326,103.935242
469083,0,1,1,1.322468,103.953206
469085,2,0,2,1.322659,103.953875
469086,13,1,14,1.322771,103.95292
469087,8,1,9,1.322454,103.953628
469088,5,0,5,1.322406,103.953523
469089,4,6,10,1.322537,103.953486
469090,1,0,1,1.322541,103.953136
469091,0,1,1,1.322541,103.953396
469092,0,4,4,1.322704,103.953237
469101,0,6,6,1.329619,103.947686
469102,1,10,11,1.329729,103.947955
469103,3,6,9,1.329664,103.947646
469104,0,6,6,1.329815,103.947886
469106,2,2,4,1.3299,103.947817
469107,14,3,17,1.32975,103.947561
469108,19,2,21,1.329986,103.947748
469110,14,35,49,1.330071,103.947678
469111,20,0,20,1.330117,103.947729
469112,39,2,41,1.329836,103.947486
469113,1,8,9,1.330141,103.947629
469115,9,0,9,1.330242,103.94754
469116,5,8,13,1.329911,103.947424
469117,1,1,2,1.322688,103.95297
469118,4,1,5,1.330002,103.947378
469119,3,0,3,1.3224,103.953374
469120,1,24,25,1.330048,103.947338
469121,5,3,8,1.330499,103.947333
469122,1,2,3,1.330413,103.947402
469124,1,17,18,1.330202,103.947216
469125,22,0,22,1.33067,103.947194
469127,0,1,1,1.322629,103.953316
469128,4,6,10,1.330276,103.947139
469129,1,8,9,1.330841,103.947056
469130,0,1,1,1.330755,103.947125
469131,1,2,3,1.330105,103.94727
469132,15,2,17,1.330346,103.947062
469133,18,1,19,1.331012,103.946918
469135,3,0,3,1.330926,103.946987
469136,0,3,3,1.331097,103.946848
469138,1,0,1,1.330306,103.947091
469139,152,2,154,1.331268,103.94671
469140,1,0,1,1.330541,103.946951
469141,2,99,101,1.331313,103.946665
469143,3,95,98,1.33107,103.946646
469144,6,7,13,1.330695,103.946832
469145,69,3,72,1.33129,103.946207
469146,3,12,15,1.330203,103.947595
469147,1,0,1,1.330581,103.946917
469148,1,2,3,1.330483,103.946985
469160,2,16,18,1.325888,103.948926
469161,1,9,10,1.325848,103.948571
469162,1,0,1,1.330073,103.947299
469163,2,0,2,1.330328,103.947471
469164,1,4,5,1.325807,103.948807
469165,12,2,14,1.325956,103.948511
469166,69,0,69,1.325773,103.948744
469167,3,0,3,1.329878,103.94785
469168,21,2,23,1.325727,103.948693
469169,1,1,2,1.325903,103.948542
469170,4,0,4,1.325681,103.948641
469171,3,0,3,1.326017,103.948491
469173,1,0,1,1.325853,103.948858
469174,0,1,1,1.32616,103.948411
469175,10,0,10,1.326206,103.948382
469176,13,0,13,1.325567,103.948482
469177,0,4,4,1.32579,103.948456
469178,9,1,10,1.325532,103.948425
469179,0,2,2,1.326063,103.948468
469180,11,1,12,1.326033,103.94831
469181,1,0,1,1.325607,103.948539
469184,8,1,9,1.325458,103.948249
469185,1,0,1,1.325885,103.948403
469187,13,2,15,1.325383,103.948059
469188,2,0,2,1.32583,103.948421
469190,2,0,2,1.325418,103.948118
469191,0,18,18,1.32611,103.948324
469192,16,0,16,1.325326,103.947935
469193,3,0,3,1.326109,103.948439
469194,0,1,1,1.325996,103.948342
469195,2,1,3,1.325893,103.947873
469196,4,2,6,1.325297,103.947856
469197,13,0,13,1.32569,103.948006
469201,6,0,6,1.325793,103.947949
469203,6,0,6,1.325843,103.94799
469204,4,2,6,1.325175,103.947545
469205,58,30,88,1.325837,103.947915
469207,2,1,3,1.325644,103.948029
469208,2,2,4,1.325154,103.947477
469210,0,2,2,1.32535,103.948003
469211,0,1,1,1.325322,103.948197
469212,53,1,54,1.325123,103.947373
469214,1,4,5,1.325106,103.947316
469215,2,1,3,1.325193,103.947177
469216,1,0,1,1.325314,103.947131
469217,18,2,20,1.32548,103.947069
469218,0,2,2,1.32514,103.94777
469219,0,2,2,1.325071,103.947213
469220,1,0,1,1.325089,103.94727
469221,0,2,2,1.325525,103.947051
469222,1,0,1,1.325054,103.947162
469223,0,1,1,1.325031,103.947099
469224,12,1,13,1.325014,103.947043
469225,3,0,3,1.32544,103.947086
469226,5,0,5,1.324985,103.946991
469227,133,0,133,1.325226,103.946664
469228,3,0,3,1.325174,103.946681
469229,7,0,7,1.325277,103.946647
469232,5,0,5,1.324945,103.946877
469233,5,2,7,1.325403,103.946607
469235,0,1,1,1.325117,103.946698
469236,61,0,61,1.324917,103.946809
469237,1,2,3,1.324879,103.946716
469238,3,0,3,1.325029,103.946529
469239,18,2,20,1.325086,103.946523
469240,2,0,2,1.325042,103.946726
469242,1,0,1,1.324977,103.946552
469243,1,1,2,1.324826,103.946554
469244,3,0,3,1.324905,103.946775
469245,0,9,9,1.325229,103.946466
469246,1,0,1,1.324896,103.946747
469247,18,7,25,1.325275,103.946438
469248,7,0,7,1.324842,103.946587
469250,5,1,6,1.324808,103.946519
469251,1,0,1,1.324859,103.946627
469252,0,2,2,1.325178,103.946484
469253,7,3,10,1.326186,103.948395
469267,245,3,248,1.322558,103.929161
469268,615,1469,2084,1.32223,103.92679
469269,917,0,917,1.320688,103.929179
469270,1518,187,1705,1.319201,103.929121
469271,11,4,15,1.321102,103.927669
469272,1204,1447,2651,1.319705,103.930186
469273,37,1072,1109,1.320564,103.927624
469274,55,444,499,1.320169,103.927549
469275,19,1619,1638,1.320188,103.935076
469276,750,467,1217,1.317575,103.929847
469277,373,1718,2091,1.318603,103.932167
469278,422,94,516,1.3189,103.935561
469279,115,1389,1504,1.321208,103.927414
469293,224,125,349,1.324312,103.943919
469294,14,8411,8425,1.319855,103.943984
469296,732,5196,5928,1.322407,103.944365
469297,603,240,843,1.322065,103.94585
469298,589,19,608,1.321651,103.945029
469299,190,919,1109,1.321792,103.943547
469300,238,545,783,1.317502,103.945488
469301,6,0,6,1.299509,103.837
469305,1,0,1,1.32479,103.946479
469311,1,0,1,1.299509,103.837
469315,170,5738,5908,1.320956,103.937524
469316,105,1852,1957,1.320715,103.938192
469317,286,108,394,1.323989,103.937761
469331,41,513,554,1.323476,103.931257
469332,1458,11,1469,1.321835,103.931045
469333,316,241,557,1.319438,103.931456
469334,1,0,1,1.299509,103.837
469335,226,7636,7862,1.322352,103.93244
469336,564,1466,2030,1.315773,103.933785
469337,1497,1105,2602,1.316703,103.93387
469338,1255,461,1716,1.314708,103.93397
469355,6,2084,2090,1.320936,103.955327
469356,6,1226,1232,1.321352,103.955033
469357,0,12,12,1.32151,103.954807
469358,13,1472,1485,1.321097,103.955204
469359,4,49,53,1.321252,103.955088
469360,361,285,646,1.32151,103.954807
469361,137,27,164,1.320849,103.954657
469362,18,65,83,1.32151,103.954807
469363,3,117,120,1.322602,103.954284
469364,2,13,15,1.322685,103.95421
469365,3,83,86,1.322745,103.954168
469366,0,179,179,1.322846,103.954087
469367,11,0,11,1.322911,103.954031
469368,5,203,208,1.32296,103.953993
469369,1,222,223,1.323012,103.953951
469370,2,24,26,1.3229,103.953858
469371,98,3,101,1.323675,103.953797
469372,6,71,77,1.323791,103.953699
469373,0,8,8,1.323849,103.95365
469374,1,0,1,1.316791,103.932389
469375,6,16,22,1.323964,103.953551
469377,0,90,90,1.32408,103.953453
469378,0,7,7,1.323608,103.953283
469379,4,130,134,1.324138,103.953404
469380,1,55,56,1.323543,103.953151
469381,2,15,17,1.324253,103.953327
469383,0,180,180,1.324303,103.953287
469385,1,0,1,1.323906,103.9536
469386,4,52,56,1.324303,103.952764
469387,3,0,3,1.324876,103.946661
469388,19,111,130,1.324451,103.953167
469389,5,0,5,1.324501,103.953128
469390,5,197,202,1.323995,103.952997
469391,3,84,87,1.32455,103.953088
469392,0,94,94,1.323925,103.952867
469394,2,73,75,1.323948,103.953033
469396,8,11,19,1.324059,103.952958
469397,0,27,27,1.324699,103.952968
469398,4,87,91,1.324111,103.952917
469399,7,0,7,1.324161,103.952872
469400,0,6,6,1.324228,103.952817
469401,1,25,26,1.325145,103.952122
469402,0,53,53,1.325355,103.952195
469404,2,11,13,1.325588,103.952017
469405,0,2,2,1.324773,103.946439
469406,87,0,87,1.325229,103.952055
469407,1,86,87,1.325223,103.952284
469408,1,0,1,1.324352,103.953247
469409,2,140,142,1.325699,103.951929
469410,3,80,83,1.325988,103.951684
469412,1,39,40,1.326126,103.951882
469413,5,186,191,1.326325,103.951759
469416,122,104,226,1.326661,103.950307
469418,9,357,366,1.329179,103.949413
469419,8,0,8,1.329251,103.949363
469420,4,450,454,1.329334,103.949303
469421,2,0,2,1.325559,103.952357
469422,13,100,113,1.329473,103.949169
469424,2,0,2,1.329417,103.949214
469425,12,458,470,1.329694,103.948964
469426,4,0,4,1.329767,103.948947
469427,17,0,17,1.329822,103.948875
469428,3,29,32,1.329877,103.94883
469429,0,2,2,1.329628,103.949036
469431,14,188,202,1.33011,103.948636
469432,5,3,8,1.330188,103.948575
469433,0,312,312,1.330265,103.948525
469435,2,13,15,1.330426,103.948403
469436,4,75,79,1.330487,103.94833
469437,0,3,3,1.324402,103.953207
469438,51,19,70,1.331901,103.948467
469439,0,37,37,1.331893,103.948288
469440,6,0,6,1.33185,103.948512
469441,0,2,2,1.329961,103.948764
469445,4,0,4,1.331751,103.948414
469446,1,0,1,1.325281,103.952375
469447,1,0,1,1.331684,103.948646
469448,4,0,4,1.331641,103.94868
469449,25,0,25,1.33163,103.948516
469451,0,2,2,1.331848,103.948323
469452,6,0,6,1.331558,103.948763
469453,1,0,1,1.331694,103.948454
469454,11,0,11,1.331506,103.948797
469455,3,0,3,1.330635,103.948558
469456,1,55,56,1.329192,103.949055
469457,9,0,9,1.331454,103.948837
469458,1,0,1,1.33155,103.948584
469459,4,59,63,1.329249,103.948998
469460,49,14,63,1.331414,103.948877
469462,39,0,39,1.329369,103.948884
469463,8,82,90,1.331399,103.948723
469464,0,15,15,1.331361,103.948733
469465,52,131,183,1.329421,103.94885
469466,8,12,20,1.330979,103.948774
469467,1,19,20,1.330979,103.948774
469468,5,44,49,1.329507,103.948787
469469,7,13,20,1.330945,103.948734
469470,0,18,18,1.330945,103.948734
469471,3,36,39,1.329552,103.948741
469472,2,12,14,1.330905,103.948683
469474,0,7,7,1.329661,103.948679
469475,1,3,4,1.33087,103.948637
469476,0,17,17,1.33087,103.948637
469477,0,47,47,1.329713,103.948633
469478,10,6,16,1.330842,103.948586
469480,4,0,4,1.329827,103.948588
469482,0,1,1,1.331453,103.948653
469483,1,99,100,1.329885,103.948531
469484,3,0,3,1.331505,103.948619
469485,0,1,1,1.330813,103.948529
469486,1,42,43,1.330062,103.948383
469487,2,0,2,1.33159,103.948539
469489,1,79,80,1.330197,103.948277
469490,2,0,2,1.330744,103.948432
469491,3,1596,1599,1.330716,103.948393
469493,7,174,181,1.33098,103.94817
469494,3,1308,1311,1.331056,103.948287
469495,6,0,6,1.330476,103.948038
469496,13,3,16,1.331035,103.948129
469497,7,823,830,1.331105,103.94825
469498,58,360,418,1.330643,103.947891
469499,8,473,481,1.331086,103.948089
469500,1,153,154,1.331149,103.948208
469501,2,852,854,1.3307,103.947859
469502,3,0,3,1.330779,103.948478
469503,4,264,268,1.331195,103.948167
469504,76,18,94,1.330871,103.947706
469505,4,0,4,1.331187,103.948022
469506,0,169,169,1.331247,103.948136
469507,1,620,621,1.331204,103.947526
469508,8,260,268,1.331246,103.947979
469509,2,0,2,1.330716,103.948393
469510,6,0,6,1.331234,103.947501
469511,0,978,978,1.331199,103.947506
469512,25,174,199,1.331283,103.947955
469513,6,0,6,1.331327,103.948072
469514,4,423,427,1.331274,103.947475
469516,10,167,177,1.331337,103.947912
469517,0,305,305,1.331378,103.948029
469518,4,695,699,1.33132,103.947437
469520,10,492,502,1.331391,103.94783
469521,4,0,4,1.33143,103.947998
469522,1,0,1,1.330779,103.948478
469523,0,247,247,1.331344,103.947391
469524,8,0,8,1.331431,103.947784
469525,0,688,688,1.33147,103.947972
469526,6,774,780,1.331398,103.947382
469528,13,2,15,1.331476,103.947781
469529,1,293,294,1.33151,103.947926
469530,12,0,12,1.331427,103.947368
469531,0,989,989,1.331418,103.947345
469532,14,124,138,1.331514,103.947767
469533,11,2504,2515,1.331577,103.947872
469534,6,572,578,1.331453,103.947346
469536,3,604,607,1.331484,103.94732
469538,421,3881,4302,1.331805,103.947613
469539,1,0,1,1.331354,103.947411
469540,0,212,212,1.331493,103.947277
469541,0,7,7,1.331536,103.947277
469544,0,109,109,1.331552,103.947227
469545,32,2,34,1.331591,103.94723
469546,5,309,314,1.331578,103.947208
469547,19,2721,2740,1.331618,103.947204
469548,4,373,377,1.331607,103.947187
469549,5,957,962,1.331855,103.946935
469550,0,156,156,1.331855,103.946935
469551,1,74,75,1.331855,103.946935
469552,2,31,33,1.331855,103.946935
469553,0,36,36,1.331855,103.946935
469554,4,47,51,1.331855,103.946935
469555,1,95,96,1.3319,103.946298
469556,1,47,48,1.331892,103.946224
469557,1,31,32,1.331935,103.94612
469558,4,350,354,1.331949,103.946035
469560,131,12,143,1.331731,103.948049
469561,5,97,102,1.330098,103.948336
469562,3,214,217,1.330544,103.948002
469563,1,125,126,1.330373,103.948126
469564,230,6,236,1.320675,103.95442
469565,168,10,178,1.320937,103.954196
469566,118,16,134,1.321218,103.953963
469567,158,6,164,1.321507,103.953739
469568,51,17,68,1.321527,103.954069
469569,106,19,125,1.32151,103.954807
469570,1,11,12,1.325312,103.951995
469571,2,30,32,1.325156,103.952373
469572,214,1044,1258,1.320837,103.95541
469573,0,16,16,1.325788,103.951861
469574,2,417,419,1.327414,103.950287
469575,1,6,7,1.327362,103.95019
469576,10,0,10,1.327288,103.950076
469577,4,10,14,1.327213,103.949956
469578,66,23,89,1.327116,103.949814
469579,0,1,1,1.33151,103.947298
469580,127,9,136,1.326961,103.949569
469581,0,1,1,1.327041,103.949706
469582,1,7,8,1.32689,103.949432
469583,1,3,4,1.32685,103.94937
469584,1,0,1,1.326932,103.949519
469585,0,8,8,1.326745,103.949205
469586,42,0,42,1.326314,103.949316
469587,2,0,2,1.331292,103.948104
469588,29,0,29,1.326948,103.949969
469589,0,2,2,1.326562,103.949585
469590,1,1,2,1.326905,103.949919
469591,26,0,26,1.326788,103.949807
469592,1,0,1,1.326785,103.949263
469593,1,0,1,1.326724,103.949737
469595,1,0,1,1.326657,103.949693
469596,1,0,1,1.326597,103.949639
469597,90,4,94,1.299509,103.837
469598,59,1,60,1.299509,103.837
469599,57,28,85,1.326562,103.94782
469600,34,173,207,1.299509,103.837
469601,70,805,875,1.299509,103.837
469623,385,67,452,1.333929,103.932513
469624,39,2662,2701,1.334661,103.932007
469625,8,705,713,1.332795,103.922305
469626,208,20,228,1.331593,103.922228
469627,252,6602,6854,1.333317,103.926892
469642,262,113,375,1.3261,103.938864
469643,45,64,109,1.326575,103.937797
469644,215,801,1016,1.330726,103.936612
469645,16,271,287,1.325864,103.93832
469646,96,835,931,1.325558,103.937856
469659,44,5556,5600,1.326906,103.930655
469661,17,6261,6278,1.326295,103.929535
469676,136,6662,6798,1.33265,103.937136
469677,33,10195,10228,1.328266,103.939687
469678,15,3003,3018,1.327927,103.939713
469679,3,81,84,1.329175,103.932896
469680,182,2825,3007,1.329819,103.931902
469695,13,1460,1473,1.335948,103.949217
469700,408,510,918,1.334613,103.942216
469701,304,59,363,1.334282,103.941072
469702,8,4567,4575,1.334822,103.941099
469715,17,1817,1834,1.326933,103.934661
469717,206,3564,3770,1.331242,103.934759
469718,50,1528,1578,1.332778,103.933674
469719,250,433,683,1.333361,103.934605
469722,826,317,1143,1.333844,103.935512
469723,11,537,548,1.299509,103.837
469724,15,85,100,1.299509,103.837
469751,129,5127,5256,1.327015,103.926342
469752,99,1812,1911,1.327525,103.927202
469753,30,1391,1421,1.299509,103.837
469767,0,2,2,1.326842,103.949858
469768,2,0,2,1.329626,103.948199
469769,1,4,5,1.329489,103.948284
469770,0,1,1,1.326516,103.949497
469771,2,0,2,1.329581,103.948233
469775,6,1,7,1.329105,103.948546
469776,4,0,4,1.329025,103.94866
469777,1,142,143,1.328956,103.948711
469778,17,36,53,1.328908,103.948448
469779,0,14,14,1.329067,103.948344
469782,8,44,52,1.328852,103.9483
469784,1,18,19,1.328804,103.948201
469786,1,1,2,1.329311,103.948415
469787,19,0,19,1.328877,103.947918
469788,84,2,86,1.328747,103.94799
469789,13,0,13,1.328848,103.947815
469790,13,3,16,1.328719,103.947857
469791,6,0,6,1.328816,103.947721
469793,0,6,6,1.328797,103.947632
469794,0,1,1,1.32942,103.94833
469795,34,0,34,1.328776,103.947511
469796,0,5,5,1.328548,103.947313
469797,2,156,158,1.328681,103.947617
469810,5,2,7,1.328689,103.947662
469825,1,490,491,1.323063,103.953204
469826,1,2,3,1.331143,103.948049
469827,84,1,85,1.323223,103.953392
469829,17,7,24,1.323108,103.953256
469830,1,0,1,1.328671,103.947546
469831,4,6,10,1.323035,103.952898
469833,0,3,3,1.32314,103.953427
469834,1,0,1,1.323094,103.952998
469836,3,0,3,1.322905,103.952521
469837,0,31,31,1.322722,103.952259
469838,4,0,4,1.322922,103.952075
469839,9,0,9,1.322865,103.952052
469840,1,0,1,1.322859,103.952452
469842,6,3,9,1.322693,103.951995
469843,17,0,17,1.322647,103.951978
469844,1,7,8,1.322601,103.951956
469845,7,3,10,1.322555,103.951927
469846,31,5,36,1.322446,103.951876
469847,1,0,1,1.322807,103.95203
469853,20,168,188,1.323154,103.953079
469858,0,1,1,1.322395,103.951853
469859,5,0,5,1.323154,103.953079
469860,3,5,8,1.323249,103.953205
469862,7,0,7,1.323072,103.952956
469863,0,4,4,1.323094,103.952998
469864,137,0,137,1.323094,103.952998
469865,8,3,11,1.323154,103.953079
469867,8,3,11,1.326175,103.94966
469868,1,36,37,1.326278,103.949597
469869,1,5,6,1.325992,103.94997
469870,1,1,2,1.328771,103.9481
469871,8,0,8,1.326072,103.949919
469872,1,4,5,1.326002,103.94979
469873,27,0,27,1.326185,103.949832
469874,14,8,22,1.326063,103.949728
469875,104,6,110,1.326255,103.949797
469877,22,1,23,1.326333,103.949628
469878,1,0,1,1.323094,103.952998
469879,2,1,3,1.322768,103.952327
469892,32,0,32,1.320165,103.954059
469893,4,1,5,1.320211,103.954127
469895,12,3,15,1.32031,103.954303
469896,4,3,7,1.320393,103.954392
469897,1,0,1,1.326329,103.949727
469898,6,1,7,1.320487,103.953512
469899,10,1,11,1.320637,103.954078
469902,3,1,4,1.32071,103.953903
469903,10,1,11,1.32077,103.953846
469904,0,1,1,1.320561,103.954033
469905,2,0,2,1.325912,103.949834
469906,6,4,10,1.320995,103.953644
469907,2,0,2,1.320912,103.953705
469908,1,0,1,1.32085,103.953785
469909,4,0,4,1.321314,103.953571
469910,31,3,34,1.321404,103.9535
469911,1,2,3,1.299509,103.837
469913,27,0,27,1.321323,103.95333
469915,2,0,2,1.321207,103.953421
469916,108,1,109,1.321608,103.953071
469917,3,0,3,1.321079,103.953289
469919,1,0,1,1.321271,103.953542
469923,0,1,1,1.321608,103.953071
469924,3,0,3,1.321734,103.952888
469925,4,1,5,1.321734,103.952888
469926,0,3,3,1.321784,103.952969
469928,23,0,23,1.321239,103.953097
469929,9,33,42,1.321734,103.952888
469930,74,5,79,1.321348,103.953011
469931,6,1,7,1.321804,103.952834
469932,4,3,7,1.321434,103.952914
469933,0,1,1,1.321136,103.953188
469934,2,0,2,1.321207,103.953421
469935,0,6,6,1.32197,103.952653
469936,0,1,1,1.321892,103.952765
469937,0,1,1,1.321611,103.952709
469938,10,0,10,1.32172,103.952618
469939,0,2,2,1.321514,103.952818
469940,7,1,8,1.321835,103.952516
469941,12,0,12,1.321932,103.952442
469942,0,3,3,1.321734,103.952888
469943,6,3,9,1.322047,103.952351
469944,11,0,11,1.322138,103.952248
469945,0,1,1,1.322077,103.952568
469946,0,11,11,1.321267,103.953072
469947,5,0,5,1.32145,103.953457
469948,4,0,4,1.299509,103.837
469960,9,651,660,1.314536,103.940239
469961,5,318,323,1.314479,103.940251
469962,11,31,42,1.314364,103.940251
469963,9,15,24,1.314307,103.940251
469964,2,44,46,1.314256,103.940251
469965,1,15,16,1.314211,103.940253
469966,0,26,26,1.314164,103.940257
469967,9,11,20,1.314095,103.940268
469968,52,43,95,1.314026,103.940274
469969,10,287,297,1.313991,103.94016
469970,3162,4351,7513,1.312372,103.93872
469971,754,1992,2746,1.312343,103.938429
469972,2704,404,3108,1.312468,103.938176
469973,523,38,561,1.312745,103.939247
469974,2885,1582,4467,1.31301,103.939928
469975,596,2289,2885,1.312745,103.939247
469976,2598,3086,5684,1.312745,103.939247
469977,3877,1852,5729,1.312167,103.937498
469978,1175,199,1374,1.312405,103.936903
469979,96,518,614,1.311778,103.936927
469980,288,443,731,1.31178,103.936248
469981,1009,336,1345,1.311738,103.93559
469982,4205,817,5022,1.311366,103.935266
469983,3723,865,4588,1.310789,103.936398
469984,935,381,1316,1.310901,103.937378
469985,4519,1003,5522,1.310791,103.93804
469986,2319,1389,3708,1.311782,103.939362
469987,2122,1578,3700,1.311673,103.939013
469988,1727,309,2036,1.311351,103.9386
469989,390,69,459,1.31114,103.939329
469990,1250,112,1362,1.311155,103.939664
469991,1897,184,2081,1.311316,103.940095
469992,2184,1058,3242,1.311646,103.940268
469993,1034,4502,5536,1.31198,103.940282
469994,335,5972,6307,1.312213,103.940144
470101,916,42,958,1.328226,103.909473
470102,201,76,277,1.328517,103.909186
470103,1552,183,1735,1.328835,103.90914
470104,528,87,615,1.329302,103.909793
470105,1203,355,1558,1.329171,103.909205
470106,1048,286,1334,1.329554,103.909247
470107,945,475,1420,1.329895,103.909136
470108,461,398,859,1.330218,103.909256
470109,172,44,216,1.329737,103.909764
470110,464,340,804,1.330146,103.910393
470111,2,4,6,1.329889,103.910012
470112,643,148,791,1.32977,103.910469
470113,402,296,698,1.330786,103.910514
470114,651,509,1160,1.330583,103.909763
470115,645,435,1080,1.33071,103.908538
470116,407,341,748,1.331044,103.908538
470117,404,8140,8544,1.331381,103.908646
470118,180,648,828,1.331143,103.909099
470119,13,1243,1256,1.33107,103.909466
470120,197,295,492,1.33088,103.909819
470121,530,18581,19111,1.33125,103.909938
470122,737,4203,4940,1.332011,103.910558
470123,463,259,722,1.332338,103.910276
470124,580,1127,1707,1.332661,103.910105
470125,277,70,347,1.332958,103.91009
470126,283,475,758,1.332726,103.910826
470127,328,102,430,1.332867,103.911183
470128,1270,272,1542,1.333505,103.911545
470129,102,162,264,1.334036,103.912218
470130,428,194,622,1.333485,103.912262
470131,630,311,941,1.333168,103.911649
470132,412,787,1199,1.332812,103.911738
470133,420,4156,4576,1.332419,103.911764
470134,339,6107,6446,1.332773,103.912496
470135,395,269,664,1.333159,103.912429
470136,679,6464,7143,1.33352,103.913481
470137,549,207,756,1.333791,103.913136
470138,210,206,416,1.334287,103.913196
470139,286,11385,11671,1.334552,103.913627
470140,196,2068,2264,1.334898,103.913319
470141,585,6100,6685,1.335317,103.913354
470142,629,2581,3210,1.335604,103.913183
470143,199,285,484,1.335035,103.912741
470144,307,143,450,1.334916,103.912427
470145,775,108,883,1.334296,103.911999
470146,495,262,757,1.334604,103.911889
470147,817,647,1464,1.334894,103.911749
470148,862,606,1468,1.335353,103.911809
470149,606,701,1307,1.335805,103.912761
470150,452,963,1415,1.336075,103.912631
470151,743,2451,3194,1.335621,103.911661
470601,861,480,1341,1.330042,103.911522
470602,1226,365,1591,1.329382,103.911541
470603,839,611,1450,1.330014,103.912339
470604,665,392,1057,1.330685,103.91302
470605,1503,543,2046,1.330231,103.913374
470606,671,260,931,1.331335,103.913689
470607,488,360,848,1.331135,103.91277
470608,634,6076,6710,1.331825,103.913075
470609,816,3795,4611,1.331892,103.912367
470610,104,399,503,1.330848,103.912143
470611,1162,301,1463,1.331221,103.915301
470612,284,324,608,1.331648,103.915742
470613,364,294,658,1.331911,103.916897
470614,432,640,1072,1.332361,103.916663
470615,582,6168,6750,1.332232,103.915893
470616,688,8172,8860,1.33175,103.914911
470617,414,726,1140,1.333112,103.916492
470618,178,549,727,1.333019,103.916938
470619,571,661,1232,1.333479,103.917612
470620,1891,346,2237,1.334008,103.918071
470621,922,179,1101,1.334479,103.916774
470622,740,359,1099,1.33406,103.916843
470623,134,61,195,1.333634,103.91695
470624,61,99,160,1.334322,103.916404
470625,183,74,257,1.33399,103.916074
470626,301,215,516,1.334329,103.915516
470627,441,5262,5703,1.333995,103.915435
470628,383,459,842,1.334849,103.914896
470629,583,3222,3805,1.334216,103.914627
470630,42,277,319,1.332925,103.91412
470631,317,653,970,1.332953,103.914939
470632,433,5674,6107,1.332034,103.91397
470701,91,338,429,1.337555,103.918829
470702,1265,1286,2551,1.33716,103.91876
470703,834,3532,4366,1.337138,103.919774
470704,651,519,1170,1.33634,103.920056
470705,939,1542,2481,1.336615,103.918863
470706,737,1996,2733,1.33615,103.918916
470707,2352,799,3151,1.335452,103.919104
470708,69,0,69,1.335033,103.919157
470709,931,113,1044,1.33531,103.922809
470710,464,51,515,1.335619,103.923756
470711,1019,535,1554,1.336013,103.923598
470712,1466,262,1728,1.335901,103.922688
470713,311,40,351,1.336675,103.922496
470714,634,433,1067,1.337071,103.923198
470715,724,1826,2550,1.337443,103.923062
470716,712,5535,6247,1.337892,103.924918
470717,896,3582,4478,1.337616,103.925357
470718,1416,465,1881,1.336733,103.925831
470719,1270,269,1539,1.336439,103.924689
470720,1096,155,1251,1.336037,103.924854
470721,1702,264,1966,1.336383,103.926219
470722,2029,220,2249,1.336719,103.928064
470723,1380,302,1682,1.33694,103.929288
470724,600,273,873,1.33716,103.928355
470725,980,139,1119,1.337502,103.929011
470726,32,2725,2757,1.338315,103.928759
470727,4,54,58,1.338315,103.928759
470728,9,37,46,1.338315,103.928759
470729,4,9,13,1.338315,103.928759
470731,10,4,14,1.338315,103.928759
470733,20,2079,2099,1.338315,103.928759
470734,11,7,18,1.338315,103.928759
470735,19,18,37,1.338315,103.928759
470736,31,10,41,1.338315,103.928759
470737,7,28,35,1.338315,103.928759
470739,40,4219,4259,1.337976,103.922713
470740,244,60,304,1.338387,103.922697
470741,38,8436,8474,1.337766,103.922274
470742,452,175,627,1.338044,103.921938
470743,220,108,328,1.338449,103.921816
470744,885,2638,3523,1.337464,103.921607
470745,397,4263,4660,1.337457,103.922266
470746,42,585,627,1.337297,103.921216
470747,22,0,22,1.336504,103.921348
470748,28,45,73,1.299509,103.837
470760,764,10889,11653,1.336572,103.935054
470761,1665,1547,3212,1.336307,103.93379
470762,1011,380,1391,1.336391,103.934216
470763,799,394,1193,1.3361,103.934666
470764,245,376,621,1.335926,103.935229
470765,805,352,1157,1.336114,103.935749
470766,1142,367,1509,1.336169,103.936171
470767,1457,552,2009,1.335962,103.936701
470768,275,162,437,1.335737,103.937072
470769,1325,430,1755,1.33595,103.937625
470770,1034,441,1475,1.336071,103.938112
470771,1172,446,1618,1.336025,103.938657
470772,1193,800,1993,1.337063,103.934379
470773,1326,753,2079,1.336606,103.937086
470774,1209,1261,2470,1.336755,103.936678
470775,76,1744,1820,1.33669,103.935776
471609,169,7204,7373,1.331833,103.913112
471613,1380,203,1583,1.332787,103.917481
471714,23,428,451,1.336556,103.92349
471739,42,3561,3603,1.337922,103.923333
471740,12,18,30,1.299509,103.837
471742,9,15,24,1.299509,103.837
471747,850,412,1262,1.336504,103.921348
471748,923,279,1202,1.336549,103.921287
471760,50,153,203,1.336594,103.934917
471761,23,434,457,1.335918,103.934434
471765,9,276,285,1.335705,103.936332
471768,45,6,51,1.335952,103.937141
471769,41,404,445,1.335629,103.938353
471772,30,1552,1582,1.336789,103.937398
471775,13,473,486,1.336534,103.936183
472609,12,2379,2391,1.299509,103.837
472613,611,215,826,1.332763,103.918116
472747,929,322,1251,1.336504,103.921348
472748,514,92,606,1.336504,103.921348
473609,5,338,343,1.299509,103.837
473613,75,212,287,1.333138,103.917572
473747,627,537,1164,1.336504,103.921348
473748,650,270,920,1.336504,103.921348
474747,4,12,16,1.299509,103.837
478926,284,82,366,1.337682,103.935241
478927,889,2965,3854,1.337682,103.935241
478928,770,1182,1952,1.337682,103.935241
478929,1175,410,1585,1.338868,103.935554
478930,957,171,1128,1.338575,103.935911
478931,629,151,780,1.338259,103.936225
478932,1160,113,1273,1.337913,103.93652
478933,428,249,677,1.337607,103.936875
478934,513,445,958,1.337327,103.936539
478935,1083,196,1279,1.337246,103.936146
478936,671,1353,2024,1.337682,103.935241
478938,2,0,2,1.322226,103.952455
478946,0,290,290,1.342203,103.940591
478947,2,0,2,1.341542,103.940753
478954,1,1,2,1.341446,103.940739
478956,1,0,1,1.322247,103.952146
478957,4,53,57,1.341285,103.940714
478958,1,0,1,1.341286,103.940715
478959,1,0,1,1.34277,103.940387
478960,0,128,128,1.343137,103.940506
478962,1,0,1,1.341223,103.940706
478964,1,525,526,1.343592,103.940428
478965,0,3,3,1.321932,103.952442
478966,2,0,2,1.342564,103.940651
478968,13,30,43,1.341458,103.940809
478969,38,498,536,1.340918,103.939886
478970,0,3,3,1.343664,103.940393
478971,3,0,3,1.344165,103.940244
478972,0,2201,2201,1.344165,103.940239
478974,0,4,4,1.341541,103.940752
478978,1,0,1,1.343158,103.940477
478988,1,233,234,1.341285,103.940714
478989,4,0,4,1.341285,103.940714
478991,1,0,1,1.342179,103.940134
479220,161,4567,4728,1.332658,103.915479
479221,30,6404,6434,1.337046,103.913899
479222,108,5851,5959,1.33329,103.916233
479223,152,34,186,1.337371,103.916468
479224,146,639,785,1.337997,103.917049
479225,213,262,475,1.335746,103.920101
479226,40,304,344,1.335847,103.921064
479229,468,202,670,1.336405,103.927061
479230,10,3097,3107,1.331629,103.908039
479231,2,315,317,1.331267,103.908034
479232,448,4740,5188,1.337986,103.934718
479233,214,1754,1968,1.337754,103.934001
479234,852,795,1647,1.337518,103.933657
479235,988,1239,2227,1.33705,103.933823
479236,863,122,985,1.337063,103.934379
479237,1333,985,2318,1.337986,103.934718
479238,28,0,28,1.337325,103.934356
479239,270,1267,1537,1.331377,103.911059
479240,819,556,1375,1.337455,103.932646
479241,649,37,686,1.33716,103.93246
479242,678,66,744,1.33749,103.932131
479243,768,1997,2765,1.33772,103.93252
479245,2989,1859,4848,1.338508,103.929631
479246,483,51,534,1.337584,103.929593
479247,111,1096,1207,1.337586,103.930135
479248,940,8,948,1.33725,103.929782
479249,475,0,475,1.33711,103.930224
479250,2169,3599,5768,1.3377,103.930704
479251,2432,535,2967,1.337433,103.931569
479252,36,15,51,1.337234,103.931685
479253,698,10,708,1.337211,103.931163
479254,458,47,505,1.3377,103.930704
479255,321,141,462,1.3377,103.930704
479256,1025,2327,3352,1.338372,103.928658
479257,877,220,1097,1.338395,103.928656
479258,837,2965,3802,1.338372,103.928658
479259,626,14,640,1.338372,103.928658
479260,509,54,563,1.338372,103.928658
479261,1779,1305,3084,1.33875,103.927867
479262,1330,757,2087,1.33875,103.927867
479263,35,673,708,1.299509,103.837
479264,2136,24,2160,1.338397,103.927818
479265,1672,167,1839,1.338336,103.922763
479266,53,2,55,1.339696,103.933685
479267,339,2120,2459,1.337532,103.920762
479268,440,3441,3881,1.299509,103.837
479269,107,1567,1674,1.299509,103.837
479270,295,1117,1412,1.299509,103.837
479271,221,1169,1390,1.338271,103.920135
479272,337,239,576,1.338271,103.920135
479273,256,111,367,1.338271,103.920135
479274,387,79,466,1.299509,103.837
479275,211,451,662,1.299509,103.837
479276,472,190,662,1.299509,103.837
479277,324,2,326,1.299509,103.837
479278,574,2,576,1.338127,103.919739
479279,284,4,288,1.299509,103.837
479280,316,9,325,1.299509,103.837
479281,397,19,416,1.299509,103.837
479282,459,7,466,1.299509,103.837
479283,435,2,437,1.299509,103.837
479284,356,46,402,1.299509,103.837
479285,2,69,71,1.299509,103.837
479286,0,1,1,1.343169,103.940507
479287,2,0,2,1.343686,103.940394
479288,5,0,5,1.299509,103.837
479289,11,0,11,1.299509,103.837
479290,19,0,19,1.299509,103.837
479291,14,0,14,1.299509,103.837
479292,79,4,83,1.299509,103.837
479293,3,36,39,1.299509,103.837
479294,21,56,77,1.299509,103.837
479295,11,3,14,1.299509,103.837
479296,5,2,7,1.299509,103.837
479297,37,0,37,1.299509,103.837
479298,35,0,35,1.299509,103.837
479299,34,0,34,1.299509,103.837
479300,5,0,5,1.299509,103.837
479301,16,65,81,1.299509,103.837
479302,14,8,22,1.299509,103.837
479303,10,1,11,1.299509,103.837
479304,1,1,2,1.299509,103.837
479305,2,0,2,1.299509,103.837
479306,4,1,5,1.299509,103.837
479307,5,1,6,1.299509,103.837
479308,9,119,128,1.299509,103.837
479309,22,326,348,1.299509,103.837
479310,0,558,558,1.299509,103.837
479311,5,4,9,1.299509,103.837
479480,10,316,326,1.299509,103.837
479481,17,1133,1150,1.299509,103.837
479750,16,2375,2391,1.336521,103.916238
483583,1,0,1,1.299509,103.837
485874,0,163,163,1.335567,103.949087
485875,3,13,16,1.335573,103.949055
485876,1,1,2,1.299509,103.837
485975,195,1154,1349,1.299509,103.837
485985,58,2477,2535,1.299509,103.837
485990,5,394,399,1.299509,103.837
485992,172,1941,2113,1.336628,103.958537
485993,68,192,260,1.299509,103.837
485995,12,4,16,1.340071,103.9652
485996,110,56,166,1.299509,103.837
485997,101,38,139,1.342486,103.964547
485998,213,84,297,1.342119,103.964176
485999,140,38,178,1.342143,103.964128
486000,395,299,694,1.341856,103.964723
486001,9,45,54,1.299509,103.837
486005,4720,6249,10969,1.334789,103.965227
486006,642,392,1034,1.337123,103.968459
486007,139,7097,7236,1.299509,103.837
486008,96,1563,1659,1.299509,103.837
486010,24,897,921,1.299509,103.837
486011,18,436,454,1.299509,103.837
486012,54,2854,2908,1.299509,103.837
486013,122,1439,1561,1.299509,103.837
486014,4,71,75,1.299509,103.837
486015,7382,6161,13543,1.336124,103.963437
486016,634,7,641,1.335421,103.96319
486017,1870,6023,7893,1.33593,103.963722
486018,5150,13817,18967,1.334844,103.963907
486025,7514,3176,10690,1.333017,103.965452
486026,5079,6878,11957,1.334129,103.965824
486027,952,23788,24740,1.334127,103.965841
486028,7921,8,7929,1.334742,103.966588
486029,6701,38696,45397,1.332843,103.965234
486030,4378,40299,44677,1.33571,103.966545
486031,145,612,757,1.337484,103.967858
486035,3857,3422,7279,1.337692,103.964624
486036,9051,12462,21513,1.333341,103.962653
486037,9888,1070,10958,1.334101,103.963661
486038,5089,1833,6922,1.336056,103.963981
486040,833,1777,2610,1.337764,103.965905
486041,571,1846,2417,1.337675,103.965275
486042,198,1054,1252,1.338512,103.965254
486045,849,2680,3529,1.333129,103.952728
486046,570,100,670,1.344177,103.964998
486047,2292,987,3279,1.333443,103.95533
486048,2118,2527,4645,1.33638,103.965487
486049,55,753,808,1.338737,103.972327
486050,255,275,530,1.330285,103.95571
486051,722,3868,4590,1.336937,103.967384
486052,31,0,31,1.336111,103.95317
486053,2,36,38,1.33609,103.953115
486054,4,0,4,1.33607,103.953066
486055,12,14,26,1.336053,103.953027
486056,2256,534,2790,1.336858,103.971498
486057,1560,647,2207,1.337264,103.964404
486058,907,2133,3040,1.336282,103.963579
486059,1828,234,2062,1.338869,103.97193
486060,509,139,648,1.331958,103.942179
486061,857,127,984,1.332466,103.942301
486062,706,108,814,1.332893,103.942403
486063,26,11,37,1.332618,103.941968
486064,3739,370,4109,1.331083,103.967517
486065,863,53327,54190,1.334717,103.961688
486066,4378,30564,34942,1.334908,103.964995
486067,37,327,364,1.344507,103.967577
486068,418,506,924,1.330749,103.962046
486069,2414,123,2537,1.348166,103.962072
486070,2108,31,2139,1.33412,103.951613
486071,464,127,591,1.338602,103.972589
486072,2700,6133,8833,1.335834,103.96431
486073,1693,5344,7037,1.336922,103.965526
486074,7,183,190,1.325076,103.952757
486075,2,364,366,1.324841,103.952845
486076,1,0,1,1.299509,103.837
486077,3,5,8,1.324881,103.952888
486078,2,3,5,1.325143,103.952853
486081,0,1,1,1.325104,103.952796
486083,2,0,2,1.335573,103.949013
486084,21,0,21,1.325213,103.95294
486085,1,2,3,1.343792,103.940555
486086,2,1,3,1.325027,103.953075
486088,1,0,1,1.324958,103.952973
486089,0,3,3,1.325233,103.952963
486090,0,40,40,1.325301,103.953045
486091,0,2,2,1.324993,103.953024
486092,19,7,26,1.325339,103.953107
486093,0,34,34,1.325139,103.953203
486094,2,7,9,1.325362,103.953135
486095,1,1,2,1.325113,103.953169
486097,10,4,14,1.325199,103.953272
486098,3,2,5,1.325447,103.95324
486099,36,0,36,1.325233,103.953314
486101,2,3,5,1.325268,103.953349
486102,1,2,3,1.325079,103.953144
486103,8,0,8,1.325302,103.953391
486105,5,1,6,1.325336,103.953425
486106,10,3,13,1.325581,103.953426
486108,5,4,9,1.325619,103.953482
486109,24,6,30,1.325397,103.953494
486110,1,8,9,1.325649,103.953521
486111,7,0,7,1.325431,103.953519
486112,23,0,23,1.325465,103.953553
486113,379,65,444,1.332064,103.951725
486114,29,30,59,1.338108,103.972068
486115,27,1467,1494,1.335626,103.949271
486116,17,623,640,1.335032,103.970513
486117,401,119,520,1.329856,103.967862
486118,752,363,1115,1.333376,103.951843
486119,231,1723,1954,1.33249,103.953332
486120,71,50,121,1.33238,103.952907
486121,651,1635,2286,1.337098,103.94609
486122,746,385,1131,1.329031,103.966134
486123,3754,642,4396,1.333673,103.950479
486124,5,0,5,1.323592,103.957119
486125,9,16,25,1.323532,103.957058
486126,869,157,1026,1.338236,103.972652
486127,300,406,706,1.333471,103.951356
486128,179,86,265,1.328982,103.967122
486129,1115,1812,2927,1.331135,103.961081
486130,170,154,324,1.337613,103.971191
486131,1,883,884,1.345255,103.967702
486132,849,1577,2426,1.33521,103.947677
486133,214,631,845,1.335357,103.971751
486134,48,288,336,1.332571,103.96997
486135,11,6,17,1.323628,103.956076
486136,2,0,2,1.325165,103.953238
486137,161,15,176,1.320957,103.95696
486138,0,2,2,1.323684,103.956136
486139,0,6,6,1.32372,103.956196
486140,4,0,4,1.323777,103.956255
486141,31,5,36,1.323834,103.956314
486142,6,3,9,1.32389,103.956374
486143,3,0,3,1.325513,103.953333
486144,14,1,15,1.323393,103.956916
486145,146,1,147,1.324093,103.956559
486146,3,2,5,1.324129,103.956595
486147,385,271,656,1.329177,103.966082
486148,1629,305,1934,1.335485,103.971819
486149,1500,2092,3592,1.331265,103.960161
486150,4927,36361,41288,1.332875,103.959004
486151,2,1,3,1.323515,103.956766
486153,40,454,494,1.333515,103.970622
486154,158,571,729,1.331949,103.95243
486155,13,3,16,1.321936,103.958135
486156,5,0,5,1.321981,103.958208
486157,1,7,8,1.322026,103.958281
486158,6,0,6,1.32207,103.958353
486159,2,7,9,1.323443,103.956987
486160,0,11,11,1.323383,103.956926
486161,169,102,271,1.338003,103.973081
486162,458,66,524,1.331362,103.951928
486164,521,2,523,1.333927,103.970841
486165,4,24,28,1.33001,103.951231
486166,41,7,48,1.33001,103.951231
486168,25,0,25,1.33001,103.951231
486169,1,0,1,1.325276,103.953015
486171,1,0,1,1.33001,103.951231
486173,1,0,1,1.33001,103.951231
486174,43,0,43,1.33001,103.951231
486175,1,0,1,1.33001,103.951231
486176,12,0,12,1.33001,103.951231
486177,41,0,41,1.33001,103.951231
486178,1,0,1,1.33001,103.951231
486179,23,0,23,1.33001,103.951231
486180,1,3,4,1.33001,103.951231
486181,8,0,8,1.33001,103.951231
486183,3,1,4,1.33001,103.951231
486184,27,0,27,1.33001,103.951231
486185,60,12,72,1.3309,103.950615
486186,4,0,4,1.330908,103.950612
486187,1,7,8,1.330902,103.950636
486188,34,0,34,1.330871,103.950605
486189,2,1,3,1.322456,103.957742
486190,16,0,16,1.330873,103.950605
486193,6,0,6,1.3309,103.950605
486194,4,0,4,1.330871,103.950634
486195,14,6,20,1.331037,103.950508
486197,7,0,7,1.331001,103.950521
486198,1,0,1,1.33001,103.951231
486199,40,0,40,1.331001,103.950536
486200,0,1,1,1.331025,103.950513
486201,13,0,13,1.331003,103.95051
486202,1,0,1,1.331038,103.950516
486204,5,0,5,1.331028,103.950521
486205,3,1,4,1.331153,103.950421
486207,1,2,3,1.330906,103.950636
486208,5,0,5,1.331149,103.950426
486209,1,0,1,1.331034,103.950543
486210,6,0,6,1.331124,103.95045
486211,3,0,3,1.331156,103.950451
486212,1,1,2,1.323664,103.956136
486213,69,0,69,1.331147,103.950429
486214,23,0,23,1.331124,103.950425
486215,23,1,24,1.331284,103.950354
486217,236,0,236,1.331252,103.950332
486218,9,1,10,1.331253,103.950331
486220,3,0,3,1.331151,103.950458
486221,4,0,4,1.331281,103.950354
486223,3,0,3,1.33125,103.950353
486224,2,0,2,1.331153,103.950431
486225,34,2,36,1.331408,103.950279
486226,1,3,4,1.331379,103.950248
486228,3,0,3,1.331277,103.950365
486229,9,0,9,1.33138,103.950239
486231,4,0,4,1.33138,103.95024
486232,24,0,24,1.331408,103.950246
486234,7,1,8,1.331407,103.950252
486235,2,10,12,1.331966,103.949653
486236,275,4,279,1.332607,103.948964
486237,2,11,13,1.332585,103.948961
486240,96,12,108,1.332602,103.948957
486241,13,0,13,1.332574,103.948944
486242,26,0,26,1.332599,103.948952
486243,31,1,32,1.332567,103.948933
486244,4,3,7,1.332597,103.948948
486246,8,0,8,1.332594,103.948943
486248,0,4,4,1.332591,103.948939
486250,1,0,1,1.33115,103.950428
486251,10,0,10,1.33254,103.948889
486252,16,0,16,1.332585,103.94893
486254,3,0,3,1.331372,103.950245
486257,9,0,9,1.332519,103.948856
486258,0,4,4,1.332763,103.949617
486259,1,0,1,1.332588,103.948934
486260,126,0,126,1.332766,103.949643
486263,5,0,5,1.332536,103.949437
486265,36,0,36,1.332516,103.949463
486266,1,0,1,1.332512,103.948845
486267,2,0,2,1.331283,103.950364
486268,3,0,3,1.332582,103.948925
486269,14,0,14,1.332539,103.949444
486270,16,0,16,1.332797,103.949613
486273,1,0,1,1.332793,103.949604
486276,0,3,3,1.332795,103.949641
486277,4,0,4,1.332521,103.949444
486278,18,8,26,1.332333,103.949925
486279,11,0,11,1.332542,103.949436
486280,1,0,1,1.332517,103.949472
486281,2,0,2,1.332538,103.949473
486282,35,7,42,1.332329,103.949902
486283,0,2,2,1.332541,103.949473
486284,3,0,3,1.332774,103.949611
486285,0,1,1,1.332336,103.949908
486287,4,0,4,1.33252,103.949468
486288,5,0,5,1.332358,103.949896
486289,1,0,1,1.33251,103.949471
486290,5,0,5,1.332357,103.949908
486292,5,0,5,1.332329,103.949907
486294,0,7,7,1.331898,103.950186
486296,20,0,20,1.3319,103.95022
486297,4,0,4,1.332541,103.949445
486299,120,0,120,1.332541,103.949464
486301,1,0,1,1.332516,103.949471
486302,0,5,5,1.3319,103.950196
486303,2,0,2,1.332545,103.949438
486304,1,0,1,1.331926,103.95022
486305,29,0,29,1.331897,103.950192
486306,8,0,8,1.331932,103.950185
486307,6,6,12,1.331679,103.950037
486308,1,0,1,1.331902,103.950215
486309,3,0,3,1.332338,103.94993
486310,7,0,7,1.331687,103.950069
486312,1,0,1,1.331689,103.950031
486313,1,3,4,1.331681,103.950067
486314,4,5,9,1.331656,103.950062
486315,2,0,2,1.331921,103.950195
486318,9,0,9,1.331687,103.950058
486319,1,4,5,1.331569,103.949822
486320,2,0,2,1.331655,103.950039
486322,11,0,11,1.331559,103.949791
486323,0,2,2,1.33154,103.949795
486324,7,0,7,1.331569,103.949814
486325,1,0,1,1.331688,103.950065
486326,3,0,3,1.331655,103.950034
486327,11,1,12,1.331567,103.949791
486328,20,4,24,1.331975,103.949491
486329,1,0,1,1.331563,103.949788
486331,0,1,1,1.331952,103.949496
486332,1,0,1,1.331978,103.949492
486334,5,0,5,1.331979,103.949494
486335,4,0,4,1.331979,103.949496
486336,2,8,10,1.332414,103.948656
486337,5,0,5,1.332411,103.948651
486339,5,0,5,1.332405,103.948642
486340,0,2,2,1.331557,103.949798
486341,2,0,2,1.332402,103.948638
486342,2,0,2,1.332399,103.948633
486343,3,0,3,1.331541,103.949818
486345,2,0,2,1.332397,103.948629
486346,1,11,12,1.321869,103.958026
486347,0,2,2,1.332388,103.948615
486348,19,45,64,1.329154,103.967634
486349,273,82,355,1.331582,103.963882
486350,396,2597,2993,1.336742,103.947448
486351,382,57,439,1.330295,103.968007
486352,396,219,615,1.333248,103.970446
486353,228,442,670,1.331285,103.952417
486354,358,9814,10172,1.332609,103.961318
486355,160,158,318,1.322,103.958315
486356,812,6,818,1.322123,103.958522
486357,2,9,11,1.323547,103.957094
486358,2,31,33,1.323512,103.957058
486359,6,0,6,1.324002,103.956466
486360,1,0,1,1.33198,103.949525
486361,1054,421,1475,1.32869,103.967394
486362,138,495,633,1.331141,103.962651
486363,2,35,37,1.322686,103.958093
486364,621,2799,3420,1.32263,103.955109
486365,354,426,780,1.321121,103.956266
486366,15,5,20,1.322859,103.956215
486367,8,0,8,1.322893,103.956257
486368,14,3,17,1.322962,103.956341
486369,22,0,22,1.32302,103.956415
486370,0,3,3,1.332394,103.948624
486371,1,1,2,1.321892,103.958063
486372,3,66,69,1.322778,103.955077
486373,11,1,12,1.322802,103.955107
486374,8,4,12,1.322849,103.955168
486376,2,2,4,1.322944,103.95529
486378,4,4,8,1.32304,103.955412
486379,2,1,3,1.323053,103.956454
486380,156,5,161,1.323135,103.955535
486382,8,6,14,1.32323,103.955657
486383,30,0,30,1.323277,103.955718
486384,0,2,2,1.323076,103.956484
486385,137,9,146,1.322034,103.957199
486387,1,3,4,1.322096,103.957275
486388,1,0,1,1.324047,103.956513
486389,5,0,5,1.322178,103.957378
486393,0,1,1,1.322137,103.957326
486394,4,2,6,1.320791,103.956661
486395,0,1,1,1.322333,103.957572
486396,1,0,1,1.320877,103.956818
486397,182,54,236,1.321205,103.957345
486398,215,45,260,1.32178,103.95797
486399,112,98,210,1.329941,103.965936
486400,449,11,460,1.332303,103.951053
486401,7,3,10,1.322204,103.958571
486402,44,0,44,1.322239,103.958634
486403,39,0,39,1.323428,103.956952
486404,19,3,22,1.323463,103.956987
486406,1,0,1,1.32113,103.957236
486408,3,0,3,1.323087,103.955474
486411,1,0,1,1.322394,103.956876
486412,2,0,2,1.323325,103.955779
486414,18,0,18,1.32301,103.956425
486415,681,1010,1691,1.330805,103.963586
486416,21,0,21,1.323117,103.955486
486417,0,1,1,1.322649,103.956689
486418,16,4,20,1.323231,103.955632
486419,2,0,2,1.322773,103.956597
486420,1,1,2,1.323288,103.955706
486423,1,0,1,1.323174,103.955559
486424,0,1,1,1.322743,103.956071
486425,1,2,3,1.322134,103.957067
486426,9,0,9,1.323122,103.956543
486427,2,0,2,1.322641,103.955943
486428,3,1,4,1.323213,103.956661
486430,1,1,2,1.323168,103.956602
486431,0,1,1,1.322784,103.956122
486432,0,7,7,1.322982,103.957218
486433,0,1,1,1.323341,103.956828
486434,14,1,15,1.322907,103.957115
486435,17,0,17,1.322873,103.95707
486436,0,5,5,1.322839,103.957019
486437,41,4,45,1.322804,103.956967
486438,1,1,2,1.323305,103.956779
486440,2,0,2,1.322775,103.956922
486441,15,4,19,1.322678,103.956791
486442,568,1411,1979,1.321728,103.95578
486443,37,41,78,1.331504,103.967524
486444,201,102,303,1.331584,103.969368
486445,394,63,457,1.332268,103.969759
486446,1,0,1,1.322947,103.957161
486447,1,1,2,1.322707,103.956836
486448,0,3,3,1.322815,103.956163
486450,0,5,5,1.323494,103.955958
486451,3,4,7,1.323551,103.956017
486452,93,0,93,1.32374,103.956196
486453,6,0,6,1.323608,103.956076
486454,11,12,23,1.323797,103.956255
486455,0,3,3,1.323382,103.955838
486456,31,0,31,1.323571,103.956017
486457,7,5,12,1.323002,103.955339
486458,1,0,1,1.322718,103.958147
486459,43,2,45,1.322938,103.957338
486460,35,0,35,1.322913,103.957306
486461,3,3,6,1.322863,103.957241
486462,6,0,6,1.322814,103.957177
486463,11,10,21,1.322764,103.957112
486464,51,0,51,1.322714,103.957048
486465,2,2,4,1.322664,103.956983
486466,4,0,4,1.322615,103.956919
486467,3,4,7,1.322565,103.956854
486468,89,5,94,1.322525,103.9568
486470,0,2,2,1.323353,103.955809
486472,4,5,9,1.322805,103.956173
486474,0,11,11,1.322873,103.956257
486476,3,4,7,1.32301,103.956425
486477,5,13,18,1.330527,103.968091
486478,70,0,70,1.331877,103.969613
486479,0,87,87,1.321336,103.956349
486480,8,0,8,1.321357,103.956376
486481,3,6,9,1.321398,103.956429
486483,17,2,19,1.321482,103.956534
486485,0,2,2,1.322669,103.956002
486486,2,0,2,1.321565,103.95664
486487,4,2,6,1.321746,103.956755
486488,2,0,2,1.321607,103.956693
486489,7,0,7,1.321774,103.956806
486491,6,14,20,1.321814,103.956863
486492,3,0,3,1.323514,103.955958
486493,50,0,50,1.321837,103.956903
486494,1,0,1,1.32306,103.955412
486495,120,32,152,1.321872,103.956942
486496,14,9,23,1.321814,103.956941
486497,2,0,2,1.321633,103.956724
486498,25,2,27,1.321844,103.95698
486499,4,4,8,1.321929,103.957028
486500,135,4,139,1.321874,103.957018
486501,3,2,5,1.321968,103.95708
486502,2,0,2,1.3219,103.956982
486503,0,1,1,1.321762,103.956879
486504,14,0,14,1.322017,103.957202
486505,1,1,2,1.321933,103.957096
486507,2,2,4,1.322134,103.957348
486508,8,0,8,1.322182,103.957407
486509,5,1,6,1.322229,103.957465
486510,2,0,2,1.32204,103.957231
486511,17,0,17,1.322323,103.957582
486512,118,2,120,1.322004,103.95656
486513,5,43,48,1.322413,103.955525
486514,5,58,63,1.322286,103.955621
486515,1,0,1,1.321993,103.957173
486516,1,0,1,1.322441,103.955553
486517,1,1,2,1.322276,103.957524
486518,1,0,1,1.322315,103.955666
486519,0,1,1,1.322343,103.955706
486520,7,2,9,1.322372,103.955746
486521,5,1,6,1.322533,103.955661
486522,3,1,4,1.322401,103.95578
486523,10,1,11,1.322562,103.955701
486524,11,1,12,1.322429,103.95582
486525,1,0,1,1.322504,103.955627
486527,0,5,5,1.322492,103.9559
486528,10,19,29,1.322803,103.955083
486529,8,0,8,1.322831,103.955119
486530,3,2,5,1.322888,103.955193
486532,15,31,46,1.321059,103.957076
486534,1,3,4,1.321155,103.957209
486536,0,3,3,1.32171,103.956817
486537,3,1,4,1.321265,103.957364
486538,8,4,12,1.322056,103.956515
486539,13,2,15,1.322096,103.95648
486540,0,1,1,1.32259,103.955735
486541,45,0,45,1.322187,103.956406
486542,0,4,4,1.322233,103.956361
486543,0,1,1,1.322136,103.95644
486544,7,0,7,1.322325,103.956287
486547,962,1538,2500,1.330703,103.966378
486548,672,429,1101,1.330635,103.964523
486549,6,2,8,1.322519,103.957838
486551,0,1,1,1.322279,103.956315
486552,19,0,19,1.322644,103.958029
486553,109,1,110,1.323335,103.955769
486554,1,1,2,1.32247,103.955587
486555,7,1,8,1.323402,103.955838
486556,2,8,10,1.323458,103.955898
486557,27,0,27,1.323854,103.956314
486558,2,3,5,1.3239,103.956364
486559,10,2,12,1.323933,103.956397
486560,30,2,32,1.323956,103.95642
486561,18,1,19,1.3239,103.956384
486562,3,2,5,1.323794,103.956487
486563,1,1,2,1.323373,103.955809
486564,6,3,9,1.32305,103.956477
486565,2,0,2,1.32303,103.956451
486567,43,0,43,1.32317,103.956632
486568,3,7,10,1.323211,103.956683
486569,3,0,3,1.321251,103.957341
486570,29,0,29,1.323291,103.956786
486571,1,8,9,1.323331,103.956838
486572,0,18,18,1.322079,103.956292
486573,0,3,3,1.323251,103.956735
486574,1,0,1,1.322602,103.957965
486575,0,1,1,1.322009,103.956205
486576,0,2,2,1.32309,103.956528
486577,13,3,16,1.32187,103.95603
486578,0,1,1,1.321963,103.956147
486579,0,60,60,1.321787,103.955924
486580,0,2,2,1.321916,103.956088
486581,64,0,64,1.323156,103.954734
486582,1,0,1,1.321823,103.955972
486583,9,1,10,1.322994,103.95485
486584,1,4,5,1.321305,103.957403
486585,0,6,6,1.321345,103.957442
486586,1,16,17,1.321425,103.95752
486587,2,11,13,1.321505,103.957598
486588,0,3,3,1.322056,103.956263
486589,1,0,1,1.323082,103.954789
486590,7,1,8,1.32173,103.957819
486591,0,3,3,1.321585,103.957676
486593,617,201,818,1.32419,103.958696
486594,115,261,376,1.331248,103.968023
486595,23,3,26,1.331255,103.969281
486596,812,2662,3474,1.332405,103.962225
486597,46,14,60,1.322115,103.958426
486598,10,4,14,1.32216,103.958499
486599,39,0,39,1.322473,103.957694
486600,3,2,5,1.32252,103.957669
486601,2,0,2,1.323231,103.954685
486602,10,0,10,1.32266,103.957591
486603,1,0,1,1.321665,103.957754
486604,2,0,2,1.322616,103.957618
486605,114,3,117,1.322339,103.957897
486606,36,2,38,1.322267,103.957853
486607,3,23,26,1.320811,103.956661
486608,4,17,21,1.320831,103.956696
486609,5,0,5,1.320872,103.956765
486610,3,3,6,1.320913,103.956835
486612,12,2,14,1.320994,103.956974
486613,1,0,1,1.322748,103.957538
486614,1,63,64,1.321337,103.956319
486615,0,4,4,1.32137,103.956359
486616,1,0,1,1.321035,103.957043
486617,0,2,2,1.322349,103.957952
486618,26,0,26,1.32147,103.956485
486619,0,2,2,1.321436,103.956443
486620,6,0,6,1.321553,103.956591
486621,3,3,6,1.321586,103.956635
486622,2,28,30,1.321466,103.956067
486623,0,1,1,1.321405,103.9564
486625,0,1,1,1.321514,103.956029
486626,2,0,2,1.321513,103.956541
486628,1,0,1,1.321708,103.955877
486629,3,2,5,1.322096,103.955574
486630,50,13,63,1.331644,103.967052
486631,239,159,398,1.33028,103.962695
486632,19,4789,4808,1.331947,103.963115
486635,0,72,72,1.347796,103.964885
486636,0,23,23,1.347822,103.964815
486637,0,1,1,1.321999,103.95565
486638,2,12,14,1.347885,103.964613
486639,3,1,4,1.347917,103.964513
486640,3,36,39,1.347949,103.964412
486641,1,3,4,1.34798,103.964311
486642,2,89,91,1.347996,103.96426
486643,3,61,64,1.348002,103.9642
486644,0,3,3,1.321808,103.957933
486645,0,4,4,1.347986,103.964272
486646,0,1,1,1.347854,103.964714
486647,2,0,2,1.321805,103.955802
486648,4,0,4,1.347934,103.964438
486649,0,1,1,1.347969,103.964328
486650,1,0,1,1.347917,103.964492
486651,0,1,1,1.3479,103.964548
486652,4,1,5,1.347865,103.964658
486653,3,0,3,1.348003,103.964218
486654,2,0,2,1.347952,103.964382
486655,0,2,2,1.347831,103.964768
486656,6,11,17,1.347798,103.964848
486657,1,6,7,1.347303,103.964782
486658,0,3,3,1.347848,103.964712
486659,1,2,3,1.347315,103.964726
486660,12,5,17,1.347358,103.964594
486661,9,1,10,1.347379,103.964528
486662,1,0,1,1.347882,103.964602
486664,4,2,6,1.347444,103.96433
486665,1,4,5,1.347466,103.964264
486666,11,0,11,1.347487,103.964198
486667,3,2,5,1.347509,103.964132
486668,3,3,6,1.347531,103.964066
486669,2,2,4,1.347552,103.964
486671,1,0,1,1.347401,103.964462
486672,2,1399,1401,1.347606,103.963835
486673,18,424,442,1.347607,103.963792
486676,7,0,7,1.347552,103.96398
486677,1,0,1,1.347595,103.963868
486678,14,0,14,1.347509,103.964112
486679,1,0,1,1.347531,103.964046
486680,3,4,7,1.347466,103.964244
486681,1,5,6,1.347444,103.96431
486682,2,1,3,1.347336,103.96466
486683,4,0,4,1.347401,103.964442
486684,0,2,2,1.34781,103.964822
486685,0,3,3,1.347423,103.964376
486686,0,1,1,1.347487,103.964178
486688,0,1,1,1.347336,103.96464
486689,5,3,8,1.346793,103.964635
486690,1,0,1,1.347304,103.964739
486694,2,0,2,1.347379,103.964508
486695,11,0,11,1.346909,103.96421
486697,5,1,6,1.346951,103.964066
486698,0,1,1,1.346804,103.964573
486699,0,1,1,1.346972,103.963993
486700,4,0,4,1.347014,103.963848
486701,0,1,1,1.346993,103.963921
486702,2,0,2,1.346888,103.964283
486703,1,0,1,1.347035,103.963776
486704,1,0,1,1.347077,103.963631
486705,3,2391,2394,1.347108,103.963522
486706,0,851,851,1.347109,103.963476
486709,0,1,1,1.347098,103.963558
486710,1,0,1,1.347056,103.963683
486712,3,1,4,1.346993,103.963901
486713,0,1,1,1.347035,103.963756
486714,2,0,2,1.347056,103.963703
486715,5,1,6,1.34693,103.964118
486716,2,2,4,1.346909,103.96419
486717,0,1,1,1.346972,103.963973
486721,0,1,1,1.346888,103.964263
486722,0,1,1,1.346804,103.964553
486723,2,2,4,1.346295,103.96447
486724,1,1,2,1.346951,103.964046
486725,1,1,2,1.346308,103.964412
486726,0,1,1,1.346794,103.964589
486727,12,1,13,1.346376,103.964206
486729,15,0,15,1.346422,103.964069
486730,0,2,2,1.346331,103.964343
486731,0,5,5,1.346468,103.963932
486732,4,2,6,1.346491,103.963864
486734,2,0,2,1.346445,103.964001
486735,1,0,1,1.346354,103.964275
486736,0,7,7,1.346582,103.96359
486737,22,5,27,1.346605,103.963522
486739,1,549,550,1.34664,103.963419
486740,0,1852,1852,1.346641,103.963375
486741,1,1,2,1.346537,103.963727
486742,1,0,1,1.34656,103.963659
486743,0,1,1,1.34661,103.963487
486744,5,4,9,1.34657,103.963608
486745,0,7,7,1.346549,103.963669
486746,0,4,4,1.346529,103.96373
486747,0,2,2,1.346631,103.963426
486748,1,3,4,1.346488,103.963852
486749,0,8,8,1.346468,103.963912
486750,80,4,84,1.346448,103.963973
486751,0,7,7,1.346427,103.964034
486752,0,2,2,1.346509,103.963791
486753,0,4,4,1.346387,103.964156
486754,5,8,13,1.346366,103.964217
486755,1,2,3,1.347358,103.964574
486756,5,14,19,1.346326,103.964338
486757,2,7,9,1.346305,103.964399
486758,3,30,33,1.346295,103.96443
486759,194,9523,9717,1.331812,103.964634
486760,305,896,1201,1.331526,103.964824
486761,79,272,351,1.33648,103.971216
486762,10,1,11,1.33602,103.97096
486763,57,146,203,1.33561,103.970634
486764,122,510,632,1.335164,103.969661
486765,2,14,16,1.334977,103.970043
486766,33,2,35,1.33488,103.96946
486767,2,3,5,1.334729,103.96937
486768,7,0,7,1.33459,103.969292
486769,79,969,1048,1.338747,103.973723
486770,0,1,1,1.34659,103.963548
486771,36,105,141,1.338474,103.972779
486772,102,0,102,1.334182,103.969043
486773,2,71,73,1.334296,103.969141
486774,3,0,3,1.346346,103.964278
486775,23,116,139,1.338494,103.971405
486776,3,0,3,1.334037,103.968954
486777,170,504,674,1.338024,103.971158
486778,8,1,9,1.333608,103.968685
486779,119,1254,1373,1.336871,103.970442
486780,15,12,27,1.333435,103.968596
486781,74,245,319,1.336418,103.970146
486782,1,0,1,1.334444,103.969235
486783,103,793,896,1.336053,103.969903
486784,7,1,8,1.333189,103.968421
486785,8,1498,1506,1.335626,103.969563
486786,0,1,1,1.333334,103.968516
486787,21,164,185,1.335099,103.969237
486788,7,0,7,1.332911,103.968253
486789,79,271,350,1.334572,103.968912
486790,102,0,102,1.332782,103.968129
486791,34,820,854,1.334045,103.968586
486792,0,14,14,1.332619,103.968477
486793,30,43,73,1.333603,103.96836
486795,30,128,158,1.333156,103.968069
486796,6,0,6,1.332338,103.967987
486797,5,478,483,1.332672,103.967772
486798,227,193,420,1.328378,103.969896
486820,1,23,24,1.342083,103.961442
486821,0,12,12,1.342179,103.961464
486822,0,54,54,1.342259,103.961478
486823,4,3,7,1.342383,103.961514
486824,36,42,78,1.341681,103.961713
486825,0,42,42,1.342508,103.961551
486826,967,91,1058,1.342078,103.961798
486827,3,24,27,1.342633,103.961588
486828,278,35,313,1.342956,103.963191
486829,3,55,58,1.342758,103.961625
486830,383,91,474,1.343476,103.963621
486831,0,64,64,1.342882,103.961661
486832,608,153,761,1.343597,103.963069
486833,37,2,39,1.343007,103.961698
486834,171,627,798,1.343729,103.962619
486835,0,68,68,1.343132,103.961735
486836,110,4198,4308,1.343153,103.962082
486837,4,154,158,1.343257,103.961772
486838,151,15,166,1.343153,103.962082
486839,0,48,48,1.343381,103.961808
486840,11,30,41,1.343443,103.962891
486841,0,2,2,1.346407,103.964095
486842,159,414,573,1.344681,103.963857
486843,180,928,1108,1.344351,103.964304
486844,3,374,377,1.343581,103.96188
486845,2,72,74,1.344301,103.963871
486846,5,294,299,1.343676,103.961892
486847,413,101,514,1.344467,103.963347
486848,5,0,5,1.343753,103.961916
486849,219,1954,2173,1.344373,103.962541
486850,59,883,942,1.344959,103.963202
486851,1,126,127,1.343876,103.96195
486852,4575,1664,6239,1.345815,103.965869
486853,6,1792,1798,1.343998,103.961983
486854,342,277,619,1.346952,103.965373
486855,3,53,56,1.344121,103.962017
486856,2,597,599,1.344243,103.962051
486857,4,85,89,1.344453,103.961979
486858,146,1045,1191,1.345671,103.963156
486859,1,11,12,1.344551,103.962045
486860,111,44,155,1.345994,103.96305
486861,0,16,16,1.344683,103.962094
486862,270,1747,2017,1.345401,103.963833
486863,2,12,14,1.344825,103.962076
486864,25,150,175,1.344889,103.962162
486865,0,573,573,1.345089,103.962161
486866,11,507,518,1.345171,103.962265
486867,5,2180,2185,1.345324,103.962295
486868,1,25,26,1.345561,103.962342
486869,9,2145,2154,1.345633,103.962387
486870,5,1948,1953,1.345919,103.962521
486871,2,26,28,1.346012,103.962553
486872,1,577,578,1.346105,103.962585
486873,0,49,49,1.346198,103.962617
486874,5,311,316,1.346291,103.96265
486875,13,61,74,1.346384,103.962682
486876,4,111,115,1.346477,103.962714
486877,12,64,76,1.34657,103.962746
486878,0,26,26,1.346663,103.962778
486879,3,0,3,1.333753,103.96878
486880,10,484,494,1.346849,103.962842
486881,2,0,2,1.343506,103.961845
486882,0,324,324,1.347035,103.962907
486883,1,154,155,1.347128,103.962939
486884,0,170,170,1.347221,103.962971
486885,22,2912,2934,1.347314,103.963003
486886,179,17,196,1.329649,103.953279
486887,141,35,176,1.329726,103.953081
486888,1,0,1,1.333055,103.968326
486889,18,185,203,1.330104,103.951163
486890,17,0,17,1.33001,103.951231
486891,0,6,6,1.33001,103.951231
486892,2,1,3,1.346756,103.96281
486893,1,0,1,1.3302,103.954432
486894,4,1080,1084,1.33001,103.951231
486895,30,0,30,1.33001,103.951231
486896,12,2,14,1.33001,103.951231
486897,1,0,1,1.33001,103.951231
486898,21,0,21,1.33001,103.951231
486899,2,0,2,1.346942,103.962874
486900,19,4,23,1.33001,103.951231
486901,8,0,8,1.33001,103.951231
486902,1,0,1,1.33001,103.951231
486903,1,11,12,1.33001,103.951231
486904,15,11,26,1.33001,103.951231
486907,1,25,26,1.331069,103.944224
486908,0,1,1,1.33001,103.951231
486909,73,1,74,1.331129,103.944284
486911,9,10,19,1.330533,103.944244
486912,4,2,6,1.331189,103.94437
486913,2,6,8,1.331224,103.944404
486914,3,14,17,1.330552,103.944295
486915,4,1,5,1.331241,103.944455
486916,2,0,2,1.33001,103.951231
486917,401,33,434,1.336864,103.955001
486918,7,0,7,1.330573,103.944344
486919,1,0,1,1.331112,103.94425
486920,10,2,12,1.331509,103.944703
486921,1,13,14,1.330593,103.94439
486922,1,0,1,1.331457,103.94466
486923,20,4,24,1.331646,103.944788
486924,77,0,77,1.330613,103.944432
486926,11,5,16,1.331775,103.944857
486927,1,12,13,1.330636,103.944496
486928,5,0,5,1.331844,103.944908
486929,16,0,16,1.331913,103.944967
486930,0,1,1,1.331569,103.944737
486931,1,5,6,1.331981,103.945027
486933,3,3,6,1.330672,103.944594
486934,3,1,4,1.332085,103.945147
486935,7,0,7,1.332119,103.945189
486936,8,32,40,1.330967,103.944853
486937,10,4,14,1.332162,103.945224
486938,1,0,1,1.330656,103.944542
486939,0,11,11,1.330944,103.944813
486940,0,1,1,1.332214,103.945275
486941,1,2,3,1.33001,103.951231
486942,1,2,3,1.332291,103.945386
486943,8,14,22,1.332334,103.945454
486945,1,1,2,1.331388,103.944626
486946,1,1,2,1.33089,103.944748
486947,0,18,18,1.332437,103.945633
486953,3,91,94,1.33316,103.948692
486954,4,35,39,1.333138,103.948636
486955,0,46,46,1.333168,103.948741
486956,0,139,139,1.333195,103.948791
486957,0,37,37,1.333218,103.948866
486958,3,56,59,1.333238,103.948937
486959,0,14,14,1.333272,103.948994
486960,1,13,14,1.333308,103.949099
486961,87,0,87,1.333332,103.94915
486962,2,29,31,1.333352,103.949187
486963,8,35,43,1.333369,103.949227
486964,5,166,171,1.333399,103.949278
486965,41,1405,1446,1.334887,103.951398
486966,2,331,333,1.299509,103.837
486967,1,12,13,1.335273,103.952687
486968,1,3,4,1.335373,103.952903
486970,11,210,221,1.335487,103.953106
486973,22,31,53,1.335681,103.953539
486974,6,0,6,1.335815,103.953897
486975,34,195,229,1.335929,103.954147
486977,0,6,6,1.336096,103.954512
486979,0,82,82,1.336183,103.954668
486980,2,31,33,1.336224,103.954762
486981,1,6,7,1.336277,103.954918
486983,64,108,172,1.336371,103.955174
486984,1,100,101,1.336484,103.955445
486985,4,76,80,1.336518,103.95556
486986,2,8,10,1.336585,103.955661
486987,8,178,186,1.336585,103.955661
486988,45,98,143,1.336585,103.955661
486989,8,35,43,1.336665,103.955857
486990,171,16,187,1.336732,103.956013
486991,5,65,70,1.336779,103.9561
486992,4,1,5,1.337924,103.958202
486993,0,12,12,1.337907,103.958203
486994,17,0,17,1.337952,103.958271
486995,30,0,30,1.337955,103.958257
486996,3,0,3,1.330916,103.944782
486997,7,3,10,1.337992,103.958329
486998,2,5,7,1.338017,103.958391
486999,2,0,2,1.332403,103.945573
487000,0,1,1,1.332256,103.945334
487002,21,0,21,1.338087,103.958509
487003,20,3,23,1.338101,103.958506
487004,0,3,3,1.337979,103.958334
487005,12,0,12,1.338127,103.958582
487006,2,2,4,1.33816,103.95863
487010,3,0,3,1.338115,103.958574
487012,732,8,740,1.330302,103.941937
487013,37,0,37,1.338301,103.958859
487014,0,2,2,1.338027,103.9584
487015,4,0,4,1.338342,103.958905
487016,0,1,1,1.338061,103.958442
487017,0,1,1,1.338344,103.958922
487018,1,0,1,1.33837,103.958975
487019,3,6,9,1.338434,103.959018
487021,3,0,3,1.338247,103.95879
487023,2,0,2,1.338314,103.95887
487025,0,2,2,1.338505,103.959139
487027,15,207,222,1.338592,103.959252
487028,6,0,6,1.338576,103.959263
487029,2,0,2,1.338555,103.95921
487030,4,10,14,1.338619,103.959339
487033,6,87,93,1.330321,103.954561
487034,11,36,47,1.335768,103.953769
487035,19,7,26,1.335768,103.953769
487036,46,2,48,1.335815,103.953897
487037,58,1842,1900,1.335862,103.954019
487038,0,58,58,1.335862,103.954019
487039,7,33,40,1.336224,103.954762
487040,355,1463,1818,1.332026,103.947419
487041,49,30,79,1.332001,103.947876
487042,9,16,25,1.335722,103.953654
487044,33,144,177,1.335722,103.953654
487046,0,31,31,1.335722,103.953654
487047,11,38,49,1.335681,103.953539
487048,487,1,488,1.33183,103.946392
487049,393,3,396,1.33183,103.946392
487052,2,9,11,1.324589,103.953797
487054,2,0,2,1.338646,103.959321
487055,2,0,2,1.324615,103.953775
487056,0,2,2,1.324537,103.953809
487057,4,0,4,1.324521,103.953789
487059,0,2,2,1.324667,103.953733
487063,1,0,1,1.33839,103.958973
487064,1,0,1,1.324876,103.953562
487065,2,1,3,1.338473,103.95909
487066,41,0,41,1.325023,103.953444
487067,3,0,3,1.324981,103.953477
487068,2,0,2,1.324505,103.95377
487070,1,4,5,1.324981,103.953497
487071,14,0,14,1.324825,103.954675
487072,0,4,4,1.324929,103.953539
487073,1,1,2,1.325007,103.953475
487074,39,0,39,1.324876,103.953582
487075,1,1,2,1.32485,103.954751
487077,1,0,1,1.324929,103.953519
487078,0,9,9,1.324772,103.953667
487079,4,4,8,1.324988,103.954855
487080,1,1,2,1.324883,103.954768
487081,151,0,151,1.324991,103.954945
487083,11,1,12,1.325075,103.95495
487084,0,27,27,1.324615,103.953795
487085,30,0,30,1.324888,103.955154
487086,1,19,20,1.324573,103.953828
487087,1,6,7,1.324834,103.95511
487088,4,0,4,1.324778,103.955042
487089,0,8,8,1.324745,103.955009
487090,18,30,48,1.324812,103.954339
487091,1,0,1,1.32494,103.954822
487092,1,0,1,1.324713,103.954945
487093,0,1,1,1.324872,103.954521
487094,7,0,7,1.325057,103.954744
487096,4,0,4,1.325222,103.954974
487097,23,1,24,1.324575,103.954827
487098,6,1,7,1.32522,103.95503
487099,0,1,1,1.324634,103.954935
487100,2,2,4,1.325207,103.955076
487102,4,1,5,1.325076,103.955195
487103,2,0,2,1.32472,103.95371
487105,1,0,1,1.32452,103.954784
487106,6,1,7,1.324846,103.955402
487126,19,43,62,1.337876,103.957843
487127,13,2,15,1.338383,103.957656
487128,2,1,3,1.324694,103.954595
487132,0,2,2,1.32501,103.955254
487133,5,1,6,1.338602,103.957413
487134,1,0,1,1.324879,103.955372
487135,92,0,92,1.338699,103.957302
487136,0,3,3,1.337853,103.957809
487137,4,1,5,1.33875,103.957282
487138,25,2,27,1.337772,103.95759
487139,3,1,4,1.338901,103.957147
487140,2,3,5,1.337754,103.957541
487141,4,1,5,1.338956,103.9571
487142,0,1,1,1.337805,103.957696
487143,1,0,1,1.337735,103.95749
487144,0,2,2,1.337826,103.957727
487145,7,3,10,1.339118,103.956969
487146,2,5,7,1.337655,103.957365
487147,24,0,24,1.339251,103.956881
487148,1,3,4,1.337634,103.957319
487149,3,4,7,1.339303,103.956851
487150,1,3,4,1.337611,103.957271
487151,4,0,4,1.337593,103.957223
487152,2,1,3,1.337793,103.957653
487153,0,17,17,1.337545,103.957121
487154,1,0,1,1.339078,103.957005
487155,5,0,5,1.337486,103.956959
487156,0,4,4,1.337463,103.95691
487157,4,1,5,1.337444,103.956869
487158,59,3,62,1.337425,103.956818
487159,1,36,37,1.337395,103.956766
487160,1,0,1,1.337523,103.957065
487161,7,4,11,1.337645,103.956758
487162,3,0,3,1.337568,103.957176
487163,0,5,5,1.337683,103.956847
487165,7,0,7,1.337733,103.956955
487166,2,0,2,1.337673,103.957406
487167,2,1,3,1.337664,103.956801
487168,1,0,1,1.337621,103.956706
487169,2,0,2,1.337754,103.957008
487170,8,10,18,1.33786,103.957247
487171,10,12,22,1.337885,103.957303
487173,0,1,1,1.337796,103.957108
487174,3,0,3,1.337777,103.957063
487175,1,0,1,1.337928,103.957397
487176,2,0,2,1.337844,103.957204
487177,2,0,2,1.337991,103.957548
487178,1,12,13,1.338004,103.957668
487179,5,6,11,1.338418,103.957321
487180,2,3,5,1.338404,103.957271
487181,2,0,2,1.33799,103.957612
487182,66,0,66,1.338359,103.957175
487183,0,1,1,1.337966,103.957494
487184,2,0,2,1.338383,103.957229
487185,40,3,43,1.338286,103.957037
487186,2,0,2,1.338312,103.957083
487187,6,2,8,1.338232,103.956872
487189,0,5,5,1.338184,103.956781
487190,10,0,10,1.338162,103.956735
487191,1,0,1,1.338334,103.957133
487192,2,1,3,1.337946,103.957441
487193,1,1,2,1.338269,103.95699
487194,7,2,9,1.338296,103.956574
487195,135,0,135,1.338308,103.956612
487196,1,0,1,1.338142,103.956688
487197,7,0,7,1.338355,103.956728
487198,5,2,7,1.338384,103.95676
487199,3,0,3,1.338117,103.956635
487200,2,1,3,1.338409,103.956811
487201,6,0,6,1.338485,103.956961
487202,5,3,8,1.338496,103.957017
487203,21,0,21,1.338522,103.957067
487204,1,1,2,1.338103,103.9566
487205,3,10,13,1.338581,103.957156
487206,10,45,55,1.338913,103.95685
487207,2,0,2,1.33856,103.957104
487208,5,2,7,1.338869,103.956745
487209,2,0,2,1.338891,103.956798
487210,61,0,61,1.338824,103.956641
487214,0,1,1,1.33833,103.956673
487215,2,0,2,1.338847,103.956693
487216,4,9,13,1.338921,103.956493
487217,0,1,1,1.338736,103.956431
487218,4,0,4,1.339025,103.956431
487219,1,3,4,1.339039,103.956401
487220,1,0,1,1.338979,103.956463
487221,0,292,292,1.339081,103.956388
487223,3,0,3,1.338465,103.956892
487225,1,0,1,1.339081,103.956388
487226,1,0,1,1.339081,103.956388
487228,1,0,1,1.339081,103.956388
487230,3,27,30,1.339081,103.956388
487255,1,4,5,1.338202,103.95794
487257,5,0,5,1.338326,103.958103
487258,4,0,4,1.338344,103.958129
487259,0,3,3,1.339081,103.956388
487260,11,0,11,1.338397,103.95823
487261,1,1,2,1.338719,103.956393
487262,1,0,1,1.339081,103.956388
487263,7,2,9,1.338531,103.958453
487265,2,11,13,1.338607,103.958564
487266,30,4,34,1.338642,103.958622
487268,44,1,45,1.33871,103.958722
487269,7,0,7,1.338769,103.958795
487270,1,2,3,1.338366,103.958171
487271,10,1,11,1.339042,103.958793
487272,1,0,1,1.338494,103.958401
487273,3,4,7,1.339221,103.958778
487274,4,2,6,1.339421,103.958805
487275,2,0,2,1.338432,103.958302
487277,1,0,1,1.339147,103.95879
487278,33,2,35,1.339871,103.958659
487279,0,6,6,1.339973,103.958257
487281,30,3,33,1.339911,103.958139
487282,16,0,16,1.339988,103.958631
487285,0,1,1,1.339808,103.958677
487286,8,2,10,1.340112,103.958608
487287,186,2,188,1.339727,103.957786
487288,0,2,2,1.339527,103.958798
487289,0,15,15,1.339666,103.957668
487290,1,6,7,1.340229,103.958583
487291,8,0,8,1.339604,103.95755
487292,3,8,11,1.339653,103.957581
487293,5,7,12,1.339291,103.957913
487294,0,12,12,1.339373,103.958062
487295,1,2,3,1.338957,103.958816
487296,4,0,4,1.339453,103.958289
487297,103,1,104,1.339481,103.958349
487298,1,0,1,1.339788,103.957904
487299,2,4,6,1.339585,103.958575
487300,64,8,72,1.339546,103.958478
487301,0,12,12,1.339584,103.957269
487302,5,1,6,1.339508,103.957317
487303,35,0,35,1.33943,103.95738
487306,1,0,1,1.339533,103.958498
487307,4,6,10,1.339121,103.95765
487308,2,8,10,1.339039,103.957741
487309,0,3,3,1.339394,103.958134
487310,4,0,4,1.338875,103.957881
487311,0,1,1,1.339212,103.957596
487312,1,0,1,1.33873,103.958013
487332,30,57,87,1.339039,103.959265
487333,0,25,25,1.33914,103.959252
487334,1,14,15,1.339239,103.959227
487335,23,58,81,1.339303,103.959223
487336,2,32,34,1.339734,103.959117
487337,3,41,44,1.339804,103.959107
487338,21,25,46,1.339872,103.959095
487339,0,31,31,1.339941,103.959067
487340,5,2,7,1.339998,103.959055
487341,2,29,31,1.340056,103.959055
487342,1,45,46,1.34013,103.959032
487344,101,238,339,1.340239,103.959015
487345,0,290,290,1.340296,103.95901
487347,4,611,615,1.340394,103.958993
487368,55,2,57,1.341094,103.963179
487370,368,444,812,1.337788,103.962314
487371,13,1756,1769,1.340704,103.963627
487372,3546,4098,7644,1.340257,103.962949
487389,7,2,9,1.33847,103.952254
487390,1,48,49,1.338496,103.952266
487391,1,0,1,1.338677,103.958092
487392,1,3,4,1.338475,103.952222
487393,8,1,9,1.338389,103.952082
487394,0,20,20,1.338433,103.952133
487395,1,0,1,1.338443,103.952196
487396,2,8,10,1.338391,103.952044
487397,1,1,2,1.340183,103.958591
487398,1,25,26,1.338349,103.951955
487399,28,1,29,1.338227,103.951738
487400,1,9,10,1.338307,103.951865
487401,1,7,8,1.338173,103.951624
487402,0,18,18,1.338265,103.951776
487403,0,24,24,1.338129,103.951519
487404,14,3,17,1.338223,103.951687
487405,7,1,8,1.338119,103.951509
487406,0,22,22,1.338181,103.951598
487407,0,1,1,1.338335,103.951967
487408,92,54,146,1.338139,103.951509
487409,0,14,14,1.338121,103.951467
487410,10,2,12,1.338103,103.951425
487411,5,0,5,1.338067,103.951341
487412,4,0,4,1.338031,103.951258
487413,1,3,4,1.337995,103.951174
487414,2,13,15,1.337958,103.95109
487415,6,69,75,1.337922,103.951006
487416,3,14,17,1.337886,103.950923
487417,0,4,4,1.33785,103.950839
487418,1,4,5,1.337814,103.950755
487419,0,60,60,1.33776,103.950673
487420,21,445,466,1.337691,103.950627
487440,1,1,2,1.338281,103.951853
487442,4,0,4,1.336074,103.952411
487443,8,0,8,1.336172,103.952369
487444,3,0,3,1.338976,103.95782
487445,2,0,2,1.335927,103.952475
487446,5,0,5,1.336465,103.952241
487447,7,0,7,1.336563,103.952199
487448,1,1,2,1.336367,103.952284
487449,1,0,1,1.337681,103.950637
487450,10,1,11,1.336328,103.952281
487451,1,0,1,1.336661,103.952156
487452,1,2,3,1.336269,103.952326
487453,9,0,9,1.336857,103.952071
487454,8,1,9,1.336553,103.952183
487455,117,2,119,1.336955,103.952029
487457,1,0,1,1.336759,103.952114
487458,1,11,12,1.336778,103.952085
487459,16,4,20,1.33715,103.951944
487460,1,0,1,1.337052,103.951986
487461,31,14,45,1.337248,103.951901
487462,4,2,6,1.337003,103.951988
487463,29,1,30,1.337346,103.951859
487464,13,16,29,1.337116,103.951939
487465,10,17,27,1.337444,103.951816
487466,6,4,10,1.337229,103.95189
487467,33,1,34,1.337542,103.951774
487468,1,1,2,1.336216,103.952329
487469,9,3,12,1.33764,103.951731
487470,1,0,1,1.336891,103.952036
487471,13,0,13,1.337738,103.951689
487472,3,2,5,1.337566,103.951743
487473,21,7,28,1.337835,103.951646
487474,1,0,1,1.337454,103.951792
487475,5,0,5,1.337933,103.951604
487477,1,8,9,1.338031,103.951561
487478,2,1,3,1.336441,103.952232
487479,0,6,6,1.338129,103.951519
487480,2,1,3,1.337904,103.951597
487481,0,8,8,1.338119,103.951509
487482,2,0,2,1.337341,103.951841
487483,14,1,15,1.335934,103.952452
487484,0,5,5,1.335991,103.952427
487485,0,2,2,1.335961,103.952481
487501,42,12,54,1.336933,103.953008
487502,6,11,17,1.336913,103.953008
487503,1,0,1,1.337679,103.951694
487504,1,0,1,1.336951,103.953048
487505,16,2,18,1.336986,103.953127
487506,3,0,3,1.338016,103.951548
487507,1,0,1,1.336931,103.953048
487508,25,4,29,1.337002,103.953205
487509,3,2,5,1.337057,103.953284
487510,16,0,16,1.337037,103.953284
487511,2,0,2,1.336103,103.952378
487512,273,2,275,1.337073,103.953363
487533,13,0,13,1.336895,103.953058
487534,1,0,1,1.337022,103.953205
487535,2,0,2,1.337083,103.953353
487537,1,0,1,1.336549,103.953117
487538,6,0,6,1.337273,103.952808
487539,1,0,1,1.337089,103.952884
487540,3,1,4,1.337457,103.952733
487541,0,1,1,1.337447,103.952743
487542,27,0,27,1.337974,103.952519
487543,4,8,12,1.337956,103.952478
487544,1,0,1,1.33772,103.952621
487545,14,0,14,1.337904,103.952355
487546,3,3,6,1.337869,103.952274
487547,1,10,11,1.337463,103.952784
487548,3,15,18,1.337834,103.952192
487550,13,4,17,1.337809,103.95212
487551,30,0,30,1.337511,103.952909
487552,67,1,68,1.337832,103.952139
487553,0,1,1,1.337939,103.952437
487554,14,3,17,1.337844,103.952168
487555,51,1,52,1.337575,103.953075
487556,109,10,119,1.337869,103.952227
487557,1,1,2,1.336895,103.952969
487558,14,5,19,1.337894,103.952285
487559,1,0,1,1.337543,103.952992
487560,0,4,4,1.337919,103.952344
487561,3,2,5,1.337595,103.953075
487562,0,1,1,1.337611,103.953117
487564,0,1,1,1.337944,103.952402
487565,12,1,13,1.337531,103.952909
487566,2,7,9,1.337984,103.952509
487567,18,2,20,1.337499,103.952826
487568,2,13,15,1.337467,103.952743
487569,0,1,1,1.337969,103.952461
487570,37,0,37,1.338004,103.952589
487571,0,4,4,1.338034,103.95266
487572,12,0,12,1.338063,103.95273
487573,1,1,2,1.337607,103.953158
487574,0,1,1,1.337989,103.952554
487575,1,2,3,1.336966,103.953127
487576,76,0,76,1.338113,103.952801
487577,2,0,2,1.338093,103.952801
487578,6,3,9,1.338054,103.95266
487579,1,0,1,1.338123,103.952871
487580,1,2,3,1.338128,103.952836
487581,1,1,2,1.338083,103.95273
487582,5,0,5,1.338527,103.95239
487583,1,0,1,1.338024,103.952589
487585,3,0,3,1.337994,103.952519
487586,0,1,1,1.338557,103.952468
487587,0,1,1,1.338646,103.952704
487588,7,1,8,1.338636,103.952625
487591,2,0,2,1.338512,103.95235
487592,6,23,29,1.338517,103.952311
487612,9,3,12,1.324193,103.954646
487613,3,9,12,1.324193,103.954666
487614,13,1,14,1.324235,103.954607
487615,3,4,7,1.324235,103.954627
487616,137,3,140,1.32432,103.954531
487617,5,0,5,1.32432,103.954551
487618,2,0,2,1.338547,103.95239
487619,2,0,2,1.324404,103.954454
487620,0,1,1,1.338651,103.952665
487621,0,4,4,1.324489,103.954397
487622,2,0,2,1.324404,103.954474
487623,2,0,2,1.324573,103.9543
487625,2,6,8,1.324658,103.954244
487627,0,62,62,1.324742,103.954167
487647,1,0,1,1.324489,103.954377
487648,1,3,4,1.333119,103.94456
487649,1,0,1,1.332985,103.94446
487651,1,0,1,1.333033,103.94442
487652,1,3,4,1.33324,103.944497
487653,1,0,1,1.333094,103.944386
487655,6,1,7,1.333188,103.944318
487656,2,1,3,1.338616,103.952625
487657,14,0,14,1.333222,103.944292
487658,5,0,5,1.333348,103.944435
487660,31,5,36,1.333391,103.944418
487661,4,2,6,1.333343,103.944233
487662,0,3,3,1.33332,103.944457
487663,17,4,21,1.333397,103.944215
487664,1,5,6,1.333538,103.944349
487666,0,1,1,1.333145,103.944352
487667,0,2,2,1.324573,103.95432
487687,16,2,18,1.332643,103.944143
487688,25,13,38,1.33243,103.944172
487689,9,0,9,1.332672,103.944194
487690,2,0,2,1.333536,103.94419
487691,3,2,5,1.332729,103.944257
487692,4,2,6,1.332521,103.944263
487693,6,0,6,1.332775,103.944302
487694,18,0,18,1.33255,103.944291
487695,10,0,10,1.33259,103.944331
487696,1,0,1,1.333595,103.944315
487697,0,2,2,1.332475,103.944217
487699,2,0,2,1.33267,103.944428
487700,1,5,6,1.332773,103.94453
487702,2,0,2,1.332728,103.944479
487703,1,0,1,1.332642,103.944388
487704,1,0,1,1.333004,103.944775
487705,4,0,4,1.333071,103.94488
487706,10,1,11,1.333114,103.944914
487708,2,1,3,1.333457,103.944382
487709,5,0,5,1.333218,103.945059
487710,1,0,1,1.333031,103.944837
487712,2,1,3,1.333183,103.945008
487732,1,5,6,1.333345,103.944926
487733,6,2,8,1.333423,103.945077
487734,8,1,9,1.333396,103.944896
487735,3,1,4,1.333477,103.94505
487736,2,3,5,1.333445,103.944872
487737,13,2,15,1.333516,103.94502
487740,1,0,1,1.333226,103.945115
487741,7,0,7,1.333616,103.944969
487742,12,0,12,1.333571,103.944808
487744,1,0,1,1.333535,103.944833
487747,25,0,25,1.333751,103.944878
487748,7,2,9,1.333706,103.94473
487750,2,1,3,1.333257,103.945195
487770,0,5,5,1.332195,103.944457
487773,11,0,11,1.332125,103.944713
487774,6,0,6,1.332258,103.944525
487775,9,0,9,1.332204,103.944785
487776,11,1,12,1.332281,103.944553
487777,5,0,5,1.332239,103.944834
487778,0,1,1,1.333619,103.944781
487779,9,0,9,1.332283,103.944857
487780,2,0,2,1.332877,103.944632
487781,1,0,1,1.332321,103.944582
487783,13,0,13,1.332363,103.944931
487784,1,0,1,1.332317,103.944897
487785,1,0,1,1.332447,103.944696
487787,0,3,3,1.333815,103.94467
487788,3,2,5,1.332556,103.944781
487789,50,3,53,1.332512,103.945067
487790,16,3,19,1.332607,103.944832
487791,7,3,10,1.332535,103.945101
487795,2,0,2,1.332349,103.94461
487796,0,4,4,1.332765,103.9451
487799,18,0,18,1.332672,103.945323
487800,22,3,25,1.332824,103.945207
487801,2,0,2,1.332604,103.945187
487802,8,0,8,1.332896,103.945295
487806,0,5,5,1.332836,103.945578
487825,16,6,22,1.342268,103.960234
487826,1,1,2,1.332861,103.945261
487827,1,1,2,1.342133,103.960222
487828,4,2,6,1.342173,103.960176
487829,0,1,1,1.332415,103.944976
487830,25,0,25,1.342208,103.960125
487831,0,1,1,1.342343,103.960137
487832,4,0,4,1.342248,103.960074
487833,1,0,1,1.342383,103.960086
487834,2,1,3,1.332466,103.945027
487835,0,2,2,1.342308,103.960188
487836,3,0,3,1.342282,103.960028
487837,8,3,11,1.342617,103.959767
487838,0,1,1,1.342417,103.96004
487839,4,0,4,1.34264,103.959733
487840,6,0,6,1.342505,103.959721
487841,1,0,1,1.342491,103.959743
487844,4,0,4,1.342551,103.959658
487845,2,1,3,1.342305,103.959994
487846,0,5,5,1.34258,103.959624
487848,2,0,2,1.34244,103.960006
487849,0,1,1,1.342663,103.95971
487850,1,1,2,1.342603,103.959584
487851,0,1,1,1.342772,103.959562
487852,15,2,17,1.342645,103.959527
487853,1,0,1,1.342795,103.959539
487857,5,0,5,1.342745,103.959383
487858,1,1,2,1.342621,103.95955
487878,8,13,21,1.346024,103.961301
487879,26,35,61,1.346045,103.961248
487880,1,0,1,1.342654,103.959518
487881,1,2,3,1.342715,103.959636
487882,24,0,24,1.345845,103.96124
487884,0,1,1,1.345943,103.961267
487886,3,0,3,1.345964,103.961214
487888,3,0,3,1.345647,103.961185
487889,7,0,7,1.34557,103.961104
487891,1,1,2,1.342756,103.959363
487893,1,0,1,1.345746,103.961212
487894,0,6,6,1.345253,103.961074
487895,1,0,1,1.345372,103.961049
487896,3,5,8,1.345154,103.961047
487898,1,1,2,1.345471,103.961076
487899,11,1,12,1.345055,103.961019
487900,7,0,7,1.345076,103.960966
487902,1,0,1,1.345274,103.961021
487903,0,1,1,1.344978,103.960938
487904,0,1,1,1.344858,103.960964
487905,3,1,4,1.344759,103.960936
487906,11,0,11,1.34478,103.960883
487907,10,0,10,1.344661,103.960909
487908,1,0,1,1.344879,103.960911
487909,0,2,2,1.345175,103.960994
487910,1,4,5,1.344608,103.960823
487912,6,9,15,1.344421,103.960823
487914,2,0,2,1.344579,103.960887
487916,9,0,9,1.344202,103.960735
487918,3,2,5,1.344126,103.960704
487919,8,0,8,1.344109,103.960636
487920,6,1,7,1.344055,103.960663
487921,4,4,8,1.344065,103.960606
487922,2,0,2,1.344298,103.960779
487923,10,0,10,1.344016,103.960594
487924,29,0,29,1.343838,103.9606
487926,3,0,3,1.345549,103.961157
487927,0,6,6,1.343932,103.960566
487928,73,2,75,1.343689,103.960527
487929,2,0,2,1.343961,103.960644
487930,5,1,6,1.343566,103.960483
487931,0,2,2,1.343879,103.960539
487932,12,2,14,1.34347,103.960461
487934,60,1,61,1.342771,103.960613
487935,2,0,2,1.3438,103.960507
487936,9,0,9,1.342632,103.960609
487937,1,0,1,1.344682,103.960856
487938,77,2,79,1.34241,103.960666
487939,2,0,2,1.343578,103.960434
487940,0,1,1,1.342554,103.960637
487942,1,0,1,1.342196,103.960692
487943,2,1,3,1.343742,103.960556
487944,14,9,23,1.345083,103.960894
487945,24,9,33,1.345027,103.960837
487946,1,2,3,1.341908,103.96072
487947,18,1,19,1.344476,103.960913
487948,2,0,2,1.342378,103.960637
487949,0,1,1,1.341971,103.960712
487950,0,12,12,1.342578,103.960382
487951,103,2,105,1.345191,103.960905
487963,12,0,12,1.342863,103.960228
487964,11,11,22,1.343017,103.960225
487965,2,0,2,1.344414,103.960923
487967,17,0,17,1.342907,103.960148
487968,2,0,2,1.342886,103.96018
487969,0,2,2,1.343073,103.960113
487970,0,1,1,1.344465,103.960975
487971,3,0,3,1.344508,103.960846
487972,3,0,3,1.34295,103.960063
487973,0,10,10,1.342984,103.960008
487974,1,0,1,1.34313,103.960101
487976,9,1,10,1.34328,103.959903
487977,47,0,47,1.343029,103.959943
487978,2,1,3,1.343188,103.959994
487979,1,0,1,1.343221,103.959954
487980,1,2,3,1.343349,103.959869
487981,0,1,1,1.343074,103.959927
487982,1,3,4,1.343415,103.959758
487983,48,0,48,1.343456,103.959742
487984,2,0,2,1.342935,103.960116
487985,3,0,3,1.343368,103.959805
487986,10,2,12,1.343591,103.959656
487987,2,0,2,1.343503,103.959711
487988,0,11,11,1.342863,103.960228
488047,2093,329,2422,1.32388,103.963164
488067,310,115,425,1.341648,103.960488
488069,0,61,61,1.341743,103.959655
488070,9,5,14,1.341565,103.960126
488071,82,1,83,1.341589,103.960089
488072,1,0,1,1.343127,103.959878
488073,10,5,15,1.34166,103.959987
488074,6,0,6,1.341693,103.959939
488076,2,16,18,1.341771,103.959826
488077,14,0,14,1.341814,103.959777
488078,0,10,10,1.341841,103.959728
488079,6,0,6,1.34191,103.959624
488080,1,1,2,1.343167,103.959828
488081,6,1,7,1.341981,103.959526
488082,2,1,3,1.343541,103.959687
488083,20,4,24,1.342059,103.959407
488084,1,0,1,1.341626,103.960037
488086,0,4,4,1.342168,103.959228
488087,2,0,2,1.341954,103.959566
488089,2,13,15,1.342272,103.959045
488090,4,0,4,1.3423,103.959002
488091,4,0,4,1.342336,103.958946
488092,1,0,1,1.342087,103.959345
488112,10,137,147,1.336161,103.951991
488113,1,5,6,1.336416,103.952054
488114,11,316,327,1.336875,103.951331
488115,6,368,374,1.336903,103.951338
488116,5,0,5,1.336977,103.951246
488117,7,366,373,1.337018,103.95128
488118,0,1,1,1.342376,103.95889
488119,31,0,31,1.337075,103.951203
488120,9,17,26,1.337109,103.951145
488121,4,3,7,1.33719,103.951107
488122,7,0,7,1.337258,103.951042
488123,0,29,29,1.33734,103.950994
488124,22,128,150,1.337415,103.950921
488125,9,0,9,1.337463,103.950877
488126,6,276,282,1.337576,103.950785
488127,4,75,79,1.337633,103.950747
488128,0,129,129,1.336021,103.952041
488129,7,5,12,1.336125,103.952036
488147,8,362,370,1.332609,103.94602
488148,9,86,95,1.332918,103.946108
488150,0,2,2,1.342211,103.959161
488151,4,0,4,1.33271,103.945961
488152,1,120,121,1.332986,103.946219
488153,15,0,15,1.33276,103.945936
488154,67,6,73,1.332995,103.946272
488155,15,1,16,1.332816,103.945916
488156,0,54,54,1.333021,103.946337
488157,0,4,4,1.332869,103.945883
488158,0,2,2,1.332955,103.946173
488159,3,0,3,1.342021,103.959463
488160,1,21,22,1.333047,103.946438
488161,1,1,2,1.33303,103.94637
488162,2,9,11,1.333073,103.946507
488163,3,0,3,1.332974,103.945835
488164,3,184,187,1.333099,103.946566
488165,19,1,20,1.333126,103.945721
488166,0,1,1,1.337042,103.951203
488167,28,0,28,1.333178,103.945686
488168,16,108,124,1.333154,103.946703
488169,1,1,2,1.333026,103.945791
488170,5,8,13,1.33318,103.94678
488171,3,0,3,1.333082,103.945764
488172,3,77,80,1.333197,103.946839
488173,0,1,1,1.333116,103.946626
488174,0,2,2,1.333226,103.945661
488175,3,0,3,1.333282,103.945636
488176,7,197,204,1.333234,103.946947
488177,1,0,1,1.333331,103.945605
488178,1,1,2,1.333218,103.946895
488180,1,158,159,1.333286,103.94706
488181,2,0,2,1.333264,103.947009
488182,0,4,4,1.333309,103.947108
488184,0,190,190,1.333332,103.947156
488185,2,6,8,1.333686,103.9454
488186,4,30,34,1.333353,103.94722
488187,4,0,4,1.333736,103.945364
488188,2,90,92,1.333381,103.947313
488189,3,4,7,1.333776,103.945342
488190,0,121,121,1.333413,103.947381
488191,0,1,1,1.333487,103.945514
488192,34,0,34,1.333537,103.947369
488193,2,3,5,1.333882,103.945293
488194,11,2,13,1.333516,103.947312
488195,3,0,3,1.333437,103.945547
488197,1,0,1,1.333832,103.945311
488198,0,1,1,1.333421,103.94704
488200,25,1,26,1.333349,103.946865
488202,0,5,5,1.333315,103.946765
488204,1,8,9,1.333276,103.946646
488205,3,0,3,1.333466,103.947163
488206,57,19,76,1.333221,103.946488
488207,4,0,4,1.333201,103.946435
488208,8,1,9,1.333178,103.946379
488210,2,1,3,1.33325,103.946543
488212,3,6,9,1.3331,103.946151
488213,12,0,12,1.333085,103.946092
488214,2,6,8,1.333065,103.946019
488215,1,9,10,1.333458,103.945825
488216,4,2,6,1.333469,103.945887
488217,1,0,1,1.333389,103.946982
488218,5,6,11,1.333509,103.945993
488220,3,1,4,1.333552,103.9461
488221,1,0,1,1.33349,103.945939
488223,1,1,2,1.333585,103.945468
488224,10,0,10,1.333646,103.946347
488225,1,0,1,1.333571,103.946152
488226,0,7,7,1.333746,103.946195
488227,1,0,1,1.333773,103.946256
488228,1,4,5,1.333706,103.946085
488229,17,0,17,1.333685,103.946018
488230,5,13,18,1.333667,103.945967
488231,1,1,2,1.333617,103.946267
488232,1,9,10,1.333625,103.945863
488233,0,2,2,1.333648,103.945918
488234,2,6,8,1.333579,103.945748
488235,3,3,6,1.333834,103.945586
488236,7,0,7,1.333919,103.945548
488256,0,5,5,1.346658,103.960365
488257,0,2,2,1.333606,103.945817
488258,4,4,8,1.346817,103.960319
488259,1,6,7,1.346924,103.960302
488260,1,1,2,1.34672,103.960322
488263,3,2,5,1.347404,103.960251
488264,21,6,27,1.347512,103.960231
488265,4,7,11,1.34764,103.96023
488285,29,0,29,1.342309,103.960945
488286,8,2,10,1.342386,103.960973
488287,2,0,2,1.347047,103.960291
488288,34,0,34,1.342611,103.960999
488290,0,1,1,1.333729,103.946143
488291,1,0,1,1.34281,103.961047
488294,12,1,13,1.343043,103.961127
488295,0,1,1,1.342962,103.960942
488296,2,0,2,1.342522,103.960968
488298,0,2,2,1.343245,103.961197
488299,1,1,2,1.343163,103.961171
488301,1,0,1,1.34317,103.96104
488302,6,3,9,1.343453,103.961248
488303,1,0,1,1.343531,103.961125
488304,0,2,2,1.343418,103.961088
488305,1,0,1,1.343645,103.961161
488308,1,4,5,1.34377,103.961378
488309,1,3,4,1.343987,103.961271
488310,0,2,2,1.343576,103.9613
488311,0,9,9,1.344101,103.961307
488312,6,0,6,1.343998,103.96143
488313,9,2,11,1.344214,103.961344
488314,11,5,16,1.344096,103.961459
488317,1,0,1,1.343759,103.961198
488318,1,2,3,1.333143,103.946279
488321,0,1,1,1.34438,103.961407
488322,0,1,1,1.344557,103.96145
488323,0,4,4,1.344672,103.961482
488324,48,6,54,1.344586,103.961623
488325,21,0,21,1.344786,103.961515
488326,7,1,8,1.344734,103.961651
488327,5,1,6,1.344901,103.961548
488328,1,7,8,1.34483,103.961671
488330,1,2,3,1.344258,103.96153
488331,3,9,12,1.345131,103.961613
488332,13,11,24,1.345075,103.96173
488333,86,3,89,1.345245,103.961646
488334,12,1,13,1.345237,103.961751
488335,7,0,7,1.34536,103.961679
488336,0,1,1,1.344521,103.961592
488337,106,13,119,1.345475,103.961711
488338,1,3,4,1.345476,103.961853
488339,0,3,3,1.344966,103.9617
488341,1,0,1,1.345344,103.961799
488342,0,12,12,1.34602,103.962042
488343,4,0,4,1.345819,103.961809
488344,14,2,16,1.346106,103.962064
488345,3,4,7,1.345934,103.961842
488346,1,0,1,1.345704,103.961777
488352,32,1,33,1.346492,103.962173
488354,3,8,11,1.346607,103.962185
488355,22,42,64,1.346757,103.962075
488356,8,16,24,1.346695,103.962228
488357,19,6,25,1.346832,103.962094
488358,1,2,3,1.34559,103.961744
488359,3,0,3,1.346814,103.96224
488360,51,1,52,1.346882,103.962286
488361,0,5,5,1.347012,103.962162
488362,0,1,1,1.346215,103.962082
488363,3,1,4,1.347085,103.962203
488364,0,2,2,1.343881,103.961414
488365,9,10,19,1.347147,103.962222
488366,71,1,72,1.347179,103.962364
488367,7,1,8,1.347256,103.9624
488368,44,2,46,1.347365,103.962427
488369,4,88,92,1.347448,103.962465
488370,12,11,23,1.342735,103.960869
488371,56,1,57,1.342848,103.960906
488372,0,1,1,1.346995,103.962313
488373,2,5,7,1.345807,103.961953
488389,3,16,19,1.3461,103.961838
488393,0,1,1,1.345534,103.96187
488394,1,0,1,1.346175,103.961579
488395,1,0,1,1.346185,103.961509
488397,1,8,9,1.346234,103.961331
488398,4,0,4,1.346244,103.961293
488399,2,0,2,1.347064,103.962343
488400,3,0,3,1.346931,103.962132
488401,0,17,17,1.346319,103.961023
488402,3,0,3,1.346281,103.961168
488403,0,4,4,1.34638,103.960827
488404,0,2,2,1.346258,103.961234
488405,64,11,75,1.346429,103.960629
488406,75,21,96,1.346445,103.960554
488438,7,1,8,1.347848,103.96037
488439,1,0,1,1.346197,103.961466
488441,5,2,7,1.347852,103.960529
488443,3,0,3,1.346337,103.960957
488444,5,0,5,1.347839,103.960804
488446,15,0,15,1.347812,103.960879
488449,3,2,5,1.347528,103.961198
488451,61,19,80,1.347509,103.961302
488452,79,0,79,1.347727,103.961178
488454,0,3,3,1.347846,103.960655
488455,1,2,3,1.347711,103.96125
488456,2,1,3,1.347451,103.961499
488458,6,1,7,1.347637,103.961453
488459,0,6,6,1.347398,103.961693
488460,0,2,2,1.346398,103.960738
488462,7,0,7,1.347573,103.961628
488463,1,2,3,1.347681,103.961344
488464,3,3,6,1.347554,103.96172
488465,5,0,5,1.347522,103.961805
488466,2,0,2,1.347608,103.96155
488467,8,0,8,1.347456,103.962021
488468,22,1,23,1.347419,103.962106
488469,1,11,12,1.347391,103.962214
488489,0,7,7,1.332999,103.943461
488490,3,0,3,1.347242,103.961884
488491,0,4,4,1.332896,103.943535
488492,6,1,7,1.332856,103.943558
488493,48,0,48,1.332799,103.943586
488495,3,2,5,1.332696,103.943655
488496,23,3,26,1.332633,103.943695
488497,4,5,9,1.332575,103.94374
488498,26,0,26,1.332512,103.943791
488499,28,1,29,1.332461,103.943831
488500,2,0,2,1.347482,103.961929
488501,62,0,62,1.332352,103.943922
488502,0,8,8,1.332301,103.943979
488503,0,1,1,1.347848,103.960445
488505,17,4,21,1.332174,103.944105
488506,7,0,7,1.332134,103.944145
488507,168,2,170,1.332096,103.94419
488527,4,11,15,1.33123,103.942859
488528,5,14,19,1.330998,103.942824
488530,2,0,2,1.332404,103.943871
488531,20,4,24,1.331195,103.943042
488532,1,3,4,1.331001,103.942986
488533,12,0,12,1.331195,103.94311
488534,14,1,15,1.331001,103.943054
488535,0,16,16,1.331091,103.943229
488536,3,0,3,1.332942,103.943501
488537,9,1,10,1.33119,103.943396
488538,15,1,16,1.330979,103.943231
488540,8,12,20,1.330956,103.943333
488541,49,27,76,1.331315,103.943424
488542,1,2,3,1.330979,103.943157
488543,28,0,28,1.331368,103.943414
488545,9,0,9,1.330944,103.943528
488546,9,0,9,1.33095,103.943557
488547,3,0,3,1.330956,103.943407
488548,2,1,3,1.33095,103.943591
488549,1,0,1,1.33226,103.944025
488550,2,0,2,1.330998,103.942875
488551,1,0,1,1.33095,103.943625
488552,2,0,2,1.330944,103.943653
488553,4,4,8,1.331566,103.943471
488554,2,0,2,1.330933,103.943716
488555,6,0,6,1.331665,103.942979
488556,4,2,6,1.331097,103.943602
488557,6,1,7,1.331637,103.943098
488558,0,3,3,1.331498,103.943454
488559,50,6,56,1.331643,103.943178
488560,0,5,5,1.331212,103.943608
488561,97,3,100,1.331853,103.943035
488562,78,0,78,1.331263,103.943619
488563,0,1,1,1.330939,103.943687
488564,1,9,10,1.331303,103.943613
488566,2,0,2,1.331665,103.942904
488567,0,1,1,1.331858,103.94308
488568,24,0,24,1.331429,103.94363
488569,2,4,6,1.331766,103.943444
488570,1,4,5,1.331482,103.943627
488571,0,3,3,1.33116,103.943596
488572,6,9,15,1.331538,103.943632
488574,2,3,5,1.331636,103.943653
488576,14,0,14,1.331716,103.94367
488577,75,0,75,1.332115,103.943467
488578,235,7,242,1.331796,103.943676
488579,3,1,4,1.332207,103.943456
488580,17,3,20,1.331859,103.943687
488582,0,2,2,1.331361,103.94363
488584,12,6,18,1.332002,103.943699
488585,29,1,30,1.332071,103.943704
488605,5,204,209,1.330843,103.942562
488606,1,0,1,1.331847,103.943166
488607,2,0,2,1.331928,103.943693
488608,3,39,42,1.331095,103.942619
488610,10,1,11,1.331267,103.942642
488611,0,1,1,1.330911,103.942568
488612,0,7,7,1.331466,103.942633
488613,4,2,6,1.331585,103.942717
488614,1,23,24,1.331665,103.942717
488615,1,14,15,1.331757,103.942745
488616,4,24,28,1.331831,103.942739
488617,131,11,142,1.331934,103.942768
488618,1,1,2,1.331026,103.942614
488619,4,6,10,1.332135,103.94279
488620,4,6,10,1.332209,103.942825
488621,6,0,6,1.331841,103.942904
488622,3,18,21,1.332318,103.942842
488623,2,0,2,1.332015,103.942773
488624,4,15,19,1.332393,103.94287
488625,14,1,15,1.332076,103.942944
488626,4,12,16,1.332513,103.942876
488627,9,1,10,1.332076,103.943058
488628,4,3,7,1.332582,103.942904
488629,0,1,1,1.331344,103.942661
488630,3,4,7,1.332668,103.942921
488631,1,1,2,1.331933,103.94291
488632,2,20,22,1.332731,103.942938
488633,4,4,8,1.332463,103.943056
488634,2,24,26,1.33284,103.942961
488635,21,6,27,1.332566,103.943051
488636,37,21,58,1.33292,103.942978
488637,3,1,4,1.333088,103.943179
488639,3,2,5,1.333174,103.943315
488640,146,5,151,1.333231,103.943383
488641,1,2,3,1.331829,103.943444
488642,5,0,5,1.33338,103.943554
488643,2,1,3,1.333346,103.943491
488644,15,1,16,1.33346,103.943713
488646,1,0,1,1.332303,103.943022
488647,13,1,14,1.333632,103.943981
488649,60,1,61,1.332983,103.943017
488650,189,0,189,1.333019,103.943108
488651,0,17,17,1.332677,103.943066
488652,1,0,1,1.333564,103.94389
488653,3,2,5,1.299509,103.837
488654,2,0,2,1.332383,103.943045
488668,3,0,3,1.33342,103.943645
488669,2,183,185,1.333544,103.947911
488671,0,1,1,1.299509,103.837
488672,4,37,41,1.333601,103.948052
488674,2,0,2,1.299509,103.837
488675,0,140,140,1.333623,103.948096
488676,4,0,4,1.333646,103.948145
488678,18,2,20,1.333677,103.94822
488679,0,202,202,1.333677,103.94822
488680,17,0,17,1.333697,103.948256
488681,0,66,66,1.333697,103.948256
488682,21,0,21,1.333729,103.948347
488683,1,34,35,1.333729,103.948347
488684,35,1,36,1.333747,103.948387
488685,2,179,181,1.333747,103.948387
488686,5,2,7,1.333801,103.948492
488687,1,69,70,1.333801,103.948492
488688,5,71,76,1.333816,103.948538
488689,1,1,2,1.333623,103.948096
488690,2,7,9,1.333843,103.948618
488691,0,63,63,1.333843,103.948618
488692,1,0,1,1.333582,103.948002
488693,1,1,2,1.333816,103.948538
488694,2,0,2,1.333859,103.948655
488695,1,73,74,1.333891,103.948732
488696,1,0,1,1.333859,103.948655
488697,1,0,1,1.333907,103.948768
488698,7,90,97,1.333941,103.948841
488700,46,6,52,1.333945,103.948884
488701,17,352,369,1.333945,103.948884
488702,0,2,2,1.333891,103.948732
488703,3,0,3,1.333544,103.947911
488704,14,5,19,1.334014,103.948319
488705,6,0,6,1.33406,103.948296
488706,2,0,2,1.333923,103.948347
488708,0,7,7,1.334235,103.948225
488709,0,3,3,1.333963,103.94833
488710,2,5,7,1.333808,103.947833
488711,0,5,5,1.333843,103.947816
488712,0,1,1,1.333907,103.948768
488714,0,6,6,1.333963,103.947773
488715,1,0,1,1.333886,103.947807
488716,4,0,4,1.334147,103.947671
488717,2,28,30,1.334203,103.947583
488718,100,1,101,1.334199,103.947476
488719,6,7,13,1.334212,103.947381
488720,4,11,15,1.334244,103.94725
488721,5,1,6,1.334261,103.947166
488722,1,18,19,1.334281,103.947039
488723,165,1,166,1.3343,103.946929
488724,2,0,2,1.334106,103.948273
488725,0,3,3,1.333765,103.94785
488726,29,1,30,1.33438,103.946574
488727,9,23,32,1.33439,103.946499
488728,87,12,99,1.334429,103.946277
488729,8,0,8,1.334408,103.946372
488730,35,23,58,1.334147,103.946464
488731,1,2,3,1.334352,103.946712
488732,16,3,19,1.334166,103.946335
488733,4,1,5,1.334485,103.946066
488734,2,1,3,1.334459,103.946152
488735,10,10,20,1.334505,103.945926
488736,2,1,3,1.334239,103.946066
488737,1,1,2,1.334337,103.946802
488739,61,1,62,1.334567,103.945729
488740,2,0,2,1.334535,103.945825
488741,8,11,19,1.334576,103.945623
488743,29,16,45,1.334605,103.945458
488744,18,3,21,1.334257,103.945348
488745,0,9,9,1.334576,103.945367
488746,223,0,223,1.334194,103.945234
488747,12,0,12,1.334557,103.94528
488748,9,2,11,1.334899,103.945026
488749,23,24,47,1.334149,103.945132
488750,110,6,116,1.334523,103.945206
488751,1,2,3,1.334269,103.945853
488752,0,2,2,1.334272,103.945597
488753,10,8,18,1.334448,103.94507
488754,4,9,13,1.334773,103.944827
488756,9,4,13,1.334391,103.944979
488757,5,0,5,1.334727,103.944764
488760,1,1,2,1.334097,103.945035
488761,1,0,1,1.334006,103.947756
488762,5,0,5,1.334861,103.944624
488763,2,0,2,1.33426,103.944815
488764,0,3,3,1.334836,103.944929
488765,9,0,9,1.33478,103.944521
488766,14,7,21,1.33413,103.944649
488767,0,2,2,1.334181,103.944723
488768,2,5,7,1.334636,103.9442
488770,1,0,1,1.334601,103.944582
488771,7,197,204,1.334876,103.944046
488773,22,7,29,1.334248,103.944213
488774,0,11,11,1.334454,103.944088
488775,0,1,1,1.334796,103.944097
488776,14,0,14,1.334102,103.944419
488777,1,1,2,1.334463,103.944366
488778,5,4,9,1.334414,103.944014
488780,21,0,21,1.334339,103.943889
488781,24,1,25,1.333855,103.943511
488782,11,5,16,1.334265,103.94377
488783,0,3,3,1.334515,103.944462
488784,41,2,43,1.334202,103.943679
488785,6,1,7,1.334029,103.943766
488786,3,11,14,1.334104,103.94361
488788,3,140,143,1.334137,103.943915
488789,0,12,12,1.334179,103.943975
488790,3,2,5,1.333652,103.943428
488791,2,0,2,1.334186,103.94414
488792,0,13,13,1.333974,103.943683
488795,0,4,4,1.333953,103.944752
488796,2,25,27,1.333593,103.943152
488797,24,127,151,1.334865,103.943919
488798,0,13,13,1.334813,103.943948
488799,0,13,13,1.334759,103.943986
488800,8,32,40,1.334711,103.944026
488801,1,8,9,1.299509,103.837
488811,11,33,44,1.325882,103.952606
488812,16,4,20,1.325918,103.952577
488813,35,2,37,1.32599,103.952517
488814,2,3,5,1.325836,103.952646
488817,4,0,4,1.325599,103.952837
488819,2,0,2,1.33363,103.943339
488820,7,1,8,1.325846,103.952636
488821,0,1,1,1.33449,103.944153
488822,1,2,3,1.33393,103.9436
488823,3,0,3,1.325663,103.952308
488824,7,2,9,1.326139,103.952586
488825,5,0,5,1.325911,103.952766
488826,1,30,31,1.325909,103.95273
488827,1,0,1,1.325846,103.952656
488830,4,0,4,1.326067,103.952981
488831,8,0,8,1.3261,103.953065
488832,183,2,185,1.326185,103.95314
488833,0,1,1,1.325987,103.952885
488834,6,0,6,1.326331,103.953292
488835,2,0,2,1.325609,103.952847
488836,64,9,73,1.326476,103.953443
488837,8,1,9,1.326347,103.95333
488838,41,0,41,1.326539,103.953509
488839,1,0,1,1.326165,103.95314
488840,1,1,2,1.326256,103.953235
488841,0,15,15,1.325909,103.95273
488842,44,24,68,1.299509,103.837
488860,3,32,35,1.346568,103.961981
488861,26,0,26,1.346817,103.961767
488862,4,1,5,1.346589,103.961888
488863,1,2,3,1.325874,103.952706
488864,1,0,1,1.326438,103.953424
488867,11,0,11,1.346916,103.96152
488868,0,3,3,1.346859,103.961675
488870,7,0,7,1.346717,103.961532
488871,20,4,24,1.346979,103.961334
488872,0,4,4,1.346735,103.961473
488874,1,0,1,1.346613,103.961814
488876,1,0,1,1.346759,103.961372
488879,4,5,9,1.34712,103.960962
488880,6,0,6,1.346846,103.961093
488881,2,2,4,1.346878,103.96096
488884,22,0,22,1.34713,103.960746
488885,2,0,2,1.326529,103.953519
488886,5,1,6,1.347301,103.960721
488888,2,0,2,1.347205,103.96073
488890,1,4,5,1.347664,103.960739
488891,32,2,34,1.347286,103.960863
488892,0,1,1,1.346783,103.961293
488893,0,1,1,1.347393,103.960855
488894,2,6,8,1.347576,103.960827
488895,1,3,4,1.347186,103.960898
488910,1,21,22,1.323496,103.954538
488911,2,11,13,1.323353,103.954696
488912,10,2,12,1.323385,103.954749
488913,25,9,34,1.323534,103.95498
488914,2,0,2,1.347468,103.960698
488915,109,0,109,1.3236,103.955052
488917,1,0,1,1.347475,103.960847
488918,4,0,4,1.323584,103.954963
488919,0,9,9,1.323747,103.955181
488922,1,0,1,1.323673,103.955116
488923,2,0,2,1.323451,103.954823
488924,3,1,4,1.323834,103.955213
488925,5,1,6,1.323968,103.955376
488926,73,0,73,1.323905,103.955271
488927,2,0,2,1.323894,103.955311
488928,1,0,1,1.32374,103.955134
488929,3,5,8,1.324115,103.955506
488930,33,1,34,1.324056,103.955403
488931,16,0,16,1.324189,103.955572
488932,14,1,15,1.324138,103.955473
488933,21,0,21,1.324262,103.955636
488934,1,0,1,1.32398,103.955338
488935,4,58,62,1.324336,103.955702
488936,3,0,3,1.346685,103.961625
488937,2,0,2,1.324041,103.955441
488938,1,6,7,1.324363,103.955665
488939,2,2,4,1.324483,103.955832
488940,7,0,7,1.324443,103.955744
488941,1,0,1,1.324214,103.955535
488942,3,0,3,1.324287,103.955593
488943,1,5,6,1.32463,103.955962
488944,4,0,4,1.324612,103.95589
488945,35,14,49,1.324667,103.955994
488947,3,0,3,1.324523,103.955816
488948,4,1,5,1.323357,103.954763
488949,3,0,3,1.323495,103.954932
488950,3,7,10,1.323288,103.954672
488951,21,3,24,1.323322,103.95472
488968,1,10,11,1.344634,103.960772
488969,12,0,12,1.34465,103.96071
488970,1,1,2,1.324409,103.955766
488972,2,5,7,1.344806,103.960529
488973,6,17,23,1.344732,103.960479
488974,11,6,17,1.344851,103.960403
488975,21,0,21,1.344747,103.960424
488976,101,8,109,1.344783,103.960355
488977,12,0,12,1.344799,103.960316
488978,2,3,5,1.299509,103.837
488979,2,2,4,1.299509,103.837
488980,2,17,19,1.299509,103.837
488997,130,268,398,1.32942,103.950052
488999,1,0,1,1.324557,103.955896
489001,0,1,1,1.329486,103.950004
489003,1,1,2,1.344678,103.960637
489005,0,1,1,1.329619,103.94991
489006,0,1,1,1.329874,103.949731
489007,46,3,49,1.32992,103.949693
489008,2,0,2,1.329752,103.949816
489009,0,1,1,1.32992,103.949713
489010,5,1,6,1.330029,103.949628
489011,4,0,4,1.330029,103.949608
489012,0,7,7,1.330102,103.949572
489013,0,2,2,1.329957,103.949685
489014,15,0,15,1.330174,103.949515
489016,0,1,1,1.329957,103.949665
489017,0,8,8,1.330247,103.949439
489018,1,10,11,1.330319,103.949402
489019,0,1,1,1.330247,103.949459
489020,29,6,35,1.330392,103.949346
489022,0,1,1,1.330319,103.949382
489023,0,11,11,1.330464,103.949269
489026,1,9,10,1.330609,103.949176
489027,0,3,3,1.323426,103.954847
489028,0,2,2,1.330102,103.949552
489029,6,4,10,1.330682,103.9491
489030,12,0,12,1.330754,103.949063
489031,1,1,2,1.330682,103.94912
489033,11,7,18,1.330827,103.948987
489035,0,3,3,1.330609,103.949156
489036,1,9,10,1.330972,103.948894
489037,0,1,1,1.330464,103.949289
489057,5,4,9,1.33012,103.950339
489058,2,13,15,1.330104,103.950371
489059,2,5,7,1.330161,103.950307
489060,7,0,7,1.330131,103.950351
489062,6,0,6,1.330183,103.950311
489063,40,0,40,1.330328,103.95018
489064,21,2,23,1.330236,103.950271
489065,1,1,2,1.330754,103.949043
489066,5,4,9,1.330289,103.95023
489068,37,0,37,1.330341,103.95019
489069,0,1,1,1.330962,103.948884
489070,2,2,4,1.330394,103.95015
489071,6,2,8,1.330662,103.949926
489072,0,6,6,1.330447,103.95011
489073,2,0,2,1.330412,103.950117
489074,1,1,2,1.330745,103.949862
489075,0,2,2,1.330499,103.95007
489076,0,3,3,1.330899,103.94893
489077,3,0,3,1.330552,103.95003
489078,0,4,4,1.330605,103.949989
489080,2,0,2,1.330829,103.949799
489081,3,4,7,1.331069,103.949618
489082,1,0,1,1.330578,103.949989
489083,20,9,29,1.331123,103.949576
489084,13,2,15,1.330763,103.949869
489085,90,0,90,1.331167,103.949543
489086,1,7,8,1.330816,103.949829
489087,5,23,28,1.331255,103.949479
489088,10,0,10,1.330868,103.949789
489089,0,2,2,1.330658,103.949949
489090,1,2,3,1.330912,103.949735
489091,0,1,1,1.33071,103.949909
489092,2,2,4,1.330974,103.949708
489093,2,11,13,1.331519,103.949285
489094,2,1,3,1.330921,103.949748
489095,2,11,13,1.331597,103.94923
489096,28,11,39,1.331079,103.949628
489097,11,7,18,1.33165,103.949186
489098,0,12,12,1.331108,103.949606
489099,3,0,3,1.331026,103.949668
489100,0,11,11,1.331138,103.949585
489101,12,1,13,1.331778,103.949083
489102,1,1,2,1.331343,103.949414
489103,6,1,7,1.331864,103.949015
489104,0,2,2,1.331196,103.949542
489105,109,3,112,1.33195,103.948947
489107,0,1,1,1.331431,103.949349
489108,1,1,2,1.331255,103.949499
489109,3,2,5,1.332121,103.94881
489112,0,1,1,1.332035,103.948878
489113,1,3,4,1.332292,103.948673
489114,3,7,10,1.331548,103.949283
489115,0,12,12,1.332368,103.948615
489116,15,6,21,1.331607,103.94924
489117,0,1,1,1.33149,103.949326
489118,1,0,1,1.332378,103.948605
489119,1,1,2,1.331372,103.949412
489120,0,1,1,1.331637,103.949216
489121,0,2,2,1.332761,103.948282
489122,1,3,4,1.331785,103.949098
489123,0,3,3,1.331693,103.949152
489124,2,6,8,1.332647,103.948245
489125,0,1,1,1.331666,103.949193
489127,5,0,5,1.331963,103.948956
489128,0,6,6,1.33255,103.948142
489129,6,0,6,1.332022,103.948909
489130,4,0,4,1.332504,103.948091
489131,6,0,6,1.332081,103.948862
489132,0,22,22,1.332458,103.94804
489133,28,23,51,1.332141,103.948814
489134,4,2,6,1.332423,103.947989
489136,27,11,38,1.332378,103.947938
489137,7,0,7,1.332259,103.94872
489138,0,40,40,1.332337,103.947881
489139,0,27,27,1.332319,103.948672
489140,2,65,67,1.332524,103.947765
489141,0,173,173,1.332524,103.947765
489142,0,4,4,1.332378,103.948625
489143,2,2,4,1.332587,103.947889
489144,4,12,16,1.332411,103.948597
489145,2,2,4,1.33269,103.94801
489147,2,51,53,1.33277,103.948118
489149,1,0,1,1.331904,103.949003
489151,12,2,14,1.332705,103.948348
489153,3,3,6,1.332825,103.948249
489154,0,2,2,1.331726,103.949145
489155,0,115,115,1.332986,103.94812
489156,3,133,136,1.333094,103.948034
489176,15,1,16,1.337546,103.955843
489177,3,0,3,1.331844,103.949051
489179,13,0,13,1.337898,103.95568
489180,4,0,4,1.337955,103.955653
489181,9,0,9,1.338016,103.955614
489182,10,12,22,1.337747,103.955876
489183,4,0,4,1.337799,103.955858
489184,7,0,7,1.338179,103.955545
489185,1,0,1,1.332574,103.948459
489186,1,2,3,1.337752,103.95575
489188,4,0,4,1.337996,103.955783
489189,2,20,22,1.338057,103.955766
489190,4,0,4,1.338378,103.955479
489191,2,0,2,1.332879,103.948206
489192,1,0,1,1.338247,103.95552
489193,3,0,3,1.337884,103.955834
489195,2,0,2,1.338425,103.95546
489196,32,0,32,1.338588,103.955391
489197,0,6,6,1.338495,103.955615
489198,0,9,9,1.338519,103.955675
489199,28,0,28,1.338641,103.955368
489202,2,0,2,1.338522,103.955423
489203,2,1,3,1.33818,103.955715
489204,0,2,2,1.338573,103.955812
489206,8,0,8,1.338909,103.954909
489207,0,1,1,1.338127,103.955743
489208,7,0,7,1.338645,103.955754
489209,0,2,2,1.338981,103.955085
489210,0,3,3,1.339008,103.955165
489211,18,0,18,1.339038,103.95506
489212,0,1,1,1.338666,103.955801
489213,7,0,7,1.338607,103.955664
489214,5,8,13,1.338593,103.955626
489215,15,0,15,1.339308,103.955075
489216,2,0,2,1.338627,103.955703
489217,6,5,11,1.339048,103.955407
489218,8,6,14,1.339071,103.955463
489219,1,11,12,1.33971,103.95489
489220,1,0,1,1.339063,103.955132
489221,4,0,4,1.339103,103.955535
489222,0,3,3,1.33901,103.954994
489223,22,1,23,1.339155,103.955634
489224,5,7,12,1.339675,103.954797
489226,35,0,35,1.339215,103.955598
489227,8,2,10,1.339198,103.955552
489228,0,3,3,1.339127,103.95558
489229,1,4,5,1.339633,103.954706
489230,7,1,8,1.339607,103.954647
489231,4,1,5,1.339149,103.955449
489232,76,8,84,1.339117,103.955393
489233,11,0,11,1.339577,103.954588
489234,2,1,3,1.339178,103.955505
489235,0,3,3,1.339643,103.954548
489236,30,2,32,1.339595,103.955247
489237,0,8,8,1.339667,103.954606
489238,1,0,1,1.339693,103.954843
489239,2,4,6,1.339621,103.95531
489240,1,0,1,1.339686,103.954658
489241,2,3,5,1.339708,103.954706
489242,4,4,8,1.339727,103.954752
489243,5,10,15,1.339677,103.955416
489244,2,0,2,1.339375,103.955034
489245,57,6,63,1.339747,103.954799
489246,2,6,8,1.339767,103.954849
489247,11,4,15,1.339777,103.95545
489248,4,0,4,1.33976,103.955417
489249,0,6,6,1.339746,103.955389
489250,0,4,4,1.339731,103.955359
489251,4,11,15,1.339717,103.955329
489252,21,5,26,1.339701,103.955267
489253,0,7,7,1.33968,103.955223
489255,0,10,10,1.337226,103.955705
489256,0,5,5,1.337193,103.955642
489257,23,0,23,1.337108,103.955219
489258,5,3,8,1.337165,103.955572
489259,2,3,5,1.337126,103.955504
489260,0,33,33,1.33702,103.954954
489261,2,1,3,1.339568,103.955192
489262,5,0,5,1.336998,103.954883
489263,0,1,1,1.339647,103.95536
489264,0,2,2,1.339701,103.955457
489265,5,2,7,1.336849,103.954582
489266,5,1,6,1.336818,103.954504
489267,0,6,6,1.3367,103.954573
489268,2,0,2,1.336906,103.954702
489269,2,10,12,1.336735,103.954302
489270,1,0,1,1.336946,103.954768
489271,11,3,14,1.336578,103.953862
489272,0,1,1,1.336459,103.954034
489273,2,2,4,1.336482,103.953641
489274,3,1,4,1.336447,103.953563
489275,30,4,34,1.336397,103.953444
489276,0,20,20,1.336369,103.953376
489277,9,5,14,1.336206,103.953141
489278,26,1,27,1.33618,103.953053
489279,3,7,10,1.33614,103.952965
489280,140,3,143,1.336015,103.952945
489281,2,0,2,1.336774,103.95439
489282,0,2,2,1.33611,103.952859
489283,2,8,10,1.336062,103.952744
489284,1,0,1,1.336534,103.953743
489285,0,10,10,1.336018,103.952643
489286,4,2,6,1.335868,103.952637
489287,17,4,21,1.335894,103.952432
489288,9,0,9,1.335811,103.952469
489289,27,245,272,1.335876,103.952392
489297,2,81,83,1.335737,103.952253
489298,1,3,4,1.336319,103.953716
489299,23,1,24,1.336292,103.953632
489300,8,5,13,1.336262,103.953554
489301,1,2,3,1.337088,103.955428
489302,50,4,54,1.336201,103.953377
489303,21,0,21,1.336172,103.953319
489304,14,0,14,1.33897,103.954878
489305,3,0,3,1.336228,103.953489
489306,0,361,361,1.335711,103.952178
489308,1,2,3,1.338989,103.954931
489309,5,2,7,1.336745,103.954684
489310,1,3,4,1.335904,103.952732
489311,3,3,6,1.337253,103.955515
489312,1,8,9,1.337217,103.95544
489314,1,5,6,1.337143,103.955303
489315,0,40,40,1.337081,103.955162
489316,13,5,18,1.336131,103.953219
489317,3,24,27,1.330932,103.944069
489318,25,7,32,1.331407,103.94418
489319,4,1,5,1.330966,103.944057
489320,0,5,5,1.331499,103.944217
489323,0,1,1,1.335935,103.952782
489324,5,1,6,1.331634,103.944289
489325,1,1,2,1.335969,103.952855
489326,8,0,8,1.331697,103.944337
489328,0,1,1,1.331075,103.94404
489330,1,0,1,1.331735,103.944383
489331,0,6,6,1.331349,103.944039
489332,8,0,8,1.331832,103.944489
489333,7,0,7,1.331403,103.944039
489334,1,0,1,1.331773,103.944423
489336,13,0,13,1.331544,103.944044
489337,0,3,3,1.336779,103.954759
489340,3,3,6,1.33184,103.944201
489341,1,0,1,1.331874,103.944544
489342,8,14,22,1.331949,103.944298
489343,0,2,2,1.331138,103.944038
489344,2,3,5,1.331453,103.944191
489363,0,3,3,1.331607,103.944067
489364,1,36,37,1.339669,103.953907
489365,0,1,1,1.331886,103.944246
489366,1,3,4,1.340198,103.95396
489367,1,0,1,1.34024,103.954007
489368,4,0,4,1.34022,103.954007
489369,1,2,3,1.340218,103.95396
489370,1,1,2,1.332006,103.944354
489372,14,6,20,1.340329,103.95419
489373,1,0,1,1.340282,103.954101
489374,3,0,3,1.340329,103.95417
489375,15,5,20,1.340591,103.954277
489376,3,0,3,1.34043,103.954233
489378,7,0,7,1.340591,103.954297
489380,1,0,1,1.340531,103.954256
489381,84,7,91,1.34076,103.954613
489382,2,0,2,1.340262,103.954101
489383,0,3,3,1.340531,103.954276
489384,1,0,1,1.340657,103.954416
489385,0,1,1,1.34074,103.954613
489386,1,34,35,1.340781,103.954712
489387,13,1,14,1.340883,103.954909
489389,5,10,15,1.340894,103.954948
489390,10,4,14,1.340863,103.954909
489391,0,4,4,1.34133,103.954601
489392,1,7,8,1.340884,103.954958
489394,3,0,3,1.340801,103.954712
489396,16,0,16,1.341287,103.954454
489402,1,0,1,1.340842,103.95481
489403,1,3,4,1.341083,103.953985
489404,1,2,3,1.341321,103.954532
489407,0,5,5,1.340947,103.953673
489408,7,0,7,1.341093,103.954027
489409,2,7,9,1.340923,103.953605
489410,1,0,1,1.34119,103.954252
489411,1,0,1,1.34106,103.953952
489412,2,0,2,1.340698,103.954515
489416,59,10,69,1.339668,103.953906
489417,13,4,17,1.339668,103.953906
489418,218,6,224,1.339668,103.953906
489419,1,1,2,1.340995,103.953802
489420,2,0,2,1.340198,103.95396
489435,1,0,1,1.341027,103.953877
489436,0,14,14,1.34026,103.953892
489437,5,1,6,1.340308,103.953852
489438,18,0,18,1.340332,103.953861
489439,1,2,3,1.341158,103.954177
489440,1,10,11,1.340477,103.9538
489441,4,1,5,1.34055,103.953749
489442,16,1,17,1.340623,103.953738
489443,1,2,3,1.340429,103.9538
489444,1,3,4,1.340768,103.953677
489445,4,1,5,1.340792,103.953646
489446,1,52,53,1.340913,103.953615
489447,0,1,1,1.340248,103.953877
489448,6,1,7,1.340913,103.953595
489449,3,0,3,1.340671,103.953698
489450,6,0,6,1.341089,103.953516
489471,6,2,8,1.337071,103.955068
489472,10,0,10,1.337151,103.955046
489473,10,0,10,1.337151,103.955046
489474,65,29,94,1.337054,103.955056
489475,2,14,16,1.337053,103.955055
489476,2,0,2,1.340198,103.95396
489479,56,3,59,1.337673,103.95445
489480,122,29,151,1.337358,103.95494
489481,2,0,2,1.337133,103.955021
489482,0,10,10,1.33755,103.954855
489483,2,5,7,1.33794,103.954342
489484,37,0,37,1.338056,103.954247
489485,5,0,5,1.338127,103.954217
489486,1,0,1,1.340903,103.953605
489488,6,0,6,1.338226,103.954135
489489,194,0,194,1.338125,103.954599
489490,23,0,23,1.338124,103.954598
489491,5,0,5,1.338317,103.954514
489492,0,4,4,1.338316,103.954513
489493,117,1,118,1.338553,103.954032
489494,15,10,25,1.338509,103.954429
489495,0,2,2,1.337785,103.954385
489497,35,0,35,1.3387,103.954343
489498,2,3,5,1.338699,103.954342
489500,30,1,31,1.338892,103.954258
489501,1,2,3,1.341006,103.95355
489502,0,1,1,1.337934,103.954685
489503,1,0,1,1.339012,103.953845
489506,6,5,11,1.339276,103.954088
489507,6,0,6,1.339275,103.954087
489508,1,7,8,1.339426,103.95389
489510,1,0,1,1.339084,103.954173
489511,3,6,9,1.339659,103.953917
489512,8,1,9,1.339658,103.953916
489513,6,1,7,1.339841,103.95418
489514,24,3,27,1.339869,103.954257
489516,0,1,1,1.339466,103.954001
489517,1,0,1,1.340082,103.954634
489518,36,0,36,1.340122,103.954723
489519,5,0,5,1.340141,103.95478
489522,3,0,3,1.338891,103.954257
489525,1,3,4,1.340248,103.955003
489527,2,0,2,1.338508,103.954428
489528,4,0,4,1.340136,103.955023
489529,3,13,16,1.340298,103.955099
489532,2,10,12,1.340232,103.955258
489533,2,0,2,1.340278,103.955054
489534,5,0,5,1.339658,103.953916
489536,7,2,9,1.339658,103.953916
489537,16,3,19,1.3399,103.954337
489538,14,1,15,1.339927,103.954406
489539,11,2,13,1.339965,103.95449
489540,5,8,13,1.338469,103.954216
489541,2,0,2,1.339658,103.953916
489542,4,1,5,1.339027,103.954178
489544,16,0,16,1.339343,103.954037
489572,7,8,15,1.33673,103.95415
489573,4,4,8,1.33673,103.95415
489574,16,0,16,1.337347,103.953889
489575,48,0,48,1.336853,103.954094
489576,1,0,1,1.340176,103.954626
489577,2,0,2,1.338385,103.954018
489579,0,14,14,1.33735,103.95391
489580,3,0,3,1.340056,103.954827
489581,1,3,4,1.337363,103.95394
489582,6,0,6,1.337347,103.953869
489583,3,4,7,1.337347,103.953869
489584,2,0,2,1.336616,103.954216
489585,5,0,5,1.337389,103.954002
489586,1,0,1,1.336853,103.954094
489587,0,1,1,1.337614,103.953736
489588,14,0,14,1.337415,103.954063
489590,5,3,8,1.337441,103.954125
489591,28,0,28,1.337969,103.953566
489592,50,2,52,1.337968,103.953566
489593,2,0,2,1.337347,103.953869
489594,30,0,30,1.338055,103.95353
489595,5,0,5,1.337474,103.954155
489596,1,0,1,1.337614,103.953735
489597,8,1,9,1.338228,103.953456
489599,5,0,5,1.338392,103.953394
489600,0,14,14,1.337435,103.954063
489601,2,0,2,1.337467,103.954186
489602,119,1,120,1.337409,103.954002
489603,7,1,8,1.33871,103.953213
489604,1,0,1,1.338229,103.953457
489606,0,6,6,1.337357,103.953879
489607,5,0,5,1.338666,103.95311
489608,0,5,5,1.337889,103.953651
489609,0,2,2,1.338429,103.95335
489610,6,0,6,1.337907,103.95369
489611,14,1,15,1.338609,103.952973
489612,15,3,18,1.337942,103.953766
489613,17,0,17,1.33859,103.952915
489615,9,1,10,1.338701,103.953252
489616,8,1,9,1.338011,103.953919
489617,1,1,2,1.338638,103.953042
489618,35,0,35,1.338046,103.953996
489620,25,0,25,1.338049,103.953958
489621,0,1,1,1.337383,103.95394
489623,0,1,1,1.338535,103.953325
489624,4,0,4,1.337996,103.953843
489625,1,4,5,1.338402,103.953384
489626,46,1,47,1.337962,103.953766
489627,13,0,13,1.338919,103.953159
489628,2,0,2,1.338668,103.953266
489630,12,18,30,1.337892,103.953613
489631,2,1,3,1.337337,103.953879
489632,0,4,4,1.338434,103.953484
489634,0,1,1,1.338468,103.953355
489635,22,1,23,1.338561,103.953756
489636,2,0,2,1.337927,103.95369
489637,1,0,1,1.338519,103.953665
489639,6,0,6,1.338553,103.953695
489640,2,0,2,1.338603,103.953846
489641,3,2,5,1.338482,103.953545
489642,8,0,8,1.338447,103.953469
489643,1,4,5,1.338412,103.953394
489644,1,3,4,1.338921,103.953198
489645,0,1,1,1.338605,103.953808
489646,4,0,4,1.338958,103.953287
489647,0,6,6,1.338982,103.953346
489649,30,2,32,1.339031,103.953463
489650,12,1,13,1.339055,103.953522
489651,2,1,3,1.338413,103.953439
489652,2,0,2,1.338518,103.95362
489653,1,0,1,1.338933,103.953228
489654,1,0,1,1.339032,103.953127
489655,11,4,15,1.339146,103.953075
489656,76,0,76,1.338054,103.953529
489677,17,336,353,1.299509,103.837
489695,5,4,9,1.325944,103.95392
489696,2,4,6,1.326125,103.953771
489697,0,1,1,1.339089,103.953101
489698,1,0,1,1.325899,103.953867
489699,0,2,2,1.338976,103.953153
489700,1,1,2,1.325854,103.953813
489701,298,0,298,1.32581,103.95376
489702,8,0,8,1.325991,103.953611
489703,5,7,12,1.325765,103.953706
489704,4,1,5,1.325946,103.953557
489705,16,7,23,1.32572,103.953653
489706,2,0,2,1.326035,103.953664
489726,1,0,1,1.32608,103.953718
489727,2,4,6,1.325674,103.954209
489728,74,0,74,1.325362,103.954143
489730,17,0,17,1.325328,103.954114
489731,31,1,32,1.325571,103.954104
489732,1,0,1,1.325396,103.954173
489733,4,5,9,1.32552,103.954052
489735,3,1,4,1.325469,103.953999
489736,5,0,5,1.325225,103.954025
489737,60,0,60,1.325318,103.953833
489739,1,1,2,1.325901,103.953504
489741,0,1,1,1.325294,103.954084
489742,4,11,15,1.325354,103.95388
489761,5,23,28,1.326647,103.951783
489762,2,4,6,1.326483,103.952147
489763,1,21,22,1.326689,103.951742
489764,1,0,1,1.325089,103.953907
489765,1,30,31,1.32681,103.951652
489766,37,0,37,1.32659,103.952033
489767,2,152,154,1.326851,103.95162
489768,1,1,2,1.325157,103.953966
489769,0,112,112,1.326968,103.95154
489771,8,1,9,1.327019,103.951511
489773,8,1412,1420,1.327106,103.951447
489775,4,44,48,1.327165,103.951408
489776,1,0,1,1.326536,103.952099
489777,12,355,367,1.327433,103.951256
489778,0,1,1,1.326885,103.951869
489779,238,323,561,1.327488,103.951207
489780,0,1,1,1.326919,103.951843
489781,0,229,229,1.327568,103.951156
489782,0,1,1,1.326954,103.951818
489783,9,1,10,1.327625,103.951124
489785,2,150,152,1.327738,103.951078
489787,9,91,100,1.327793,103.951035
489788,0,2,2,1.32665,103.951996
489789,0,16,16,1.32716,103.951652
489790,0,7,7,1.327453,103.95145
489792,11,0,11,1.327547,103.95139
489793,0,1,1,1.326996,103.951783
489794,0,1,1,1.327599,103.951356
489795,26,2,28,1.327719,103.951279
489796,6,10,16,1.327771,103.951245
489797,0,4,4,1.327831,103.95122
489798,0,1,1,1.327659,103.951314
489799,7,2,9,1.326483,103.952147
489818,2,0,2,1.327125,103.951681
489821,0,5,5,1.326858,103.95235
489822,100,0,100,1.326769,103.952721
489823,0,3,3,1.338947,103.953166
489824,2,0,2,1.326666,103.952801
489826,2,0,2,1.32682,103.952681
489827,3,16,19,1.327022,103.952224
489828,2,0,2,1.326872,103.952641
489829,1,3,4,1.327077,103.952181
489830,3,0,3,1.326913,103.952308
489832,1,2,3,1.326974,103.95256
489833,0,1,1,1.326378,103.952114
489834,0,2,2,1.326923,103.952601
489835,8,1,9,1.327242,103.952055
489836,1,3,4,1.327129,103.95244
489837,6,10,16,1.327297,103.952013
489838,7,3,10,1.32718,103.9524
489839,0,2,2,1.327077,103.95248
489840,2,2,4,1.327232,103.95236
489841,1,0,1,1.327187,103.952097
489842,0,13,13,1.327283,103.95232
489843,3,1,4,1.327641,103.951865
489844,26,6,32,1.327662,103.952123
489845,123,0,123,1.327684,103.95183
489847,4,10,14,1.327718,103.951796
489848,1,0,1,1.327615,103.951899
489849,1,2,3,1.327026,103.95252
489850,3,2,5,1.327782,103.952021
489851,2,1,3,1.327752,103.951762
489852,9,0,9,1.327825,103.951986
489853,0,20,20,1.327864,103.951702
489854,12,5,17,1.327868,103.951952
489855,1,0,1,1.327748,103.952055
489856,46,10,56,1.327902,103.951918
489857,34,376,410,1.328005,103.951631
489858,7,1,8,1.327945,103.951884
489859,2,7,9,1.328247,103.952413
489860,17,180,197,1.327997,103.95185
489861,12,3,15,1.328242,103.952323
489862,9,20,29,1.328103,103.95219
489863,1,1,2,1.327572,103.951933
489864,38,3,41,1.328068,103.952224
489865,1,0,1,1.327933,103.951668
489867,1,0,1,1.328098,103.952424
489868,2,6,8,1.328,103.952292
489869,2,1,3,1.327795,103.951736
489870,0,5,5,1.327957,103.952326
489871,0,2,2,1.32819,103.952354
489872,0,1,1,1.328034,103.952474
489873,0,2,2,1.327858,103.952593
489874,7,2,9,1.327862,103.952395
489876,2,8,10,1.327819,103.952429
489877,23,0,23,1.326858,103.953407
489878,1,10,11,1.327785,103.952463
489879,1,2,3,1.327938,103.952528
489880,5,14,19,1.327733,103.952497
489881,8,1,9,1.326773,103.953492
489882,2,3,5,1.327408,103.952684
489885,7,0,7,1.326688,103.953576
489886,1,0,1,1.327905,103.952361
489887,21,1,22,1.326645,103.953618
489888,8,0,8,1.327232,103.952818
489889,8,1,9,1.326603,103.95366
489891,9,0,9,1.326561,103.953702
489892,4,0,4,1.327115,103.952907
489893,2,0,2,1.327779,103.952642
489894,1,0,1,1.327291,103.952773
489895,1,0,1,1.327056,103.952951
489897,12,2,14,1.326433,103.953829
489899,1,0,1,1.326476,103.953787
489900,7,3,10,1.326881,103.953085
489901,11,1,12,1.326348,103.953913
489902,2,0,2,1.326518,103.953745
489905,12,1,13,1.326264,103.953998
489906,0,1,1,1.326391,103.953871
489907,24,0,24,1.326221,103.95404
489908,2,0,2,1.326822,103.953129
489909,78,0,78,1.326179,103.954082
489911,0,1,1,1.326705,103.953218
489912,10,5,15,1.326529,103.953352
489913,3,0,3,1.326815,103.953449
489918,0,1,1,1.326136,103.954124
489919,11,2,13,1.32549,103.954429
489921,6,0,6,1.325455,103.954466
489922,33,0,33,1.325797,103.954462
489923,4,0,4,1.325414,103.954509
489924,5,1,6,1.325755,103.954504
489925,18,0,18,1.325712,103.954546
489926,0,7,7,1.325558,103.954356
489927,3,0,3,1.326094,103.954166
489929,3104,319,3423,1.32824,103.951653
489930,4,5,9,1.32567,103.954588
489931,3,0,3,1.325524,103.954393
489932,12,0,12,1.325585,103.954673
489933,34,0,34,1.325542,103.954715
489934,10,0,10,1.3255,103.954757
489935,0,3,3,1.325627,103.95463
489945,48,4132,4180,1.335798,103.944708
489946,140,650,790,1.338391,103.947656
489947,357,619,976,1.337734,103.948804
489948,95,1080,1175,1.335123,103.949641
489949,144,2068,2212,1.334575,103.949792
489968,39,115,154,1.336547,103.949616
489977,195,1343,1538,1.336436,103.94949
489978,62,87,149,1.336766,103.949887
489979,153,106,259,1.335608,103.950678
489980,99,3632,3731,1.335453,103.950314
498730,27,530,557,1.299509,103.837
498736,397,224,621,1.312778,103.997141
498738,413,314,727,1.31754,103.992979
498740,269,124,393,1.352597,103.970782
498741,115,193,308,1.299509,103.837
498745,663,1102,1765,1.377531,104.002224
498746,1350,866,2216,1.375791,104.002348
498750,45,53,98,1.314871,104.00136
498751,138,882,1020,1.312778,103.997141
498752,16,53,69,1.299509,103.837
498753,30,2,32,1.299509,103.837
498754,9,28,37,1.299509,103.837
498755,5870,33,5903,1.348337,103.97018
498756,359,639,998,1.347766,103.970887
498760,6087,1433,7520,1.363916,104.022181
498761,318,472,790,1.299509,103.837
498765,628,494,1122,1.350071,103.970425
498766,86,2,88,1.352044,103.968344
498770,1837,277,2114,1.353167,103.972889
498771,40,137,177,1.352221,103.969615
498772,1349,350,1699,1.351793,103.972763
498773,551,1,552,1.355248,103.97475
498774,773,50,823,1.353376,103.973971
498775,16,298,314,1.350279,103.967059
498778,27,3,30,1.349005,103.968522
498780,5869,396,6265,1.348924,103.969833
498781,2080,643,2723,1.378308,104.001036
498782,1095,249,1344,1.377721,104.001359
498783,3711,752,4463,1.379835,104.001682
498784,1648,60,1708,1.381297,104.001012
498785,1060,69,1129,1.316788,104.00558
498786,110,449,559,1.352765,103.974292
498787,154,1442,1596,1.37568,104.002665
498788,5641,1097,6738,1.348841,103.969345
498789,558,169,727,1.353421,103.968386
498790,3147,44,3191,1.34731,103.969575
498791,81,126,207,1.352088,103.971864
498792,1843,393,2236,1.374838,104.001512
498793,4070,165,4235,1.375446,104.003223
498794,106,24,130,1.316605,104.020485
498795,151,335,486,1.351648,103.970676
498796,339,107,446,1.353027,103.971877
498797,54,8,62,1.353246,103.970942
498798,1581,2719,4300,1.378424,104.001813
498799,43,100,143,1.314548,103.998814
498800,196,2721,2917,1.315713,104.01538
498801,1792,305,2097,1.375922,104.001426
498802,743,426,1169,1.351117,103.968797
498803,1148,163,1311,1.376738,104.0025
498804,56,396,452,1.350574,103.966835
498805,5714,56,5770,1.316759,104.021764
498806,33,890,923,1.381435,104.000346
498807,100,727,827,1.374167,104.003844
498808,252,202,454,1.350514,103.966617
498809,26,1,27,1.351148,103.974199
498810,268,2,270,1.351521,103.974419
498811,580,1,581,1.352329,103.974252
498812,454,130,584,1.352504,103.974337
498813,14,14,28,1.352699,103.975188
498814,201,63,264,1.353101,103.974548
498815,1536,278,1814,1.377125,104.001404
498816,602,321,923,1.352495,103.967471
498817,205,1871,2076,1.347041,103.970651
498818,99,0,99,1.326736,104.003572
498819,10,35,45,1.326742,104.003601
498820,5,0,5,1.326768,104.003569
498822,3,0,3,1.325331,103.954727
498823,175,167,342,1.350856,103.969484
498824,9,1,10,1.352825,103.96841
498825,6,196,202,1.352139,103.967593
498826,22,4531,4553,1.351587,103.967968
498827,1499,95,1594,1.351176,103.966113
498828,187,1472,1659,1.353002,103.967333
498829,13,1317,1330,1.351851,103.967804
498830,15,53,68,1.351817,103.966144
498831,135,0,135,1.351557,103.966288
498832,6,243,249,1.35093,103.96655
498833,14368,36486,50854,1.314525,103.988688
498834,510,3,513,1.359216,103.973729
498836,2934,1500,4434,1.360792,103.973122
498837,2,0,2,1.326646,103.953263
498838,9,2,11,1.359918,103.976048
498839,606,729,1335,1.360235,103.974917
498840,432,56,488,1.359415,103.974821
498841,823,55,878,1.358954,103.974698
498842,90,31,121,1.35724,103.975091
498843,129,125,254,1.357242,103.975085
498844,272,25,297,1.357214,103.975124
498845,7,18,25,1.360159,103.975499
498846,0,11,11,1.360159,103.975499
498899,5,6,11,1.359788,103.975615
498900,3,8,11,1.359705,103.975593
498901,4,28,32,1.359665,103.975571
498902,2,17,19,1.359558,103.975547
498905,6,29,35,1.358963,103.975235
498906,0,13,13,1.35895,103.975312
498907,1,4,5,1.359798,103.975802
498911,0,5,5,1.359516,103.975739
498913,0,12,12,1.359258,103.975935
498917,0,2,2,1.359918,103.976048
498918,4,2,6,1.359258,103.975935
498919,8,3,11,1.359258,103.975935
498921,3,4,7,1.358622,103.975891
498923,40,1,41,1.359192,103.97561
498926,0,2,2,1.359258,103.975935
498928,1,3,4,1.359192,103.97561
498929,1,2,3,1.326761,104.003568
498930,6,8,14,1.35925,103.97553
498931,5,4,9,1.359169,103.975513
498932,2,4,6,1.359192,103.97561
498933,2,12,14,1.359192,103.97561
498934,0,13,13,1.359215,103.975451
498935,0,33,33,1.359062,103.975483
498936,2,1,3,1.359437,103.975717
498937,22,0,22,1.359192,103.97561
498938,3,5,8,1.359192,103.97561
498939,2,0,2,1.359192,103.97561
498940,1,0,1,1.325882,103.954377
498941,12,1,13,1.359258,103.975935
498942,7,1,8,1.299509,103.837
498985,1546,632,2178,1.387773,103.999061
498988,44,5,49,1.391193,103.989835
498989,28,22,50,1.391505,103.989036
498990,3,42,45,1.391407,103.989666
498991,225,2167,2392,1.391593,103.989133
498992,15,4,19,1.299509,103.837
499171,20,34,54,1.390199,103.987686
499172,1007,49,1056,1.390748,103.987461
499173,133,2335,2468,1.390199,103.987686
499235,1,3,4,1.353892,103.969157
499236,13,457,470,1.35406,103.969044
499237,15,0,15,1.353811,103.969189
499238,0,2,2,1.359192,103.97561
499239,0,3,3,1.359192,103.97561
499240,5,1,6,1.353568,103.969345
499241,5,0,5,1.353595,103.969492
499242,88,0,88,1.353595,103.969568
499243,55,0,55,1.353794,103.969085
499244,1,2,3,1.353556,103.969259
499247,5,0,5,1.353483,103.969647
499248,5,0,5,1.353641,103.969111
499249,0,4,4,1.35302,103.969397
499251,6,0,6,1.353062,103.969662
499252,0,5,5,1.353077,103.969762
499254,1,0,1,1.299509,103.837
499258,13,0,13,1.353479,103.969142
499259,4,0,4,1.353379,103.969169
499260,0,1,1,1.35293,103.969329
499261,2,0,2,1.353892,103.969062
499263,0,3,3,1.353431,103.969308
499264,10,1,11,1.352749,103.969253
499265,2,3,5,1.352962,103.969585
499266,17,0,17,1.352973,103.969666
499267,19,1,20,1.352984,103.969762
499328,12,0,12,1.354169,103.969192
499483,0,8,8,1.383211,103.988244
499547,284,66,350,1.366246,103.976029
499548,10,14,24,1.365571,103.978768
499549,191,13,204,1.365015,103.980316
499550,276,284,560,1.36532,103.981175
499611,3993,262,4255,1.350607,103.972323
499612,1225,1737,2962,1.344017,103.97024
499613,73,1418,1491,1.350506,103.96841
499614,165,275,440,1.345746,103.971535
499615,189,592,781,1.350195,103.968807
499616,106,2,108,1.350197,103.967893
499617,5,2,7,1.349929,103.967491
499618,24,9,33,1.349602,103.967026
499619,5,575,580,1.349198,103.966589
499620,316,5,321,1.347326,103.972144
499621,10,0,10,1.347786,103.972281
499622,92,112,204,1.346936,103.971268
499623,146,26,172,1.347273,103.971594
499624,15,3,18,1.34598,103.973088
499625,39,24,63,1.347788,103.971845
499626,713,449,1162,1.348351,103.971801
499627,0,171,171,1.34807,103.970646
499628,102,18,120,1.348391,103.971473
499629,151,1,152,1.348185,103.970793
499630,36,1,37,1.349119,103.971432
499631,87,8,95,1.348251,103.970902
499632,42,50,92,1.348939,103.972372
499633,1133,88,1221,1.348351,103.971012
499637,368,336,704,1.349657,103.966571
499638,1324,2683,4007,1.345612,103.969589
499639,1281,51,1332,1.34842,103.972538
499640,14,151,165,1.348001,103.967138
499641,2169,1042,3211,1.347033,103.96769
499642,6267,148,6415,1.346459,103.968747
499643,853,58,911,1.344973,103.971348
499675,2765,641,3406,1.373058,104.008
499676,203,855,1058,1.373093,104.00553
499677,12,116,128,1.299509,103.837
499739,4641,1349,5990,1.317675,103.974319
499740,1186,1187,2373,1.316136,103.977512
499741,70,512,582,1.316933,103.978777
499803,2260,1166,3426,1.328994,103.979489
499804,14,83,97,1.376168,104.003389
499805,50,582,632,1.326002,103.974733
499867,1029,439,1468,1.387992,103.989875
499931,71,451,522,1.3683,103.979106
499932,153,322,475,1.369022,103.979107
499933,19,34,53,1.367892,103.979482
499939,12,2,14,1.368256,103.980567
499940,2,5,7,1.367947,103.981332
499941,43,0,43,1.36794,103.980888
499942,24,12,36,1.367373,103.981304
499943,203,141,344,1.367524,103.98005
500001,531,237,768,1.388386,103.987522
500002,54,17,71,1.389167,103.988273
500003,48,86,134,1.389652,103.988118
500004,1065,19320,20385,1.388892,103.987688
500005,469,2046,2515,1.389256,103.987189
504749,139,643,782,1.299509,103.837
506816,78,115,193,1.299509,103.837
506817,359,1,360,1.378705,103.969765
506818,198,22,220,1.381335,103.967829
506819,16,0,16,1.299509,103.837
506820,9,21,30,1.299509,103.837
506821,32,0,32,1.299509,103.837
506822,2,0,2,1.353186,103.969183
506823,53,21,74,1.383142,103.97148
506824,108,29,137,1.299509,103.837
506825,124,19,143,1.299509,103.837
506826,31,15,46,1.299509,103.837
506831,8,76,84,1.299509,103.837
506832,14,147,161,1.299509,103.837
506836,2,0,2,1.299509,103.837
506843,0,3,3,1.352847,103.96923
506844,0,4,4,1.299509,103.837
506846,195,12,207,1.299509,103.837
506847,156,68,224,1.299509,103.837
506848,449,12,461,1.35584,103.965835
506849,312,1,313,1.299509,103.837
506850,111,7,118,1.299509,103.837
506851,173,640,813,1.299509,103.837
506856,412,962,1374,1.299509,103.837
506857,100,242,342,1.299509,103.837
506858,179,215,394,1.299509,103.837
506859,361,1476,1837,1.355773,103.965051
506860,581,64,645,1.299509,103.837
506861,318,12,330,1.299509,103.837
506862,113,48,161,1.299509,103.837
506863,311,98,409,1.35584,103.965835
506864,229,192,421,1.356943,103.966399
506865,301,54,355,1.299509,103.837
506866,267,945,1212,1.356811,103.964798
506867,213,1028,1241,1.356811,103.964798
506868,371,62,433,1.299509,103.837
506869,655,501,1156,1.299509,103.837
506870,288,583,871,1.299509,103.837
506871,5,0,5,1.299509,103.837
506873,13,8,21,1.299509,103.837
506875,0,2,2,1.299509,103.837
506876,0,2,2,1.299509,103.837
506878,9,0,9,1.299509,103.837
506881,604,413,1017,1.354955,103.966646
506882,661,50,711,1.354955,103.966646
506883,408,69,477,1.354955,103.966646
506884,535,11,546,1.354955,103.966646
506885,105,16,121,1.354955,103.966646
506886,232,336,568,1.354955,103.966646
506887,1024,13,1037,1.354955,103.966646
506888,164,123,287,1.354955,103.966646
506889,321,257,578,1.354955,103.966646
506890,707,342,1049,1.354955,103.966646
506891,91,1108,1199,1.354448,103.9672
506892,593,122,715,1.356811,103.964798
506893,441,122,563,1.356811,103.964798
506894,139,173,312,1.356811,103.964798
506895,373,14,387,1.357092,103.965149
506901,6,0,6,1.36333,103.97037
506902,5,10,15,1.363396,103.970202
506906,3034,693,3727,1.352892,103.965457
506907,1,0,1,1.353298,103.969182
506908,26,1,27,1.299509,103.837
506911,194,409,603,1.359081,103.966963
506912,314,160,474,1.358917,103.967314
506913,94,254,348,1.358896,103.967655
506914,680,163,843,1.358358,103.967524
506915,268,53,321,1.358586,103.967221
506916,536,49,585,1.358551,103.966905
506917,127,87,214,1.358763,103.966576
506918,332,71,403,1.358114,103.967358
506921,33,276,309,1.379673,103.977826
506926,144,0,144,1.378891,103.961386
506927,36,85,121,1.380125,103.959289
506928,157,0,157,1.379518,103.963035
506929,64,0,64,1.379518,103.963035
506931,31,313,344,1.36576,103.967129
506936,46,4367,4413,1.389496,103.986432
506937,7,416,423,1.386799,103.987273
506938,23,1696,1719,1.386689,103.987276
506939,1,2,3,1.299509,103.837
506940,16,40,56,1.36547,103.974994
506941,407,62,469,1.357288,103.964241
506942,206,462,668,1.357287,103.964224
506943,122,3,125,1.35732,103.96424
506944,570,48,618,1.357293,103.96425
506945,590,145,735,1.357229,103.963549
506946,316,1966,2282,1.357999,103.963696
506947,480,1,481,1.357993,103.963697
506948,282,0,282,1.35797,103.963691
506949,370,0,370,1.357972,103.963666
506950,260,580,840,1.35797,103.9637
506951,449,586,1035,1.357925,103.964656
506952,84,322,406,1.357925,103.964656
506953,8,288,296,1.362791,103.973266
506954,1,2,3,1.386589,103.987273
506955,0,9,9,1.362791,103.973266
506956,158,50,208,1.378815,103.976969
506957,2,4,6,1.362585,103.972742
506958,5,7,12,1.362563,103.972687
506959,1,3,4,1.362945,103.971411
506960,16,0,16,1.38484,103.974286
506961,189,8,197,1.380148,103.963004
506962,12,4,16,1.379938,103.963017
506966,5,0,5,1.360139,103.971124
506967,12,1,13,1.359773,103.972538
506968,540,1268,1808,1.358924,103.969853
506969,11,0,11,1.35673,103.973577
506971,6,0,6,1.35806,103.971359
506977,1,0,1,1.299509,103.837
506978,1,0,1,1.358054,103.971331
506983,16,0,16,1.358049,103.971359
506987,1,0,1,1.35803,103.971329
506989,1,0,1,1.358024,103.971357
506996,156,140,296,1.379571,103.962805
506997,1,8,9,1.391002,103.98057
506999,392,129,521,1.357127,103.967142
507000,582,131,713,1.357003,103.967565
507001,699,85,784,1.356906,103.967878
507002,524,64,588,1.35678,103.968366
507003,64,461,525,1.356714,103.968784
507004,370,135,505,1.356273,103.968649
507005,420,201,621,1.355965,103.968571
507006,283,1702,1985,1.3556,103.968448
507007,555,119,674,1.356024,103.96798
507008,565,19,584,1.356316,103.968059
507009,497,454,951,1.359303,103.965523
507010,571,614,1185,1.35919,103.966144
507011,676,132,808,1.358681,103.965977
507012,351,150,501,1.358662,103.965278
507013,130,678,808,1.359324,103.964725
507014,2,0,2,1.299509,103.837
507015,1,4,5,1.378498,103.958403
507017,1,7,8,1.363483,103.97095
507018,0,5,5,1.363483,103.97095
507020,973,82,1055,1.381335,103.965134
507022,0,5,5,1.391415,103.97633
507024,0,1,1,1.358032,103.971326
507025,3108,6,3114,1.358772,103.963631
507026,943,1085,2028,1.35867,103.962871
507027,644,949,1593,1.359026,103.964585
507028,189,19,208,1.377703,103.976798
507029,81,1350,1431,1.378365,103.956584
507030,2,0,2,1.378465,103.958399
507031,28,1,29,1.36295,103.972913
507032,29,1,30,1.362938,103.97297
507033,5,0,5,1.362924,103.973059
507034,3,0,3,1.362791,103.973266
507035,21,1,22,1.362914,103.973139
507036,5,0,5,1.362899,103.973194
507038,1,0,1,1.390787,103.97589
507039,1,0,1,1.362878,103.973305
507040,11,0,11,1.362858,103.97342
507041,3,23,26,1.362845,103.973478
507043,7,0,7,1.362852,103.971478
507045,1,0,1,1.362871,103.973351
507046,4,1,5,1.362702,103.971648
507047,0,6,6,1.362666,103.971704
507048,0,1,1,1.36276,103.971563
507049,8,0,8,1.362613,103.971799
507050,2,1,3,1.362912,103.973093
507051,3,1,4,1.362541,103.971906
507052,1,0,1,1.362632,103.971757
507053,7,1,8,1.362499,103.972041
507054,67,7,74,1.362484,103.972105
507055,1,13,14,1.362461,103.972175
507056,7,7,14,1.36245,103.972236
507057,0,2,2,1.362956,103.972865
507058,16,2,18,1.362457,103.97239
507059,2,0,2,1.362444,103.97234
507060,0,4,4,1.3625,103.972497
507061,3,16,19,1.362522,103.97256
507062,1,6,7,1.362539,103.972618
507063,3,11,14,1.362411,103.972766
507064,19,13,32,1.362434,103.972812
507065,1,6,7,1.362468,103.972882
507066,3,15,18,1.362486,103.97291
507067,2,14,16,1.362503,103.97295
507068,0,8,8,1.36252,103.972984
507069,2,15,17,1.362543,103.973013
507070,6,13,19,1.362554,103.973054
507071,1,63,64,1.362577,103.973081
507072,60,90,150,1.362583,103.973115
507073,1,79,80,1.362599,103.973153
507074,7,15,22,1.362606,103.973171
507076,100,161,261,1.384586,103.973733
507077,52,15,67,1.384818,103.97421
507078,9,834,843,1.359552,103.968313
507079,419,112,531,1.358954,103.969009
507080,164,4745,4909,1.357898,103.969164
507081,183,629,812,1.357338,103.969042
507082,1005,361,1366,1.357375,103.968288
507083,465,101,566,1.357949,103.968148
507084,203,23,226,1.357811,103.9687
507085,157,48,205,1.358145,103.968807
507086,158,128,286,1.358383,103.968256
507087,980,623,1603,1.367946,103.973559
507088,0,1,1,1.36252,103.971978
507090,8,0,8,1.367958,103.97342
507092,24,1,25,1.367969,103.973431
507094,1,67,68,1.378929,103.95933
507095,1,52,53,1.37899,103.959327
507096,121,0,121,1.360452,103.968845
507097,4,56,60,1.376717,103.976646
507098,83,50,133,1.377478,103.976412
507099,22,79,101,1.375581,103.975434
507100,278,35,313,1.375809,103.975166
507101,223,1857,2080,1.376106,103.974874
507102,319,21,340,1.375663,103.975485
507103,1,620,621,1.376161,103.975019
507104,1,104,105,1.361134,103.967041
507105,2,1,3,1.362585,103.971854
507106,77,33,110,1.360921,103.967234
507108,14,29,43,1.360898,103.96727
507109,2,0,2,1.362478,103.972456
507110,1,6,7,1.360876,103.967306
507111,0,3,3,1.361087,103.967125
507112,2,6,8,1.360853,103.967342
507114,1,1,2,1.360995,103.967257
507115,0,14,14,1.360863,103.967463
507116,2,42,44,1.360807,103.967414
507118,43,4,47,1.360784,103.96745
507119,1,0,1,1.367994,103.973458
507120,4,22,26,1.360761,103.967486
507122,4,0,4,1.360738,103.967522
507123,3,7,10,1.36071,103.967703
507124,0,9,9,1.360715,103.967558
507125,25,0,25,1.360667,103.967787
507126,0,23,23,1.360693,103.967594
507127,17,10,27,1.360623,103.967863
507128,70,2,72,1.36067,103.96763
507129,5,0,5,1.360597,103.967905
507130,1,123,124,1.360647,103.967666
507132,153,6,159,1.360624,103.967701
507134,0,11,11,1.360601,103.967737
507135,0,1,1,1.360785,103.96758
507136,1,0,1,1.360517,103.96803
507137,5,0,5,1.360491,103.968071
507138,0,22,22,1.360555,103.967809
507139,0,1,1,1.360578,103.967773
507140,11,2,13,1.360533,103.967845
507142,0,100,100,1.360445,103.96814
507143,5,2,7,1.360426,103.968166
507144,0,4,4,1.360407,103.968193
507145,2,0,2,1.36083,103.967378
507146,8,85,93,1.360368,103.968246
507147,0,12,12,1.360349,103.968273
507148,1,1,2,1.360387,103.96822
507149,7,0,7,1.360311,103.968327
507150,0,6,6,1.360419,103.968016
507151,1,1,2,1.360464,103.967953
507152,3,0,3,1.360951,103.967319
507153,33,0,33,1.360234,103.968433
507154,2,1,3,1.360373,103.968079
507155,7,14,21,1.360186,103.968482
507156,5,8,13,1.360283,103.968205
507157,2,3,5,1.360158,103.968504
507159,4,1,5,1.360072,103.968538
507160,4,1,5,1.360215,103.9683
507161,10,4,14,1.360039,103.968544
507162,3,3,6,1.360158,103.968344
507163,4,2,6,1.359974,103.968556
507164,1,8,9,1.360072,103.968378
507165,2,5,7,1.359909,103.968568
507166,0,3,3,1.360328,103.968142
507167,0,2,2,1.360262,103.968385
507168,14,3,17,1.359924,103.968405
507169,4,5,9,1.359778,103.968591
507170,2,0,2,1.359844,103.968579
507172,2,16,18,1.359584,103.968632
507173,6,25,31,1.359517,103.968639
507174,4,0,4,1.359452,103.96865
507176,1,1,2,1.359713,103.968603
507177,3,651,654,1.359256,103.968686
507178,1,25,26,1.363613,103.967362
507179,0,1,1,1.360473,103.96809
507180,0,1,1,1.363648,103.967327
507181,0,1,1,1.36369,103.967286
507182,0,2,2,1.359321,103.968674
507184,1,0,1,1.363737,103.967239
507185,3,9,12,1.363912,103.967059
507186,1,0,1,1.363867,103.967106
507187,0,1,1,1.363959,103.967014
507189,3,1,4,1.364094,103.966875
507191,13,2,15,1.364183,103.966784
507192,4,0,4,1.36423,103.966738
507194,1,9,10,1.364296,103.966669
507196,4,1,5,1.364441,103.966751
507197,1,0,1,1.364005,103.966967
507198,14,3,17,1.364357,103.966671
507199,4,0,4,1.364336,103.966651
507200,19,0,19,1.363603,103.967354
507201,0,8,8,1.364315,103.966631
507202,6,2,8,1.363672,103.967283
507204,2,0,2,1.363777,103.967198
507205,0,4,4,1.364252,103.96657
507206,19,2,21,1.363833,103.96712
507207,1,0,1,1.364399,103.966711
507208,1,0,1,1.364209,103.966529
507210,7,4,11,1.363994,103.966957
507211,15,0,15,1.364125,103.966447
507212,57,0,57,1.364074,103.966876
507213,8,2,10,1.364083,103.966406
507214,4,0,4,1.364154,103.966794
507215,1,0,1,1.363913,103.967039
507216,0,12,12,1.364235,103.966713
507217,0,4,4,1.363998,103.966325
507218,0,13,13,1.364275,103.966672
507219,2,0,2,1.363753,103.967202
507220,119,2,121,1.364305,103.966641
507221,4,1,5,1.363914,103.966243
507223,1,1,2,1.363956,103.966284
507224,1,1,2,1.363872,103.966202
507225,19,7,26,1.363829,103.966161
507226,1,0,1,1.364041,103.966366
507228,1,1,2,1.364205,103.966545
507230,10,0,10,1.363986,103.966333
507231,1,0,1,1.364132,103.966474
507232,4,1,5,1.363913,103.966262
507233,0,1,1,1.363703,103.966039
507235,2,0,2,1.364059,103.966404
507236,0,1,1,1.363661,103.965998
507237,5,0,5,1.363576,103.965916
507238,1,0,1,1.363767,103.966121
507241,1,2,3,1.359998,103.968391
507242,3,0,3,1.363492,103.965835
507243,1,1,2,1.363618,103.965957
507244,1,3,4,1.363475,103.965839
507245,1,0,1,1.363694,103.96605
507246,5,0,5,1.363402,103.965768
507247,27,0,27,1.363365,103.965712
507249,10,1,11,1.363323,103.965671
507252,0,4,4,1.363183,103.965556
507253,168,4,172,1.363238,103.965589
507257,59,3,62,1.363154,103.965508
507258,70,2,72,1.362954,103.965334
507259,32,0,32,1.363112,103.965467
507261,1,0,1,1.363407,103.965753
507263,30,0,30,1.363027,103.965385
507264,5,0,5,1.362901,103.965073
507265,3,11,14,1.362985,103.965344
507266,6,0,6,1.363049,103.964936
507268,2,3,5,1.363123,103.964867
507269,6,2,8,1.362931,103.965283
507270,29,21,50,1.362401,103.965164
507271,2,2,4,1.362416,103.965214
507272,0,1,1,1.36307,103.965426
507273,0,1,1,1.362441,103.965273
507274,35,13,48,1.362491,103.965392
507275,16,2,18,1.362503,103.965422
507276,0,3,3,1.363548,103.965909
507277,0,4,4,1.362544,103.965546
507278,6,13,19,1.362574,103.965599
507279,0,3,3,1.362524,103.965484
507280,0,25,25,1.362634,103.965705
507281,37,3,40,1.362664,103.965758
507282,0,23,23,1.362694,103.965811
507283,2,2,4,1.362725,103.965864
507284,4,12,16,1.362755,103.965917
507285,1,0,1,1.362466,103.965333
507286,0,9,9,1.362815,103.966023
507287,7,0,7,1.362845,103.966076
507288,36,12,48,1.362875,103.966129
507289,1,5,6,1.362905,103.966182
507290,0,5,5,1.362935,103.966235
507291,15,7,22,1.362965,103.966288
507292,2,3,5,1.362995,103.966341
507293,0,21,21,1.363025,103.966394
507294,132,2,134,1.363055,103.966447
507295,1,4,5,1.363086,103.9665
507296,0,2,2,1.36345,103.965794
507297,0,10,10,1.363146,103.966606
507298,2,8,10,1.363176,103.966659
507299,0,5,5,1.363206,103.966712
507300,0,13,13,1.363236,103.966765
507301,39,4,43,1.363266,103.966818
507302,0,17,17,1.363296,103.966871
507303,1,4,5,1.363326,103.966924
507304,0,16,16,1.363356,103.966977
507305,3,4,7,1.363386,103.96703
507306,1,17,18,1.363417,103.967083
507307,5,5,10,1.363447,103.967136
507308,21,28,49,1.363477,103.967189
507309,4,27,31,1.363507,103.967242
507310,1,48,49,1.363537,103.967295
507311,3,16,19,1.363567,103.967348
507312,7,17,24,1.363582,103.967375
507313,1,1,2,1.363116,103.966553
507314,0,16,16,1.363612,103.967463
507315,4,1,5,1.363633,103.967518
507316,0,117,117,1.363649,103.96757
507317,6,3,9,1.363669,103.967618
507318,8,33,41,1.363691,103.967671
507319,1,39,40,1.36371,103.967727
507320,2,20,22,1.363728,103.967784
507321,0,2,2,1.363592,103.967414
507322,15,6,21,1.363775,103.967874
507323,17,8,25,1.363821,103.967903
507324,0,2,2,1.363753,103.967827
507325,2,13,15,1.363905,103.967921
507326,3,33,36,1.363942,103.967899
507327,3,17,20,1.364088,103.967725
507328,3,11,14,1.364244,103.96754
507329,0,31,31,1.364117,103.967992
507330,0,3,3,1.362604,103.965652
507331,1,20,21,1.364145,103.967898
507332,1,2,3,1.364133,103.967936
507333,1,8,9,1.364235,103.967839
507334,2,2,4,1.364263,103.967763
507335,0,11,11,1.364314,103.967724
507336,0,3,3,1.364205,103.967877
507337,0,12,12,1.362411,103.965154
507338,105,32,137,1.364418,103.967665
507339,94,0,94,1.362439,103.965221
507340,2,13,15,1.364443,103.967578
507341,16,0,16,1.362467,103.965288
507342,13,211,224,1.364469,103.967579
507343,1,1,2,1.363858,103.967915
507344,4,0,4,1.364517,103.967509
507345,1,4,5,1.362523,103.965422
507346,2,155,157,1.364544,103.967507
507347,2,0,2,1.362495,103.965355
507348,0,5,5,1.364592,103.96743
507349,0,2,2,1.362533,103.965453
507350,0,93,93,1.36491,103.966868
507352,4,0,4,1.36493,103.966849
507353,6,4,10,1.362613,103.965632
507354,61,195,256,1.364949,103.966829
507356,4,70,74,1.364969,103.966809
507357,4,0,4,1.362678,103.965746
507358,0,211,211,1.364989,103.966789
507359,0,11,11,1.36271,103.965803
507360,1,1,2,1.362554,103.965515
507361,5,0,5,1.362742,103.96586
507362,0,35,35,1.365028,103.96675
507363,1,0,1,1.362785,103.96597
507365,103,2,105,1.362807,103.965975
507366,0,37,37,1.365068,103.96671
507367,1,0,1,1.362775,103.965918
507368,1,10,11,1.365088,103.966691
507369,16,2,18,1.362872,103.966089
507370,1,28,29,1.365107,103.966671
507371,16,0,16,1.362905,103.966146
507372,0,89,89,1.365117,103.966661
507373,0,3,3,1.364339,103.967658
507374,4,557,561,1.365282,103.966768
507376,1,37,38,1.36523,103.966722
507377,5,2,7,1.363002,103.966318
507378,2,2,4,1.365179,103.966677
507380,0,63,63,1.365153,103.966654
507381,7,4,11,1.363067,103.966432
507382,68,1,69,1.365127,103.966631
507383,2,0,2,1.365009,103.96677
507384,1,51,52,1.365083,103.966589
507385,12,5,17,1.363132,103.966546
507388,7,31,38,1.364996,103.966505
507389,0,5,5,1.363197,103.966661
507391,3,0,3,1.362937,103.966203
507392,2,29,31,1.364909,103.966422
507393,1,1,2,1.363099,103.966489
507394,0,9,9,1.364865,103.96638
507395,3,1,4,1.363294,103.966832
507396,0,20,20,1.364822,103.966338
507397,24,5,29,1.363326,103.966889
507398,14,8,22,1.364778,103.966296
507399,3,0,3,1.363229,103.966718
507400,18,22,40,1.364734,103.966254
507401,5,7,12,1.363391,103.967003
507402,2,0,2,1.363261,103.966775
507403,1,0,1,1.36284,103.966032
507404,79,19,98,1.364647,103.96617
507405,10,3,13,1.363456,103.967118
507406,4,8,12,1.364603,103.966128
507407,9,0,9,1.363488,103.967175
507408,0,13,13,1.36456,103.966086
507409,1,3,4,1.363521,103.967232
507410,3,1,4,1.364516,103.966045
507411,1,0,1,1.363424,103.967061
507412,1,19,20,1.364472,103.966003
507413,3,2,5,1.363567,103.967314
507414,3,2,5,1.364429,103.965961
507415,0,13,13,1.363583,103.967345
507416,0,39,39,1.364385,103.965919
507417,0,5,5,1.363953,103.967828
507418,1,7,8,1.364342,103.965877
507419,10,4,14,1.36401,103.967768
507420,2,8,10,1.364298,103.965835
507421,1,0,1,1.363545,103.967281
507422,0,10,10,1.364254,103.965793
507424,0,6,6,1.364211,103.965751
507425,37,0,37,1.364127,103.967626
507427,0,2,2,1.364691,103.966212
507428,5,646,651,1.364123,103.965668
507430,9,8,17,1.36408,103.965626
507431,1,0,1,1.364052,103.96772
507432,2,58,60,1.364036,103.965584
507433,30,1,31,1.364308,103.96744
507434,0,2,2,1.364174,103.967574
507435,1,0,1,1.36426,103.967489
507436,6,32,38,1.363949,103.9655
507437,0,10,10,1.364393,103.967348
507438,0,2,2,1.363992,103.965542
507439,38,0,38,1.36444,103.967303
507440,30,14,44,1.363862,103.965416
507441,0,1,1,1.364349,103.967388
507442,8,2,10,1.363818,103.965374
507443,9,0,9,1.364529,103.967216
507444,1,7,8,1.363774,103.965333
507445,15,2,17,1.364578,103.967175
507446,6,2,8,1.363731,103.965291
507447,8,0,8,1.364627,103.967122
507448,1,17,18,1.363687,103.965249
507449,0,4,4,1.364652,103.967091
507450,2,0,2,1.363905,103.965458
507451,0,1,1,1.364484,103.96726
507452,0,10,10,1.3636,103.965165
507453,4,0,4,1.364747,103.967012
507454,0,4,4,1.363556,103.965123
507455,0,3,3,1.363359,103.966946
507456,28,4,32,1.363512,103.965081
507457,11,0,11,1.364856,103.966903
507458,2,4,6,1.363469,103.965039
507460,26,13,39,1.363425,103.964997
507462,3,29,32,1.363382,103.964956
507463,0,2,2,1.363643,103.965207
507464,6,15,21,1.363338,103.964914
507465,1,0,1,1.364693,103.967066
507466,0,1,1,1.365073,103.966685
507467,4,26,30,1.3651,103.966658
507468,0,13,13,1.363251,103.96483
507469,1,12,13,1.365117,103.966641
507470,0,9,9,1.363229,103.964809
507471,1,0,1,1.363294,103.964872
507472,1,45,46,1.363207,103.964788
507473,12,3,15,1.365029,103.966556
507474,0,2,2,1.365018,103.96674
507475,2,0,2,1.363159,103.964742
507476,4,7,11,1.363112,103.964696
507477,17,66,83,1.36493,103.966462
507478,1,1,2,1.364979,103.966509
507480,95,48,143,1.363017,103.964604
507481,6,1,7,1.364832,103.966367
507482,78,1,79,1.362969,103.964558
507484,1,17,18,1.362922,103.964512
507485,10,2,12,1.364733,103.966273
507486,1,4,5,1.362874,103.964466
507488,18,36,54,1.362826,103.96442
507489,3,1,4,1.364635,103.966178
507490,0,2,2,1.363064,103.96465
507492,11,43,54,1.362731,103.964328
507493,54,2,56,1.364536,103.966084
507494,6,7,13,1.362684,103.964282
507495,56,0,56,1.364487,103.966037
507496,5,36,41,1.362636,103.964236
507497,8,0,8,1.364438,103.965989
507498,8,16,24,1.362589,103.96419
507500,8,33,41,1.362541,103.964144
507501,1,1,2,1.362779,103.964374
507502,9,24,33,1.362493,103.964098
507503,1,0,1,1.365078,103.966604
507504,0,18,18,1.362446,103.964052
507506,0,1,1,1.36429,103.965848
507508,2,38,40,1.362351,103.96396
507509,2,2,4,1.364142,103.965706
507510,1,9,10,1.362327,103.963937
507512,0,66,66,1.362189,103.963889
507513,7,8,15,1.364044,103.965611
507514,0,4,4,1.362189,103.963889
507515,23,0,23,1.363995,103.965564
507516,0,113,113,1.362116,103.963898
507517,0,1,1,1.362398,103.964006
507518,5,0,5,1.362079,103.963902
507520,2,408,410,1.362053,103.963906
507521,0,1,1,1.363945,103.965517
507522,2,2,4,1.36201,103.963736
507523,55,0,55,1.363798,103.965375
507524,2,742,744,1.361968,103.963555
507525,1,2,3,1.364802,103.966957
507526,2,4,6,1.361925,103.963374
507528,12,3470,3482,1.361904,103.963284
507529,10,0,10,1.36365,103.965233
507530,3,1697,1700,1.361863,103.963193
507531,14,0,14,1.363601,103.965186
507532,0,254,254,1.361873,103.963236
507533,0,2,2,1.364339,103.965895
507534,0,115,115,1.361883,103.963278
507535,1,0,1,1.363847,103.965422
507536,3,44,47,1.361893,103.963321
507537,0,3,3,1.363749,103.965328
507538,2,8,10,1.361903,103.963363
507539,16,0,16,1.363404,103.964997
507540,3,24,27,1.361913,103.963406
507541,2,1,3,1.363453,103.965044
507542,9,5,14,1.361923,103.963449
507543,5,1,6,1.363305,103.964903
507544,0,14,14,1.361933,103.963491
507545,5,5,10,1.363256,103.964855
507546,1,7,8,1.361943,103.963534
507547,49,5,54,1.363232,103.964832
507548,1,8,9,1.361952,103.963576
507549,0,1,1,1.363502,103.965092
507550,14,1,15,1.361962,103.963619
507551,17,0,17,1.363109,103.964713
507552,0,18,18,1.361972,103.963661
507553,0,1,1,1.363197,103.964798
507554,4,3,7,1.361982,103.963704
507555,8,0,8,1.362718,103.964335
507556,1,11,12,1.361992,103.963747
507557,0,1,1,1.362914,103.964524
507558,28,0,28,1.362002,103.963789
507560,7,9,16,1.362012,103.963832
507561,1,2,3,1.363355,103.96495
507562,5,13,18,1.362022,103.963874
507563,2,17,19,1.362053,103.963931
507564,0,6,6,1.362027,103.963896
507565,21,1,22,1.362072,103.963986
507566,0,4,4,1.362042,103.963927
507567,34,7,41,1.362092,103.964054
507568,3,14,17,1.362053,103.96399
507569,18,0,18,1.362112,103.964123
507570,5,7,12,1.362074,103.964063
507571,3,1,4,1.362132,103.964192
507572,0,14,14,1.362095,103.964135
507574,3,6,9,1.362116,103.964208
507575,0,3,3,1.362639,103.964483
507576,0,8,8,1.362138,103.964281
507578,3,4,7,1.362159,103.964354
507579,0,13,13,1.362212,103.964467
507580,0,13,13,1.36218,103.964426
507582,0,14,14,1.362201,103.964499
507583,5,4,9,1.362251,103.964604
507584,4,22,26,1.362222,103.964572
507586,1,12,13,1.362243,103.964645
507587,1,7,8,1.362291,103.964742
507588,0,5,5,1.362264,103.964717
507589,3,1,4,1.362311,103.96481
507590,7,11,18,1.362285,103.96479
507591,47,2,49,1.362331,103.964879
507592,1,11,12,1.362307,103.964863
507593,11,0,11,1.362351,103.964948
507594,6,2,8,1.362328,103.964936
507595,1,12,13,1.362371,103.965017
507596,5,6,11,1.362349,103.965008
507598,3,0,3,1.362172,103.964329
507599,0,1,1,1.362523,103.964146
507600,1,10,11,1.36238,103.965118
507601,307,27,334,1.379147,103.97761
507602,9,244,253,1.378708,103.977602
507603,165,29,194,1.37812,103.977461
507604,207,63,270,1.377756,103.977207
507605,235,9,244,1.377431,103.976898
507657,2027,1790,3817,1.354068,103.965799
507658,1236,627,1863,1.369035,103.981058
507661,9,5956,5965,1.358722,103.969437
507662,26,575,601,1.359713,103.969784
507663,33,521,554,1.359948,103.970064
507664,12,240,252,1.36007,103.970108
507665,206,707,913,1.360185,103.970227
507666,24,447,471,1.360395,103.970399
507667,118,442,560,1.360328,103.970375
507668,16,508,524,1.360432,103.97047
507669,4,821,825,1.361198,103.970929
507670,0,53,53,1.361266,103.970908
507671,0,15,15,1.361315,103.970906
507672,1,0,1,1.362401,103.96512
507675,4,483,487,1.361788,103.971569
507676,3,13,16,1.363247,103.974024
507678,0,19,19,1.363983,103.974505
507679,7,39,46,1.364099,103.974547
507680,6,11,17,1.364227,103.974577
507681,0,2,2,1.363552,103.965139
507682,1,14,15,1.364448,103.974648
507684,1,32,33,1.364748,103.974732
507685,7,37,44,1.364805,103.974759
507686,3,48,51,1.36502,103.974823
507687,1,504,505,1.365205,103.974965
507688,4,57,61,1.365366,103.974971
507689,9,34,43,1.365573,103.975025
507690,3,429,432,1.365776,103.975082
507691,1,116,117,1.365937,103.97514
507692,95,501,596,1.366133,103.975229
507694,13,352,365,1.368417,103.977262
507696,30,327,357,1.365254,103.974953
507697,25,93,118,1.363411,103.974192
507699,1,12,13,1.36354,103.974285
507700,0,6,6,1.363564,103.974302
507701,5,79,84,1.363666,103.974333
507702,4,45,49,1.363688,103.974387
507703,48,18,66,1.365072,103.974877
507704,6,3,9,1.365614,103.97504
507705,127,6259,6386,1.353217,103.965281
507706,396,485,881,1.35411,103.964411
507707,1526,116,1642,1.362182,103.974029
507708,4,814,818,1.361675,103.971476
507709,262,4,266,1.357388,103.9697
507714,10,836,846,1.337551,103.958476
507739,17,0,17,1.388755,103.983399
507740,56,0,56,1.389034,103.984038
507741,71,74,145,1.38876,103.982492
507742,69,46,115,1.388618,103.983176
507743,86,34,120,1.388978,103.984236
507744,38,156,194,1.388628,103.983698
507745,0,4,4,1.388866,103.982304
507746,0,8,8,1.388968,103.982172
507759,7,23,30,1.390136,103.978939
507760,42,21,63,1.39072,103.979292
507761,6,0,6,1.390846,103.979181
507763,6,45,51,1.389575,103.978466
507764,9,10,19,1.390615,103.979248
507779,37,1,38,1.36457,103.973435
507780,2,1,3,1.36237,103.965081
507781,22,1,23,1.364679,103.9735
507782,15,0,15,1.364738,103.97329
507783,2,2,4,1.364724,103.97352
507784,8,1,9,1.364885,103.973435
507785,1,0,1,1.361378,103.970924
507786,5,0,5,1.364816,103.973556
507802,1,0,1,1.364766,103.973542
507803,0,1,1,1.364023,103.973023
507804,24,0,24,1.363845,103.972957
507806,67,0,67,1.363689,103.972896
507809,0,6,6,1.363493,103.972859
507810,11,0,11,1.363575,103.972671
507811,2,37,39,1.363717,103.972742
507812,28,0,28,1.36361,103.97259
507813,2,3,5,1.363774,103.972593
507815,3,3,6,1.363831,103.972447
507816,16,0,16,1.363688,103.972286
507817,2,1,3,1.364625,103.973471
507818,1,0,1,1.363896,103.972991
507819,54,0,54,1.363899,103.972225
507820,1,0,1,1.363724,103.972194
507821,5,0,5,1.363932,103.972112
507824,1,1,2,1.36433,103.974619
507825,2,0,2,1.363984,103.972016
507826,16,1,17,1.363919,103.971573
507827,3,3,6,1.364005,103.971835
507829,38,3,41,1.363953,103.971523
507833,1,0,1,1.363761,103.972095
507836,20,2,22,1.363991,103.971251
507837,0,9,9,1.364165,103.971334
507840,9,3,12,1.363919,103.971573
507855,2,0,2,1.363851,103.971839
507859,2,0,2,1.363732,103.97432
507861,12,1,13,1.363783,103.973991
507862,0,7,7,1.364,103.97396
507863,4,0,4,1.363779,103.973794
507865,1,4,5,1.363678,103.973775
507866,14,3,17,1.364149,103.973527
507867,2,1,3,1.36386,103.972315
507868,3,7,10,1.364202,103.973375
507870,1,1,2,1.36379,103.974101
507871,27,0,27,1.363304,103.973666
507872,1,3,4,1.364409,103.972986
507873,3,1,4,1.363322,103.973543
507874,3,1,4,1.364424,103.972818
507875,9,0,9,1.363539,103.973605
507876,21,9,30,1.364472,103.97267
507879,6,0,6,1.363763,103.973701
507880,1,1,2,1.364288,103.973165
507882,52,1,53,1.363941,103.973638
507884,25,0,25,1.363984,103.973521
507885,1,9,10,1.364816,103.971958
507886,1,1,2,1.364714,103.972394
507887,0,1,1,1.364008,103.971327
507888,1,0,1,1.364892,103.971807
507889,69,25,94,1.36494,103.971603
507890,58,1,59,1.36421,103.972935
507891,3,0,3,1.363547,103.973745
507892,1,1,2,1.364057,103.973355
507893,1,0,1,1.364104,103.973214
507894,10,0,10,1.364516,103.972268
507895,4,0,4,1.364589,103.972119
507896,1,0,1,1.364417,103.972505
507898,7,2,9,1.364788,103.971693
507899,0,1,1,1.364648,103.971955
507900,4,10,14,1.364893,103.971428
507901,3,0,3,1.364276,103.972779
507902,1,2,3,1.364694,103.972594
507903,1,0,1,1.364847,103.971551
507904,0,1,1,1.299509,103.837
507916,24,2,26,1.366116,103.974713
507917,2,5,7,1.36585,103.974705
507918,10,5,15,1.365729,103.974718
507919,10,3,13,1.365629,103.974693
507921,15,0,15,1.365518,103.974289
507922,1,0,1,1.299509,103.837
507923,49,0,49,1.365703,103.974603
507924,0,7,7,1.365886,103.974587
507926,1,5,6,1.366247,103.974493
507927,1,2,3,1.299509,103.837
507928,46,5,51,1.366216,103.974321
507929,0,9,9,1.366046,103.974089
507930,7,0,7,1.366097,103.973945
507931,0,1,1,1.365518,103.974289
507934,135,7,142,1.365957,103.973557
507935,14,6,20,1.365904,103.973174
507936,19,0,19,1.365506,103.972827
507939,31,13,44,1.365706,103.972925
507940,4,1,5,1.365396,103.972569
507941,1,0,1,1.366005,103.973345
507943,3,0,3,1.36618,103.974404
507944,12,0,12,1.36532,103.972386
507946,3,0,3,1.365567,103.972647
507947,68,0,68,1.365302,103.97228
507948,2,0,2,1.36436,103.972635
507949,3,0,3,1.365302,103.97228
507950,25,0,25,1.36528,103.972124
507951,8,10,18,1.365449,103.971986
507952,30,2,32,1.36543,103.972132
507953,37,2,39,1.365221,103.971981
507954,3,8,11,1.365412,103.971811
507955,6,5,11,1.364759,103.970875
507956,2,6,8,1.365539,103.971761
507957,1,0,1,1.365614,103.972786
507958,3,1,4,1.365725,103.971683
507959,7,2,9,1.365808,103.971646
507960,109,0,109,1.365883,103.971622
507961,0,2,2,1.365494,103.972304
507962,0,3,3,1.36528,103.972124
507963,45,0,45,1.365305,103.97127
507964,3,7,10,1.365178,103.971346
507965,11,5,16,1.365074,103.971138
507966,3,0,3,1.365533,103.971122
507967,5,1,6,1.365185,103.971185
507968,3,0,3,1.365164,103.971105
507969,11,12,23,1.36538,103.971042
507970,2,0,2,1.365632,103.970989
507974,1,0,1,1.365651,103.971703
507976,0,3,3,1.36528,103.971111
507977,5,0,5,1.365587,103.974546
507978,59,6,65,1.365305,103.970975
507979,18,0,18,1.365478,103.970948
507980,19,0,19,1.365561,103.970883
507981,151,7,158,1.365635,103.970846
507982,5,0,5,1.365484,103.971124
507983,1,0,1,1.364778,103.970614
507984,0,1,1,1.365446,103.974622
507985,1,0,1,1.299509,103.837
507990,6,0,6,1.299509,103.837
507991,2,6,8,1.36481,103.971176
507992,1,1,2,1.365006,103.971063
507994,0,1,1,1.299509,103.837
507995,45,0,45,1.364464,103.970943
507997,3,0,3,1.365587,103.974546
507998,10,2,12,1.364576,103.970498
507999,18,6,24,1.364517,103.970327
508000,6,5,11,1.363976,103.970977
508001,0,3,3,1.364503,103.97067
508002,88,2,90,1.364017,103.970619
508003,8,1,9,1.364048,103.97043
508004,1,0,1,1.36446,103.97107
508007,3,7,10,1.364092,103.970172
508008,0,7,7,1.363873,103.970862
508009,13,0,13,1.363881,103.97076
508010,1,1,2,1.364648,103.971172
508011,3,0,3,1.36399,103.970829
508012,1,0,1,1.364068,103.970276
508013,1,0,1,1.363956,103.970335
508014,3,94,97,1.36356,103.970707
508015,1,4,5,1.363427,103.970642
508017,13,1,14,1.364459,103.971137
508018,3,222,225,1.363389,103.970625
508019,8,0,8,1.299509,103.837
508031,3,2,5,1.364841,103.974699
508032,1,0,1,1.363976,103.970217
508034,1,0,1,1.364856,103.974668
508035,0,1,1,1.364917,103.974492
508037,6,0,6,1.364939,103.974409
508039,76,7,83,1.365004,103.974233
508040,15,0,15,1.365075,103.974347
508041,206,3,209,1.365017,103.974193
508042,6,2,8,1.365136,103.974184
508043,79,0,79,1.36507,103.974059
508044,1,0,1,1.364927,103.974448
508045,379,1,380,1.365113,103.973925
508046,5,0,5,1.365267,103.973877
508047,1,0,1,1.365201,103.974033
508049,10,31,41,1.365268,103.97353
508051,7,1,8,1.365312,103.973334
508052,0,1,1,1.365173,103.973742
508055,1,0,1,1.365461,103.973326
508056,0,2,2,1.363905,103.970638
508057,1,5,6,1.365173,103.973742
508058,21,7,28,1.3651,103.973877
508059,41,3,44,1.365304,103.973395
508060,8,2,10,1.365035,103.974498
508062,1,0,1,1.36543,103.973073
508087,0,3,3,1.363916,103.970486
508120,2,109,111,1.299509,103.837
508143,7,13,20,1.368647,103.976931
508145,1,0,1,1.299509,103.837
508146,1,127,128,1.369968,103.975646
508147,1,1,2,1.365496,103.97293
508148,3,0,3,1.379786,103.984221
508150,31,195,226,1.368862,103.9777
508167,11,0,11,1.370155,103.97823
508182,1,0,1,1.369616,103.97516
508188,2,0,2,1.370112,103.976399
508193,1,0,1,1.373435,103.980566
508194,3,0,3,1.369718,103.976866
508198,1,7,8,1.374123,103.981267
508199,12,375,387,1.374204,103.981357
508200,11,339,350,1.374436,103.981599
508201,0,23,23,1.374565,103.981684
508203,0,1,1,1.373668,103.980814
508212,1,0,1,1.374798,103.981919
508213,0,1,1,1.376044,103.983169
508215,0,1,1,1.376241,103.983398
508216,1,0,1,1.376576,103.983741
508219,0,337,337,1.371908,103.977122
508221,4,281,285,1.371317,103.979184
508222,2,48,50,1.372067,103.978798
508223,2,22,24,1.37234,103.9789
508224,16,10,26,1.372354,103.979927
508226,73,3,76,1.372601,103.98087
508242,3,10,13,1.389685,103.981912
508245,2,4,6,1.389801,103.98192
508246,91,8,99,1.389945,103.981927
508247,1,0,1,1.376716,103.983825
508248,34,231,265,1.39112,103.982224
508250,1,0,1,1.38989,103.982096
508251,2,0,2,1.373535,103.980691
508252,281,0,281,1.390771,103.982263
508253,5,0,5,1.390796,103.982121
508254,0,1,1,1.38989,103.982096
508255,7,0,7,1.390796,103.982121
508256,11,0,11,1.390796,103.982121
508257,16,5,21,1.390265,103.982163
508258,36,3,39,1.390173,103.982126
508259,4,9,13,1.299509,103.837
508260,0,8,8,1.299509,103.837
508487,690,340,1030,1.386547,103.977791
508488,291,28,319,1.386605,103.977753
508502,2632,9010,11642,1.39073,103.986152
508503,855,3240,4095,1.391181,103.985639
508505,147,42,189,1.391988,103.984849
508506,18,298,316,1.391242,103.981646
508507,25,36,61,1.392272,103.979848
508508,1903,150,2053,1.392253,103.979583
508511,5,24,29,1.391842,103.979986
508512,9,17,26,1.391099,103.985185
508513,25,193,218,1.390694,103.979804
508515,18,56,74,1.392173,103.980151
508516,50,52,102,1.389485,103.979202
508517,1,4,5,1.392194,103.978427
508519,0,1,1,1.390796,103.982121
508520,0,3,3,1.373725,103.98084
508522,147,276,423,1.391373,103.982175
508523,17,9,26,1.392361,103.982719
508524,39,3,42,1.392071,103.982134
508525,18,1,19,1.392484,103.982003
508526,51,0,51,1.392373,103.981772
508527,6,0,6,1.392278,103.981459
508528,79,1,80,1.391826,103.983784
508529,418,207,625,1.38899,103.97781
508530,16,10,26,1.299509,103.837
508531,9,1,10,1.299509,103.837
508532,3,33,36,1.362401,103.966189
508533,107,4,111,1.362378,103.966221
508534,10,0,10,1.362341,103.966279
508535,2,4,6,1.362303,103.966337
508537,34,4,38,1.362228,103.966452
508538,3,0,3,1.392166,103.978393
508539,0,5,5,1.362152,103.966568
508540,65,0,65,1.362115,103.966626
508541,25,3,28,1.362077,103.966684
508544,1,0,1,1.392168,103.978429
508545,1,2,3,1.36219,103.96651
508546,1,8,9,1.361927,103.966916
508547,1,0,1,1.361964,103.966858
508548,13,0,13,1.361889,103.966974
508549,0,1,1,1.361876,103.96651
508550,2,7,9,1.361851,103.967031
508551,1,0,1,1.361821,103.966558
508552,15,0,15,1.361814,103.967089
508553,1,0,1,1.361811,103.966604
508554,0,1,1,1.361753,103.966682
508557,0,4,4,1.361293,103.967725
508558,3,4,7,1.361701,103.967263
508559,3,0,3,1.36189,103.966485
508560,10,0,10,1.361743,103.967241
508561,0,1,1,1.361776,103.967147
508562,8,1,9,1.361743,103.967241
508567,5,0,5,1.361191,103.967882
508568,43,0,43,1.361509,103.967556
508569,2,1,3,1.361273,103.967757
508572,28,0,28,1.361406,103.967713
508573,1,0,1,1.361252,103.967788
508574,2,0,2,1.390352,103.982769
508575,1,0,1,1.361129,103.967976
508576,11,0,11,1.361304,103.967869
508577,2,0,2,1.361355,103.967791
508578,4,2,6,1.361258,103.967948
508579,3,0,3,1.36117,103.967913
508580,38,0,38,1.361201,103.968026
508581,2,10,12,1.361149,103.968105
508583,0,2,2,1.361088,103.968039
508584,1,0,1,1.361108,103.968007
508585,3,6,9,1.361024,103.968292
508586,59,18,77,1.360932,103.968442
508587,2,8,10,1.360901,103.968477
508588,2,0,2,1.361047,103.968261
508589,3,2,5,1.360816,103.968596
508590,4,0,4,1.360773,103.968655
508591,36,2,38,1.360731,103.968715
508592,1,0,1,1.360995,103.968315
508593,15,4,19,1.360645,103.968833
508594,5,0,5,1.360624,103.968863
508595,5,4,9,1.360555,103.96894
508596,2,0,2,1.360855,103.968532
508597,0,3,3,1.361067,103.96807
508598,1,2,3,1.360365,103.968876
508599,0,2,2,1.360527,103.968967
508600,3,0,3,1.360452,103.969005
508601,0,2,2,1.360279,103.968897
508602,2,1,3,1.360365,103.969036
508603,0,4,4,1.360106,103.96894
508604,0,1,1,1.360688,103.968774
508605,1,0,1,1.36026,103.969062
508606,1,0,1,1.36002,103.968961
508607,0,5,5,1.359933,103.968982
508608,7,2,9,1.36012,103.969096
508609,1,0,1,1.36019,103.969079
508610,2,5,7,1.36005,103.969114
508612,22,1,23,1.35998,103.969131
508613,0,7,7,1.359674,103.969046
508614,0,2,2,1.360192,103.968919
508615,9,5,14,1.359588,103.969067
508616,67,0,67,1.35984,103.969165
508617,0,11,11,1.359502,103.969089
508618,13,2,15,1.35977,103.969183
508620,6,13,19,1.3597,103.9692
508621,7,0,7,1.359329,103.969131
508622,0,7,7,1.35963,103.969217
508623,0,1,1,1.359847,103.969004
508624,16,2,18,1.35956,103.969234
508626,14,14,28,1.35949,103.969252
508627,1,1066,1067,1.359111,103.969199
508628,10,8,18,1.35942,103.969269
508629,0,3,3,1.36033,103.969045
508630,0,1,1,1.359243,103.969152
508631,0,2,2,1.35991,103.969148
508632,2,40,42,1.35914,103.969338
508633,3,672,675,1.35907,103.969355
508634,2,5,7,1.361047,103.968101
508635,15,0,15,1.361026,103.968133
508636,5,3,8,1.361006,103.968164
508638,15,0,15,1.360965,103.968227
508639,1,2,3,1.35935,103.969286
508640,4,5,9,1.360944,103.968258
508641,18,0,18,1.360891,103.968332
508642,2,2,4,1.360837,103.968406
508643,1,0,1,1.35928,103.969303
508644,1,0,1,1.360784,103.96848
508645,0,1,1,1.360731,103.968555
508646,0,2,2,1.35921,103.969321
508647,3,0,3,1.360864,103.968338
508648,0,3,3,1.360527,103.968807
508649,119,8,127,1.36198,103.9695
508650,100,7,107,1.361961,103.969311
508651,44,2,46,1.361843,103.969357
508652,2,2,4,1.361697,103.968979
508653,0,1,1,1.360677,103.968629
508654,43,0,43,1.361782,103.968917
508655,4,2,6,1.361579,103.969067
508656,4,0,4,1.361856,103.968818
508657,0,3,3,1.360452,103.968845
508659,0,5,5,1.361367,103.968771
508660,228,2,230,1.362003,103.968549
508661,33,0,33,1.361321,103.96872
508662,8,5,13,1.361853,103.968373
508663,2,2,4,1.361658,103.968139
508664,22,0,22,1.361615,103.96824
508665,11,0,11,1.361756,103.968379
508666,3,1,4,1.361842,103.968494
508668,2,8,10,1.361549,103.968906
508669,11,21,32,1.361488,103.968866
508670,0,2,2,1.360624,103.968703
508671,4,3,7,1.361911,103.96926
508672,17,0,17,1.361903,103.96877
508673,6,24,30,1.361255,103.968536
508674,18,2,20,1.361293,103.968683
508675,10,1,11,1.36125,103.96863
508676,1,4,5,1.36189,103.96857
508677,0,2,2,1.361387,103.968696
508678,2,3,5,1.361487,103.968865
508679,1,1,2,1.361487,103.968865
508680,2,2,4,1.299509,103.837
508681,8,0,8,1.299509,103.837
508682,3,0,3,1.361476,103.968925
508686,0,68,68,1.386493,103.981858
508702,24,167,191,1.374423,103.97228
508703,9,47,56,1.374665,103.972552
508704,0,4,4,1.375494,103.97162
508705,240,68,308,1.374941,103.971734
508706,21,7,28,1.375388,103.971075
508707,112,1,113,1.37575,103.971311
508708,179,35,214,1.375036,103.972179
508719,82,1429,1511,1.370724,103.968484
508720,86,677,763,1.371105,103.968856
508721,129,120,249,1.371515,103.969265
508722,216,1242,1458,1.37207,103.969923
508723,543,1017,1560,1.37301,103.970772
508724,1608,15,1623,1.376453,103.972563
508725,11,756,767,1.37621,103.974244
508726,730,735,1465,1.376846,103.974537
508727,1,0,1,1.361711,103.969215
508728,98,148,246,1.378151,103.976207
508729,60,1,61,1.379263,103.976152
508730,368,1526,1894,1.374016,103.973238
508731,123,165,288,1.379421,103.976091
508732,23,1033,1056,1.374674,103.973684
508733,6,0,6,1.37952,103.976019
508734,32,0,32,1.379701,103.975887
508735,20,66,86,1.380002,103.975766
508736,1,0,1,1.377628,103.975758
508737,77,4,81,1.380299,103.975646
508738,29,0,29,1.380504,103.975529
508739,549,3,552,1.380742,103.975311
508740,27,191,218,1.379486,103.976511
508741,4,406,410,1.380247,103.97622
508742,6,92,98,1.380879,103.975245
508743,59,221,280,1.381757,103.975551
508744,18,2,20,1.381001,103.975165
508745,33,45,78,1.381132,103.975646
508746,17,0,17,1.381165,103.975084
508747,443,37,480,1.380719,103.976097
508748,232,100,332,1.381326,103.974989
508749,0,1,1,1.380131,103.975726
508750,19,151,170,1.381743,103.974804
508751,225,8,233,1.382395,103.974889
508752,29,0,29,1.381871,103.974718
508753,1,0,1,1.381448,103.974876
508754,65,99,164,1.383927,103.974311
508755,50,59,109,1.382326,103.974437
508756,69,527,596,1.384275,103.973941
508757,24,46,70,1.382474,103.974379
508758,169,10,179,1.38516,103.973253
508759,14,0,14,1.382602,103.97428
508760,6,115,121,1.385345,103.973064
508761,0,14,14,1.382727,103.974185
508762,187,82,269,1.386132,103.97236
508763,1,13,14,1.382878,103.97411
508764,9,356,365,1.38301,103.97401
508765,170,0,170,1.383192,103.973915
508766,173,142,315,1.38365,103.973721
508767,10,2,12,1.384191,103.973332
508768,912,6,918,1.384761,103.973074
508769,1149,376,1525,1.372343,103.97139
508770,1118,0,1118,1.383286,103.974481
508771,204,595,799,1.374976,103.974628
508772,1,1,2,1.299509,103.837
508773,290,40,330,1.386111,103.971424
508774,470,3848,4318,1.371257,103.969602
508775,541,45,586,1.38198,103.974871
508776,247,1735,1982,1.367887,103.967075
508784,12,157,169,1.379243,103.974162
508785,8,120,128,1.379023,103.974343
508786,0,36,36,1.37934,103.974322
508787,2,3,5,1.379108,103.974506
508788,4,0,4,1.379398,103.974462
508789,6,2,8,1.379191,103.974636
508790,19,1,20,1.379492,103.974629
508791,12,0,12,1.379282,103.974781
508792,3,2,5,1.379552,103.974776
508793,1,0,1,1.382194,103.974543
508794,32,0,32,1.379625,103.974933
508795,1,0,1,1.379345,103.974908
508811,1,63,64,1.379677,103.962725
508812,0,1,1,1.379463,103.975052
508813,0,1,1,1.379733,103.962703
508814,0,1,1,1.379784,103.962698
508815,1,0,1,1.379833,103.962691
508819,0,1,1,1.379884,103.962671
508820,8,106,114,1.380162,103.962594
508836,62,47,109,1.374782,103.969417
508837,40,36,76,1.375146,103.969127
508838,28,31,59,1.374473,103.969169
508839,37,0,37,1.375031,103.968997
508840,7,0,7,1.374143,103.968887
508841,2,9,11,1.374916,103.968891
508842,23,53,76,1.373834,103.968609
508843,1,0,1,1.380107,103.962613
508844,2,0,2,1.383461,103.974348
508845,46,0,46,1.374564,103.968548
508846,116,6,122,1.374297,103.968288
508847,3,0,3,1.374176,103.968164
508849,5,4,9,1.373946,103.967933
508865,5,16,21,1.378976,103.961389
508866,4,28,32,1.379146,103.961602
508867,10,3,13,1.37905,103.961378
508868,4,4,8,1.379209,103.961582
508869,1,3,4,1.379176,103.961338
508870,1,0,1,1.374814,103.968791
508871,2,2,4,1.379251,103.961332
508872,21,0,21,1.379347,103.961543
508873,1,0,1,1.379278,103.96156
508874,3,2,5,1.379421,103.96152
508875,7,1,8,1.379428,103.961292
508876,1,1,2,1.374691,103.96866
508877,0,1,1,1.379354,103.961298
508878,12,261,273,1.379553,103.961497
508879,38,182,220,1.379611,103.961255
508895,43,14,57,1.383251,103.972642
508896,15,0,15,1.383632,103.972995
508897,0,5,5,1.383417,103.972942
508913,337,999,1336,1.370725,103.970831
508914,1101,379,1480,1.37203,103.97235
508915,298,162,460,1.372623,103.969273
508916,946,105,1051,1.372955,103.968803
508917,1039,57,1096,1.37397,103.967259
508918,1231,76,1307,1.375028,103.966551
508919,77,478,555,1.375786,103.966339
508920,43,4,47,1.372269,103.969392
508921,703,175,878,1.374889,103.966319
508922,1,5,6,1.375156,103.965999
508923,72,2589,2661,1.371289,103.970238
508924,40,35,75,1.373129,103.968123
508925,26,6,32,1.373648,103.967608
508926,16,23,39,1.373328,103.968378
508927,618,1326,1944,1.372509,103.968691
508928,42,116,158,1.372819,103.968384
508929,207,28,235,1.374364,103.966851
508930,1,12,13,1.375659,103.965597
508931,55,26,81,1.376181,103.966063
508935,13,172,185,1.373727,103.971363
508936,3,0,3,1.374176,103.968164
508937,8,0,8,1.373954,103.971144
508938,375,46,421,1.374324,103.970091
508939,37,57,94,1.374084,103.97102
508940,3,1,4,1.374349,103.970781
508941,1,14,15,1.374581,103.970542
508942,18,10,28,1.374736,103.970422
508943,1,38,39,1.374967,103.970014
508944,143,43,186,1.376075,103.968231
508945,2,9,11,1.376187,103.967748
508946,36,2,38,1.37592,103.968078
508948,63,35,98,1.375714,103.967873
508949,830,6,836,1.374158,103.965869
508950,8,45,53,1.375593,103.967753
508951,67,0,67,1.375482,103.967642
508952,25,4,29,1.375212,103.967384
508953,15,0,15,1.375049,103.967235
508954,91,109,200,1.374934,103.967127
508955,17,17,34,1.37485,103.967033
508956,103,145,248,1.373755,103.966287
508957,88,0,88,1.373272,103.965974
508958,187,9965,10152,1.370538,103.967971
508959,84,5,89,1.376651,103.96723
508960,135,7,142,1.373819,103.96571
508961,67,225,292,1.373388,103.96547
508962,270,16,286,1.372971,103.965261
508963,0,53,53,1.372745,103.965221
508964,97,0,97,1.375792,103.967246
508965,2,587,589,1.373846,103.971245
508966,32,11,43,1.374478,103.97067
508967,292,284,576,1.372458,103.965879
508968,397,1,398,1.371742,103.966566
508969,73,3821,3894,1.371489,103.967722
508970,607,99,706,1.377257,103.966661
508971,77,293,370,1.370264,103.967668
508975,2,93,95,1.377532,103.975095
508976,528,149,677,1.377744,103.975012
508977,3,233,236,1.3776,103.975431
508978,1,0,1,1.379565,103.96126
508979,90,1,91,1.378263,103.974621
508980,126,1000,1126,1.380982,103.973312
508981,10,389,399,1.38154,103.972747
508982,9,1,10,1.381836,103.972647
508983,9,1185,1194,1.381995,103.972475
508984,2599,254,2853,1.382257,103.972427
508985,1065,19,1084,1.382646,103.970805
508986,53,16,69,1.382985,103.971288
508987,47,658,705,1.382721,103.972069
508988,5302,514,5816,1.38403,103.970452
508989,110,0,110,1.383142,103.97148
508990,9,260,269,1.383302,103.971863
508991,4,22,26,1.383762,103.971596
508992,79,255,334,1.384583,103.971591
508993,34,2,36,1.38503,103.971933
508994,23,302,325,1.385311,103.972269
508996,1,0,1,1.378037,103.974712
508997,0,2,2,1.37949,103.961508
509002,56,0,56,1.380279,103.968198
509005,15,7,22,1.380231,103.968398
509007,1,5,6,1.380854,103.968082
509010,3057,551,3608,1.380404,103.973394
509011,156,1,157,1.381283,103.972948
509012,2051,0,2051,1.385044,103.971584
509013,121,3,124,1.384485,103.970494
509014,39,44,83,1.384258,103.971015
509015,661,36,697,1.384578,103.970046
509016,861,245,1106,1.379958,103.973574
509017,213,19,232,1.379646,103.972939
509018,73,39,112,1.299509,103.837
509019,200,19,219,1.380365,103.970442
509020,99,12,111,1.38403,103.970452
509022,124,4,128,1.299509,103.837
509023,295,16,311,1.383142,103.97148
509024,7,1,8,1.299509,103.837
509025,18,3,21,1.378133,103.958504
509026,165,14,179,1.378617,103.957872
509027,4,42,46,1.37802,103.957363
509028,8,22,30,1.378001,103.957412
509029,7,0,7,1.377965,103.957511
509031,40,37,77,1.377895,103.957721
509032,15,29,44,1.377893,103.957811
509033,0,10,10,1.377913,103.957874
509034,17,41,58,1.377933,103.957937
509035,10,8,18,1.377973,103.958063
509036,4,5,9,1.378013,103.958189
509037,25,159,184,1.378053,103.958315
509038,15,1,16,1.378093,103.958441
509039,8,11,19,1.377754,103.958089
509040,12,3,15,1.377753,103.958157
509041,15,23,38,1.37787,103.958182
509042,19,6,25,1.377851,103.958235
509043,7,96,103,1.378116,103.958802
509045,1,5,6,1.378115,103.958801
509046,7,1,8,1.378115,103.958801
509047,0,3,3,1.37396,103.970446
509048,2,11,13,1.378115,103.958801
509049,60,29,89,1.378047,103.957407
509050,132,28,160,1.378063,103.95736
509051,277,6,283,1.37809,103.957303
509058,322,622,944,1.36854,103.970164
509059,465,182,647,1.368084,103.969539
509060,311,46,357,1.367267,103.969196
509061,196,115,311,1.367441,103.969614
509062,493,59,552,1.366804,103.969858
509063,400,40,440,1.367413,103.970355
509064,294,40,334,1.366927,103.970722
509065,544,83,627,1.367488,103.971026
509066,818,65,883,1.368416,103.97085
509067,248,105,353,1.368956,103.971271
509068,523,711,1234,1.370108,103.97134
509069,340,2447,2787,1.369077,103.97071
509070,14,2,16,1.368008,103.970361
509071,66,0,66,1.37486,103.980775
509072,2,37,39,1.37673,103.977903
509085,2,0,2,1.378811,103.969603
509087,3,0,3,1.378115,103.958801
509088,6,93,99,1.390257,103.976134
509106,0,2,2,1.391041,103.977126
509107,1,10,11,1.363212,103.968477
509108,4,17,21,1.363316,103.968688
509110,0,5,5,1.363333,103.968893
509111,7,7,14,1.3631,103.969167
509112,0,7,7,1.363301,103.96904
509113,2,0,2,1.36323,103.968789
509114,0,6,6,1.363238,103.969172
509115,13,1,14,1.362876,103.969513
509116,143,12,155,1.363157,103.969291
509117,2,0,2,1.362982,103.969348
509118,18,6,24,1.363049,103.969487
509119,3,0,3,1.391041,103.977126
509120,1,131,132,1.363083,103.969657
509121,27,2,29,1.362594,103.97002
509122,2,189,191,1.363004,103.969701
509123,4,0,4,1.362536,103.97012
509126,1,3,4,1.362813,103.969934
509127,0,2,2,1.362796,103.969671
509128,0,48,48,1.362838,103.970051
509129,1,0,1,1.380764,103.96796
509130,1,55,56,1.362805,103.970121
509131,2,1,3,1.362705,103.969833
509132,0,6,6,1.362666,103.970121
509133,45,12,57,1.361774,103.970791
509134,15,8,23,1.362521,103.970371
509135,2,64,66,1.362582,103.97048
509136,2,23,25,1.362505,103.970506
509137,0,3,3,1.361823,103.970776
509138,1,10,11,1.362303,103.970759
509139,5,46,51,1.362179,103.970869
509140,2,2,4,1.362026,103.970884
509141,1,1,2,1.362351,103.970415
509142,37,28,65,1.361763,103.970887
509159,6,188,194,1.366923,103.968326
509207,1,44,45,1.363377,103.970861
509208,4,39,43,1.363312,103.970921
509209,0,17,17,1.363209,103.970995
509210,0,6,6,1.363158,103.97103
509211,0,8,8,1.363116,103.971069
509212,9,9,18,1.363067,103.97112
509213,5,4,9,1.363029,103.971148
509214,0,7,7,1.362981,103.971184
509215,0,10,10,1.362904,103.971246
509216,8,6,14,1.362853,103.971299
509217,1,6,7,1.362788,103.971361
509218,0,8,8,1.362761,103.97139
509219,0,2,2,1.361883,103.970887
509220,2,11,13,1.362667,103.971484
509221,1,12,13,1.36261,103.971535
509222,56,25,81,1.362584,103.971594
509223,0,18,18,1.362533,103.971691
509224,4,0,4,1.362531,103.971739
509225,6,2,8,1.3625,103.971793
509226,33,2,35,1.362481,103.971841
509228,27,0,27,1.362434,103.97195
509230,1,1,2,1.36272,103.971441
509231,13,71,84,1.36232,103.972493
509232,74,23,97,1.362331,103.972539
509233,1,13,14,1.362348,103.97259
509234,5,8,13,1.362366,103.97263
509235,5,8,13,1.362377,103.972664
509236,12,5,17,1.362392,103.972718
509237,17,1,18,1.363279,103.971194
509238,2,2,4,1.363268,103.971228
509239,1,0,1,1.362244,103.970605
509240,253,2,255,1.363251,103.971302
509241,17,0,17,1.363228,103.971387
509242,1,1,2,1.362298,103.972446
509243,20,1,21,1.363205,103.971501
509244,61,3,64,1.363189,103.971634
509246,1,1,2,1.363222,103.971439
509247,3,0,3,1.362388,103.970602
509248,0,1,1,1.363256,103.971268
509249,1,0,1,1.363079,103.973259
509250,1,6,7,1.362937,103.97242
509252,4,0,4,1.363131,103.971985
509253,21,3,24,1.363302,103.971114
509254,0,4,4,1.363291,103.971154
509255,6,0,6,1.363239,103.971342
509256,1,1,2,1.363168,103.971762
509258,3,0,3,1.363157,103.971816
509260,20,1,21,1.363065,103.972344
509261,35,0,35,1.36305,103.972406
509262,0,3,3,1.363084,103.972225
509263,10,5,15,1.363019,103.972543
509264,0,1,1,1.36315,103.971878
509265,1,2,3,1.36304,103.972485
509267,0,1,1,1.363009,103.972604
509287,4,12,16,1.363158,103.968164
509288,0,4,4,1.363076,103.968324
509289,0,18,18,1.363324,103.967767
509290,10,0,10,1.363208,103.967924
509291,1,1,2,1.363116,103.97207
509292,12,0,12,1.363047,103.96817
509293,1,2,3,1.362995,103.972665
509294,5,5,10,1.362939,103.968342
509295,0,3,3,1.362909,103.968555
509296,5,2,7,1.362811,103.968681
509297,10,0,10,1.36254,103.968823
509298,1,2,3,1.362952,103.968306
509299,1,1,2,1.363136,103.968049
509300,2,1,3,1.362739,103.968833
509301,14,0,14,1.362565,103.969181
509302,3,2,5,1.362248,103.969335
509303,40,6,46,1.362479,103.969335
509304,7,0,7,1.362378,103.969463
509305,11,1,12,1.362275,103.969641
509306,3,4,7,1.362175,103.969787
509307,22,1,23,1.3621,103.969951
509308,1,3,4,1.362007,103.970174
509309,4,2,6,1.361883,103.970349
509310,31,0,31,1.361149,103.970399
509312,21,0,21,1.361126,103.970347
509313,2,3,5,1.361613,103.970531
509314,1,0,1,1.362972,103.972795
509315,0,2,2,1.362477,103.968977
509317,1,1,2,1.361552,103.970534
509318,18,0,18,1.361006,103.970205
509319,0,1,1,1.361086,103.970302
509320,4,31,35,1.36096,103.970142
509321,0,1,1,1.361439,103.970533
509323,9,3,12,1.361321,103.970542
509324,1,0,1,1.361378,103.970541
509325,164,0,164,1.361259,103.970548
509327,0,1,1,1.361268,103.969327
509328,5,0,5,1.361278,103.969354
509329,0,6,6,1.361138,103.970555
509330,100,0,100,1.36089,103.969421
509331,1,1146,1147,1.361085,103.970554
509332,7,10,17,1.360868,103.969416
509333,32,5,37,1.361278,103.970135
509334,1,0,1,1.361201,103.970538
509335,0,2,2,1.361491,103.970528
509336,105,3,108,1.361157,103.969998
509340,0,1,1,1.361232,103.970095
509371,352,1501,1853,1.377819,103.956217
509372,61,2775,2836,1.377646,103.956459
509373,9,2,11,1.377646,103.956459
509374,80,1,81,1.377646,103.956459
509375,7,1,8,1.377646,103.956459
509376,5,0,5,1.377646,103.956459
509377,11,0,11,1.377646,103.956459
509378,23,2,25,1.378235,103.956878
509379,22,1,23,1.378295,103.956878
509380,23,0,23,1.37837,103.956939
509381,5,1,6,1.378598,103.956904
509382,0,10,10,1.37861,103.957035
509383,6,28,34,1.378633,103.957084
509396,1,23,24,1.377447,103.958133
509397,63,52,115,1.37757,103.958374
509399,2,6,8,1.377694,103.958482
509400,0,4,4,1.377754,103.958585
509401,0,1,1,1.362669,103.969035
509402,6,24,30,1.377832,103.958774
509403,3,59,62,1.377638,103.958675
509404,1328,949,2277,1.378954,103.958813
509405,83,44,127,1.377679,103.958816
509406,0,6,6,1.377697,103.95893
509407,3,269,272,1.377729,103.959005
509408,205,366,571,1.378774,103.95905
509409,143,172,315,1.378774,103.95905
509410,353,16,369,1.378774,103.95905
509413,264,1,265,1.378262,103.959969
509414,247,14,261,1.378262,103.959969
509415,52,66,118,1.378262,103.959969
509419,3,46,49,1.378295,103.960183
509420,54,8,62,1.378337,103.960234
509421,46,35,81,1.378564,103.960464
509422,260,19,279,1.378653,103.960677
509424,142,27,169,1.378702,103.96083
509425,42,64,106,1.378702,103.96083
509426,2,0,2,1.361198,103.970044
509427,2,1,3,1.362341,103.969159
509428,38,26,64,1.378718,103.960955
509429,0,1,1,1.377781,103.958675
509431,5,18,23,1.379311,103.960758
509432,604,150,754,1.378817,103.961209
509433,2,0,2,1.378702,103.96083
509436,0,2,2,1.37875,103.961023
509438,4,28,32,1.37875,103.961023
509439,278,18,296,1.379352,103.96328
509440,29,80,109,1.379458,103.96325
509441,161,8,169,1.379458,103.96325
509442,0,2,2,1.37875,103.961023
509444,1,0,1,1.378788,103.960943
509445,8,0,8,1.379458,103.96325
509447,0,4,4,1.379458,103.96325
509448,5,2,7,1.379458,103.96325
509449,0,1,1,1.379458,103.96325
509450,0,2,2,1.379458,103.96325
509451,1,0,1,1.379458,103.96325
509452,18,3,21,1.380153,103.963302
509453,8,2,10,1.380203,103.963287
509454,5,61,66,1.380286,103.963249
509456,560,148,708,1.379226,103.963835
509457,2,3,5,1.379226,103.963835
509458,5,3,8,1.379226,103.963835
509459,0,6,6,1.379226,103.963835
509460,1,1,2,1.379458,103.96325
509461,1,0,1,1.380123,103.963311
509462,5,0,5,1.379226,103.963835
509463,14,1,15,1.379226,103.963835
509464,4,0,4,1.379226,103.963835
509465,2,3,5,1.379226,103.963835
509467,7,7,14,1.379226,103.963835
509468,23,57,80,1.379373,103.964137
509469,1,0,1,1.379226,103.963835
509470,2,0,2,1.379226,103.963835
509471,1,0,1,1.379444,103.964175
509472,3,0,3,1.378702,103.96083
509473,1,1,2,1.379517,103.964173
509474,1,1,2,1.379685,103.964167
509475,0,2,2,1.379741,103.964169
509476,1,0,1,1.379573,103.964183
509477,1,1,2,1.379794,103.964162
509478,24,1,25,1.379962,103.96413
509479,40,0,40,1.380124,103.964123
509480,1,1,2,1.379905,103.964144
509481,4,1,5,1.38024,103.964121
509482,1,0,1,1.379854,103.964148
509483,1,0,1,1.380293,103.964093
509484,16,1,17,1.380394,103.964104
509485,102,0,102,1.380453,103.96409
509486,4,1,5,1.38051,103.964098
509487,11,39,50,1.380578,103.964097
509488,2,1,3,1.379629,103.964175
509489,312,1,313,1.380217,103.96444
509490,6,6,12,1.3796,103.964505
509491,0,6,6,1.379692,103.964483
509492,2,2,4,1.379614,103.964514
509493,0,1,1,1.38035,103.964109
509494,4,1,5,1.379636,103.964534
509495,1,1,2,1.380179,103.964121
509498,2,0,2,1.379814,103.964865
509499,2,0,2,1.379719,103.96465
509500,3,0,3,1.379998,103.964169
509502,2,0,2,1.379687,103.964546
509503,29,15,44,1.380554,103.964536
509504,367,73,440,1.380298,103.964704
509506,282,2,284,1.379249,103.963462
509507,7,42,49,1.377378,103.95814
509508,25,20,45,1.377672,103.958532
509509,0,19,19,1.377412,103.958009
509510,4,150,154,1.378042,103.95926
509511,6,1,7,1.378027,103.959368
509512,1,1,2,1.379833,103.964764
509513,11,1,12,1.377948,103.959522
509514,0,4,4,1.378561,103.959485
509515,1,0,1,1.379639,103.964521
509516,8,2,10,1.378657,103.959459
509517,7,0,7,1.378717,103.959445
509518,5,0,5,1.378765,103.959396
509520,0,1,1,1.378646,103.959459
509521,6,15,21,1.362345,103.968089
509524,1,0,1,1.378884,103.959339
509525,92,1,93,1.362598,103.967858
509528,1,0,1,1.362527,103.967925
509529,1,165,166,1.362936,103.967478
509530,1,81,82,1.362904,103.967337
509532,0,5,5,1.362764,103.96748
509533,1,11,12,1.362521,103.967653
509534,0,2,2,1.377996,103.95947
509535,6,0,6,1.36243,103.967567
509536,7,0,7,1.362443,103.967223
509537,0,2,2,1.362692,103.967532
509538,18,0,18,1.362483,103.967135
509539,2,0,2,1.362296,103.967407
509540,0,14,14,1.362589,103.966994
509541,4,1,5,1.362266,103.967159
509542,1,14,15,1.362629,103.966931
509544,3,0,3,1.379691,103.964523
509545,4,1,5,1.362369,103.96698
509547,7,0,7,1.362463,103.966852
509548,40,0,40,1.362506,103.966784
509565,1,501,502,1.360858,103.964625
509566,4,2,6,1.360932,103.964681
509567,0,16,16,1.36109,103.964632
509568,0,1,1,1.362859,103.967566
509569,4,1,5,1.361166,103.964572
509570,1,4,5,1.361075,103.964858
509572,6,4,10,1.361144,103.96492
509574,12,12,24,1.36119,103.96496
509575,11,10,21,1.36126,103.965012
509576,0,2,2,1.362251,103.967286
509577,1,0,1,1.360989,103.964761
509578,1,33,34,1.361547,103.964271
509579,84,2,86,1.361356,103.965137
509580,4,44,48,1.361595,103.964442
509581,11,19,30,1.361408,103.965188
509582,14,0,14,1.361423,103.964539
509583,0,4,4,1.361468,103.965259
509584,0,3,3,1.362334,103.96704
509585,18,3,21,1.361505,103.965302
509586,6,1,7,1.361269,103.964653
509587,0,7,7,1.361557,103.965353
509588,9,4,13,1.361206,103.964704
509589,0,50,50,1.361614,103.965404
509590,3,5,8,1.361488,103.965062
509591,0,10,10,1.361666,103.965455
509592,0,3,3,1.361337,103.964584
509593,0,3,3,1.361568,103.965011
509594,1,0,1,1.361305,103.965068
509595,3,21,24,1.361775,103.965563
509596,0,8,8,1.361728,103.964914
509597,1,22,23,1.361838,103.965632
509598,1,41,42,1.361739,103.965119
509599,13,1,14,1.361636,103.965188
509601,0,56,56,1.361825,103.965426
509615,1,30,31,1.36143,103.963828
509616,1,541,542,1.361375,103.963676
509617,2,1,3,1.361717,103.965512
509618,5,74,79,1.361306,103.963733
509619,8,0,8,1.36127,103.963908
509620,12,102,114,1.361243,103.963778
509621,2,2,4,1.361189,103.963959
509622,1,47,48,1.361174,103.96383
509623,5,0,5,1.361104,103.964011
509624,0,98,98,1.3611,103.963875
509625,4,9,13,1.361001,103.964074
509626,4,7,11,1.360997,103.963938
509628,11,842,853,1.360877,103.963989
509630,0,3,3,1.36135,103.963868
509631,0,7,7,1.36075,103.964233
509632,1,520,521,1.360665,103.964131
509633,1,0,1,1.361648,103.964971
509634,9,0,9,1.361822,103.967721
509635,21,3,24,1.361934,103.967681
509636,5,1,6,1.361857,103.967773
509637,1,2,3,1.360768,103.964057
509638,4,4,8,1.361954,103.967858
509639,49,0,49,1.36207,103.96781
509640,2,1,3,1.362004,103.967754
509641,16,2,18,1.362157,103.967888
509642,5,0,5,1.362098,103.968
509643,9,11,20,1.362239,103.967948
509644,0,15,15,1.362149,103.968063
509645,1,10,11,1.362226,103.968151
509646,0,20,20,1.362304,103.968222
509647,6,0,6,1.362396,103.968307
509648,12,1,13,1.362453,103.968364
509649,13,1,14,1.362533,103.968438
509650,0,2,2,1.361471,103.964331
509667,18,20,38,1.388737,103.978819
509668,4,1,5,1.388599,103.978614
509669,1500,71,1571,1.388907,103.979795
509670,6,0,6,1.388762,103.979504
509671,0,12,12,1.388902,103.980681
509672,0,1,1,1.361868,103.967624
509673,1497,455,1952,1.388594,103.978027
509674,15,343,358,1.299509,103.837
509675,3,0,3,1.361994,103.967915
509684,83,0,83,1.388819,103.98152
509686,2,3,5,1.388394,103.981522
509687,9,8,17,1.38863,103.981645
509688,7,0,7,1.390294,103.981262
509690,126,4,130,1.389356,103.981473
509691,6,854,860,1.387909,103.980437
509692,4,0,4,1.3878,103.981103
509693,2,0,2,1.36259,103.968507
509694,18,0,18,1.387982,103.980781
509696,2,0,2,1.388051,103.980997
509698,2,0,2,1.388504,103.981018
509700,1,86,87,1.387899,103.980256
509701,7,0,7,1.387899,103.981154
509702,0,18,18,1.388134,103.98112
509704,1,3,4,1.388263,103.980235
509705,24,6,30,1.388011,103.981169
509706,11,814,825,1.387707,103.9811
509707,7,0,7,1.389695,103.981463
509709,1,0,1,1.389107,103.98081
509710,2,4,6,1.391152,103.975711
509725,26,11,37,1.361318,103.963329
509726,234,193,427,1.361148,103.963445
509727,584,669,1253,1.36065,103.962636
509728,458,69,527,1.360439,103.962255
509729,725,260,985,1.359922,103.962442
509730,727,455,1182,1.3601,103.962943
509731,278,326,604,1.360246,103.96332
509732,361,1,362,1.360719,103.965352
509733,477,1,478,1.361195,103.965872
509734,729,89,818,1.36116,103.966685
509735,712,117,829,1.36061,103.966172
509736,493,2296,2789,1.359762,103.965678
509737,281,6966,7247,1.359934,103.964911
509738,46,125,171,1.360192,103.966484
509739,1203,117,1320,1.360427,103.967087
509740,386,97,483,1.359548,103.967539
509741,724,1331,2055,1.359553,103.967566
509742,1013,413,1426,1.359581,103.966521
509743,470,130,600,1.356422,103.967759
509744,522,186,708,1.356532,103.967346
509745,39,2,41,1.356822,103.967324
509746,461,141,602,1.359104,103.966684
509747,49,6,55,1.386566,103.986604
509748,14,18,32,1.386577,103.986227
509765,5,686,691,1.389324,103.975251
509786,99,0,99,1.386348,103.980411
509819,19,0,19,1.383017,103.979667
509851,232,975,1207,1.386992,103.980967
509853,19,122,141,1.389031,103.976626
509854,41,178,219,1.388669,103.977046
509855,0,39,39,1.389847,103.976107
509856,2,10,12,1.389918,103.976046
509857,8,4,12,1.388802,103.97687
509860,0,409,409,1.385094,103.98145
509862,20,0,20,1.379148,103.981151
509863,146,0,146,1.37896,103.981809
509864,59,16,75,1.389739,103.976163
509866,4342,1,4343,1.388723,103.976509
509875,15,2,17,1.363964,103.974083
509876,9,4,13,1.364025,103.974098
509877,18,2,20,1.364147,103.974129
509878,1,2,3,1.389426,103.980001
509881,1,0,1,1.391045,103.975669
509882,4,1,5,1.364514,103.974223
509883,0,11,11,1.364358,103.974004
509886,4,2,6,1.364759,103.974285
509888,1,0,1,1.364308,103.974001
509889,1,0,1,1.364881,103.974316
509907,364,200,564,1.389956,103.988702
509908,307,1045,1352,1.387078,103.986959
509912,23,970,993,1.299509,103.837
509922,94,4013,4107,1.388227,103.986749
509923,19,1210,1229,1.388475,103.986749
509924,1,33,34,1.388754,103.986665
509925,5,36,41,1.388952,103.986597
509926,11,2401,2412,1.389167,103.986536
509927,1293,649,1942,1.376011,103.977967
509928,12,42,54,1.373558,103.981256
509932,2727,295,3022,1.37279,103.981726
509933,818,256,1074,1.299509,103.837
509944,2,114,116,1.390294,103.98283
509945,108,20,128,1.389457,103.982396
509946,12,15,27,1.389157,103.98255
509948,20,50,70,1.389645,103.982823
509950,2908,2,2910,1.390657,103.983779
509984,735,71,806,1.39094,103.975177
509985,63,20,83,1.390007,103.974822
509986,24,2,26,1.390007,103.974822
509987,42,17,59,1.27508,103.845904
510101,372,476,848,1.367035,103.958084
510102,452,705,1157,1.367508,103.958001
510103,639,285,924,1.367748,103.958595
510104,521,6669,7190,1.367906,103.958675
510105,309,2113,2422,1.368442,103.957359
510106,408,681,1089,1.368251,103.957444
510107,552,410,962,1.367503,103.957461
510108,199,182,381,1.367484,103.957044
510109,146,605,751,1.368301,103.956184
510110,477,3755,4232,1.368735,103.956282
510111,33,4442,4475,1.368042,103.956353
510112,241,346,587,1.367717,103.955746
510113,127,202,329,1.368044,103.955754
510114,456,456,912,1.368533,103.954686
510115,390,7992,8382,1.368908,103.954736
510116,83,40,123,1.368376,103.954464
510117,344,76,420,1.368032,103.954834
510118,517,680,1197,1.36723,103.954648
510119,227,115,342,1.367521,103.954725
510120,121,44,165,1.367281,103.954351
510121,483,159,642,1.366873,103.954398
510122,323,106,429,1.366524,103.954336
510123,115,119,234,1.366228,103.954014
510124,1069,104,1173,1.365868,103.954219
510125,800,645,1445,1.36615,103.954384
510126,720,404,1124,1.365553,103.955149
510127,485,589,1074,1.365884,103.955142
510128,382,421,803,1.366254,103.95525
510129,414,463,877,1.366562,103.955766
510130,209,1570,1779,1.365287,103.956823
510131,196,1423,1619,1.365544,103.956453
510132,151,5935,6086,1.366152,103.956171
510133,98,67,165,1.365496,103.95611
510134,319,20,339,1.365162,103.956534
510135,268,61,329,1.364529,103.957502
510136,261,101,362,1.364683,103.957663
510137,369,1529,1898,1.365039,103.957358
510138,93,972,1065,1.363361,103.959677
510139,153,195,348,1.363475,103.959355
510140,180,263,443,1.363907,103.958786
510141,73,2303,2376,1.364147,103.958687
510142,458,274,732,1.363471,103.958888
510143,335,101,436,1.362286,103.960305
510144,449,96,545,1.362467,103.960403
510145,186,294,480,1.363189,103.960818
510146,98,328,426,1.363026,103.960155
510147,393,195,588,1.362834,103.962206
510148,358,63,421,1.362189,103.962068
510149,576,660,1236,1.361779,103.962187
510150,836,355,1191,1.363013,103.963113
510151,108,283,391,1.362864,103.962568
510152,226,202,428,1.363735,103.962196
510153,162,115,277,1.363737,103.962794
510154,58,67,125,1.363293,103.963243
510155,226,113,339,1.363456,103.963431
510156,113,492,605,1.363978,103.96292
510157,264,559,823,1.364281,103.962609
510158,107,1030,1137,1.364583,103.962189
510159,33,1075,1108,1.363657,103.961462
510160,206,159,365,1.364056,103.962461
510161,299,251,550,1.363662,103.961734
510180,1080,8441,9521,1.364116,103.960112
510181,720,1234,1954,1.364554,103.960556
510182,117,199,316,1.364676,103.960914
510183,179,120,299,1.36493,103.960513
510184,116,103,219,1.365264,103.960131
510185,633,12,645,1.365654,103.9599
510186,231,294,525,1.364994,103.959536
510187,283,6079,6362,1.364729,103.959325
510188,619,2446,3065,1.365235,103.959011
510189,298,282,580,1.365669,103.958891
510190,278,4105,4383,1.36568,103.958428
510191,350,889,1239,1.365906,103.958577
510192,584,1380,1964,1.366494,103.958982
510193,429,151,580,1.366129,103.959201
510194,467,44,511,1.366035,103.959588
510195,264,166,430,1.366395,103.960034
510196,123,96,219,1.366214,103.960253
510197,226,122,348,1.36643,103.960669
510198,264,810,1074,1.366791,103.960163
510199,328,1734,2062,1.367163,103.959539
510203,215,210,425,1.367135,103.962052
510204,342,292,634,1.367237,103.9626
510205,211,473,684,1.366695,103.963127
510206,135,737,872,1.366397,103.962859
510207,196,72,268,1.366537,103.962274
510208,420,988,1408,1.366178,103.962206
510209,620,362,982,1.36668,103.961724
510210,390,1246,1636,1.36678,103.961414
510211,474,3551,4025,1.367273,103.960864
510212,628,1036,1664,1.367544,103.960608
510213,279,80,359,1.368373,103.961756
510214,494,131,625,1.367891,103.961473
510215,189,86,275,1.36841,103.960632
510216,468,947,1415,1.368974,103.960916
510217,366,2086,2452,1.369476,103.961
510218,185,278,463,1.369412,103.961439
510219,145,426,571,1.369327,103.961705
510220,453,584,1037,1.369781,103.961336
510221,323,266,589,1.37026,103.961361
510222,446,578,1024,1.370556,103.961859
510223,176,286,462,1.370569,103.961374
510224,118,1843,1961,1.3708,103.961093
510225,179,282,461,1.37117,103.961072
510226,753,842,1595,1.371031,103.961687
510227,555,431,986,1.371517,103.961476
510228,333,523,856,1.372158,103.961607
510229,538,1467,2005,1.372428,103.961888
510230,229,3871,4100,1.372718,103.961019
510231,146,1886,2032,1.373406,103.961372
510232,187,4529,4716,1.374687,103.96163
510233,247,163,410,1.374413,103.962057
510234,337,558,895,1.37358,103.961885
510235,184,480,664,1.373364,103.962321
510236,124,2620,2744,1.374362,103.96257
510237,180,276,456,1.374216,103.962933
510238,181,203,384,1.373762,103.963037
510239,337,2547,2884,1.373274,103.963387
510240,138,165,303,1.373423,103.962542
510241,186,100,286,1.373146,103.962646
510242,145,1741,1886,1.371376,103.962387
510243,304,21,325,1.371464,103.963014
510244,366,1510,1876,1.371466,103.963276
510245,129,288,417,1.371141,103.962959
510246,68,2179,2247,1.371108,103.96251
510247,114,1024,1138,1.370641,103.962491
510248,138,179,317,1.370576,103.96294
510249,66,3691,3757,1.370222,103.963176
510250,155,37,192,1.370237,103.96294
510251,84,1175,1259,1.370263,103.962481
510252,275,2755,3030,1.36807,103.962685
510253,155,236,391,1.368058,103.963225
510254,253,170,423,1.368277,103.963765
510255,156,1537,1693,1.36825,103.964123
510256,441,3208,3649,1.367336,103.963944
510257,26,3504,3530,1.367218,103.963798
510258,53,7614,7667,1.367095,103.964726
510259,391,335,726,1.366385,103.964571
510266,156,3484,3640,1.366067,103.963745
510267,98,77,175,1.365752,103.963339
510268,98,1833,1931,1.365294,103.963023
510269,104,61,165,1.365228,103.963888
510270,268,46,314,1.365461,103.964202
510271,195,235,430,1.36585,103.964175
510272,415,93,508,1.36498,103.964426
510273,308,123,431,1.364748,103.964197
510274,276,961,1237,1.364157,103.96421
510275,370,286,656,1.364311,103.964694
510405,263,1150,1413,1.373503,103.955609
510406,615,153,768,1.373821,103.95546
510407,407,306,713,1.373661,103.954391
510408,425,174,599,1.37324,103.953666
510409,609,178,787,1.372747,103.954114
510410,76,7,83,1.372691,103.953971
510411,517,252,769,1.372513,103.954127
510412,419,229,648,1.373408,103.955047
510413,121,248,369,1.37272,103.955519
510414,257,3480,3737,1.372644,103.956424
510415,246,997,1243,1.37178,103.956268
510416,483,237,720,1.371627,103.95564
510417,741,542,1283,1.371955,103.955478
510418,446,214,660,1.371957,103.954139
510419,583,167,750,1.371355,103.954636
510420,234,1,235,1.371295,103.954498
510421,1034,314,1348,1.371185,103.954905
510422,831,266,1097,1.370753,103.954562
510423,407,513,920,1.369885,103.954681
510424,37,5,42,1.369808,103.954482
510425,702,2844,3546,1.369631,103.954737
510426,571,130,701,1.369989,103.956174
510427,373,491,864,1.370291,103.955986
510428,454,570,1024,1.369451,103.956487
510429,411,3970,4381,1.370084,103.956674
510440,244,2482,2726,1.368929,103.958942
510441,45,68,113,1.369239,103.958199
510442,305,12958,13263,1.36892,103.95797
510443,79,3284,3363,1.369427,103.957429
510444,52,11946,11998,1.369873,103.957524
510445,9,50,59,1.369873,103.957524
510446,770,325,1095,1.370367,103.957523
510447,44,533,577,1.370835,103.957884
510448,105,83,188,1.37064,103.958041
510449,53,77,130,1.370857,103.958367
510450,216,198,414,1.371119,103.957964
510451,324,165,489,1.371543,103.957837
510452,276,3007,3283,1.371653,103.957441
510453,374,2767,3141,1.371844,103.957288
510454,110,150,260,1.371986,103.957969
510455,45,53,98,1.371772,103.958339
510456,593,235,828,1.371929,103.958776
510457,237,94,331,1.371809,103.959469
510458,382,359,741,1.371473,103.9596
510459,372,297,669,1.371108,103.959699
510460,670,274,944,1.371159,103.959108
510461,636,315,951,1.371335,103.958606
510463,133,141,274,1.372704,103.95799
510464,172,175,347,1.372851,103.958328
510465,211,259,470,1.373429,103.958521
510466,531,114,645,1.373425,103.958274
510467,248,120,368,1.373537,103.956666
510468,145,3575,3720,1.373819,103.956648
510469,144,80,224,1.373545,103.957469
510470,166,133,299,1.373801,103.957437
510471,53,41,94,1.374292,103.957766
510472,289,413,702,1.374231,103.957203
510473,407,318,725,1.374487,103.957265
510474,166,10011,10177,1.375201,103.956593
510475,231,3345,3576,1.375183,103.957046
510476,155,4912,5067,1.375174,103.958288
510477,854,263,1117,1.374557,103.958209
510478,305,104,409,1.374542,103.958921
510479,177,2925,3102,1.375167,103.959143
510480,218,426,644,1.374809,103.959274
510481,228,163,391,1.373934,103.958832
510482,318,573,891,1.373775,103.959673
510483,170,342,512,1.374019,103.959904
510484,336,3740,4076,1.373617,103.960544
510485,54,3027,3081,1.374514,103.960842
510486,329,346,675,1.374305,103.960308
510487,271,4324,4595,1.374903,103.960519
510500,502,880,1382,1.376176,103.945927
510501,427,673,1100,1.375994,103.946348
510502,252,1116,1368,1.375546,103.946074
510503,350,354,704,1.375693,103.945591
510504,1038,747,1785,1.37616,103.944765
510505,349,755,1104,1.376701,103.945043
510506,345,1312,1657,1.376972,103.944896
510507,313,163,476,1.376594,103.944614
510508,566,118,684,1.37612,103.944271
510509,572,10,582,1.375834,103.94402
510510,248,151,399,1.375776,103.944465
510511,303,120,423,1.375192,103.944064
510512,130,15,145,1.375552,103.943796
510513,284,58,342,1.37515,103.943603
510514,155,236,391,1.37454,103.943255
510515,259,3851,4110,1.374208,103.94295
510516,400,3940,4340,1.374198,103.943471
510517,660,323,983,1.374456,103.943935
510518,306,343,649,1.374419,103.944607
510519,286,424,710,1.374062,103.94497
510520,263,2418,2681,1.373621,103.944811
510521,465,934,1399,1.373738,103.94439
510524,32,641,673,1.299509,103.837
510525,19,102,121,1.299509,103.837
510526,229,438,667,1.299509,103.837
510527,26,105,131,1.370732,103.947931
510528,53,5341,5394,1.299509,103.837
510529,9,8,17,1.299509,103.837
510530,55,525,580,1.370958,103.94959
510531,446,41,487,1.371369,103.950364
510532,279,317,596,1.371346,103.950711
510533,417,224,641,1.370856,103.950845
510534,411,413,824,1.37036,103.950553
510535,161,396,557,1.370606,103.950097
510536,363,3183,3546,1.370754,103.949914
510537,309,1234,1543,1.369762,103.949721
510538,592,1249,1841,1.369618,103.95022
510539,12,1559,1571,1.36957,103.950444
510540,211,1290,1501,1.369458,103.950617
510541,123,1355,1478,1.369269,103.95108
510542,40,2266,2306,1.369255,103.951304
510543,269,1375,1644,1.369165,103.951498
510544,281,605,886,1.369027,103.952133
510545,11,1467,1478,1.369039,103.952371
510546,212,811,1023,1.368958,103.952586
510547,492,2910,3402,1.368966,103.953371
510548,253,218,471,1.36846,103.953465
510549,104,267,371,1.367884,103.953439
510550,402,106,508,1.367346,103.953373
510551,657,144,801,1.367383,103.952883
510552,362,120,482,1.367656,103.952693
510553,394,497,891,1.368009,103.952777
510554,278,258,536,1.368507,103.952909
510555,323,992,1315,1.368118,103.951888
510556,330,286,616,1.367593,103.95192
510557,580,205,785,1.366839,103.952232
510558,367,446,813,1.366792,103.95166
510559,702,428,1130,1.366517,103.951676
510560,825,517,1342,1.366792,103.95047
510561,430,520,950,1.367005,103.950836
510562,292,480,772,1.367557,103.950312
510564,528,244,772,1.368408,103.950027
510565,490,63,553,1.368949,103.950237
510566,552,276,828,1.369114,103.949795
510567,1366,560,1926,1.369295,103.94915
510568,513,781,1294,1.368815,103.948873
510569,535,767,1302,1.369657,103.94908
510570,231,2028,2259,1.37284,103.946505
510571,631,3342,3973,1.373199,103.945597
510572,463,728,1191,1.37353,103.94561
510573,196,680,876,1.373908,103.945858
510574,278,407,685,1.374274,103.946081
510575,519,302,821,1.373136,103.946224
510576,282,114,396,1.372997,103.946796
510577,316,98,414,1.373215,103.947266
510578,328,872,1200,1.374195,103.947561
510579,485,206,691,1.374505,103.947312
510580,413,224,637,1.374738,103.946853
510581,419,525,944,1.374929,103.946648
510582,250,268,518,1.375323,103.946903
510583,167,225,392,1.37574,103.947119
510584,403,136,539,1.375086,103.947016
510585,307,336,643,1.375464,103.947367
510586,378,586,964,1.37523,103.947821
510601,568,735,1303,1.377653,103.943641
510602,523,472,995,1.377392,103.943975
510603,382,144,526,1.376937,103.943663
510604,418,56,474,1.376439,103.943293
510605,760,361,1121,1.377089,103.94292
510606,523,151,674,1.376804,103.942682
510607,454,281,735,1.376379,103.942467
510608,846,115,961,1.375944,103.942914
510609,389,41,430,1.375676,103.942747
510610,484,435,919,1.375467,103.942097
510611,304,64,368,1.375122,103.942321
510612,323,3607,3930,1.374797,103.942073
510613,322,1679,2001,1.375058,103.94149
510614,284,699,983,1.375751,103.941571
510615,544,276,820,1.376431,103.941687
510623,63,77,140,1.377844,103.94239
510624,17,1008,1025,1.377892,103.941553
510625,1369,1127,2496,1.378441,103.94193
510626,533,2979,3512,1.379721,103.940995
510627,232,499,731,1.37958,103.940668
510628,585,694,1279,1.379147,103.941275
510629,587,211,798,1.378961,103.940769
510630,690,278,968,1.378343,103.940881
510631,1020,207,1227,1.378837,103.940322
510632,663,270,933,1.378612,103.940016
510633,821,396,1217,1.377874,103.940718
510634,1211,363,1574,1.377591,103.940641
510635,456,387,843,1.3774,103.940343
510636,397,425,822,1.377026,103.940865
510637,400,125,525,1.376751,103.940373
510638,357,275,632,1.376214,103.940589
510639,404,351,755,1.376701,103.939826
510640,754,4900,5654,1.375926,103.940361
510641,229,5009,5238,1.376505,103.939602
510642,306,1722,2028,1.377646,103.938217
510643,321,1516,1837,1.377784,103.938038
510644,243,1579,1822,1.378237,103.937669
510645,275,1031,1306,1.378386,103.937888
510646,311,156,467,1.37817,103.938177
510647,150,105,255,1.378424,103.939056
510648,627,102,729,1.378759,103.938795
510649,368,257,625,1.378432,103.938369
510650,356,673,1029,1.378658,103.93806
510651,326,1612,1938,1.379085,103.938354
510700,542,471,1013,1.380306,103.93813
510701,381,591,972,1.379977,103.937861
510702,210,126,336,1.380245,103.937499
510703,130,291,421,1.380507,103.937299
510704,172,26,198,1.38074,103.937269
510705,448,109,557,1.380526,103.937849
510706,415,293,708,1.380772,103.938088
510707,257,177,434,1.381159,103.938569
510708,445,643,1088,1.381402,103.938941
510709,378,1492,1870,1.381631,103.938534
510710,841,267,1108,1.382002,103.937525
510711,460,20,480,1.381785,103.938104
510712,620,627,1247,1.381982,103.938285
510713,301,616,917,1.38227,103.937942
510714,354,589,943,1.382593,103.937567
510715,460,104,564,1.382871,103.937121
510716,454,228,682,1.383026,103.936824
510717,324,693,1017,1.382787,103.936556
510718,433,687,1120,1.382348,103.936426
510719,440,96,536,1.382021,103.936772
510720,442,7,449,1.381769,103.936481
510721,637,289,926,1.381404,103.936297
510722,421,144,565,1.380871,103.936795
510723,297,674,971,1.380676,103.936606
510724,137,392,529,1.381016,103.936236
510725,791,546,1337,1.381359,103.935747
510734,226,173,399,1.379861,103.93618
510735,228,2024,2252,1.379692,103.936062
510736,687,602,1289,1.379349,103.937574
510737,527,272,799,1.379518,103.936991
510738,344,114,458,1.37906,103.936588
510739,448,6457,6905,1.378544,103.936837
510740,335,659,994,1.378088,103.936081
510741,405,427,832,1.37769,103.936424
510742,334,1840,2174,1.377193,103.935557
510743,330,758,1088,1.377615,103.93533
510744,251,4750,5001,1.377582,103.935099
510745,211,10505,10716,1.378376,103.935751
510746,400,3555,3955,1.378602,103.935233
510747,414,1980,2394,1.379194,103.934693
510748,332,910,1242,1.378433,103.935003
510749,646,212,858,1.378692,103.934513
510750,344,547,891,1.378159,103.934733
510751,676,88,764,1.378192,103.934026
510752,133,1082,1215,1.377919,103.934852
510753,500,423,923,1.377195,103.934276
510754,660,199,859,1.377335,103.933923
510755,740,128,868,1.377538,103.933597
510756,519,3885,4404,1.377801,103.93341
510757,417,320,737,1.37715,103.933214
510758,548,302,850,1.376863,103.933209
510759,835,1015,1850,1.376522,103.932717
510760,347,75,422,1.376606,103.933165
510761,755,146,901,1.376144,103.933643
510762,698,303,1001,1.375884,103.933653
510763,530,125,655,1.376115,103.934034
510764,485,458,943,1.376379,103.934221
510765,476,848,1324,1.376916,103.934433
510766,695,2312,3007,1.37493,103.93682
510767,614,132,746,1.375696,103.935702
510768,658,273,931,1.375395,103.935396
510769,1159,597,1756,1.375137,103.935015
510770,283,414,697,1.375126,103.935823
510771,512,1475,1987,1.375829,103.936319
510772,259,1753,2012,1.375516,103.936781
510773,412,373,785,1.374916,103.936365
510774,1030,578,1608,1.374494,103.936345
510775,914,106,1020,1.374429,103.936794
510776,480,166,646,1.37493,103.93682
510777,886,3089,3975,1.375255,103.937223
510778,1038,914,1952,1.374569,103.93805
510779,279,160,439,1.373996,103.937797
510780,351,208,559,1.373715,103.937583
510781,891,2024,2915,1.374003,103.938357
510782,676,999,1675,1.373574,103.938538
511108,15,541,556,1.367998,103.957032
511135,4,34,38,1.364802,103.956863
511137,0,26,26,1.299509,103.837
511142,10,307,317,1.362889,103.959773
511146,5,1685,1690,1.299509,103.837
511149,12,2015,2027,1.36242,103.962653
511155,12,1510,1522,1.299509,103.837
511158,5,1811,1816,1.364063,103.961716
511180,6,481,487,1.364743,103.960115
511185,25,289,314,1.299509,103.837
511199,4,589,593,1.36652,103.959622
511204,3,169,172,1.366798,103.962545
511207,20,125,145,1.299509,103.837
511212,278,2264,2542,1.367899,103.960084
511216,7,562,569,1.368316,103.961217
511220,14,335,349,1.370097,103.960993
511225,8,1208,1216,1.371818,103.96093
511231,8,1911,1919,1.37383,103.961116
511233,3,86,89,1.369427,103.957429
511235,5,151,156,1.373773,103.962588
511239,6,1008,1014,1.299509,103.837
511245,5,1652,1657,1.370833,103.963417
511255,6,75,81,1.299509,103.837
511257,3,1673,1676,1.367665,103.962828
511267,14,2779,2793,1.299509,103.837
511269,10,1826,1836,1.364801,103.96345
511272,8,212,220,1.365061,103.964683
511273,7,17,24,1.299509,103.837
511426,7,214,221,1.299509,103.837
511441,43,251,294,1.369721,103.95753
511458,15,669,684,1.371675,103.960137
511467,12,5246,5258,1.373354,103.956537
511476,436,748,1184,1.374651,103.957334
511500,9,688,697,1.376437,103.94559
511511,464,362,826,1.3142,103.891472
511521,27,1760,1787,1.37389,103.943994
511524,695,688,1383,1.371321,103.947558
511525,299,489,788,1.370732,103.947931
511526,616,334,950,1.367538,103.947137
511527,505,353,858,1.368493,103.947469
511528,941,500,1441,1.370188,103.947788
511530,548,890,1438,1.299509,103.837
511555,22,666,688,1.368501,103.951826
511561,18,431,449,1.367617,103.950913
511564,5,199,204,1.368276,103.949534
511575,10,173,183,1.369427,103.957429
511578,9,204,213,1.373991,103.947079
511584,2,170,172,1.299509,103.837
511586,20,162,182,1.374729,103.947755
511601,10,177,187,1.37714,103.943287
511603,3,259,262,1.376863,103.943437
511609,1,36,37,1.299509,103.837
511613,6,180,186,1.299509,103.837
511614,10,451,461,1.375826,103.94226
511628,8,3072,3080,1.379115,103.941067
511631,9,157,166,1.379358,103.940233
511633,7,1597,1604,1.374821,103.951201
511635,159,187,346,1.37714,103.93994
511636,12,1402,1414,1.37693,103.939045
511638,8,1036,1044,1.299509,103.837
511649,1,32,33,1.378329,103.938367
511700,3,353,356,1.380637,103.938293
511704,13,68,81,1.299509,103.837
511710,12,117,129,1.382355,103.93734
511718,12,325,337,1.381734,103.935773
511736,3,509,512,1.378749,103.937422
511738,3,48,51,1.299509,103.837
511741,12,115,127,1.299509,103.837
511744,58,217,275,1.378355,103.935407
511747,28,2918,2946,1.378854,103.934054
511754,5,849,854,1.299509,103.837
511757,37,1282,1319,1.377238,103.933063
511762,5,227,232,1.376025,103.933341
511770,7,25,32,1.375218,103.936258
511773,6,445,451,1.374647,103.935899
511782,3,148,151,1.373749,103.938485
512142,5,65,70,1.299509,103.837
512149,2,345,347,1.299509,103.837
512212,8,130,138,1.299509,103.837
512216,2,368,370,1.299509,103.837
512220,1,106,107,1.299509,103.837
512225,8,320,328,1.299509,103.837
512245,2,203,205,1.364157,103.96421
512269,3,99,102,1.299509,103.837
512458,3,121,124,1.299509,103.837
512476,5,2647,2652,1.374651,103.957334
512524,430,15,445,1.370732,103.947931
512525,658,151,809,1.370732,103.947931
512526,340,201,541,1.367923,103.947025
512527,329,492,821,1.370732,103.947931
512528,500,93,593,1.370618,103.948043
512530,307,863,1170,1.371267,103.8889
512555,16,392,408,1.299509,103.837
512601,8,597,605,1.299509,103.837
512649,3,80,83,1.378294,103.93875
512710,14,86,100,1.299509,103.837
512757,9,127,136,1.299509,103.837
513524,679,411,1090,1.370556,103.94746
513525,315,169,484,1.369408,103.947827
513526,318,153,471,1.370732,103.947931
513527,664,352,1016,1.370732,103.947931
513528,513,3005,3518,1.371018,103.94804
513530,302,137,439,1.371714,103.950134
514526,769,103,872,1.370732,103.947931
514527,391,1588,1979,1.369746,103.947821
514528,27,1050,1077,1.299509,103.837
514530,176,1399,1575,1.370958,103.94959
518070,5,792,797,1.299509,103.837
518071,4,163,167,1.299509,103.837
518072,3,280,283,1.299509,103.837
518073,7,573,580,1.299509,103.837
518074,9,977,986,1.299509,103.837
518075,6,582,588,1.299509,103.837
518076,1,3,4,1.299509,103.837
518080,88,878,966,1.376475,103.958561
518081,72,186,258,1.299509,103.837
518082,81,1132,1213,1.299509,103.837
518083,27,7,34,1.299509,103.837
518084,112,12,124,1.299509,103.837
518085,50,21,71,1.37624,103.958411
518086,94,9,103,1.299509,103.837
518087,119,11,130,1.299509,103.837
518088,169,36,205,1.377349,103.958933
518089,94,110,204,1.299509,103.837
518090,65,60,125,1.299509,103.837
518091,93,193,286,1.299509,103.837
518130,6,230,236,1.299509,103.837
518131,4,12,16,1.299509,103.837
518132,0,74,74,1.299509,103.837
518133,20,300,320,1.299509,103.837
518134,1,31,32,1.299509,103.837
518135,0,7,7,1.299509,103.837
518136,1,73,74,1.299509,103.837
518137,4,28,32,1.299509,103.837
518138,1,1,2,1.388728,103.981729
518139,3,2,5,1.299509,103.837
518140,21,685,706,1.371179,103.945157
518141,4,83,87,1.299509,103.837
518142,6,109,115,1.299509,103.837
518143,5,153,158,1.299509,103.837
518144,1,7,8,1.299509,103.837
518145,704,8,712,1.377223,103.959635
518146,879,30,909,1.377223,103.959635
518147,841,68,909,1.377223,103.959635
518150,252,2128,2380,1.376224,103.959729
518151,105,626,731,1.376224,103.959729
518152,372,219,591,1.376224,103.959729
518153,170,129,299,1.376224,103.959729
518154,221,328,549,1.376224,103.959729
518155,525,857,1382,1.376224,103.959729
518156,695,464,1159,1.377223,103.959635
518157,644,436,1080,1.377223,103.959635
518158,280,19,299,1.377223,103.959635
518159,107,30,137,1.299509,103.837
518160,1162,226,1388,1.377607,103.960503
518161,957,25,982,1.377541,103.960507
518162,728,69,797,1.377893,103.960528
518163,797,153,950,1.3775,103.960526
518164,423,12,435,1.37772,103.960509
518165,97,17,114,1.377236,103.96113
518166,886,27,913,1.377236,103.96113
518167,80,81,161,1.299509,103.837
518168,209,179,388,1.376224,103.959729
518169,96,78,174,1.376224,103.959729
518170,928,16,944,1.370543,103.945641
518171,1639,6,1645,1.370543,103.945641
518172,697,6,703,1.370543,103.945641
518173,438,10,448,1.370543,103.945641
518174,537,1,538,1.299509,103.837
518175,420,13,433,1.370258,103.945808
518176,502,2465,2967,1.370543,103.945641
518177,163,6,169,1.299509,103.837
518178,41,211,252,1.299509,103.837
518179,4,5,9,1.299509,103.837
518180,342,63,405,1.299509,103.837
518181,196,287,483,1.40624,103.759964
518182,159,196,355,1.299509,103.837
518183,1352,42,1394,1.299509,103.837
518184,774,1518,2292,1.377236,103.96113
518185,436,753,1189,1.376126,103.960801
518186,180,41,221,1.299509,103.837
518187,231,267,498,1.299509,103.837
518188,740,121,861,1.376167,103.96094
518189,180,620,800,1.299509,103.837
518190,1198,9,1207,1.371345,103.943893
518191,502,8,510,1.370876,103.944022
518192,1028,48,1076,1.370941,103.944406
518193,152,10,162,1.371255,103.944191
518194,551,2690,3241,1.371016,103.944808
518195,1086,720,1806,1.370543,103.945641
518196,466,950,1416,1.370543,103.945641
518197,881,218,1099,1.370543,103.945641
518198,667,14,681,1.370543,103.945641
518199,1207,16,1223,1.370543,103.945641
518200,10,7,17,1.398514,103.929002
518201,93,58,151,1.299509,103.837
518205,788,108,896,1.373071,103.942671
518206,536,10,546,1.373075,103.942643
518207,350,1076,1426,1.37304,103.943302
518208,560,916,1476,1.372878,103.943708
518209,624,831,1455,1.372823,103.944326
518210,566,425,991,1.372824,103.944299
518211,1036,1071,2107,1.371534,103.944712
518212,585,355,940,1.371892,103.944283
518213,1460,54,1514,1.371852,103.944063
518214,862,56,918,1.371781,103.943697
518215,542,216,758,1.372376,103.943896
518216,515,43,558,1.37237,103.943521
518217,654,41,695,1.372364,103.943097
518218,19,6,25,1.372651,103.94314
518219,734,6,740,1.37262,103.942824
518220,39,207,246,1.380419,103.930751
518225,1,0,1,1.364719,103.974075
518226,21,71,92,1.378435,103.948245
518228,28,251,279,1.391799,103.931344
518230,496,3,499,1.391885,103.931778
518232,154,64,218,1.386977,103.930351
518233,56,61,117,1.387979,103.930083
518234,431,116,547,1.390108,103.929228
518235,19,5,24,1.389424,103.930266
518237,2,6,8,1.389666,103.93033
518238,19,47,66,1.390237,103.929639
518239,139,534,673,1.371115,103.964096
518240,122,764,886,1.37082,103.964581
518241,41,2,43,1.37888,103.944908
518242,0,2,2,1.299509,103.837
518243,0,1,1,1.379718,103.94848
518244,17,0,17,1.379421,103.944858
518245,1,1,2,1.378924,103.94489
518246,0,5,5,1.379432,103.944884
518247,0,2,2,1.3791,103.944818
518248,8,0,8,1.379454,103.944938
518250,6,3,9,1.379476,103.944991
518251,2,1,3,1.36427,103.97416
518253,15,1,16,1.37942,103.944821
518254,7,2,9,1.37952,103.945098
518255,16,13,29,1.379452,103.944884
518256,13,0,13,1.379542,103.945151
518257,0,5,5,1.379474,103.944938
518258,5,0,5,1.379564,103.945204
518259,21,0,21,1.379518,103.945044
518260,6,0,6,1.379586,103.945258
518261,3,0,3,1.379333,103.944793
518262,0,11,11,1.379608,103.945311
518263,23,9,32,1.379606,103.945258
518264,18,0,18,1.37963,103.945364
518265,0,2,2,1.379144,103.9448
518266,1,4,5,1.379652,103.945418
518267,5,24,29,1.379684,103.945461
518268,1,0,1,1.379012,103.944854
518269,1,12,13,1.380308,103.945252
518270,0,1,1,1.379674,103.945471
518271,4,2,6,1.379694,103.945471
518273,7,0,7,1.379718,103.945533
518274,3,0,3,1.379562,103.945151
518275,36,1,37,1.379743,103.945595
518276,18,0,18,1.37977,103.945713
518277,9,4,13,1.379791,103.945718
518278,0,1,1,1.37969,103.945511
518279,5,0,5,1.37984,103.945842
518281,1,1,2,1.37965,103.945364
518282,7,4,11,1.379865,103.945956
518284,2,0,2,1.379889,103.945965
518285,7,8,15,1.379986,103.946212
518286,3,3,6,1.379929,103.946117
518287,17,13,30,1.380035,103.946336
518288,2,0,2,1.379897,103.946036
518289,2,0,2,1.379961,103.946198
518290,9,1,10,1.379992,103.946279
518291,1,2,3,1.379738,103.945633
518292,1,0,1,1.379801,103.945794
518293,1,4,5,1.38025,103.94669
518294,20,1,21,1.380056,103.94644
518295,1,6,7,1.380372,103.946794
518296,37,0,37,1.380088,103.946521
518297,80,9,89,1.380372,103.946794
518298,4,1,5,1.380118,103.946584
518299,12,6,18,1.380223,103.946319
518301,0,19,19,1.380265,103.946395
518302,20,1,21,1.380258,103.946717
518303,8,9,17,1.380269,103.946452
518304,2,0,2,1.380084,103.946459
518305,4,10,14,1.380277,103.946504
518306,4,0,4,1.380399,103.946836
518307,15,10,25,1.380247,103.946577
518308,7,0,7,1.380452,103.946895
518310,1,0,1,1.380024,103.946359
518311,2,5,7,1.380409,103.947112
518312,11,0,11,1.380356,103.947187
518314,4,0,4,1.380229,103.947325
518315,5,8,13,1.380178,103.94732
518316,3,7,10,1.378376,103.943771
518317,2,829,831,1.378356,103.943756
518318,0,1,1,1.380461,103.947037
518319,11,1,12,1.378376,103.943751
518321,5,10,15,1.37841,103.943754
518322,143,0,143,1.378488,103.943825
518324,13,1,14,1.37854,103.943858
518325,8,6,14,1.378478,103.943798
518326,4,1,5,1.378592,103.943892
518327,0,1,1,1.37841,103.943774
518328,13,0,13,1.378643,103.943926
518329,0,13,13,1.378546,103.943842
518330,26,0,26,1.378695,103.94396
518331,0,3,3,1.380138,103.946584
518332,0,4,4,1.378747,103.943993
518333,3,0,3,1.37858,103.943864
518334,2,0,2,1.380329,103.946777
518336,3,6,9,1.378841,103.944051
518337,0,1,1,1.378512,103.94382
518339,4,0,4,1.378749,103.943975
518340,13,3,16,1.378783,103.943997
518341,2,2,4,1.378817,103.944019
518342,0,1,1,1.378681,103.943931
518343,6,0,6,1.378966,103.944172
518344,3,1,4,1.378951,103.944225
518346,6,2,8,1.378891,103.944311
518347,3,0,3,1.378614,103.943886
518348,0,2,2,1.378799,103.944027
518349,186,0,186,1.37877,103.944483
518350,1,1,2,1.37881,103.944426
518352,1,37,38,1.378659,103.944645
518353,12,89,101,1.378055,103.944218
518354,8,142,150,1.378068,103.944247
518356,3,4,7,1.378104,103.944272
518357,2,3,5,1.378124,103.944265
518358,12,0,12,1.378177,103.94432
518360,0,2,2,1.37873,103.94454
518361,0,1,1,1.378851,103.944041
518362,1,1,2,1.378249,103.944369
518363,0,10,10,1.378262,103.944358
518364,3,2,5,1.378394,103.944467
518366,0,1,1,1.378216,103.944327
518367,0,2,2,1.378322,103.944418
518368,0,1,1,1.378467,103.944515
518369,179,0,179,1.378401,103.944451
518371,1,2,3,1.37885,103.944368
518372,15,8,23,1.378639,103.944645
518373,35,0,35,1.378493,103.944513
518374,0,1,1,1.378539,103.944564
518375,13,9,22,1.378701,103.944742
518376,11,0,11,1.378764,103.944839
518377,8,1,9,1.378826,103.944936
518378,53,4,57,1.378649,103.944635
518379,6,0,6,1.378844,103.944978
518380,4,5,9,1.378859,103.944966
518381,1,2,3,1.378447,103.944482
518382,110,0,110,1.378872,103.944996
518384,1,2,3,1.378861,103.945019
518387,1,3,4,1.378968,103.945269
518388,1,0,1,1.37867,103.944694
518389,0,1,1,1.378949,103.945178
518390,2,0,2,1.378355,103.94442
518391,0,3,3,1.378897,103.945057
518392,1,2,3,1.379039,103.945436
518393,1,5,6,1.379074,103.945519
518394,40,0,40,1.379026,103.945359
518395,3,7,10,1.379109,103.945603
518396,0,3,3,1.379,103.945299
518397,1,0,1,1.379003,103.945353
518398,6,0,6,1.379077,103.94548
518399,1,4,5,1.37918,103.945769
518400,2,17,19,1.379103,103.945541
518401,0,2,2,1.378975,103.945238
518402,16,1,17,1.379129,103.945601
518403,0,3,3,1.379052,103.94542
518404,6,4,10,1.379155,103.945662
518405,2,3,5,1.379286,103.946019
518406,1,0,1,1.379145,103.945686
518407,0,5,5,1.379322,103.946103
518408,17,1,18,1.379206,103.945783
518409,17,2,19,1.379357,103.946186
518410,2,0,2,1.379216,103.945853
518411,1,1,2,1.379232,103.945843
518412,0,2,2,1.379393,103.946269
518413,0,1,1,1.37918,103.945722
518414,3,0,3,1.379251,103.945936
518415,3,4,7,1.379464,103.946436
518416,0,7,7,1.379309,103.946025
518417,9,3,12,1.379499,103.946519
518418,1,0,1,1.379428,103.946353
518419,0,9,9,1.379534,103.946603
518420,15,5,20,1.37936,103.946146
518421,12,6,18,1.37957,103.946686
518422,4,0,4,1.379386,103.946206
518423,7,1,8,1.379605,103.946769
518424,21,5,26,1.379412,103.946267
518425,1,8,9,1.379656,103.946865
518426,1,0,1,1.379334,103.946085
518427,12,1,13,1.379656,103.946865
518429,10,5,15,1.379765,103.947004
518430,134,1,135,1.379489,103.946448
518431,0,3,3,1.379283,103.945964
518432,7,1,8,1.379514,103.946509
518433,23,6,29,1.379891,103.947118
518434,3,0,3,1.379765,103.947004
518435,1,0,1,1.379437,103.946327
518438,2,0,2,1.379257,103.945904
518440,20,11,31,1.379617,103.946751
518441,0,13,13,1.380158,103.94732
518442,7,0,7,1.379643,103.946811
518443,114,16,130,1.379665,103.946847
518444,1,0,1,1.37997,103.947178
518445,2,6,8,1.379732,103.946945
518446,1,0,1,1.37971,103.946919
518447,8,4,12,1.379822,103.947047
518448,1,3,4,1.379867,103.947079
518449,1,0,1,1.379777,103.946996
518450,2,0,2,1.379592,103.94669
518451,87,1,88,1.380031,103.947205
518452,5,0,5,1.380086,103.947247
518453,0,1,1,1.379922,103.947121
518454,5,7,12,1.380168,103.94731
518455,1238,55,1293,1.390887,103.931184
518457,3385,98612,101997,1.372567,103.950162
518458,20,1846,1866,1.367897,103.964391
518462,9,22,31,1.371692,103.922369
518463,0,31,31,1.370877,103.922632
518470,5,0,5,1.368467,103.924771
518471,1,9,10,1.367592,103.929179
518472,2,49,51,1.367869,103.929169
518473,4,28,32,1.368008,103.929401
518474,3,180,183,1.299509,103.837
518476,6,524,530,1.368364,103.924664
518486,1,86,87,1.368332,103.924629
518517,16,2,18,1.380429,103.945796
518518,9,5,14,1.380476,103.945815
518519,3,3,6,1.380492,103.945794
518520,1,1,2,1.379976,103.947163
518521,1,0,1,1.380141,103.947289
518522,10,1,11,1.380808,103.945805
518523,0,1,1,1.380618,103.945791
518524,6,1,7,1.381028,103.945798
518525,4,4,8,1.380871,103.945783
518526,4,5,9,1.381249,103.945792
518527,0,1,1,1.380744,103.945787
518528,3,4,7,1.381241,103.945899
518530,11,0,11,1.381242,103.946016
518531,6,0,6,1.381239,103.945782
518532,1,0,1,1.380997,103.945779
518533,0,6,6,1.381332,103.945769
518534,12,0,12,1.381443,103.946428
518535,6,2,8,1.381415,103.945766
518536,13,0,13,1.381674,103.94656
518537,0,2,2,1.380587,103.945812
518538,8,1,9,1.381906,103.946691
518539,12,0,12,1.381747,103.945755
518540,5,1,6,1.382012,103.946747
518541,1,1,2,1.381581,103.945761
518542,15,6,21,1.381489,103.946237
518543,13,6,19,1.382059,103.945747
518544,1,7,8,1.381666,103.946381
518545,0,1,1,1.381246,103.946251
518546,1,3,4,1.381259,103.945782
518547,2,0,2,1.381913,103.94575
518549,7,1,8,1.382464,103.945966
518550,0,6,6,1.382454,103.945976
518584,23,0,23,1.379616,103.944799
518585,0,3,3,1.37954,103.946569
518586,13,1,14,1.379599,103.944765
518587,5,1,6,1.379599,103.944745
518588,68,0,68,1.379595,103.944674
518589,2,0,2,1.382319,103.945884
518592,47,0,47,1.379586,103.944491
518594,3,5,8,1.379581,103.9444
518596,0,3,3,1.379616,103.944779
518597,3,1,4,1.379572,103.944217
518598,2,0,2,1.379595,103.944671
518599,7,1,8,1.379568,103.944125
518600,1,4,5,1.379574,103.944224
518601,1,0,1,1.382174,103.945801
518602,7,0,7,1.37957,103.944149
518603,1,4,5,1.379559,103.943943
518604,4,0,4,1.379566,103.944075
518606,2,0,2,1.379577,103.944298
518607,9,0,9,1.37954,103.94375
518608,12,0,12,1.379559,103.943926
518609,7,0,7,1.379555,103.943852
518610,0,11,11,1.379552,103.943777
518611,33,40,73,1.37956,103.94375
518612,7,21,28,1.379616,103.944799
518645,7,12,19,1.380311,103.944492
518646,3,15,18,1.380307,103.944512
518647,4,0,4,1.380355,103.944491
518648,0,5,5,1.380347,103.944511
518649,5,0,5,1.380444,103.944488
518650,178,0,178,1.380427,103.944509
518651,22,1,23,1.380532,103.944486
518652,23,2,25,1.380507,103.944506
518653,7,2,9,1.380621,103.944483
518654,57,0,57,1.380586,103.944504
518656,8,3,11,1.380666,103.944502
518658,23,0,23,1.380746,103.9445
518659,3,0,3,1.379581,103.944373
518660,0,3,3,1.380886,103.944476
518662,4,0,4,1.380906,103.944495
518663,58,1,59,1.381063,103.944471
518664,1,6,7,1.380986,103.944493
518665,19,1,20,1.381151,103.944469
518667,50,0,50,1.38124,103.944466
518668,0,2,2,1.379563,103.944001
518669,12,0,12,1.381328,103.944464
518670,11,1,12,1.381225,103.944487
518671,25,15,40,1.381417,103.944461
518672,4,0,4,1.381305,103.944484
518673,1,0,1,1.379563,103.944034
518674,0,43,43,1.381385,103.944482
518675,41,0,41,1.381604,103.944453
518676,6,0,6,1.381465,103.94448
518677,0,2,2,1.381146,103.944489
518678,2,0,2,1.381653,103.944442
518679,13,0,13,1.381746,103.944413
518680,0,15,15,1.381604,103.944473
518681,13,1,14,1.381826,103.944358
518682,25,2,27,1.381702,103.944452
518683,6,0,6,1.381882,103.944284
518684,4,22,26,1.38179,103.944414
518685,249,3,252,1.381925,103.944207
518686,18,2,20,1.381826,103.944378
518687,6,1,7,1.381968,103.94413
518688,14,2,16,1.381881,103.944308
518689,5,0,5,1.382011,103.944052
518691,7,2,9,1.382054,103.943975
518692,4,4,8,1.381959,103.944166
518693,1,0,1,1.381505,103.944459
518694,0,5,5,1.381998,103.944096
518695,5,1,6,1.38214,103.94382
518696,1,0,1,1.382097,103.943898
518697,1,0,1,1.382037,103.944025
518698,80,0,80,1.382076,103.943955
518699,1,0,1,1.382183,103.943743
518700,5,0,5,1.382116,103.943884
518702,24,0,24,1.382155,103.943813
518703,2,0,2,1.381554,103.944476
518704,6,0,6,1.382194,103.943743
518705,2,11,13,1.382354,103.943434
518706,32,1,33,1.382233,103.943672
518707,4,0,4,1.382397,103.943356
518708,1,2,3,1.380826,103.944498
518709,100,0,100,1.38244,103.943279
518710,2,2,4,1.382312,103.943531
518711,153,0,153,1.382483,103.943202
518712,116,1,117,1.382351,103.94346
518713,7,0,7,1.382526,103.943124
518714,4,0,4,1.38239,103.94339
518716,23,3,26,1.382429,103.943319
518717,4,0,4,1.382612,103.94297
518718,19,0,19,1.382468,103.943249
518719,2,0,2,1.382312,103.943511
518720,1,14,15,1.382507,103.943178
518721,2,0,2,1.382655,103.942892
518722,3,0,3,1.382272,103.943602
518723,38,0,38,1.382741,103.942738
518724,5,2,7,1.382586,103.943037
518725,11,13,24,1.382752,103.942709
518726,5,0,5,1.382625,103.942966
518727,1,1,2,1.382698,103.942815
518728,7,3,10,1.382703,103.942825
518729,1,0,1,1.382226,103.943666
518730,2,13,15,1.382762,103.942719
518764,552,34,586,1.379932,103.935493
518765,281,5169,5450,1.379692,103.93558
518766,338,955,1293,1.379981,103.934967
518767,511,1313,1824,1.380193,103.935094
518768,683,1305,1988,1.380426,103.935254
518769,465,3092,3557,1.380598,103.935373
518770,458,610,1068,1.380532,103.935637
518771,500,405,905,1.380423,103.936095
518798,197,7,204,1.375781,103.935197
518799,306,526,832,1.376067,103.937002
518866,123,5,128,1.374697,103.945633
518900,44,99,143,1.366863,103.952642
518901,276,504,780,1.367101,103.949261
518902,259,62,321,1.367979,103.950803
518934,452,1540,1992,1.372334,103.959377
518935,330,7,337,1.372421,103.957724
518968,157,1363,1520,1.372305,103.962479
518969,218,1461,1679,1.369233,103.962377
519073,298,4286,4584,1.366972,103.956826
519075,188,3828,4016,1.364903,103.961329
519108,57,134,191,1.383915,103.943689
519109,20,3,23,1.383915,103.943689
519110,47,0,47,1.385524,103.942374
519111,31,86,117,1.383669,103.943946
519112,21,9,30,1.383586,103.944039
519113,18,19,37,1.383483,103.944179
519114,7,12,19,1.383296,103.944494
519115,11,34,45,1.383171,103.944717
519116,22,34,56,1.383046,103.94494
519117,21,28,49,1.38292,103.945163
519118,46,36,82,1.382795,103.945386
519119,20,62,82,1.382762,103.945444
519120,20,15,35,1.382729,103.945502
519121,4,6,10,1.386434,103.941633
519122,14,21,35,1.382204,103.946055
519123,15,121,136,1.382087,103.946273
519124,66,1,67,1.381825,103.946205
519125,19,51,70,1.381929,103.946491
519126,233,26,259,1.382012,103.946747
519127,35,43,78,1.381712,103.947258
519128,11,1,12,1.381707,103.947268
519129,7,33,40,1.381701,103.947278
519130,6,0,6,1.381111,103.947473
519131,3,0,3,1.382547,103.943107
519132,16,72,88,1.3812,103.947824
519133,89,24,113,1.381009,103.948004
519134,56,156,212,1.380876,103.948197
519136,6,0,6,1.383248,103.946982
519137,9,0,9,1.384529,103.945529
519139,2,0,2,1.382664,103.942896
519140,1,0,1,1.382742,103.942754
519142,6,0,6,1.384016,103.946866
519143,1,0,1,1.384313,103.945923
519144,13,2,15,1.382906,103.950221
519146,5,1,6,1.384023,103.946869
519147,209,42,251,1.381666,103.94847
519148,14,4,18,1.38517,103.944716
519149,224,0,224,1.384139,103.943539
519150,12,0,12,1.385124,103.943968
519151,13,19,32,1.299509,103.837
519152,24,0,24,1.299509,103.837
519153,5,0,5,1.299509,103.837
519169,2,0,2,1.384369,103.945733
519170,0,1,1,1.384344,103.945888
519171,10,1,11,1.380959,103.946814
519172,4,5,9,1.381702,103.947268
519173,2,1,3,1.380967,103.947643
519174,6,0,6,1.381712,103.947258
519175,9,3,12,1.299509,103.837
519208,1,25,26,1.380291,103.94384
519209,9,19,28,1.380291,103.94386
519210,3,3,6,1.380334,103.943839
519211,15,0,15,1.380334,103.943859
519212,4,1,5,1.380421,103.943837
519213,4,3,7,1.380421,103.943857
519214,1,3,4,1.380507,103.943835
519215,1,2,3,1.381336,103.947036
519216,7,0,7,1.380593,103.943833
519217,20,1,21,1.380593,103.943853
519218,1,0,1,1.380665,103.946872
519219,7,0,7,1.380679,103.943851
519221,12,14,26,1.380766,103.943849
519222,0,2,2,1.380856,103.946814
519223,1,0,1,1.380679,103.943831
519224,11,0,11,1.380938,103.943825
519225,4,0,4,1.380938,103.943845
519226,3,0,3,1.380507,103.943855
519228,16,33,49,1.381111,103.943821
519229,43,0,43,1.381111,103.943841
519230,102,0,102,1.381197,103.943819
519231,1,0,1,1.380852,103.943847
519232,6,0,6,1.381284,103.943808
519233,11,1,12,1.38124,103.943838
519234,12,1,13,1.381368,103.943767
519235,1,0,1,1.381197,103.943839
519236,15,0,15,1.381428,103.943696
519237,4,0,4,1.381408,103.943755
519238,42,1,43,1.381467,103.943618
519239,12,0,12,1.381446,103.943679
519240,0,2,2,1.380852,103.943827
519241,7,15,22,1.381485,103.943603
519242,2,0,2,1.381506,103.94354
519243,64,0,64,1.381523,103.943526
519244,1,0,1,1.381329,103.943819
519246,0,3,3,1.381024,103.943823
519247,6,22,28,1.3816,103.943374
519248,1,0,1,1.381585,103.943384
519249,12,0,12,1.381638,103.943298
519250,1,0,1,1.381663,103.943229
519252,9,0,9,1.381742,103.943073
519254,12,9,21,1.381781,103.942995
519255,0,2,2,1.381545,103.943462
519256,11,0,11,1.38182,103.942917
519257,17,0,17,1.381792,103.942993
519258,12,0,12,1.38186,103.942839
519259,11,0,11,1.38183,103.942917
519260,4,0,4,1.381899,103.942761
519261,4,0,4,1.381869,103.942841
519262,3,0,3,1.381624,103.943306
519263,13,0,13,1.381907,103.942765
519264,45,19,64,1.381977,103.942605
519265,14,0,14,1.381946,103.942689
519267,3,7,10,1.381984,103.942612
519268,3,0,3,1.381938,103.942683
519269,2,0,2,1.381754,103.943069
519270,17,1,18,1.382095,103.942372
519272,3,0,3,1.382056,103.94245
519274,3,0,3,1.382135,103.942294
519275,1,1,2,1.382022,103.942536
519276,2,0,2,1.382138,103.942308
519277,11,0,11,1.382176,103.942231
519278,8,13,21,1.382252,103.94206
519279,34,1,35,1.382214,103.942155
519280,33,1934,1967,1.382262,103.942031
519281,6,29,35,1.382253,103.942079
519282,4,23,27,1.382272,103.942041
519283,21,113,134,1.299509,103.837
519284,13,160,173,1.381765,103.93983
519285,7,145,152,1.38168,103.940961
519286,5,8,13,1.299509,103.837
519287,4,130,134,1.299509,103.837
519288,9,3,12,1.381658,103.940208
519289,4,1,5,1.299509,103.837
519290,5,15,20,1.299509,103.837
519291,3,59,62,1.299509,103.837
519292,6220,71,6291,1.381745,103.941873
519316,268,174,442,1.383148,103.928277
519317,243,161,404,1.382934,103.927207
519318,53,20,73,1.386391,103.930656
519319,1,0,1,1.381703,103.943151
519320,24,63,87,1.384683,103.929548
519321,112,396,508,1.384415,103.929079
519322,10,25,35,1.384269,103.93046
519323,210,51,261,1.383441,103.927189
519324,25,1,26,1.384926,103.930809
519325,138,0,138,1.381541,103.927913
519326,130,138,268,1.381956,103.929627
519351,35,5,40,1.388395,103.932735
519352,82,53,135,1.385027,103.93646
519353,3,5,8,1.386735,103.936079
519354,2,2,4,1.385556,103.936541
519355,0,1,1,1.385985,103.931415
519385,41,757,798,1.37916,103.939304
519419,107,2609,2716,1.370648,103.955936
519420,73,5770,5843,1.370786,103.957085
519421,213,3634,3847,1.374513,103.954463
519455,73,142,215,1.369059,103.95897
519456,45,4618,4663,1.370928,103.960372
519457,640,3544,4184,1.368309,103.959529
519459,528,3456,3984,1.368831,103.959585
519460,363,406,769,1.368831,103.959585
519461,23,566,589,1.368831,103.959585
519462,650,165,815,1.369711,103.959337
519463,346,81,427,1.369513,103.959727
519464,815,903,1718,1.369377,103.960124
519490,30,10521,10551,1.373639,103.949739
519491,603,7519,8122,1.37484,103.953523
519492,476,70,546,1.373953,103.95402
519493,283,8,291,1.373848,103.95362
519494,261,3,264,1.374366,103.953307
519495,298,730,1028,1.375095,103.953365
519496,19,17,36,1.374329,103.953594
519497,676,507,1183,1.375978,103.953397
519498,335,2326,2661,1.378252,103.94271
519499,21,2639,2660,1.375265,103.953113
519500,6,339,345,1.374766,103.952351
519524,80,53,133,1.377331,103.939371
519525,55,2436,2491,1.375048,103.94063
519526,26,918,944,1.379683,103.933576
519527,1179,570,1749,1.382669,103.93487
519528,1890,464,2354,1.378293,103.932269
519529,190,121,311,1.375706,103.939709
519530,385,1814,2199,1.373547,103.941339
519531,675,5,680,1.373547,103.941339
519532,802,273,1075,1.373547,103.941339
519599,9288,16176,25464,1.379085,103.955139
519634,254,1010,1264,1.373013,103.949331
519635,8,250,258,1.370348,103.951416
519636,14,2338,2352,1.37077,103.951464
519637,86,415,501,1.37131,103.951285
519638,6,80,86,1.372664,103.951927
519639,2,4,6,1.372626,103.952514
519640,526,1329,1855,1.374293,103.951975
519668,3,19,22,1.380339,103.945134
519669,0,5,5,1.380359,103.945153
519670,5,3,8,1.380385,103.945132
519671,78,0,78,1.380424,103.945151
519672,7,0,7,1.380475,103.945129
519673,6,1,7,1.380553,103.945147
519674,2,0,2,1.382213,103.942138
519675,9,1,10,1.380682,103.945143
519676,1,3,4,1.380657,103.945124
519677,7,0,7,1.380812,103.945139
519679,5,0,5,1.380942,103.945135
519681,3,2,5,1.381071,103.945131
519682,14,12,26,1.380929,103.945115
519683,0,1,1,1.386022,103.933674
519684,9,5,14,1.381019,103.945112
519685,3,2,5,1.38133,103.945122
519686,1,0,1,1.3812,103.945126
519687,24,4,28,1.38146,103.945118
519688,2,2,4,1.3812,103.945106
519690,3,1,4,1.381291,103.945104
519691,4,0,4,1.381718,103.94511
519692,1,0,1,1.38111,103.945109
519693,8,0,8,1.381848,103.945106
519694,19,0,19,1.381472,103.945098
519695,1,0,1,1.381382,103.945101
519696,5,3,8,1.381563,103.945095
519697,19,29,48,1.382107,103.945098
519698,4,10,14,1.381654,103.945092
519699,64,2,66,1.382167,103.945079
519700,1,2,3,1.382174,103.942216
519701,2,0,2,1.380566,103.945126
519702,146,5,151,1.381835,103.945087
519703,128,1,129,1.382785,103.945396
519704,5,4,9,1.381926,103.945084
519705,15,18,33,1.382233,103.944965
519706,1,2,3,1.381744,103.945089
519707,10,9,19,1.382298,103.944852
519708,16,3,19,1.382107,103.945078
519709,10,3,13,1.38243,103.944625
519711,1,1,2,1.382167,103.945079
519712,4,1,5,1.3822,103.945002
519713,3,0,3,1.382016,103.945081
519714,2,6,8,1.382233,103.944945
519715,9,7,16,1.382824,103.943943
519716,1,0,1,1.381978,103.945102
519717,15,2,17,1.382364,103.944718
519718,38,6,44,1.38243,103.944605
519719,9,2,11,1.383218,103.943262
519720,3,1,4,1.382495,103.944491
519721,26,12,38,1.383349,103.943035
519722,3,6,9,1.382561,103.944378
519723,0,1,1,1.382298,103.944832
519724,4,2,6,1.382692,103.944151
519725,17,6,23,1.382758,103.944037
519726,0,6,6,1.382824,103.943923
519728,0,5,5,1.382955,103.943696
519729,19,0,19,1.383021,103.943583
519730,1,5,6,1.383086,103.943469
519731,2,0,2,1.382561,103.944398
519732,9,12,21,1.383218,103.943242
519733,26,0,26,1.383283,103.943129
519734,3,10,13,1.383339,103.943025
519735,12,4,16,1.382955,103.943716
519736,14,1,15,1.383086,103.943489
519737,0,3,3,1.382692,103.944171
519768,4,313,317,1.372406,103.940734
519769,5,49,54,1.372419,103.940804
519770,29,0,29,1.372419,103.940867
519771,8,2,10,1.372413,103.940923
519772,4,0,4,1.372419,103.94098
519773,1,2,3,1.299509,103.837
519774,4,0,4,1.372425,103.941083
519775,5,4,9,1.372436,103.94114
519776,4,1,5,1.372473,103.9413
519777,5,2,7,1.372489,103.941346
519779,2,0,2,1.383152,103.943356
519780,10,0,10,1.372546,103.941479
519781,0,1,1,1.382627,103.944264
519782,2,6,8,1.372581,103.94157
519783,9,43,52,1.372399,103.941466
519784,5,15,20,1.372596,103.941607
519785,0,10,10,1.372424,103.941541
519787,7,2,9,1.372448,103.941593
519788,0,13,13,1.37269,103.941876
519789,15,7,22,1.372467,103.941657
519790,10,0,10,1.372719,103.941922
519791,7,11,18,1.372485,103.941728
519792,3,2,5,1.372759,103.941978
519794,1,1,2,1.372531,103.94145
519795,4,1,5,1.37286,103.942117
519796,4,1,5,1.372887,103.942153
519797,0,3,3,1.372425,103.941032
519798,0,1,1,1.37256,103.94152
519799,0,5,5,1.372721,103.942128
519801,9,0,9,1.372662,103.942061
519802,0,2,2,1.372839,103.942081
519803,3,3,6,1.372592,103.941952
519804,35,12,47,1.372564,103.941912
519805,4,13,17,1.372174,103.942126
519807,4,4,8,1.372215,103.942194
519808,1,0,1,1.372747,103.942168
519809,2,5,7,1.37227,103.942285
519810,11,1,12,1.372298,103.94233
519811,1,3,4,1.372326,103.942376
519812,1,0,1,1.372243,103.94224
519813,3,2,5,1.372371,103.942457
519814,4,3,7,1.372182,103.942071
519815,2,2,4,1.372215,103.942028
519816,1,0,1,1.372353,103.942422
519817,56,5,61,1.372163,103.942522
519818,1,0,1,1.372173,103.942571
519819,11,5,16,1.372081,103.942403
519820,1,35,36,1.372031,103.942361
519821,2,10,12,1.372136,103.942134
519822,1,1,2,1.372627,103.941997
519823,3,6,9,1.372066,103.942226
519824,5,3,8,1.372018,103.942288
519825,5,2,7,1.371971,103.94235
519826,17,3,20,1.371924,103.942411
519827,3,4,7,1.371876,103.942473
519828,25,4,29,1.371829,103.942534
519829,3,10,13,1.371782,103.942596
519830,5,52,57,1.371729,103.942652
519831,3,27,30,1.371676,103.942708
519832,7,0,7,1.371623,103.942764
519833,1,8,9,1.37157,103.94282
519834,1,0,1,1.372098,103.942454
519835,0,3,3,1.372782,103.942213
519836,73,2,75,1.371381,103.94297
519837,0,3,3,1.371446,103.942922
519838,25,0,25,1.37128,103.943035
519839,4,1,5,1.371212,103.943074
519840,24,24,48,1.371143,103.943114
519841,5,1,6,1.371075,103.943154
519842,2,3,5,1.371007,103.943194
519843,11,6,17,1.370938,103.943234
519844,15,5,20,1.37087,103.943273
519845,35,36,71,1.370802,103.943313
519846,0,89,89,1.372726,103.940701
519847,1,1,2,1.372113,103.942165
519849,2,0,2,1.372726,103.940701
519850,119,0,119,1.372726,103.940701
519851,7,0,7,1.372726,103.940701
519855,15,0,15,1.372858,103.941427
519856,2,1,3,1.371348,103.942995
519857,1,0,1,1.371511,103.942872
519858,0,1,1,1.372951,103.941611
519859,5,0,5,1.372989,103.94175
519860,8,2,10,1.373007,103.94177
519861,12,0,12,1.373032,103.941857
519862,125,0,125,1.373055,103.941913
519863,9,6,15,1.373084,103.941978
519885,20,42,62,1.374331,103.940953
519886,95,36,131,1.380371,103.947978
519916,4,0,4,1.380463,103.946041
519917,1,0,1,1.372999,103.941663
519918,7,1,8,1.380609,103.9465
519919,4,0,4,1.380651,103.946686
519920,15,0,15,1.380699,103.94704
519921,2,2,4,1.380674,103.947198
519922,58,0,58,1.380575,103.947334
519923,21,6,27,1.380437,103.947508
519924,27,33,60,1.380437,103.947508
519925,87,85,172,1.380697,103.948021
519926,53,0,53,1.384944,103.943441
519927,3,0,3,1.37288,103.941516
519928,19,16,35,1.380651,103.946686
519929,509,1024,1533,1.373852,103.9402
519930,724,183,907,1.373852,103.9402
519931,371,658,1029,1.374053,103.939278
519932,593,742,1335,1.374494,103.939116
519933,680,151,831,1.374693,103.939498
519934,876,315,1191,1.374598,103.94001
519935,615,1630,2245,1.373852,103.940208
519936,29,13,42,1.380674,103.947198
519937,111,196,307,1.372741,103.939309
519938,795,1614,2409,1.377302,103.941495
519939,518,6,524,1.377302,103.941495
519940,22,18,40,1.376793,103.942122
519941,327,49,376,1.377106,103.942364
519942,138,13,151,1.377275,103.942186
519943,517,9,526,1.377302,103.941495
519944,900,2726,3626,1.377302,103.941495
519945,216,1304,1520,1.379907,103.942983
519946,46,1,47,1.379741,103.942237
519947,28,0,28,1.379248,103.943527
519948,15,2,17,1.379336,103.943415
519949,85,3,88,1.379718,103.94263
519950,85,3670,3755,1.379907,103.942983
519951,78,1513,1591,1.299509,103.837
519952,49,81,130,1.299509,103.837
519953,53,36,89,1.299509,103.837
519954,213,178,391,1.379907,103.942983
519955,222,2,224,1.299509,103.837
519956,80,109,189,1.299509,103.837
519957,105,7,112,1.299509,103.837
519958,13,16,29,1.299509,103.837
519959,1385,613,1998,1.371565,103.941295
519960,1055,335,1390,1.370984,103.942002
519961,1050,310,1360,1.370515,103.942621
519962,514,236,750,1.369629,103.943279
519963,619,129,748,1.37021,103.94327
519964,818,34,852,1.371063,103.94264
519965,38,15,53,1.371411,103.942197
519966,657,22,679,1.371957,103.941821
520031,56,139,195,1.339872,103.943002
520101,2241,2869,5110,1.34101,103.95148
520102,261,530,791,1.341361,103.951189
520103,479,3980,4459,1.347684,103.94615
520104,499,244,743,1.347294,103.946427
520105,110,645,755,1.341236,103.950525
520106,209,208,417,1.341904,103.950689
520107,239,305,544,1.342174,103.950426
520108,89,4361,4450,1.34305,103.950904
520109,271,143,414,1.342359,103.950082
520110,39,298,337,1.342802,103.950132
520111,157,212,369,1.342442,103.949506
520112,706,149,855,1.343101,103.949504
520113,529,181,710,1.342895,103.949724
520114,399,271,670,1.34379,103.950315
520115,4,203,207,1.343219,103.950464
520116,327,283,610,1.343678,103.951217
520117,352,350,702,1.34464,103.951336
520118,24,90,114,1.344907,103.946751
520119,198,3552,3750,1.343846,103.95184
520120,645,7194,7839,1.344733,103.953034
520121,36,1595,1631,1.345002,103.948144
520122,680,316,996,1.345555,103.95249
520123,282,563,845,1.345275,103.95335
520124,372,205,577,1.346334,103.953376
520125,1,173,174,1.346123,103.953949
520126,425,144,569,1.346909,103.95407
520127,409,178,587,1.34671,103.954304
520128,62,92,154,1.346902,103.954847
520129,6,790,796,1.346352,103.954339
520130,208,3097,3305,1.346243,103.954805
520131,69,3674,3743,1.345497,103.953968
520132,64,5446,5510,1.346699,103.955851
520133,219,218,437,1.347339,103.955572
520134,364,263,627,1.347767,103.955429
520135,256,4129,4385,1.347885,103.957114
520136,334,111,445,1.347853,103.956207
520137,329,457,786,1.347581,103.956241
520138,167,323,490,1.347233,103.956888
520139,67,4793,4860,1.34669,103.956506
520140,358,4213,4571,1.347674,103.943774
520141,217,2825,3042,1.345729,103.954998
520142,156,87,243,1.345435,103.955133
520143,734,523,1257,1.348109,103.943659
520144,110,139,249,1.345355,103.955602
520145,148,284,432,1.344913,103.955534
520146,188,3144,3332,1.344643,103.955832
520147,126,93,219,1.345372,103.955883
520148,255,2048,2303,1.346275,103.955978
520149,245,512,757,1.345956,103.955974
520150,234,1407,1641,1.346176,103.957147
520151,239,3430,3669,1.345744,103.95715
520153,146,2354,2500,1.345245,103.957096
520154,236,1407,1643,1.344831,103.957024
520155,143,1048,1191,1.344708,103.958392
520156,489,316,805,1.345118,103.958581
520157,293,291,584,1.34466,103.959356
520158,36,1,37,1.34428,103.959547
520159,52,0,52,1.344768,103.9597
520160,421,248,669,1.345186,103.959619
520161,92,0,92,1.345323,103.959954
520162,189,77,266,1.345724,103.959673
520163,248,1325,1573,1.345973,103.959073
520164,102,2478,2580,1.346043,103.958444
520165,299,442,741,1.345588,103.958852
520166,15,13281,13296,1.3457,103.958113
520167,11,65,76,1.343131,103.958556
520168,13,49,62,1.343084,103.958919
520201,28,279,307,1.352943,103.953569
520202,437,2353,2790,1.352848,103.952343
520203,486,258,744,1.352409,103.952489
520204,457,2512,2969,1.352197,103.951696
520205,204,287,491,1.351916,103.952154
520206,270,7834,8104,1.350917,103.952245
520207,521,388,909,1.351331,103.952213
520208,257,5186,5443,1.351418,103.953188
520209,455,194,649,1.351863,103.952839
520210,520,16734,17254,1.354012,103.953888
520211,311,4388,4699,1.354067,103.954792
520212,492,517,1009,1.354377,103.953892
520213,550,282,832,1.35475,103.953877
520214,120,569,689,1.354605,103.953526
520215,414,555,969,1.354608,103.953116
520216,697,10808,11505,1.354012,103.952513
520217,238,4976,5214,1.35422,103.951818
520218,496,346,842,1.354437,103.952491
520219,760,185,945,1.354837,103.952518
520220,136,582,718,1.355603,103.952075
520221,22,3671,3693,1.341777,103.956448
520222,100,4863,4963,1.341605,103.956896
520223,79,4068,4147,1.342096,103.957469
520224,112,262,374,1.343107,103.957229
520225,96,240,336,1.342413,103.957195
520226,53,74,127,1.342563,103.956952
520227,128,1806,1934,1.342119,103.95615
520228,292,892,1184,1.342671,103.955659
520229,270,75,345,1.34305,103.955831
520230,123,224,347,1.343249,103.955709
520231,203,111,314,1.34368,103.956804
520232,168,2619,2787,1.344213,103.957059
520233,112,4306,4418,1.344255,103.956512
520234,116,4524,4640,1.343532,103.955281
520235,9,2175,2184,1.342971,103.955314
520236,666,330,996,1.355938,103.947135
520237,436,1988,2424,1.355561,103.947119
520238,64,1550,1614,1.355732,103.946594
520239,57,2279,2336,1.354673,103.947203
520240,390,2638,3028,1.354673,103.947203
520241,204,655,859,1.354673,103.947203
520242,143,7642,7785,1.34318,103.954184
520243,202,1772,1974,1.343839,103.954878
520244,222,394,616,1.344088,103.954655
520245,229,244,473,1.344648,103.954161
520246,75,2519,2594,1.345102,103.954109
520247,44,5631,5675,1.344307,103.9535
520248,62,2815,2877,1.344085,103.953308
520249,848,2766,3614,1.352042,103.948076
520250,721,68,789,1.352326,103.948177
520251,943,159,1102,1.352835,103.948137
520252,133,368,501,1.35251,103.949094
520253,378,2728,3106,1.341878,103.952477
520254,147,3674,3821,1.341851,103.952015
520255,132,4857,4989,1.342557,103.951436
520256,161,4859,5020,1.34298,103.951878
520257,522,147,669,1.354011,103.949519
520258,411,57,468,1.354356,103.949759
520259,613,1124,1737,1.355086,103.94998
520260,467,376,843,1.354686,103.950014
520261,500,1600,2100,1.354257,103.950836
520262,670,672,1342,1.353784,103.950901
520263,845,756,1601,1.35325,103.951078
520264,235,141,376,1.352851,103.951031
520265,391,315,706,1.352404,103.950185
520266,341,3218,3559,1.352112,103.950447
520267,1114,921,2035,1.350829,103.949236
520268,565,985,1550,1.351399,103.947878
520269,413,268,681,1.350815,103.947829
520270,402,325,727,1.350037,103.94875
520271,1010,6643,7653,1.349904,103.949588
520272,335,4756,5091,1.349125,103.950233
520273,244,1373,1617,1.348764,103.950331
520274,263,231,494,1.348256,103.950055
520275,645,345,990,1.347992,103.950657
520276,301,140,441,1.347436,103.950737
520277,571,242,813,1.34725,103.950943
520278,634,152,786,1.34673,103.951364
520279,508,149,657,1.346604,103.951846
520280,457,5675,6132,1.347603,103.951694
520281,477,434,911,1.347303,103.95226
520282,276,5241,5517,1.347726,103.952356
520283,404,1258,1662,1.348705,103.952926
520284,447,369,816,1.349076,103.95246
520285,339,6721,7060,1.35004,103.952868
520286,558,824,1382,1.349569,103.952891
520287,291,2236,2527,1.349162,103.954157
520288,381,1170,1551,1.348747,103.954419
520289,635,363,998,1.34968,103.955049
520290,105,217,322,1.349798,103.954642
520291,516,306,822,1.350056,103.955029
520292,279,490,769,1.350193,103.955705
520293,580,173,753,1.350442,103.954763
520294,227,3203,3430,1.350616,103.954158
520295,251,213,464,1.350793,103.954742
520296,123,6563,6686,1.351018,103.955347
520297,370,372,742,1.351127,103.954746
520298,135,11208,11343,1.35166,103.954812
520299,5,201,206,1.3502,103.953924
520301,270,5565,5835,1.353372,103.955447
520302,350,5242,5592,1.352554,103.95511
520303,263,3250,3513,1.351956,103.955739
520304,486,87,573,1.352158,103.956256
520305,400,403,803,1.352429,103.955728
520306,104,416,520,1.353233,103.955748
520307,111,299,410,1.352939,103.956319
520308,394,152,546,1.352957,103.956767
520309,128,3181,3309,1.353433,103.956776
520310,159,1459,1618,1.353444,103.957096
520311,127,3690,3817,1.353385,103.957486
520312,203,176,379,1.35266,103.957087
520313,400,38,438,1.352197,103.956808
520314,487,109,596,1.352206,103.957117
520315,104,320,424,1.35222,103.957523
520316,347,447,794,1.351642,103.957812
520317,314,375,689,1.351553,103.956773
520318,236,1416,1652,1.351617,103.955978
520319,297,331,628,1.351032,103.956293
520320,634,192,826,1.350722,103.957027
520321,530,148,678,1.350725,103.957397
520322,928,173,1101,1.350895,103.958147
520323,118,261,379,1.35171,103.95841
520324,368,1692,2060,1.352556,103.959431
520325,172,711,883,1.352561,103.959111
520326,239,974,1213,1.352566,103.958597
520327,87,5145,5232,1.352456,103.958319
520328,175,155,330,1.353182,103.9583
520329,208,251,459,1.353331,103.958625
520330,145,1644,1789,1.353137,103.959382
520331,293,2925,3218,1.353166,103.959876
520332,382,713,1095,1.353279,103.960668
520333,83,168,251,1.353059,103.961026
520334,165,288,453,1.35254,103.96103
520335,81,181,262,1.352568,103.960701
520336,280,355,635,1.352623,103.960184
520337,214,988,1202,1.352539,103.959782
520338,529,1238,1767,1.351858,103.959553
520339,563,180,743,1.351281,103.958909
520340,296,213,509,1.351228,103.95989
520341,355,257,612,1.351207,103.961011
520342,414,153,567,1.351214,103.961716
520343,731,4808,5539,1.351945,103.961193
520345,567,3531,4098,1.351938,103.96231
520346,250,155,405,1.351247,103.962391
520347,564,239,803,1.351902,103.962992
520348,291,422,713,1.352754,103.963292
520349,215,389,604,1.353419,103.963088
520350,143,204,347,1.353832,103.96282
520351,316,5332,5648,1.352874,103.962755
520352,206,405,611,1.354171,103.96216
520353,296,553,849,1.354375,103.962821
520354,265,193,458,1.355099,103.962378
520355,63,151,214,1.355072,103.961513
520356,64,295,359,1.354427,103.961414
520357,113,4435,4548,1.354099,103.961524
520358,231,1915,2146,1.354327,103.960943
520359,201,386,587,1.355936,103.961529
520360,192,144,336,1.35543,103.96217
520361,378,271,649,1.356092,103.962381
520362,99,85,184,1.356241,103.961538
520363,156,12273,12429,1.355777,103.960731
520364,117,1546,1663,1.356851,103.95964
520365,289,213,502,1.357677,103.960896
520366,159,353,512,1.35763,103.961467
520367,167,119,286,1.35829,103.960333
520368,391,688,1079,1.358748,103.960978
520369,351,5182,5533,1.358614,103.960233
520370,82,6307,6389,1.357931,103.959529
520371,157,3435,3592,1.356947,103.958651
520372,124,878,1002,1.356545,103.95804
520373,135,15,150,1.356028,103.958719
520374,95,246,341,1.35654,103.958562
520381,474,857,1331,1.35409,103.959041
520382,178,3350,3528,1.35401,103.958794
520383,137,1768,1905,1.354135,103.958149
520384,178,1231,1409,1.354013,103.957913
520385,761,244,1005,1.354961,103.958405
520386,334,362,696,1.354783,103.958957
520387,334,105,439,1.355191,103.958811
520388,513,194,707,1.355492,103.95829
520389,119,60,179,1.354782,103.957884
520390,123,2557,2680,1.356149,103.957758
520391,305,375,680,1.355875,103.958032
520392,328,51,379,1.355182,103.957313
520393,218,121,339,1.355179,103.95678
520394,240,1242,1482,1.355189,103.955988
520395,348,1560,1908,1.355809,103.955954
520396,197,789,986,1.355811,103.956476
520401,515,651,1166,1.357156,103.944661
520402,123,158,281,1.357338,103.945461
520403,553,273,826,1.357528,103.94489
520404,35,3,38,1.358087,103.944404
520405,576,241,817,1.357847,103.944882
520406,599,2308,2907,1.35786,103.945655
520407,430,353,783,1.358151,103.94489
520408,698,699,1397,1.358809,103.945147
520409,407,293,700,1.3591,103.945112
520410,170,5467,5637,1.358812,103.94615
520411,509,571,1080,1.359151,103.946104
520412,246,243,489,1.359454,103.946201
520413,84,589,673,1.359479,103.945626
520414,495,249,744,1.359735,103.946202
520415,50,271,321,1.359479,103.946873
520416,317,122,439,1.35909,103.947239
520417,293,6393,6686,1.358802,103.947131
520418,347,6632,6979,1.358232,103.947458
520419,411,8193,8604,1.357849,103.946666
520420,141,540,681,1.357829,103.947535
520421,168,297,465,1.35754,103.947546
520422,23,412,435,1.357315,103.947025
520423,346,1571,1917,1.357129,103.947519
520424,737,433,1170,1.357438,103.948133
520425,307,1576,1883,1.359095,103.948162
520426,438,250,688,1.359526,103.947916
520427,499,414,913,1.35934,103.948371
520428,276,2587,2863,1.359296,103.949031
520429,593,1392,1985,1.359091,103.949773
520430,254,338,592,1.359488,103.95013
520431,465,157,622,1.359476,103.950679
520432,382,480,862,1.359015,103.950692
520433,107,1885,1992,1.35893,103.951134
520434,663,574,1237,1.359256,103.951528
520435,180,40,220,1.359735,103.951113
520436,407,519,926,1.359625,103.951517
520437,792,401,1193,1.359979,103.95151
520438,592,229,821,1.360344,103.951487
520439,51,3074,3125,1.360461,103.95113
520440,234,1880,2114,1.360748,103.951526
520441,55,1936,1991,1.360447,103.952099
520442,74,1396,1470,1.359716,103.952121
520443,235,2095,2330,1.358875,103.951896
520444,375,2508,2883,1.358268,103.95136
520445,528,2785,3313,1.358201,103.950588
520446,390,666,1056,1.357965,103.950955
520447,382,2157,2539,1.357232,103.950506
520448,552,376,928,1.357415,103.950996
520449,703,1513,2216,1.357089,103.950988
520450,518,473,991,1.357356,103.951548
520451,649,275,924,1.356595,103.954038
520452,30,164,194,1.356816,103.954567
520453,459,165,624,1.357026,103.953961
520454,175,5024,5199,1.357369,103.954989
520455,588,207,795,1.357365,103.95385
520456,627,181,808,1.357586,103.954422
520457,63,251,314,1.357815,103.953665
520458,316,411,727,1.357982,103.95443
520459,150,3980,4130,1.358302,103.954006
520460,245,4462,4707,1.358207,103.954936
520461,361,3275,3636,1.358854,103.954346
520462,293,2684,2977,1.358975,103.954987
520463,388,303,691,1.359237,103.954551
520464,64,5075,5139,1.35972,103.955112
520465,252,193,445,1.359595,103.954548
520466,92,1097,1189,1.359708,103.9541
520467,373,351,724,1.359964,103.954533
520468,17,2163,2180,1.360455,103.955078
520469,143,382,525,1.360326,103.954541
520470,321,1849,2170,1.360772,103.954557
520471,43,2791,2834,1.360289,103.954089
520472,226,614,840,1.359798,103.953545
520473,201,22,223,1.359649,103.952747
520474,193,597,790,1.359819,103.952705
520475,92,236,328,1.360322,103.953147
520476,267,267,534,1.361002,103.953814
520477,319,127,446,1.361151,103.952591
520478,12,3,15,1.361342,103.95368
520479,157,148,305,1.361342,103.95368
520480,237,13988,14225,1.361342,103.95368
520481,26,74,100,1.361342,103.95368
520482,46,69,115,1.361307,103.952521
520483,154,89,243,1.361307,103.952521
520484,173,8276,8449,1.361307,103.952521
520485,116,1796,1912,1.360061,103.955789
520486,420,402,822,1.359654,103.957297
520487,129,3256,3385,1.359577,103.957842
520488,237,48,285,1.359952,103.95645
520489,131,336,467,1.360636,103.957428
520490,285,3431,3716,1.362032,103.956755
520491,289,1314,1603,1.362648,103.953698
520492,339,326,665,1.363048,103.95348
520493,269,1349,1618,1.362665,103.952348
520494,233,335,568,1.363182,103.952463
520495,503,184,687,1.362476,103.950914
520496,769,401,1170,1.361458,103.950072
520497,350,1334,1684,1.359325,103.958608
520498,826,3808,4634,1.36169,103.957859
520499,14,109,123,1.299509,103.837
520501,225,1399,1624,1.355612,103.945002
520502,93,754,847,1.356402,103.945176
520503,621,363,984,1.355612,103.945002
520504,34,1479,1513,1.356383,103.945729
520505,543,128,671,1.355612,103.945002
520506,105,3805,3910,1.355917,103.945907
520507,17,506,523,1.355205,103.945941
520508,109,2706,2815,1.354641,103.945536
520509,64,459,523,1.355612,103.945002
520510,70,1876,1946,1.354627,103.944872
520512,47,5054,5101,1.353496,103.943379
520513,38,63,101,1.353731,103.944362
520515,134,782,916,1.357173,103.938802
520516,361,392,753,1.356656,103.938397
520517,248,254,502,1.35666,103.939265
520518,46,2450,2496,1.356228,103.938818
520519,114,436,550,1.356251,103.940118
520520,23,15,38,1.310116,103.918282
520522,13,272,285,1.299509,103.837
520524,24,85,109,1.299509,103.837
520601,1,1,2,1.372726,103.940701
520603,0,3,3,1.380651,103.946686
520610,1,0,1,1.380561,103.94628
520611,1,21,22,1.299509,103.837
520701,501,3482,3983,1.356196,103.936745
520702,548,2672,3220,1.35619,103.937348
520703,424,186,610,1.356669,103.93762
520704,394,438,832,1.356614,103.937165
520705,411,483,894,1.357202,103.937183
520706,987,203,1190,1.357558,103.937454
520707,294,199,493,1.357635,103.936851
520708,479,347,826,1.358019,103.936767
520709,547,338,885,1.358094,103.937509
520710,634,322,956,1.35876,103.937685
520711,640,324,964,1.358533,103.937078
520712,520,136,656,1.35901,103.937079
520713,793,327,1120,1.359497,103.937629
520714,701,1206,1907,1.360038,103.937046
520715,707,370,1077,1.35966,103.937074
520716,286,257,543,1.359482,103.936586
520717,512,1795,2307,1.358856,103.935075
520718,205,252,457,1.359157,103.935521
520719,394,2257,2651,1.358851,103.935936
520720,675,185,860,1.359397,103.93596
520721,1245,1055,2300,1.359988,103.936249
520722,342,1083,1425,1.359972,103.935626
520723,319,2889,3208,1.359982,103.935113
520724,645,341,986,1.356875,103.934915
520725,522,103,625,1.357033,103.935196
520726,1116,779,1895,1.357027,103.935941
520727,653,674,1327,1.356254,103.935504
520728,572,426,998,1.356254,103.934733
520729,553,1668,2221,1.356311,103.934197
520730,640,2590,3230,1.356734,103.933482
520731,809,295,1104,1.357084,103.934096
520732,649,166,815,1.357505,103.934306
520733,606,760,1366,1.357789,103.933881
520734,672,253,925,1.358161,103.934401
520735,680,2035,2715,1.359614,103.934106
520736,388,4552,4940,1.35876,103.934301
520737,347,768,1115,1.358935,103.933956
520738,393,103,496,1.35909,103.93364
520739,219,50,269,1.359232,103.933156
520740,316,414,730,1.35938,103.932763
520741,1155,2655,3810,1.360046,103.932987
520742,1061,382,1443,1.359642,103.933151
520801,204,7668,7872,1.34703,103.937957
520802,363,3295,3658,1.346069,103.938108
520803,752,953,1705,1.345189,103.93787
520804,704,305,1009,1.345751,103.937226
520805,414,471,885,1.346217,103.937214
520806,465,3283,3748,1.345592,103.936761
520807,406,6187,6593,1.345854,103.936136
520808,105,61,166,1.346494,103.93595
520809,383,340,723,1.346093,103.936369
520810,644,346,990,1.346371,103.936672
520811,247,268,515,1.346566,103.937215
520812,549,167,716,1.346973,103.937397
520813,216,251,467,1.346895,103.936364
520814,526,382,908,1.347257,103.936468
520815,221,275,496,1.34729,103.937391
520816,486,136,622,1.347614,103.937643
520817,507,223,730,1.347639,103.936553
520818,365,327,692,1.347969,103.936695
520819,411,4306,4717,1.348389,103.936696
520820,198,3117,3315,1.347988,103.936179
520821,83,119,202,1.348648,103.934491
520822,137,1823,1960,1.348357,103.934423
520823,42,824,866,1.348669,103.934117
520824,230,1136,1366,1.349082,103.932672
520825,55,383,438,1.349394,103.932742
520826,211,220,431,1.349408,103.933469
520827,223,7239,7462,1.349652,103.933901
520828,309,708,1017,1.348836,103.93485
520829,258,6103,6361,1.349192,103.93486
520830,166,9036,9202,1.350165,103.934779
520831,120,8019,8139,1.350301,103.934489
520832,504,183,687,1.350182,103.935295
520833,374,1160,1534,1.350714,103.934012
520834,37,2822,2859,1.350247,103.935715
520835,236,9421,9657,1.35116,103.933929
520836,695,568,1263,1.350518,103.935199
520837,126,232,358,1.350902,103.934264
520838,299,613,912,1.350806,103.935342
520839,574,299,873,1.351261,103.934284
520840,530,346,876,1.351084,103.935607
520841,614,187,801,1.351646,103.934317
520842,364,1064,1428,1.351708,103.935857
520843,386,1431,1817,1.351858,103.934599
520844,130,7951,8081,1.352108,103.936474
520845,458,1040,1498,1.352176,103.934793
520846,307,348,655,1.352087,103.935929
520847,297,464,761,1.352497,103.934965
520848,284,273,557,1.352426,103.936039
520849,90,270,360,1.352896,103.935495
520850,72,89,161,1.353058,103.936028
520851,260,4368,4628,1.352923,103.934837
520852,562,767,1329,1.352666,103.936378
520853,440,2146,2586,1.353256,103.934966
520854,507,1319,1826,1.353025,103.936473
520855,418,112,530,1.353541,103.935251
520856,485,74,559,1.353393,103.936561
520857,1165,182,1347,1.354322,103.935746
520858,653,266,919,1.354336,103.937941
520859,306,307,613,1.35466,103.938032
520860,216,3899,4115,1.355432,103.937808
520861,503,114,617,1.355112,103.937229
520862,652,157,809,1.354646,103.936464
520863,560,6415,6975,1.355424,103.93583
520864,424,213,637,1.355039,103.935664
520865,290,4134,4424,1.353877,103.934198
520866,391,3731,4122,1.354253,103.934393
520867,582,153,735,1.355099,103.933969
520868,898,290,1188,1.354776,103.933865
520869,724,542,1266,1.35455,103.933658
520870,1024,486,1510,1.354362,103.933405
520871,486,394,880,1.354413,103.932566
520872,550,193,743,1.354186,103.932314
520873,529,231,760,1.353934,103.93212
520874,422,391,813,1.353675,103.931932
520875,436,1002,1438,1.352675,103.931848
520876,569,1301,1870,1.353021,103.931271
520877,552,308,860,1.352494,103.931454
520878,1036,349,1385,1.35219,103.931279
520879,780,2295,3075,1.352041,103.930972
520880,678,2621,3299,1.351443,103.931629
520881,505,1087,1592,1.352306,103.932625
520882,52,2267,2319,1.351419,103.933555
520883,429,242,671,1.351921,103.932892
520884,421,397,818,1.351501,103.932736
520885,833,448,1281,1.351142,103.932848
520886,572,741,1313,1.351025,103.932154
520887,496,4057,4553,1.35042,103.931863
520888,557,2881,3438,1.350858,103.931033
520889,520,216,736,1.3499,103.930992
520890,51,160,211,1.299509,103.837
520891,428,84,512,1.349181,103.931084
520892,409,1760,2169,1.349055,103.929185
520893,239,2218,2457,1.348515,103.930131
520894,1106,1383,2489,1.348632,103.931897
520895,570,1943,2513,1.347751,103.931698
520896,584,237,821,1.348349,103.932373
520897,470,2426,2896,1.347711,103.934242
520898,227,338,565,1.347317,103.934713
520899,403,311,714,1.346503,103.935317
520902,628,3166,3794,1.351286,103.939243
520903,200,161,361,1.351024,103.939607
520906,117,50,167,1.350409,103.939915
520907,532,130,662,1.350582,103.939199
520908,223,888,1111,1.350511,103.938749
520909,614,338,952,1.35018,103.939207
520910,463,3924,4387,1.349777,103.938483
520911,803,362,1165,1.349702,103.939901
520912,269,216,485,1.349474,103.939215
520913,106,422,528,1.348837,103.938979
520914,478,617,1095,1.348986,103.939459
520915,377,961,1338,1.348627,103.939517
520916,975,488,1463,1.349044,103.940203
520921,598,208,806,1.348084,103.940804
520922,1101,721,1822,1.347553,103.940724
520924,525,275,800,1.346827,103.940687
520925,605,269,874,1.346518,103.940824
520926,201,259,460,1.346122,103.940989
520927,27,176,203,1.346344,103.940079
520928,142,385,527,1.345999,103.940159
520929,1135,520,1655,1.346349,103.939481
520930,708,392,1100,1.345945,103.939481
520931,310,320,630,1.346221,103.939019
520932,402,169,571,1.345581,103.939386
520933,607,891,1498,1.345244,103.939025
520934,534,9637,10171,1.345335,103.93992
520935,931,4659,5590,1.345755,103.941047
520936,324,900,1224,1.346584,103.941546
520937,352,470,822,1.347283,103.941525
520938,811,2110,2921,1.347958,103.941706
520939,406,502,908,1.348462,103.941256
520940,349,1134,1483,1.34917,103.941387
520941,545,207,752,1.349492,103.940647
520942,246,193,439,1.3497,103.940561
520943,151,2286,2437,1.350297,103.941165
520944,864,543,1407,1.350758,103.940801
520945,287,788,1075,1.351,103.940486
520946,308,5620,5928,1.3514,103.939788
521101,962,10823,11785,1.347401,103.945289
521102,412,11154,11566,1.346834,103.945761
521105,531,3925,4456,1.348106,103.947131
521106,365,288,653,1.347602,103.947515
521107,399,11811,12210,1.348365,103.948013
521108,266,2122,2388,1.347925,103.948375
521109,673,898,1571,1.347407,103.948708
521110,778,2760,3538,1.347002,103.949156
521111,751,171,922,1.346944,103.947435
521112,427,350,777,1.346328,103.947349
521113,813,451,1264,1.346586,103.946355
521114,343,1649,1992,1.346034,103.94651
521117,385,5569,5954,1.299509,103.837
521119,223,6154,6377,1.345232,103.946547
521120,407,70,477,1.344873,103.953069
521122,122,120,242,1.34553,103.952412
521123,446,3945,4391,1.345224,103.947937
521124,380,458,838,1.345421,103.949545
521125,435,6496,6931,1.346232,103.949919
521126,276,341,617,1.345796,103.950313
521127,887,112,999,1.345272,103.950319
521128,53,114,167,1.346878,103.954823
521129,130,74,204,1.344049,103.947811
521130,349,72,421,1.346322,103.954816
521131,624,55,679,1.345624,103.954019
521132,214,116,330,1.344639,103.947105
521133,120,173,293,1.344027,103.946603
521134,521,99,620,1.345149,103.946052
521135,224,101,325,1.34446,103.945768
521136,76,338,414,1.3447,103.945195
521137,66,360,426,1.345531,103.94471
521138,304,444,748,1.345799,103.945616
521139,1036,618,1654,1.346653,103.944868
521141,500,3709,4209,1.348385,103.94473
521142,281,747,1028,1.348711,103.944656
521144,804,497,1301,1.348476,103.94372
521145,1380,149,1529,1.348829,103.943776
521146,717,772,1489,1.348188,103.942383
521147,959,3012,3971,1.34915,103.942084
521148,406,898,1304,1.350186,103.942037
521149,717,1973,2690,1.351428,103.942626
521150,325,265,590,1.350995,103.943144
521151,693,9481,10174,1.3514,103.943742
521156,311,3747,4058,1.351602,103.944979
521157,418,1171,1589,1.351138,103.944846
521158,433,353,786,1.351422,103.945846
521159,895,291,1186,1.35107,103.945902
521160,346,406,752,1.350787,103.94498
521161,413,334,747,1.350003,103.945943
521162,390,384,774,1.349888,103.947052
521163,663,133,796,1.349592,103.947279
521164,546,2937,3483,1.349683,103.945939
521165,356,199,555,1.34926,103.946017
521166,215,2819,3034,1.348823,103.946267
521167,310,134,444,1.343518,103.959289
521168,42,5,47,1.342689,103.958899
521201,357,308,665,1.353088,103.952493
521202,43,5773,5816,1.353187,103.95217
521208,514,9346,9860,1.352001,103.954055
521221,868,246,1114,1.355117,103.952519
521222,527,421,948,1.355475,103.952515
521223,67,87,154,1.355354,103.952973
521224,108,44,152,1.355335,103.953507
521225,437,277,714,1.355196,103.953862
521226,436,347,783,1.355534,103.953832
521227,297,1685,1982,1.354831,103.95502
521228,189,372,561,1.355671,103.954585
521229,697,1161,1858,1.355869,103.953813
521230,291,210,501,1.35616,103.950247
521231,91,1046,1137,1.355948,103.949077
521232,1185,989,2174,1.356364,103.948738
521233,424,1484,1908,1.356391,103.947332
521234,498,459,957,1.355862,103.948181
521235,581,2784,3365,1.355546,103.9482
521242,88,6970,7058,1.354036,103.946633
521243,469,542,1011,1.354673,103.947203
521244,327,1120,1447,1.353832,103.947141
521245,813,2761,3574,1.352872,103.947116
521246,410,4119,4529,1.352872,103.947116
521247,382,522,904,1.352265,103.946938
521248,520,725,1245,1.351937,103.94713
521253,599,1077,1676,1.353224,103.94809
521254,369,124,493,1.352987,103.949203
521255,25,43,68,1.352771,103.950258
521256,17,3275,3292,1.342543,103.95232
521281,36,136,172,1.299509,103.837
521299,198,2747,2945,1.3502,103.953924
521307,14,1482,1496,1.353386,103.956102
521311,9,953,962,1.353044,103.957633
521316,10,384,394,1.35186,103.956992
521330,33,4417,4450,1.353315,103.958943
521331,33,14874,14907,1.353324,103.960414
521340,1,185,186,1.351559,103.960387
521351,24,947,971,1.352283,103.962552
521354,22,203,225,1.354342,103.961935
521359,10,387,397,1.355099,103.961066
521361,19,420,439,1.356078,103.96275
521364,9,1330,1339,1.357045,103.959177
521366,20,124,144,1.35816,103.961081
521367,307,179,486,1.357696,103.959903
521374,11,4161,4172,1.356457,103.958956
521384,9,238,247,1.35433,103.958506
521390,7,3053,3060,1.355918,103.957246
521450,272,2707,2979,1.358327,103.952125
521485,557,359,916,1.359952,103.95645
521486,603,94,697,1.35889,103.956845
521487,237,5187,5424,1.359985,103.958264
521488,219,302,521,1.360636,103.957428
521489,426,4706,5132,1.361324,103.957485
521490,126,1216,1342,1.36256,103.95621
521491,248,4608,4856,1.362343,103.954155
521492,7,371,378,1.363176,103.954123
521493,219,4224,4443,1.362303,103.95201
521494,13,204,217,1.36289,103.951736
521495,233,217,450,1.362661,103.951149
521496,343,388,731,1.361258,103.949668
521497,278,1617,1895,1.358427,103.9581
521498,357,2445,2802,1.361088,103.95862
521499,104,1681,1785,1.359456,103.95599
521512,24,4279,4303,1.299509,103.837
521515,158,291,449,1.356988,103.938383
521518,235,638,873,1.356362,103.938405
521519,827,1002,1829,1.356251,103.940118
521520,536,19,555,1.356937,103.940076
521522,692,1017,1709,1.341376,103.756106
521523,846,501,1347,1.299509,103.837
521524,1091,339,1430,1.358451,103.938429
521601,3,205,208,1.299509,103.837
521603,6,41,47,1.299509,103.837
521604,0,5,5,1.299509,103.837
521606,5,0,5,1.299509,103.837
521607,0,4,4,1.299509,103.837
521608,0,7,7,1.373219,103.932442
521701,12,3872,3884,1.356541,103.936594
521704,11,255,266,1.299509,103.837
521708,30,5441,5471,1.35776,103.93332
521716,6,671,677,1.358368,103.936704
521720,17,440,457,1.359548,103.936315
521723,12,1169,1181,1.359401,103.93505
521727,32,1820,1852,1.356717,103.936014
521730,114,2274,2388,1.357544,103.933684
521742,137,2083,2220,1.359808,103.934219
521823,17,1283,1300,1.348861,103.933336
521826,5,11,16,1.349211,103.934109
521827,205,731,936,1.349914,103.932728
521828,7,34,41,1.349126,103.934276
521842,18,2114,2132,1.351285,103.937994
521856,10,95,105,1.352875,103.938025
521857,39,3507,3546,1.354308,103.93513
521858,248,117,365,1.35431,103.937102
521859,219,220,439,1.355109,103.938023
521860,66,2801,2867,1.355423,103.93855
521861,334,193,527,1.354666,103.937225
521862,563,200,763,1.355098,103.936442
521863,58,1308,1366,1.355425,103.936594
521864,452,431,883,1.354661,103.935647
521866,394,5584,5978,1.355507,103.934462
521867,203,2945,3148,1.355649,103.933757
521868,439,1614,2053,1.356121,103.932806
521869,734,1206,1940,1.355098,103.932812
521870,845,593,1438,1.356287,103.931088
521871,539,2709,3248,1.354373,103.931773
521872,258,146,404,1.355341,103.930821
521874,851,1167,2018,1.353132,103.932067
521878,352,1656,2008,1.352082,103.931563
521879,202,156,358,1.352003,103.931003
521880,63,202,265,1.352011,103.931962
521882,360,4983,5343,1.352018,103.933357
521885,407,3334,3741,1.351179,103.932894
521886,200,319,519,1.351875,103.932314
521887,114,677,791,1.350204,103.931568
521888,806,214,1020,1.350544,103.930818
521889,717,646,1363,1.349441,103.931338
521890,778,4095,4873,1.347467,103.92813
521891,369,361,730,1.348713,103.930907
521892,284,2106,2390,1.348862,103.92954
521893,168,2139,2307,1.348305,103.930542
521894,456,432,888,1.347971,103.931857
521895,270,5023,5293,1.34764,103.932444
521896,491,1429,1920,1.348594,103.932446
521897,335,1267,1602,1.34746,103.935094
521898,345,121,466,1.346671,103.934827
521899,394,2632,3026,1.346225,103.93522
521921,0,104,104,1.347389,103.941128
522117,12,5730,5742,1.299509,103.837
522136,55,77,132,1.299509,103.837
522137,30,436,466,1.345941,103.944978
522167,134,30,164,1.343151,103.959588
522168,206,61,267,1.342655,103.958718
522201,107,7336,7443,1.353504,103.952866
522229,1,266,267,1.343507,103.956496
522230,456,478,934,1.356323,103.949935
522256,553,338,891,1.353344,103.950445
522299,309,5770,6079,1.349515,103.954147
522450,12,305,317,1.357718,103.951909
522486,86,4177,4263,1.358862,103.957316
522487,285,2072,2357,1.360636,103.957428
522489,386,388,774,1.361814,103.956521
522491,429,3969,4398,1.361923,103.954683
522492,240,292,532,1.363393,103.953668
522493,227,3117,3344,1.362035,103.951433
522494,238,340,578,1.363602,103.952368
522495,566,188,754,1.363205,103.95164
522496,290,3573,3863,1.360486,103.950165
522497,368,687,1055,1.358303,103.958506
522498,670,277,947,1.361105,103.959508
522499,163,131,294,1.358775,103.956307
522515,443,27,470,1.356988,103.93866
522518,192,4,196,1.356395,103.938665
522519,748,304,1052,1.356251,103.940118
522520,359,529,888,1.356251,103.940118
522522,1047,478,1525,1.357888,103.938938
522523,649,1080,1729,1.360046,103.938527
522524,626,415,1041,1.358862,103.93873
522601,0,53,53,1.299509,103.837
522602,0,1,1,1.310116,103.918282
522605,0,1,1,1.299509,103.837
522606,0,1,1,1.299509,103.837
522827,9,3840,3849,1.35005,103.932481
522842,983,509,1492,1.351145,103.936991
522856,584,1352,1936,1.353089,103.937583
522857,77,149,226,1.354309,103.93664
522858,57,462,519,1.354301,103.938593
522860,60,1405,1465,1.355416,103.937101
522863,62,2884,2946,1.355424,103.935123
522864,11,4180,4191,1.354498,103.935255
522868,576,2369,2945,1.355619,103.933111
522869,576,172,748,1.354973,103.932907
522870,6,164,170,1.299509,103.837
522871,809,3809,4618,1.356324,103.931683
522872,107,286,393,1.355112,103.931269
522878,284,1474,1758,1.351443,103.931629
522879,495,10,505,1.351443,103.931629
522890,290,1751,2041,1.346922,103.933501
522891,5,321,326,1.348907,103.93051
523137,3,0,3,1.345941,103.944978
523167,77,15,92,1.342946,103.95933
523168,147,3142,3289,1.342437,103.958458
523201,27,60,87,1.352821,103.952974
523230,405,98,503,1.356297,103.949468
523450,811,140,951,1.357116,103.952127
523491,386,280,666,1.362477,103.954651
523492,374,80,454,1.363883,103.954039
523493,722,110,832,1.362369,103.951424
523494,0,29,29,1.299509,103.837
523495,411,126,537,1.363635,103.952014
523496,420,4018,4438,1.36084,103.950535
523497,139,2643,2782,1.358859,103.959055
523498,139,192,331,1.36156,103.959052
523499,518,337,855,1.358808,103.956009
523515,382,57,439,1.356987,103.93901
523518,200,14,214,1.356367,103.938986
523519,660,1188,1848,1.356201,103.94004
523520,735,139,874,1.356336,103.939993
523522,674,733,1407,1.358079,103.939338
523523,949,884,1833,1.299509,103.837
523607,0,1,1,1.299509,103.837
523842,462,3225,3687,1.351598,103.93696
523856,557,1321,1878,1.352594,103.93743
523868,278,755,1033,1.355912,103.932721
523869,5,67,72,1.299509,103.837
523870,19,87,106,1.299509,103.837
523871,1116,715,1831,1.356805,103.931165
523878,119,626,745,1.352168,103.931529
523879,2,34,36,1.299509,103.837
523890,40,198,238,1.347298,103.9337
524137,6,435,441,1.345941,103.944978
524167,104,16,120,1.342925,103.959126
524168,125,3356,3481,1.342879,103.958249
524201,595,374,969,1.352255,103.953629
524230,1006,738,1744,1.355875,103.952508
524450,903,103,1006,1.357133,103.952834
524491,223,3306,3529,1.362487,103.955169
524492,1,0,1,1.299509,103.837
524493,652,208,860,1.362652,103.952015
524494,613,276,889,1.363587,103.953244
524495,578,275,853,1.364025,103.952458
524496,11,608,619,1.361277,103.950577
524497,261,669,930,1.359674,103.958913
524498,197,107,304,1.361906,103.958585
524499,32,10177,10209,1.299509,103.837
524515,230,391,621,1.356958,103.939284
524518,98,351,449,1.356387,103.939267
524519,336,2914,3250,1.356218,103.94005
524523,451,476,927,1.359691,103.938892
524609,0,1,1,1.299509,103.837
524842,441,1135,1576,1.350657,103.937465
524856,403,76,479,1.35212,103.938665
524868,3,27,30,1.299509,103.837
524869,2,28,30,1.299509,103.837
524872,8,1191,1199,1.299509,103.837
524879,5,132,137,1.299509,103.837
524890,8,49,57,1.299509,103.837
525137,13,1951,1964,1.345941,103.944978
525230,497,3001,3498,1.355433,103.950594
525450,165,207,372,1.357555,103.953124
525491,245,86,331,1.363004,103.954841
525492,1,3,4,1.299509,103.837
525494,601,280,881,1.363926,103.9533
525495,584,260,844,1.364306,103.952759
525496,415,4490,4905,1.361528,103.951084
525497,330,168,498,1.360173,103.959404
525498,69,181,250,1.362376,103.958136
525842,111,1470,1581,1.351754,103.938303
525856,779,1426,2205,1.352944,103.938686
526201,1,5,6,1.35251,103.952944
526230,562,202,764,1.355665,103.951293
526450,304,254,558,1.357932,103.953109
526491,519,246,765,1.363502,103.954355
526492,0,6,6,1.299509,103.837
526494,5,198,203,1.299509,103.837
526496,705,368,1073,1.362056,103.950207
526497,227,695,922,1.359664,103.95991
526498,383,74,457,1.362981,103.957455
526842,533,104,637,1.35198,103.937852
526856,384,865,1249,1.352973,103.938309
527201,409,680,1089,1.352871,103.954388
527230,313,907,1220,1.35608,103.951448
527450,254,2807,3061,1.358313,103.952894
527491,280,197,477,1.362904,103.954197
527494,0,6,6,1.299509,103.837
527497,326,492,818,1.359184,103.959434
527498,278,236,514,1.363309,103.956916
527842,1048,3809,4857,1.352196,103.937262
528230,180,436,616,1.356077,103.950973
528491,0,48,48,1.299509,103.837
528492,0,59,59,1.299509,103.837
528494,1,5,6,1.299509,103.837
528497,2,26,28,1.358763,103.958516
528498,689,1619,2308,1.362396,103.957296
528534,50,298,348,1.351008,103.928061
528543,88,1222,1310,1.378645,103.921082
528548,168,85,253,1.365742,103.933438
528553,162,2617,2779,1.36554,103.932002
528568,3,3,6,1.351469,103.927982
528569,18,35,53,1.299509,103.837
528570,22,324,346,1.299509,103.837
528571,2,1,3,1.345941,103.944978
528572,17,45,62,1.299509,103.837
528573,3,119,122,1.299509,103.837
528574,11,1,12,1.299509,103.837
528578,12,797,809,1.299509,103.837
528583,1045,245,1290,1.299509,103.837
528584,339,241,580,1.299509,103.837
528585,401,79,480,1.350412,103.927471
528586,306,6,312,1.299509,103.837
528587,172,62,234,1.299509,103.837
528588,501,35,536,1.352664,103.928257
528589,213,1017,1230,1.350412,103.927471
528590,233,7,240,1.344715,103.946729
528591,276,54,330,1.299509,103.837
528592,26,34,60,1.352697,103.929773
528593,292,53,345,1.358957,103.941073
528594,350,347,697,1.358957,103.941073
528595,324,212,536,1.358957,103.941073
528596,187,42,229,1.299509,103.837
528597,705,1116,1821,1.358789,103.939915
528598,652,224,876,1.35938,103.940889
528599,93,12,105,1.358957,103.941073
528603,3435,169,3604,1.375441,103.923974
528604,1649,5000,6649,1.374297,103.93064
528605,849,808,1657,1.375428,103.930342
528606,42,23,65,1.299509,103.837
528608,370,31,401,1.359211,103.940522
528609,165,29,194,1.299509,103.837
528610,99,3,102,1.299509,103.837
528611,302,125,427,1.299509,103.837
528612,257,180,437,1.299509,103.837
528613,427,49,476,1.299509,103.837
528614,302,455,757,1.359211,103.940522
528615,322,810,1132,1.358957,103.941073
528616,221,124,345,1.358069,103.940088
528617,158,65,223,1.359009,103.941128
528618,5,26,31,1.372562,103.92677
528619,5,20,25,1.299509,103.837
528620,49,16,65,1.37261,103.927043
528621,26,128,154,1.375158,103.921097
528622,12,0,12,1.37212,103.927118
528623,116,5,121,1.372787,103.926711
528624,14,2,16,1.372719,103.926447
528625,11,0,11,1.337002,103.902595
528626,6,0,6,1.375222,103.921121
528627,12,1,13,1.37294,103.926021
528628,20,2,22,1.299509,103.837
528629,11,9,20,1.373389,103.925978
528630,5,4,9,1.371537,103.926083
528631,7,2,9,1.299509,103.837
528632,44,9,53,1.375222,103.921121
528633,6,5,11,1.372709,103.928047
528634,8,2,10,1.372615,103.926099
528635,1,2,3,1.299509,103.837
528636,8,1,9,1.373934,103.928846
528637,7,10,17,1.299509,103.837
528638,0,3,3,1.299509,103.837
528639,19,5,24,1.299509,103.837
528640,234,0,234,1.299509,103.837
528641,15,9,24,1.371605,103.925115
528642,34,9,43,1.372272,103.92538
528643,10,7,17,1.299509,103.837
528644,1,0,1,1.299509,103.837
528645,19,109,128,1.37282,103.925581
528683,98,93,191,1.368534,103.92365
528684,917,70,987,1.348761,103.926309
528685,623,129,752,1.348761,103.926309
528686,745,153,898,1.348761,103.926309
528687,857,90,947,1.348761,103.926309
528688,325,186,511,1.348761,103.926309
528689,892,415,1307,1.348761,103.926309
528690,223,222,445,1.348761,103.926309
528691,748,284,1032,1.348761,103.926309
528692,252,1845,2097,1.348761,103.926309
528693,67,2275,2342,1.299509,103.837
528694,198,94,292,1.343428,103.932509
528699,5,1533,1538,1.354054,103.930816
528700,12,886,898,1.353422,103.930539
528704,15832,3922,19754,1.357903,103.931809
528705,2283,2458,4741,1.359988,103.932133
528714,221,33,254,1.341127,103.956518
528715,172,2,174,1.340489,103.956803
528716,825,37,862,1.340216,103.956957
528717,739,65,804,1.339987,103.957242
528718,460,10,470,1.339871,103.957042
528719,404,2,406,1.339756,103.956807
528720,819,192,1011,1.339744,103.956573
528721,545,81,626,1.339946,103.956294
528724,34,21,55,1.370627,103.924584
528729,2030,4619,6649,1.355937,103.940888
528730,13,636,649,1.299509,103.837
528735,2560,8463,11023,1.355802,103.941912
528736,3279,533,3812,1.355412,103.941748
528739,9,607,616,1.368349,103.930386
528740,228,7,235,1.368231,103.93022
528741,17,9,26,1.368069,103.929994
528742,24,4,28,1.367954,103.92978
528743,18,1,19,1.367812,103.929559
528744,23,48,71,1.367355,103.928912
528745,19,314,333,1.367224,103.928577
528746,2,7,9,1.299509,103.837
528749,1,49,50,1.369806,103.933611
528750,10,2,12,1.369635,103.933622
528755,1,0,1,1.372699,103.92556
528756,6,3,9,1.370317,103.93651
528759,796,1079,1875,1.37637,103.922255
528760,2201,627,2828,1.373163,103.929232
528761,58,38,96,1.299509,103.837
528762,76,206,282,1.299509,103.837
528763,24,36,60,1.299509,103.837
528764,4607,83842,88449,1.374183,103.932748
528765,4414,1607,6021,1.372484,103.932199
528766,2316,4121,6437,1.373066,103.933723
528769,399,443,842,1.299509,103.837
528770,199,249,448,1.299509,103.837
528771,318,301,619,1.299509,103.837
528772,534,1346,1880,1.299509,103.837
528773,273,240,513,1.299509,103.837
528774,3,42,45,1.370303,103.937806
528775,225,50,275,1.360264,103.926471
528777,213,724,937,1.35801,103.929572
528778,651,1647,2298,1.367651,103.930262
528779,507,180,687,1.349669,103.960839
528780,194,13,207,1.349767,103.961683
528781,504,222,726,1.34973,103.961918
528782,495,127,622,1.349591,103.962199
528783,473,52,525,1.349411,103.962379
528784,267,233,500,1.349232,103.962554
528785,511,108,619,1.349016,103.962709
528786,190,189,379,1.34878,103.962762
528787,277,839,1116,1.34855,103.962838
528788,444,275,719,1.34858,103.962269
528789,457,140,597,1.34867,103.962
528790,657,240,897,1.348552,103.961755
528791,501,114,615,1.348751,103.961548
528792,684,86,770,1.348913,103.961344
528793,926,223,1149,1.349099,103.961135
528794,506,215,721,1.349376,103.960977
528795,625,74,699,1.349583,103.96085
528796,515,545,1060,1.349857,103.960772
528797,26,1,27,1.349198,103.962
528798,1514,152,1666,1.360488,103.929698
528799,1156,8419,9575,1.354566,103.942332
528800,374,253,627,1.347751,103.959953
528801,558,342,900,1.347005,103.959587
528802,556,438,994,1.347338,103.959622
528803,457,296,753,1.348227,103.959219
528804,357,95,452,1.347579,103.959273
528805,718,101,819,1.348375,103.959181
528806,19,3,22,1.348386,103.959824
528807,586,128,714,1.348665,103.959215
528808,699,364,1063,1.349184,103.959874
528809,637,77,714,1.34917,103.96034
528810,442,73,515,1.348933,103.960501
528811,840,102,942,1.348701,103.960579
528812,18,428,446,1.377309,103.924674
528813,13,299,312,1.367381,103.944466
528814,2,0,2,1.369128,103.936817
528815,22,5,27,1.368996,103.936638
528816,115,6,121,1.368672,103.933601
528817,149,28,177,1.3688,103.93608
528818,2,49,51,1.370041,103.935488
528819,2,0,2,1.369128,103.936817
528820,980,217,1197,1.375443,103.923974
528821,3004,281,3285,1.366664,103.929454
528822,14,31,45,1.371758,103.927713
528823,1044,954,1998,1.35799,103.933039
528824,354,291,645,1.358009,103.932681
528825,636,1598,2234,1.358551,103.932427
528826,703,699,1402,1.358551,103.932427
528827,506,56,562,1.358651,103.933089
528828,432,254,686,1.358354,103.93333
528829,61,1677,1738,1.358225,103.933336
528830,752,1,753,1.370847,103.928792
528831,1,35,36,1.299509,103.837
528832,31,4079,4110,1.372519,103.930075
528833,3596,24565,28161,1.342806,103.952974
528836,243,114,357,1.340964,103.941375
528837,140,358,498,1.339975,103.941108
528838,183,160,343,1.3406,103.941876
528839,242,295,537,1.339254,103.941341
528840,414,365,779,1.339813,103.942417
528841,89,263,352,1.338758,103.940955
528842,448,477,925,1.350925,103.936817
528843,247,251,498,1.341892,103.942416
528844,142,29,171,1.341471,103.942906
528845,100,97,197,1.34091,103.943287
528871,1473,52,1525,1.34312,103.944123
528872,2739,316,3055,1.342513,103.944673
528873,4,7,11,1.342377,103.943245
528874,24,545,569,1.342675,103.943611
528875,182,117,299,1.342214,103.944212
528876,48,43,91,1.341756,103.944363
528877,223,58,281,1.340813,103.944103
528878,1134,242,1376,1.340508,103.943831
528879,252,116,368,1.340324,103.943537
528880,167,137,304,1.339499,103.942571
528881,829,149,978,1.338445,103.941453
528882,872,1073,1945,1.344724,103.941739
528883,109,152,261,1.338704,103.94167
528885,122,34,156,1.339222,103.942256
528886,1107,149,1256,1.33899,103.941994
528887,117,358,475,1.338283,103.94106
528888,149,122,271,1.344633,103.943348
528890,129,284,413,1.344449,103.943073
528891,39,228,267,1.341678,103.945019
528892,291,173,464,1.341212,103.944622
528906,323,105,428,1.347973,103.940012
528907,186,2152,2338,1.346782,103.939586
528933,411,26,437,1.353327,103.933573
528985,107,983,1090,1.34958,103.935565
528986,350,48,398,1.350082,103.936638
528988,1287,429,1716,1.352771,103.940312
528989,13,1397,1410,1.299509,103.837
529014,225,1022,1247,1.347836,103.935565
529067,192,2473,2665,1.3582,103.935299
529093,275,849,1124,1.360673,103.956206
529095,31,1625,1656,1.360779,103.958951
529096,20,505,525,1.362857,103.956826
529097,17,24,41,1.36169,103.957859
529098,66,603,669,1.360695,103.959894
529123,219,495,714,1.361178,103.954344
529151,84,354,438,1.36121,103.951927
529176,648,215,863,1.357339,103.948893
529177,451,314,765,1.357878,103.949913
529203,630,3450,4080,1.357257,103.946039
529204,108,6575,6683,1.357087,103.946489
529230,313,379,692,1.356232,103.950657
529231,113,66,179,1.355997,103.960586
529232,327,4646,4973,1.355874,103.959886
529233,170,229,399,1.355874,103.959886
529234,267,3827,4094,1.355874,103.959886
529235,328,5124,5452,1.355084,103.960663
529236,129,36,165,1.355069,103.95999
529237,90,82,172,1.355063,103.959624
529238,176,17,193,1.355224,103.959261
529239,217,18,235,1.355667,103.958935
529240,343,36,379,1.355993,103.959164
529241,17,37,54,1.355874,103.959886
529258,98,1365,1463,1.35349,103.961799
529259,22,1250,1272,1.352024,103.960433
529283,183,70,253,1.354061,103.956972
529284,30,1815,1845,1.354349,103.960259
529285,1,0,1,1.370126,103.936537
529286,478,4469,4947,1.353795,103.960579
529287,8,27,35,1.354349,103.960259
529314,118,528,646,1.299509,103.837
529341,253,8642,8895,1.353558,103.954448
529366,118,6246,6364,1.348251,103.951859
529392,229,1433,1662,1.350835,103.951438
529393,380,1214,1594,1.351484,103.951159
529394,17,1789,1806,1.355574,103.949558
529398,22,450,472,1.355586,103.950421
529400,215,866,1081,1.354805,103.948043
529426,104,2240,2344,1.349774,103.94402
529427,201,1302,1503,1.34871,103.944486
529453,128,22,150,1.345753,103.947446
529454,64,1048,1112,1.346217,103.949144
529455,375,3495,3870,1.348692,103.949063
529482,646,6617,7263,1.353247,103.942273
529483,882,405,1287,1.353041,103.942261
529492,0,39,39,1.299509,103.837
529494,1,4,5,1.299509,103.837
529497,1,35,36,1.359857,103.959581
529498,350,2981,3331,1.36169,103.957859
529508,92,2530,2622,1.352954,103.943696
529509,3206,68515,71721,1.352738,103.943831
529510,5424,114282,119706,1.352661,103.945245
529536,5918,79694,85612,1.354396,103.945206
529537,66,297,363,1.354312,103.945301
529538,895,32072,32967,1.353448,103.945119
529539,533,11979,12512,1.35206,103.94302
529540,386,5838,6224,1.352584,103.943035
529541,411,915,1326,1.353213,103.942969
529542,643,3845,4488,1.354404,103.942418
529543,27,9,36,1.354384,103.944265
529544,38,356,394,1.299509,103.837
529564,333,8,341,1.357607,103.955857
529565,226,604,830,1.360298,103.948581
529568,12,639,651,1.360442,103.947451
529593,237,78,315,1.349409,103.929982
529594,71,1167,1238,1.349381,103.928364
529595,226,2292,2518,1.350311,103.92864
529596,435,3151,3586,1.350311,103.92864
529597,192,620,812,1.350311,103.92864
529598,232,97,329,1.350311,103.92864
529599,394,62,456,1.350311,103.92864
529600,17,9,26,1.299509,103.837
529601,148,17,165,1.299509,103.837
529602,194,20,214,1.350311,103.92864
529603,137,18,155,1.350311,103.92864
529604,372,218,590,1.350311,103.92864
529605,39,846,885,1.350311,103.92864
529619,42,4108,4150,1.357607,103.958896
529620,369,441,810,1.356315,103.94444
529621,11,136,147,1.356904,103.944125
529622,20,111,131,1.299509,103.837
529623,3,141,144,1.299509,103.837
529647,13,885,898,1.347606,103.94233
529649,367,5332,5699,1.354087,103.940674
529651,112,1021,1133,1.355562,103.939999
529652,74,1811,1885,1.354717,103.939872
529653,44,5408,5452,1.352109,103.941842
529654,7,152,159,1.343633,103.945573
529679,79,4625,4704,1.348637,103.938472
529680,109,4439,4548,1.351997,103.942355
529681,61,2943,3004,1.356131,103.94646
529682,19,1133,1152,1.345936,103.938712
529683,11,482,493,1.345022,103.938371
529684,2469,4872,7341,1.351617,103.94163
529705,213,6647,6860,1.348878,103.935731
529706,144,540,684,1.349548,103.936412
529707,30,2340,2370,1.348452,103.937528
529731,69,2851,2920,1.34906,103.947788
529757,2075,5734,7809,1.345555,103.932462
529759,0,22,22,1.346583,103.930371
529761,16,637,653,1.348244,103.929745
529762,13,19,32,1.348031,103.928512
529763,360,100,460,1.347389,103.928168
529764,28,133,161,1.347342,103.931355
529765,64,69,133,1.344025,103.933191
529766,3,0,3,1.299509,103.837
529767,22,85,107,1.345287,103.931672
529768,9,51,60,1.346469,103.930821
529769,18,37,55,1.346716,103.930266
529770,173,78,251,1.346678,103.929206
529771,768,1975,2743,1.348862,103.927874
529772,292,251,543,1.348228,103.928099
529773,786,106,892,1.348011,103.927873
529774,1568,252,1820,1.347327,103.927452
529775,45,0,45,1.347604,103.927296
529776,861,67,928,1.347588,103.926806
529777,809,153,962,1.348259,103.92706
529778,1048,286,1334,1.348797,103.927347
529779,59,77,136,1.348761,103.926309
529780,490,53,543,1.348761,103.926309
529781,549,76,625,1.348761,103.926309
529782,625,336,961,1.348761,103.926309
529783,25,66,91,1.367303,103.928092
529784,27,1,28,1.367102,103.927708
529785,7,47,54,1.366722,103.926257
529786,12,31,43,1.366863,103.927884
529787,0,47,47,1.366708,103.927311
529788,22,1,23,1.366885,103.92663
529789,6,15,21,1.366884,103.926629
529790,9,20,29,1.366884,103.926629
529791,0,27,27,1.366884,103.926629
529792,26,0,26,1.366883,103.926623
529793,1,0,1,1.353986,103.960457
529794,1,0,1,1.366882,103.926622
529795,0,3,3,1.343901,103.932124
529796,5,278,283,1.366882,103.926622
529797,3,27,30,1.366998,103.925895
529799,6,0,6,1.366877,103.926607
529800,2,0,2,1.368882,103.93381
529801,0,1,1,1.366882,103.926622
529802,1,0,1,1.366877,103.926607
529803,1,0,1,1.366438,103.926119
529804,4,1,5,1.366463,103.926082
529806,0,1,1,1.366444,103.926125
529807,0,1,1,1.366429,103.926003
529861,306,866,1172,1.341573,103.957853
529862,650,2056,2706,1.341176,103.95836
529863,200,332,532,1.340637,103.958764
529864,635,86,721,1.340476,103.958188
529865,595,143,738,1.340066,103.957687
529866,376,141,517,1.340761,103.957656
529867,24,0,24,1.341028,103.958176
529868,443,340,783,1.341135,103.957898
529869,525,201,726,1.342558,103.95502
529870,324,65,389,1.342005,103.954901
529871,569,18862,19431,1.342642,103.954488
529872,94,24,118,1.342169,103.954518
529874,496,2301,2797,1.341225,103.955402
529875,210,2,212,1.341236,103.955397
529876,72,0,72,1.341202,103.955399
529877,554,63,617,1.341203,103.955424
529878,332,0,332,1.341225,103.955431
529879,82,4,86,1.341396,103.955175
529880,605,5,610,1.341234,103.955422
529881,972,1528,2500,1.341127,103.956518
529882,194,75,269,1.341127,103.956518
529883,299,18,317,1.340932,103.955884
529884,152,52,204,1.340806,103.955686
529885,392,28,420,1.34053,103.955999
529886,424,2,426,1.341127,103.956518
529888,245,126,371,1.342977,103.953583
529889,4055,12999,17054,1.340711,103.949352
529890,2277,61307,63584,1.339498,103.95051
529891,1499,123,1622,1.338994,103.95154
529892,1804,619,2423,1.338522,103.950366
529893,99,8988,9087,1.338951,103.950326
529894,115,0,115,1.340939,103.952619
529895,637,952,1589,1.341687,103.949116
529896,147,20,167,1.340164,103.951801
529897,148,425,573,1.342022,103.949165
529898,313,3042,3355,1.340737,103.948089
529899,269,292,561,1.341659,103.953661
529900,166,1,167,1.341659,103.953661
529901,390,0,390,1.341659,103.953661
529902,417,3,420,1.341659,103.953661
529903,395,22383,22778,1.341659,103.953661
529904,520,8632,9152,1.341659,103.953661
529905,874,4271,5145,1.299509,103.837
529906,496,34660,35156,1.299509,103.837
529914,16,177,193,1.344551,103.954818
529915,63,190,253,1.344852,103.955148
529940,62,166,228,1.34807,103.958804
529941,18,108,126,1.348756,103.958749
529942,1693,512,2205,1.34962,103.959059
529943,1586,278,1864,1.349466,103.958381
529944,1870,736,2606,1.348913,103.957537
529945,1246,347,1593,1.348436,103.9577
529946,1122,6207,7329,1.348064,103.957938
529947,1617,5066,6683,1.347739,103.958139
529948,912,372,1284,1.346757,103.958631
529949,66,4032,4098,1.346559,103.957362
529950,27,4988,5015,1.34658,103.956941
529974,19,3454,3473,1.34353,103.957452
529999,2,3,5,1.299509,103.837
530000,32,338,370,1.386444,103.923269
530001,367,3314,3681,1.364165,103.892898
530002,395,5259,5654,1.363089,103.893071
530003,10,161,171,1.362158,103.893364
530004,2,4,6,1.36369,103.893495
530005,1029,394,1423,1.350018,103.87682
530006,257,228,485,1.362767,103.893935
530007,250,337,587,1.362307,103.893387
530008,7,1638,1645,1.362155,103.89315
530009,2,806,808,1.363385,103.895395
530010,3,41,44,1.363385,103.895395
530011,2,176,178,1.363294,103.895576
530015,779,375,1154,1.362725,103.891747
530016,709,284,993,1.362905,103.890918
530017,577,274,851,1.363424,103.890817
530018,494,425,919,1.363217,103.891716
530019,439,1347,1786,1.363895,103.891604
530020,707,220,927,1.363912,103.890571
530021,485,2544,3029,1.364231,103.891251
530022,627,1730,2357,1.364268,103.890309
530023,1466,4735,6201,1.364858,103.8907
530024,1670,1081,2751,1.365475,103.891901
530025,91,2055,2146,1.365847,103.891567
530101,220,4157,4377,1.355027,103.891234
530102,184,278,462,1.355013,103.890731
530103,625,1770,2395,1.355363,103.890382
530104,88,2990,3078,1.354793,103.890305
530105,253,6822,7075,1.354063,103.890125
530106,247,3672,3919,1.353777,103.890572
530107,44,4002,4046,1.353425,103.890682
530108,391,4663,5054,1.352862,103.889926
530109,411,211,622,1.355343,103.889211
530110,351,1340,1691,1.354706,103.889287
530111,367,67,434,1.354879,103.888869
530112,469,400,869,1.354482,103.888688
530113,319,357,676,1.353566,103.888684
530114,204,7350,7554,1.352895,103.888846
530115,375,13742,14117,1.352785,103.88785
530116,480,581,1061,1.353166,103.887769
530117,33,208,241,1.353602,103.888154
530118,195,1639,1834,1.353465,103.887498
530119,366,219,585,1.354061,103.88788
530120,300,16,316,1.354379,103.887847
530121,113,438,551,1.35372,103.886877
530122,186,11,197,1.353695,103.886178
530123,452,389,841,1.353415,103.886286
530124,711,395,1106,1.352906,103.886586
530125,244,3623,3867,1.352399,103.886309
530126,625,10101,10726,1.352274,103.885741
530127,42,94,136,1.352903,103.885794
530128,707,2631,3338,1.351716,103.886458
530129,627,1501,2128,1.351523,103.887507
530130,511,658,1169,1.351314,103.886447
530131,39,266,305,1.351508,103.887066
530132,227,360,587,1.350905,103.886555
530133,211,365,576,1.350522,103.887311
530134,745,967,1712,1.350452,103.886433
530135,965,67,1032,1.349788,103.886835
530136,40,209,249,1.349779,103.886327
530137,704,219,923,1.34908,103.886687
530138,739,2851,3590,1.351672,103.884257
530139,383,448,831,1.352196,103.884214
530140,979,336,1315,1.352583,103.883728
530141,720,225,945,1.353064,103.883778
530142,1633,299,1932,1.353,103.88285
530143,583,138,721,1.352453,103.882963
530144,390,111,501,1.351973,103.883296
530145,347,707,1054,1.351603,103.88343
530146,118,1099,1217,1.351296,103.882275
530147,497,68,565,1.351695,103.882082
530148,54,28,82,1.352139,103.88204
530149,104,6,110,1.352862,103.881982
530150,69,58,127,1.352786,103.881145
530151,68,47,115,1.352246,103.881318
530152,314,1227,1541,1.351652,103.880903
530153,55,1040,1095,1.351649,103.881141
530154,841,587,1428,1.352269,103.8801
530155,547,473,1020,1.3526,103.880036
530156,474,433,907,1.35267,103.879619
530157,70,139,209,1.353028,103.879672
530158,513,673,1186,1.35178,103.880123
530159,475,755,1230,1.351492,103.879335
530160,535,1180,1715,1.352046,103.879036
530161,1120,509,1629,1.352572,103.87866
530165,498,709,1207,1.350617,103.888015
530166,469,1151,1620,1.351528,103.888444
530167,496,1325,1821,1.351758,103.888545
530168,194,2835,3029,1.352165,103.889412
530169,441,1373,1814,1.351665,103.889729
530170,501,182,683,1.351441,103.889365
530171,229,614,843,1.351103,103.889221
530172,501,3426,3927,1.3506,103.889391
530173,502,238,740,1.350165,103.888923
530174,17,181,198,1.349319,103.888378
530201,156,639,795,1.357813,103.883205
530202,383,165,548,1.357437,103.883638
530203,199,1153,1352,1.357428,103.884693
530204,121,189,310,1.358853,103.884919
530205,443,556,999,1.359336,103.885208
530206,62,834,896,1.358423,103.885393
530207,55,584,639,1.357587,103.886302
530208,265,5649,5914,1.358844,103.886685
530209,104,221,325,1.359092,103.886095
530210,241,355,596,1.35929,103.886963
530211,823,4854,5677,1.359336,103.887765
530212,213,2170,2383,1.359509,103.888103
530220,908,780,1688,1.357418,103.884703
530221,673,209,882,1.357017,103.883883
530222,614,61,675,1.356333,103.883712
530230,590,281,871,1.358865,103.888352
530231,1119,359,1478,1.358346,103.887903
530232,948,194,1142,1.358574,103.888523
530233,323,37,360,1.357637,103.888193
530234,719,246,965,1.358229,103.888749
530235,88,59,147,1.35716,103.888488
530236,391,591,982,1.357853,103.888926
530237,758,160,918,1.356562,103.88881
530238,772,54,826,1.357292,103.889264
530239,504,1742,2246,1.356016,103.890407
530240,437,430,867,1.356396,103.890502
530241,778,2159,2937,1.356457,103.891594
530242,654,1408,2062,1.357334,103.891882
530243,36,318,354,1.357673,103.891663
530244,480,1026,1506,1.358071,103.891739
530245,797,239,1036,1.358423,103.891648
530246,215,93,308,1.358775,103.891331
530247,326,161,487,1.35922,103.891459
530248,895,3814,4709,1.359497,103.892492
530249,315,364,679,1.359649,103.891726
530250,48,81,129,1.35964,103.891236
530251,264,70,334,1.359935,103.891351
530252,827,5241,6068,1.36022,103.892582
530253,655,225,880,1.360423,103.892033
530254,111,33,144,1.360271,103.891265
530301,790,336,1126,1.367817,103.893883
530302,877,1583,2460,1.368509,103.894499
530303,44,363,407,1.368033,103.894645
530304,811,2871,3682,1.3677,103.894926
530305,31,309,340,1.367052,103.894716
530306,254,342,596,1.367205,103.895251
530307,316,269,585,1.366683,103.894867
530308,463,6640,7103,1.36678,103.895678
530309,776,722,1498,1.36622,103.89496
530310,641,476,1117,1.366347,103.895856
530311,486,429,915,1.365636,103.894723
530312,89,39,128,1.365573,103.894214
530313,301,119,420,1.365293,103.894611
530314,628,130,758,1.364745,103.89425
530315,148,97,245,1.364862,103.894963
530316,166,3021,3187,1.364935,103.896198
530317,300,143,443,1.365257,103.89618
530318,36,146,182,1.36561,103.896118
530319,148,876,1024,1.365703,103.896644
530320,341,1743,2084,1.366379,103.898155
530321,611,335,946,1.367067,103.898193
530322,610,11831,12441,1.366983,103.897127
530323,31,531,562,1.367241,103.897729
530324,847,393,1240,1.367459,103.897256
530325,482,1502,1984,1.367593,103.898772
530326,1131,366,1497,1.368029,103.898494
530327,715,4691,5406,1.368256,103.896155
530328,781,591,1372,1.368716,103.896332
530332,893,379,1272,1.368442,103.897708
530333,32,18,50,1.368561,103.898361
530334,496,138,634,1.368839,103.897811
530335,205,84,289,1.368984,103.898662
530336,503,192,695,1.36932,103.89824
530337,942,123,1065,1.36962,103.898235
530338,111,349,460,1.369607,103.898822
530339,517,236,753,1.37006,103.898444
530340,220,126,346,1.370119,103.897868
530341,1270,268,1538,1.370416,103.898324
530344,122,1207,1329,1.369849,103.900002
530345,88,122,210,1.370301,103.899374
530346,205,901,1106,1.370454,103.900249
530347,165,565,730,1.370877,103.900259
530348,121,25,146,1.371017,103.899569
530349,926,198,1124,1.371579,103.899859
530350,1030,2379,3409,1.37208,103.900256
530351,657,61,718,1.371731,103.898879
530352,557,195,752,1.372037,103.898997
530353,22,19,41,1.37218,103.899501
530354,651,478,1129,1.372426,103.899423
530355,331,97,428,1.371822,103.898292
530356,337,2132,2469,1.372568,103.898837
530357,438,2574,3012,1.372969,103.899163
530358,614,5320,5934,1.368874,103.895518
530359,67,1048,1115,1.369189,103.895197
530360,782,401,1183,1.369472,103.895524
530361,476,422,898,1.369259,103.895824
530362,445,1509,1954,1.370041,103.896001
530363,913,68,981,1.369912,103.896242
530364,25,45,70,1.299509,103.837
530365,84,36,120,1.299509,103.837
530370,575,3389,3964,1.363701,103.889401
530371,565,150,715,1.363599,103.889663
530372,601,131,732,1.363162,103.890126
530373,1016,71,1087,1.362682,103.890291
530374,318,103,421,1.362906,103.889651
530375,292,223,515,1.363265,103.889344
530376,57,152,209,1.299509,103.837
530401,789,3340,4129,1.374806,103.896763
530402,560,565,1125,1.374466,103.896633
530403,109,125,234,1.374663,103.896376
530404,266,332,598,1.373888,103.895851
530405,568,538,1106,1.374023,103.896322
530406,390,249,639,1.373634,103.896022
530407,628,232,860,1.373001,103.895582
530408,348,165,513,1.373318,103.895353
530409,443,54,497,1.373743,103.89514
530410,87,2195,2282,1.373964,103.894683
530411,523,640,1163,1.374063,103.89518
530412,169,3302,3471,1.374737,103.895427
530413,438,341,779,1.374553,103.895647
530414,678,503,1181,1.37487,103.895844
530415,489,384,873,1.375211,103.896433
530416,525,1061,1586,1.375614,103.896206
530417,339,1507,1846,1.376436,103.894771
530418,506,770,1276,1.376106,103.8954
530419,451,453,904,1.376176,103.894785
530420,883,136,1019,1.37578,103.89465
530421,544,305,849,1.375473,103.894647
530422,500,459,959,1.374717,103.894121
530423,932,359,1291,1.374252,103.893992
530424,619,262,881,1.373784,103.893451
530425,526,802,1328,1.373445,103.893477
530426,260,2084,2344,1.373697,103.893017
530427,192,1258,1450,1.374528,103.893045
530428,171,291,462,1.37502,103.89312
530429,352,237,589,1.375422,103.893711
530430,375,121,496,1.375467,103.893291
530431,69,546,615,1.375648,103.893079
530432,243,1233,1476,1.376255,103.893024
530433,290,460,750,1.376197,103.893628
530434,844,2502,3346,1.376462,103.893622
530435,448,425,873,1.377519,103.893613
530436,750,3771,4521,1.377246,103.894135
530437,838,1473,2311,1.377192,103.893309
530438,198,1082,1280,1.378031,103.89314
530439,1133,563,1696,1.378612,103.89344
530440,345,355,700,1.379157,103.893518
530441,93,231,324,1.378472,103.893953
530442,75,793,868,1.379287,103.893171
530443,328,739,1067,1.379503,103.893234
530444,600,140,740,1.379503,103.893866
530445,674,315,989,1.37914,103.894303
530446,808,289,1097,1.378808,103.894272
530447,176,30,206,1.379537,103.894762
530448,763,238,1001,1.379134,103.895115
530449,762,231,993,1.378798,103.895177
530450,188,94,282,1.379302,103.895536
530451,440,219,659,1.378848,103.89593
530452,632,918,1550,1.378361,103.896523
530453,328,522,850,1.378504,103.895879
530454,131,122,253,1.378183,103.895395
530455,473,135,608,1.37747,103.895452
530456,386,1041,1427,1.377167,103.895429
530457,527,1644,2171,1.376994,103.895989
530458,672,1743,2415,1.377729,103.896269
530460,547,824,1371,1.373272,103.894543
530461,247,4284,4531,1.372827,103.894551
530462,715,382,1097,1.372273,103.894549
530463,226,184,410,1.372381,103.894856
530464,380,196,576,1.372233,103.896271
530465,285,902,1187,1.372128,103.896887
530466,561,258,819,1.372567,103.896978
530467,249,312,561,1.373362,103.896802
530468,232,224,456,1.373697,103.897203
530470,212,250,462,1.299509,103.837
530471,92,61,153,1.299509,103.837
530473,42,163,205,1.299509,103.837
530474,19,43,62,1.299509,103.837
530475,365,947,1312,1.277769,103.848391
530476,165,710,875,1.377847,103.90365
530477,64,733,797,1.299509,103.837
530501,240,1645,1885,1.37211,103.886795
530502,540,3852,4392,1.37277,103.886929
530503,742,3047,3789,1.373606,103.887642
530504,630,121,751,1.373157,103.888018
530505,140,677,817,1.373161,103.887614
530506,519,272,791,1.372744,103.887549
530507,580,162,742,1.372433,103.887535
530508,874,3893,4767,1.371646,103.887909
530509,75,195,270,1.372254,103.888227
530510,97,56,153,1.372545,103.888533
530511,542,372,914,1.372048,103.88871
530512,542,2476,3018,1.371267,103.8889
530513,427,880,1307,1.372104,103.889531
530514,239,743,982,1.372137,103.889176
530515,597,304,901,1.372429,103.888944
530516,506,114,620,1.372712,103.88893
530517,69,169,238,1.372797,103.889656
530520,419,281,700,1.373408,103.890054
530521,735,1072,1807,1.373446,103.890728
530522,1133,2617,3750,1.373466,103.891682
530523,275,295,570,1.37373,103.890519
530524,653,587,1240,1.374089,103.890505
530525,424,320,744,1.374897,103.891256
530526,913,299,1212,1.374434,103.890462
530527,662,195,857,1.374821,103.890448
530528,472,139,611,1.375183,103.890502
530529,406,310,716,1.375495,103.890531
530530,50,133,183,1.375273,103.890028
530531,159,1112,1271,1.375767,103.890172
530532,291,4578,4869,1.376083,103.891037
530533,1276,537,1813,1.375881,103.891567
530534,298,234,532,1.377182,103.890494
530535,586,2091,2677,1.376549,103.890196
530536,336,1224,1560,1.377232,103.889377
530537,402,2515,2917,1.377702,103.889591
530538,725,122,847,1.377841,103.890127
530539,617,180,797,1.377545,103.890148
530540,851,186,1037,1.376459,103.890846
530541,526,540,1066,1.377507,103.891091
530542,537,4433,4970,1.377031,103.891824
530543,86,296,382,1.377714,103.891932
530544,744,28,772,1.378529,103.891831
530545,148,133,281,1.378223,103.891692
530546,378,216,594,1.378947,103.891757
530547,460,111,571,1.379252,103.891935
530548,420,247,667,1.379552,103.891404
530549,614,162,776,1.378166,103.891271
530550,484,44,528,1.378175,103.890715
530551,722,323,1045,1.378481,103.890737
530552,357,504,861,1.3788,103.8904
530553,502,137,639,1.379119,103.890374
530554,311,3760,4071,1.378769,103.889747
530555,560,103,663,1.379654,103.889735
530556,500,234,734,1.379732,103.890204
530557,620,494,1114,1.379954,103.890429
530558,218,113,331,1.380489,103.889779
530559,400,118,518,1.380042,103.889492
530560,190,204,394,1.380312,103.889383
530561,16,63,79,1.38034,103.889086
530562,406,146,552,1.380954,103.889115
530563,452,9820,10272,1.37998,103.888737
530564,508,628,1136,1.379844,103.888452
530565,279,5098,5377,1.380033,103.888211
530566,597,1714,2311,1.381444,103.888653
530567,410,1934,2344,1.378551,103.889059
530568,841,2174,3015,1.378078,103.888945
530569,569,2355,2924,1.377423,103.888191
530570,813,388,1201,1.377996,103.888365
530571,916,264,1180,1.37857,103.888182
530572,680,47,727,1.378301,103.887438
530573,535,295,830,1.377615,103.887554
530574,879,3128,4007,1.3775,103.886937
530575,612,498,1110,1.377971,103.887001
530576,1016,450,1466,1.378356,103.886574
530577,234,365,599,1.378669,103.885037
530578,296,1105,1401,1.378971,103.885278
530579,666,1600,2266,1.379041,103.886188
530580,538,171,709,1.378838,103.886922
530581,83,178,261,1.299509,103.837
530582,88,145,233,1.379221,103.886446
530601,212,421,633,1.37085,103.887304
530602,658,4651,5309,1.371215,103.886893
530603,299,2716,3015,1.371408,103.885884
530604,175,278,453,1.370979,103.885901
530605,713,371,1084,1.371008,103.886508
530606,463,184,647,1.370676,103.885875
530607,503,448,951,1.370327,103.886103
530608,145,5219,5364,1.370719,103.885382
530609,13,68,81,1.370031,103.885427
530610,312,1228,1540,1.370295,103.885131
530611,659,3414,4073,1.36994,103.88471
530612,48,123,171,1.369648,103.885355
530613,350,462,812,1.369447,103.88484
530614,596,394,990,1.36906,103.884658
530615,727,1776,2503,1.368676,103.884831
530616,428,656,1084,1.368951,103.883519
530617,348,172,520,1.369505,103.883583
530618,119,427,546,1.369522,103.884236
530619,278,148,426,1.3699,103.883702
530620,449,8668,9117,1.370154,103.883778
530621,95,93,188,1.370124,103.883174
530622,112,843,955,1.37021,103.882812
530623,364,4926,5290,1.370491,103.88227
530624,646,281,927,1.370248,103.882263
530625,253,461,714,1.370124,103.881609
530626,182,199,381,1.36981,103.881874
530627,593,1430,2023,1.369392,103.882022
530628,1254,1849,3103,1.369554,103.880757
530629,385,355,740,1.369878,103.880992
530630,807,362,1169,1.370307,103.880988
530631,715,14331,15046,1.370693,103.881449
530632,337,3338,3675,1.370676,103.880707
530633,708,647,1355,1.369904,103.879092
530634,496,674,1170,1.369999,103.878611
530635,680,373,1053,1.370192,103.879073
530636,569,360,929,1.370599,103.879173
530637,883,127,1010,1.370942,103.879263
530638,85,49,134,1.370893,103.878726
530639,224,10370,10594,1.370682,103.879813
530640,333,207,540,1.37136,103.879697
530641,51,1479,1530,1.371344,103.879894
530642,886,119,1005,1.371775,103.879699
530643,352,364,716,1.371587,103.880577
530644,379,2684,3063,1.37148,103.881255
530645,192,1501,1693,1.371783,103.881337
530646,327,326,653,1.371889,103.880767
530647,4,11,15,1.371915,103.880269
530648,598,346,944,1.372084,103.879704
530649,222,210,432,1.372405,103.880487
530650,501,247,748,1.372114,103.881278
530651,268,122,390,1.372576,103.881121
530652,528,426,954,1.37248,103.881369
530653,520,82,602,1.372852,103.88122
530654,263,111,374,1.37281,103.881573
530655,769,383,1152,1.373166,103.881845
530656,331,102,433,1.373452,103.881732
530657,354,449,803,1.373876,103.881873
530658,1065,320,1385,1.373389,103.882573
530659,150,44,194,1.373386,103.883094
530660,507,276,783,1.373645,103.882784
530661,326,454,780,1.374151,103.882519
530662,758,7678,8436,1.374423,103.88261
530665,1094,4926,6020,1.374078,103.884111
530666,150,8025,8175,1.373751,103.884898
530667,794,366,1160,1.37381,103.884029
530668,50,78,128,1.373382,103.883408
530669,348,176,524,1.373348,103.884107
530670,103,1641,1744,1.372944,103.884724
530671,461,168,629,1.373086,103.88393
530672,170,229,399,1.372553,103.884061
530673,659,904,1563,1.372581,103.884631
530674,832,291,1123,1.372192,103.884554
530675,595,336,931,1.371899,103.884241
530676,356,474,830,1.371578,103.884123
530677,463,782,1245,1.371214,103.884066
530678,525,1839,2364,1.370903,103.884068
530679,55,61,116,1.371534,103.884961
530680,515,1300,1815,1.371977,103.885282
530681,514,5447,5961,1.373235,103.886822
530682,531,1272,1803,1.373989,103.885424
530683,415,4941,5356,1.373235,103.886822
530684,663,5032,5695,1.373235,103.886822
530685,424,7955,8379,1.37526,103.886006
530686,785,594,1379,1.375776,103.88545
530687,53,4820,4873,1.37617,103.884992
530688,636,372,1008,1.376192,103.885594
530689,543,608,1151,1.37653,103.885773
530690,459,1667,2126,1.376901,103.885665
530691,66,832,898,1.37655,103.88639
530692,59,606,665,1.376478,103.886949
530693,1021,2546,3567,1.376703,103.887436
530694,17,70,87,1.376044,103.887975
530695,608,457,1065,1.376299,103.887448
530696,412,414,826,1.375937,103.887421
530697,709,233,942,1.375575,103.887403
530698,640,7260,7900,1.375132,103.887018
530699,488,354,842,1.376161,103.889245
530701,661,1627,2288,1.365982,103.889863
530702,459,661,1120,1.365774,103.889529
530703,489,444,933,1.365551,103.889342
530704,498,2601,3099,1.365185,103.889157
530705,435,416,851,1.365576,103.888397
530706,467,209,676,1.365973,103.8887
530707,517,520,1037,1.366227,103.88878
530708,858,5333,6191,1.366651,103.889006
530709,423,2090,2513,1.367031,103.888085
530710,463,400,863,1.366629,103.888063
530711,497,156,653,1.366309,103.887661
530712,592,130,722,1.365882,103.88742
530713,299,12,311,1.365951,103.886537
530714,118,59,177,1.3663,103.886644
530715,772,100,872,1.366578,103.886998
530716,452,233,685,1.367097,103.886881
530717,183,885,1068,1.367345,103.886945
530718,81,92,173,1.366567,103.88627
530719,869,94,963,1.366842,103.886254
530720,783,389,1172,1.367298,103.886083
530804,149,1224,1373,1.370936,103.894571
530805,210,373,583,1.370868,103.894425
530806,122,284,406,1.371095,103.894009
530809,78,1634,1712,1.371321,103.893785
530810,97,2527,2624,1.371622,103.893653
530811,88,45,133,1.371823,103.893725
530814,10,252,262,1.37221,103.893194
530830,398,335,733,1.371071,103.889975
530831,728,2264,2992,1.371415,103.890061
530832,215,391,606,1.370671,103.889549
530833,512,1395,1907,1.3704,103.889386
530834,352,750,1102,1.369973,103.889721
530835,423,488,911,1.370415,103.889848
530836,528,932,1460,1.369852,103.890836
530837,457,191,648,1.369333,103.891397
530838,829,70,899,1.370206,103.891269
530850,433,16,449,1.369992,103.893321
530851,480,443,923,1.370175,103.893538
530852,394,432,826,1.369747,103.893742
530853,988,468,1456,1.369355,103.893974
530909,860,255,1115,1.378508,103.882927
530910,814,3659,4473,1.378943,103.882907
530911,653,4211,4864,1.378941,103.883808
530912,757,243,1000,1.378542,103.883884
530913,753,277,1030,1.378054,103.8839
530914,260,1352,1612,1.377569,103.883963
530915,397,1032,1429,1.377577,103.883749
530916,632,1084,1716,1.374913,103.884238
530917,1328,5065,6393,1.374998,103.883469
530918,640,131,771,1.375635,103.883522
530919,586,729,1315,1.376024,103.884067
530920,528,983,1511,1.376827,103.883915
530921,447,534,981,1.376444,103.884001
530922,526,142,668,1.376401,103.883451
530923,619,222,841,1.376149,103.882902
530924,430,86,516,1.376329,103.882061
530925,573,1069,1642,1.376726,103.882463
530926,379,101,480,1.376176,103.880828
530927,556,255,811,1.376645,103.880622
530928,804,937,1741,1.376673,103.881369
530929,421,197,618,1.376007,103.881475
530930,974,2308,3282,1.375388,103.881391
530931,645,4774,5419,1.375572,103.880497
530932,24,473,497,1.375145,103.882117
530933,20,160,180,1.299509,103.837
530936,471,5170,5641,1.374669,103.87993
530937,669,7104,7773,1.374681,103.879451
530938,738,188,926,1.374355,103.879742
530939,421,145,566,1.373928,103.87976
530940,1052,205,1257,1.373527,103.879666
530941,1064,244,1308,1.373767,103.87925
530942,1022,247,1269,1.3734,103.880544
530943,684,77,761,1.373899,103.880804
530944,203,219,422,1.374372,103.880394
530945,392,643,1035,1.374252,103.881049
530946,927,4708,5635,1.374565,103.881112
530950,522,5836,6358,1.375976,103.878784
530951,772,284,1056,1.375689,103.878212
530952,730,3115,3845,1.375332,103.877533
530953,652,3193,3845,1.376603,103.877403
530954,904,343,1247,1.376769,103.878167
530955,607,234,841,1.376395,103.878274
530956,960,190,1150,1.376652,103.878829
530957,718,681,1399,1.376656,103.879369
530958,623,1484,2107,1.376655,103.879777
530959,972,36,1008,1.376958,103.879081
530960,742,316,1058,1.377232,103.878546
530961,888,160,1048,1.377689,103.878725
530962,775,327,1102,1.377684,103.878272
530963,632,119,751,1.377147,103.878136
530964,620,2753,3373,1.377266,103.877438
530965,763,1455,2218,1.378605,103.877391
530966,910,158,1068,1.378379,103.878272
530967,453,341,794,1.378387,103.878727
530968,741,3443,4184,1.378715,103.878545
530969,847,4572,5419,1.378761,103.8795
530970,910,2620,3530,1.378796,103.880428
530971,530,266,796,1.378436,103.879679
530972,905,251,1156,1.378451,103.87925
530973,389,286,675,1.377729,103.879795
530974,986,41,1027,1.37766,103.879355
530975,706,276,982,1.377347,103.879538
530976,444,467,911,1.377275,103.880045
530977,3,44,47,1.381888,103.879318
530978,2,1,3,1.366882,103.926622
530980,40,272,312,1.379997,103.880122
530981,22,4,26,1.380337,103.878937
530982,96,737,833,1.380817,103.87933
530983,18,133,151,1.382125,103.87897
530984,48,113,161,1.38142,103.880542
530985,30,8,38,1.381485,103.880029
530986,14,49,63,1.382067,103.880364
530988,18,109,127,1.299509,103.837
530991,1,0,1,1.366404,103.925973
530992,0,53,53,1.299509,103.837
530995,0,1,1,1.299509,103.837
530996,0,1,1,1.299509,103.837
530997,2,0,2,1.366877,103.926607
530998,1,0,1,1.299509,103.837
530999,1,0,1,1.299509,103.837
531001,990,1210,2200,1.350909,103.875414
531002,691,251,942,1.350669,103.875584
531003,419,336,755,1.350556,103.876088
531004,287,170,457,1.350291,103.876432
531006,513,48,561,1.349437,103.877222
531007,730,382,1112,1.349081,103.876999
531008,793,175,968,1.34887,103.876741
531011,4,186,190,1.368572,103.899699
531107,12,176,188,1.299509,103.837
531135,27,260,287,1.349852,103.886653
531159,50,390,440,1.351901,103.879536
531166,287,708,995,1.350822,103.888194
531167,25,8963,8988,1.299509,103.837
531168,15,341,356,1.299509,103.837
531172,23,525,548,1.350687,103.888941
531174,646,980,1626,1.349319,103.888378
531220,5,168,173,1.299509,103.837
531304,9,337,346,1.299509,103.837
531364,120,181,301,1.299509,103.837
531365,300,80,380,1.369857,103.897433
531373,28,119,147,1.362535,103.889906
531376,1092,480,1572,1.363716,103.893953
531435,36,311,347,1.377921,103.894015
531465,12,929,941,1.372358,103.897375
531470,1583,1016,2599,1.379179,103.901972
531471,2377,1113,3490,1.377693,103.901698
531473,887,454,1341,1.378197,103.900609
531475,1804,1105,2909,1.376207,103.900135
531476,1514,437,1951,1.376659,103.904189
531477,925,920,1845,1.377633,103.903619
531548,61,366,427,1.379008,103.891201
531555,21,302,323,1.379811,103.889872
531559,14,1231,1245,1.379696,103.889165
531566,14,397,411,1.380832,103.888541
531567,9,504,513,1.378928,103.888502
531570,5,36,41,1.299509,103.837
531574,140,636,776,1.377655,103.886376
531576,14,293,307,1.378588,103.885858
531581,9,3079,3088,1.299509,103.837
531582,13,28,41,1.299509,103.837
531685,9,518,527,1.375927,103.886496
531697,6,363,369,1.299509,103.837
531698,842,361,1203,1.375223,103.88751
531699,725,925,1650,1.376971,103.888836
531830,29,1267,1296,1.370884,103.890595
531838,14,25,39,1.369963,103.891814
531850,13,86,99,1.37012,103.892989
531909,15,288,303,1.378275,103.88358
531918,11,80,91,1.299509,103.837
531919,35,2665,2700,1.375492,103.884227
531923,16,18,34,1.299509,103.837
531925,5,341,346,1.376813,103.883158
531931,19,1804,1823,1.376148,103.88042
531932,371,1235,1606,1.299509,103.837
531933,307,226,533,1.375901,103.881999
531938,8,9,17,1.373866,103.879282
531941,30,554,584,1.374212,103.879088
531946,31,2287,2318,1.37472,103.880445
531955,4,314,318,1.375923,103.877757
531962,6,39,45,1.377942,103.878151
531966,9,521,530,1.377939,103.877786
531971,5,487,492,1.377985,103.880148
531973,9,40,49,1.377974,103.879954
531977,1,2,3,1.381835,103.879185
531978,5,6,11,1.381888,103.879318
531979,405,2328,2733,1.379582,103.878945
531980,964,2164,3128,1.379626,103.880472
531981,695,1312,2007,1.380566,103.880577
531982,3,182,185,1.381681,103.87876
531983,0,120,120,1.381818,103.87925
531984,813,910,1723,1.382078,103.881089
531985,779,1211,1990,1.381146,103.880127
531986,965,1,966,1.382252,103.879717
531987,749,262,1011,1.380038,103.878222
531988,326,2282,2608,1.379752,103.877291
531996,1,1,2,1.299509,103.837
531997,4,3,7,1.299509,103.837
531998,4,25,29,1.299509,103.837
532002,15,243,258,1.349936,103.87582
532174,505,520,1025,1.349189,103.889078
532364,319,55,374,1.369134,103.897651
532365,217,99,316,1.299509,103.837
532373,14,11,25,1.362212,103.890814
532376,509,88,597,1.363756,103.894081
532470,2244,1702,3946,1.378772,103.900916
532471,2262,1212,3474,1.379179,103.901972
532473,581,2146,2727,1.376759,103.900907
532475,1583,758,2341,1.376207,103.900135
532476,2968,1141,4109,1.373745,103.90237
532477,1451,710,2161,1.370509,103.90073
532698,938,3586,4524,1.374993,103.887804
532699,214,679,893,1.376819,103.888453
532932,417,1253,1670,1.37515,103.88231
532977,1,3,4,1.381998,103.879368
532978,10,17,27,1.381997,103.879303
532979,1035,1198,2233,1.379599,103.87922
532980,923,3425,4348,1.379796,103.881056
532981,369,399,768,1.38053,103.880108
532982,1,125,126,1.381764,103.878809
532983,1,104,105,1.382021,103.878927
532984,1143,150,1293,1.382074,103.880758
532985,1430,823,2253,1.381212,103.879727
532986,1407,10,1417,1.382252,103.879717
532987,923,2586,3509,1.379468,103.878123
532988,508,815,1323,1.379758,103.877174
532991,2,5,7,1.299509,103.837
532992,3,0,3,1.381998,103.879368
532996,0,1,1,1.299509,103.837
532997,0,2,2,1.299509,103.837
532998,3,5,8,1.299509,103.837
533174,362,108,470,1.349319,103.888378
533365,69,47,116,1.299509,103.837
533376,603,28,631,1.364185,103.894096
533470,1432,381,1813,1.379179,103.901972
533473,886,790,1676,1.376118,103.90125
533475,1077,644,1721,1.376207,103.900135
533476,1558,547,2105,1.37787,103.904267
533477,1303,299,1602,1.377633,103.903619
533698,783,1864,2647,1.375423,103.888331
533699,771,365,1136,1.376559,103.888635
533862,13,952,965,1.299509,103.837
533863,205,817,1022,1.299509,103.837
533864,266,1512,1778,1.369092,103.909425
533865,7657,2662,10319,1.366964,103.907641
533866,1,1,2,1.299509,103.837
533867,7,282,289,1.299509,103.837
533868,0,23,23,1.299509,103.837
533869,1,34,35,1.299509,103.837
533870,3,254,257,1.299509,103.837
533871,0,145,145,1.299509,103.837
533872,0,14,14,1.299509,103.837
533873,1,0,1,1.299509,103.837
533875,1,0,1,1.299509,103.837
533876,0,20,20,1.373862,103.902809
533877,2,1,3,1.299509,103.837
533878,2,16,18,1.299509,103.837
533879,1,7,8,1.299509,103.837
533880,1,6,7,1.299509,103.837
533881,1,9,10,1.299509,103.837
533882,0,1,1,1.299509,103.837
533884,0,1,1,1.299509,103.837
533885,0,2,2,1.299509,103.837
533886,1,150,151,1.299509,103.837
533887,0,5,5,1.299509,103.837
533888,1,0,1,1.299509,103.837
533890,0,1,1,1.299509,103.837
533891,0,3,3,1.299509,103.837
533892,0,14,14,1.299509,103.837
533893,6,110,116,1.299509,103.837
533900,0,3,3,1.299509,103.837
533901,0,5,5,1.299509,103.837
533902,3,33,36,1.299509,103.837
533910,1,0,1,1.299509,103.837
533911,5,0,5,1.299509,103.837
533912,1144,607,1751,1.371626,103.909428
533913,1,6,7,1.299509,103.837
533917,1,0,1,1.299509,103.837
533922,0,37,37,1.299509,103.837
533923,0,17,17,1.299509,103.837
533924,0,31,31,1.299509,103.837
533925,2,419,421,1.299509,103.837
533926,0,1,1,1.299509,103.837
533928,0,1,1,1.299509,103.837
533929,0,1,1,1.299509,103.837
533931,0,6,6,1.299509,103.837
533932,9,1632,1641,1.299509,103.837
533935,0,5,5,1.299509,103.837
533936,0,2,2,1.299509,103.837
533938,1,2,3,1.299509,103.837
533940,0,1,1,1.299509,103.837
533941,794,727,1521,1.338428,103.88839
533947,1,0,1,1.354111,103.879562
533948,1,1,2,1.299509,103.837
533949,2,278,280,1.299509,103.837
533950,1,6,7,1.299509,103.837
533951,99,94,193,1.299509,103.837
533952,1276,1103,2379,1.372919,103.910542
533953,0,63,63,1.299509,103.837
533954,0,15,15,1.355067,103.881497
533955,1,0,1,1.299509,103.837
533956,3,25,28,1.299509,103.837
533957,11,27,38,1.299509,103.837
533958,2,1,3,1.299509,103.837
533960,40,17,57,1.299509,103.837
533961,9,33,42,1.299509,103.837
533962,0,3,3,1.299509,103.837
533963,0,1,1,1.299509,103.837
533964,4,0,4,1.299509,103.837
533965,11,1,12,1.299509,103.837
533966,0,1,1,1.299509,103.837
533967,0,1,1,1.299509,103.837
533968,159,0,159,1.299509,103.837
533969,16,0,16,1.299509,103.837
533970,297,810,1107,1.299509,103.837
533971,115,1610,1725,1.370498,103.895356
533972,766,3037,3803,1.334675,103.890368
533973,718,474,1192,1.370183,103.908874
533974,1,0,1,1.299509,103.837
533975,24,15,39,1.299509,103.837
533977,0,12,12,1.381888,103.879318
533978,523,352,875,1.379987,103.878792
533979,866,1072,1938,1.379635,103.879869
533980,825,369,1194,1.380025,103.880827
533981,664,363,1027,1.380526,103.879656
533982,1,48,49,1.38188,103.878828
533983,1,53,54,1.38219,103.879016
533984,1477,818,2295,1.382342,103.881239
533985,22,565,587,1.382375,103.879108
533986,1705,428,2133,1.382643,103.880329
533987,529,767,1296,1.37937,103.877808
533988,483,801,1284,1.379575,103.877856
533989,0,1,1,1.299509,103.837
533990,0,1,1,1.299509,103.837
533997,0,168,168,1.299509,103.837
533998,0,290,290,1.299509,103.837
534002,1,0,1,1.299509,103.837
534005,2,0,2,1.299509,103.837
534006,52,123,175,1.361354,103.889397
534007,125,123,248,1.299509,103.837
534008,99,34,133,1.299509,103.837
534009,74,7,81,1.299509,103.837
534012,52,32,84,1.380287,103.885255
534013,2289,3113,5402,1.33525,103.889631
534014,403,34,437,1.376312,103.903217
534015,798,114,912,1.376312,103.903217
534016,92,280,372,1.299509,103.837
534017,205,806,1011,1.299509,103.837
534018,295,727,1022,1.376312,103.903217
534019,604,396,1000,1.375732,103.903688
534020,424,354,778,1.299509,103.837
534021,1767,699,2466,1.375922,104.001426
534022,1051,289,1340,1.299509,103.837
534023,1,6,7,1.299509,103.837
534024,273,17,290,1.299509,103.837
534025,261,7,268,1.299509,103.837
534026,261,41,302,1.378625,103.902771
534027,314,34,348,1.299509,103.837
534028,310,6,316,1.378625,103.902771
534029,333,32,365,1.299509,103.837
534030,477,258,735,1.378625,103.902771
534031,550,898,1448,1.378632,103.902764
534032,906,1882,2788,1.378485,103.902533
534033,739,2001,2740,1.377895,103.902633
534034,393,629,1022,1.299509,103.837
534035,577,1028,1605,1.378637,103.902716
534036,0,2,2,1.299509,103.837
534037,1292,37,1329,1.364018,103.89515
534038,1003,176,1179,1.363768,103.895123
534039,679,21,700,1.299509,103.837
534040,151,2626,2777,1.299509,103.837
534041,776,625,1401,1.299509,103.837
534042,927,212,1139,1.299509,103.837
534043,671,411,1082,1.299509,103.837
534044,629,98,727,1.299509,103.837
534045,508,55,563,1.299509,103.837
534046,990,161,1151,1.299509,103.837
534047,599,1111,1710,1.299509,103.837
534048,302,572,874,1.299509,103.837
534049,312,4,316,1.350349,103.880059
534050,2,25,27,1.299509,103.837
534051,243,3169,3412,1.350722,103.879958
534053,74,9,83,1.336939,103.890006
534054,684,399,1083,1.336881,103.891199
534055,0,156,156,1.299509,103.837
534056,5,79,84,1.299509,103.837
534057,2190,1030,3220,1.335801,103.88904
534058,12,31,43,1.299509,103.837
534059,4,345,349,1.299509,103.837
534060,1,0,1,1.299509,103.837
534061,2,0,2,1.299509,103.837
534062,3,0,3,1.299509,103.837
534063,19,0,19,1.348067,103.881505
534064,6,1,7,1.299509,103.837
534066,25,0,25,1.299509,103.837
534067,2,0,2,1.299509,103.837
534068,1,0,1,1.299509,103.837
534069,0,3,3,1.299509,103.837
534070,649,0,649,1.351777,103.881277
534071,929,0,929,1.351777,103.881277
534072,535,3,538,1.351777,103.881277
534073,328,6,334,1.351777,103.881277
534074,592,5,597,1.351777,103.881277
534075,641,26,667,1.35293,103.881405
534076,907,187,1094,1.351777,103.881277
534077,729,26,755,1.351777,103.881277
534078,799,58,857,1.352458,103.881713
534079,1013,13,1026,1.351777,103.881277
534080,1905,36,1941,1.351777,103.881277
534081,809,64,873,1.351777,103.881277
534082,562,26,588,1.351777,103.881277
534083,118,4,122,1.351777,103.881277
534084,193,2065,2258,1.338641,103.889438
534085,191,4,195,1.357997,103.881404
534086,24,2740,2764,1.350736,103.88267
534089,47,1,48,1.350628,103.882683
534090,3,0,3,1.299509,103.837
534091,1,0,1,1.338017,103.883427
534095,1,0,1,1.350456,103.882674
534096,3,2,5,1.350324,103.882512
534097,3,0,3,1.350578,103.882687
534100,11,495,506,1.350697,103.882415
534101,3146,1557,4703,1.3361,103.889908
534102,28,277,305,1.349688,103.880026
534103,1811,843,2654,1.335407,103.889992
534104,403,1280,1683,1.337909,103.889805
534105,0,5,5,1.34706,103.886115
534106,1572,629,2201,1.335256,103.889713
534108,4,68,72,1.348592,103.882719
534110,1,0,1,1.350288,103.882719
534111,1,0,1,1.348876,103.883281
534113,2,0,2,1.299509,103.837
534115,8,0,8,1.348876,103.883281
534116,8,0,8,1.348876,103.883281
534117,23,0,23,1.348876,103.883281
534118,1906,1446,3352,1.337755,103.888621
534119,2157,516,2673,1.338141,103.889431
534120,369,1548,1917,1.336797,103.889313
534121,0,17,17,1.349752,103.881706
534122,0,3,3,1.350341,103.882473
534123,44,0,44,1.349752,103.881706
534124,6,0,6,1.349752,103.881706
534125,5,0,5,1.349752,103.881706
534127,2,0,2,1.348876,103.883281
534128,2,0,2,1.349752,103.881706
534129,0,1,1,1.348876,103.883281
534130,21,0,21,1.350404,103.881767
534133,1,0,1,1.350368,103.881974
534134,1,0,1,1.349752,103.881706
534135,88,0,88,1.349752,103.881706
534136,5,0,5,1.349752,103.881706
534137,6,1,7,1.349752,103.881706
534138,870,2400,3270,1.337091,103.888909
534140,1,9,10,1.356224,103.882528
534141,1,16,17,1.356224,103.882528
534142,13,3,16,1.356224,103.882528
534143,0,4,4,1.356224,103.882528
534144,6,3,9,1.356224,103.882528
534145,10,0,10,1.356147,103.882442
534146,14,0,14,1.356147,103.882442
534148,14,2,16,1.356069,103.882355
534149,17,0,17,1.355992,103.882269
534150,0,97,97,1.356797,103.881962
534151,11,0,11,1.356745,103.881933
534152,2,105,107,1.35677,103.881879
534153,0,12,12,1.356735,103.881844
534154,2,4,6,1.3567,103.881783
534155,1,2,3,1.349752,103.881706
534156,1,0,1,1.349752,103.881706
534157,2,1,3,1.356505,103.88179
534158,826,3,829,1.336319,103.890745
534159,3,2,5,1.355865,103.883181
534160,2,4,6,1.354488,103.880203
534161,5,0,5,1.354488,103.880203
534163,281,34,315,1.356326,103.88034
534165,0,177,177,1.299509,103.837
534166,158,459,617,1.33716,103.889147
534167,1132,445,1577,1.339131,103.888424
534168,2,48,50,1.338964,103.896651
534171,7,0,7,1.350817,103.881632
534172,8,7,15,1.359998,103.890876
534174,31,0,31,1.350197,103.881226
534175,13,0,13,1.350086,103.881252
534176,0,1,1,1.356475,103.881817
534177,3,5,8,1.358601,103.889951
534178,1,4,5,1.358656,103.889939
534179,63,2,65,1.358713,103.889936
534180,3,3,6,1.358604,103.889866
534181,3,1,4,1.358645,103.889829
534182,187,468,655,1.337395,103.890304
534183,3,16,19,1.353882,103.878841
534184,22,29,51,1.353857,103.879043
534185,5,6,11,1.353973,103.878932
534186,4,18,22,1.354013,103.87897
534187,4,16,20,1.354057,103.879024
534188,16,11,27,1.35411,103.879091
534189,0,31,31,1.349323,103.88426
534190,98,22568,22666,1.380728,103.88548
534191,14,1357,1371,1.380362,103.884927
534192,0,13,13,1.339211,103.884295
534193,30,283,313,1.341757,103.898382
534194,44,510,554,1.38291,103.883492
534195,0,4,4,1.345226,103.87575
534196,0,5,5,1.359683,103.890099
534197,350,482,832,1.349898,103.898429
534198,876,163,1039,1.372946,103.902113
534199,489,39,528,1.372767,103.901943
534200,244,783,1027,1.372736,103.901373
534201,608,16,624,1.372536,103.901774
534202,269,5,274,1.37226,103.901499
534203,704,185,889,1.371876,103.901275
534204,343,225,568,1.372271,103.901172
534205,379,1305,1684,1.372502,103.900956
534206,786,657,1443,1.372731,103.900784
534207,777,80,857,1.372947,103.901036
534208,603,88,691,1.373218,103.901321
534209,868,496,1364,1.373444,103.901613
534210,6,0,6,1.349325,103.883594
534211,2,0,2,1.349752,103.881706
534213,2,0,2,1.349325,103.883594
534215,0,9,9,1.349325,103.883594
534217,0,1,1,1.350259,103.881244
534219,73,0,73,1.34938,103.884308
534220,1,0,1,1.349427,103.88424
534221,29,0,29,1.339181,103.884289
534222,6,1,7,1.339181,103.884289
534223,10,0,10,1.339181,103.884289
534224,1,0,1,1.339181,103.884289
534225,3,0,3,1.356476,103.881847
534226,24,1,25,1.339181,103.884289
534228,4,0,4,1.339181,103.884289
534229,1,1,2,1.349325,103.883594
534232,1,0,1,1.339181,103.884289
534233,66,1878,1944,1.337413,103.890586
534234,277,307,584,1.345146,103.899746
534235,1,420,421,1.353133,103.877792
534236,1007,0,1007,1.35023,103.899408
534237,641,187,828,1.374544,103.902283
534238,527,1160,1687,1.37734,103.881046
534239,594,10,604,1.35028,103.880603
534241,1,15,16,1.350003,103.88115
534242,0,3,3,1.339181,103.884289
534244,0,5,5,1.349692,103.881174
534245,0,1,1,1.339181,103.884289
534247,0,4,4,1.350231,103.881114
534248,0,6,6,1.349685,103.881118
534249,1,70,71,1.350164,103.881136
534250,0,57,57,1.350149,103.881241
534251,1,13,14,1.350064,103.88115
534253,0,5,5,1.350326,103.881178
534254,1,0,1,1.349706,103.881231
534255,3,869,872,1.350279,103.881192
534256,172,672,844,1.377661,103.88253
534257,5024,0,5024,1.342752,103.90027
534258,44,0,44,1.34278,103.90025
534259,2,0,2,1.339181,103.884289
534260,1835,235,2070,1.373589,103.901016
534261,5,0,5,1.345554,103.883927
534262,2,0,2,1.342748,103.900249
534263,4,0,4,1.346763,103.881422
534264,0,2,2,1.346367,103.881879
534265,4,0,4,1.346184,103.881603
534266,55,19,74,1.346453,103.882067
534267,1,0,1,1.350446,103.881145
534268,5,0,5,1.34645,103.882362
534270,5,0,5,1.34652,103.882328
534271,1,1,2,1.346484,103.881513
534272,0,2,2,1.346603,103.882339
534273,9,3,12,1.346708,103.882269
534275,1,5,6,1.346844,103.882231
534276,51,0,51,1.346859,103.882245
534277,2,7,9,1.346911,103.882231
534278,0,2,2,1.346626,103.882294
534279,1,1,2,1.346998,103.882217
534281,0,7,7,1.347125,103.882164
534282,55,0,55,1.347183,103.882146
534283,7,10,17,1.347097,103.881944
534284,5,0,5,1.347447,103.882016
534285,7,1,8,1.347027,103.881696
534286,15,0,15,1.34784,103.88217
534288,54,3,57,1.347784,103.882066
534289,0,5,5,1.347805,103.882036
534290,10,1,11,1.34779,103.881986
534291,26,6,32,1.346882,103.881332
534292,1,4,5,1.347784,103.881932
534293,8,0,8,1.346879,103.881321
534294,13,1,14,1.347793,103.881852
534295,19,8,27,1.346876,103.88131
534296,0,6,6,1.347747,103.881794
534297,23,0,23,1.346871,103.881298
534298,1,0,1,1.346367,103.88237
534299,2,3,5,1.346867,103.881287
534300,85,4,89,1.347717,103.881681
534301,3,0,3,1.350115,103.88113
534303,2,6,8,1.346859,103.881259
534304,3,12,15,1.347717,103.881505
534305,65,0,65,1.346852,103.881245
534306,1,0,1,1.347743,103.881711
534307,6,8,14,1.34685,103.881234
534308,5,2,7,1.347705,103.881414
534310,1,1,2,1.347047,103.882194
534311,5,3,8,1.346841,103.881204
534312,2,0,2,1.347677,103.88137
534313,1,0,1,1.347731,103.881472
534314,2,10,12,1.347668,103.88126
534315,5,14,19,1.346829,103.88117
534316,6,6,12,1.347664,103.881211
534318,0,5,5,1.347672,103.881147
534319,25,131,156,1.346819,103.881141
534320,1,5,6,1.347619,103.881104
534321,1,2,3,1.346863,103.881272
534322,1,16,17,1.347624,103.880929
534323,13,1,14,1.347629,103.880879
534324,0,7,7,1.347612,103.880856
534325,13,2,15,1.347597,103.880768
534326,8,378,386,1.347599,103.880738
534327,19,4,23,1.345868,103.885667
534328,2,0,2,1.347665,103.881307
534329,2,0,2,1.345825,103.885683
534330,1,3,4,1.345653,103.885787
534331,5,0,5,1.345399,103.885435
534332,1,0,1,1.346835,103.881186
534333,4,0,4,1.345322,103.885327
534334,4,1,5,1.34527,103.885287
534335,1,0,1,1.345352,103.885369
534336,0,3,3,1.347623,103.881046
534337,0,1,1,1.345213,103.885253
534338,1,8,9,1.345081,103.88515
534339,0,2,2,1.345782,103.885708
534340,5,1,6,1.34499,103.885076
534341,11,1,12,1.344944,103.885036
534342,0,4,4,1.344898,103.884997
534343,0,2,2,1.345035,103.885116
534345,0,7,7,1.344772,103.884883
534346,21,2,23,1.34472,103.884843
534347,2,4,6,1.34468,103.884815
534348,2,2,4,1.344651,103.884786
534349,21,5,26,1.344625,103.884751
534351,0,1,1,1.345127,103.885201
534352,3,0,3,1.345173,103.88523
534353,2,0,2,1.344865,103.884969
534354,1,0,1,1.344421,103.884761
534355,14,3,17,1.344567,103.884646
534356,27,3,30,1.344616,103.884609
534357,5,10,15,1.344655,103.884549
534358,4,0,4,1.344706,103.884526
534359,6,1,7,1.344752,103.884504
534360,1,0,1,1.344514,103.884674
534361,4,0,4,1.344802,103.884439
534363,1,1,2,1.344473,103.88471
534364,0,2,2,1.345552,103.885053
534365,15,1,16,1.345498,103.884972
534366,11,0,11,1.345488,103.884958
534367,9,0,9,1.345424,103.884904
534368,9,0,9,1.345384,103.884862
534369,1,5,6,1.345349,103.884797
534371,8,0,8,1.345276,103.884717
534374,1,0,1,1.34478,103.884485
534375,3,1,4,1.34512,103.884526
534376,5,0,5,1.345087,103.884495
534377,313,4,317,1.345068,103.884462
534378,20,4,24,1.345002,103.884376
534379,1,0,1,1.34515,103.884561
534380,0,2,2,1.345519,103.884996
534382,10,0,10,1.347427,103.882633
534383,25,2,27,1.347393,103.882508
534384,2,0,2,1.347462,103.882758
534385,1,0,1,1.347479,103.882821
534386,38,26,64,1.346476,103.88016
534387,9,37,46,1.346558,103.880138
534388,150,1,151,1.3466,103.880062
534389,1,5,6,1.346649,103.880073
534392,459,1742,2201,1.350753,103.899534
534393,435,571,1006,1.351496,103.900265
534395,691,59,750,1.349942,103.900068
534396,779,111,890,1.352933,103.898942
534397,6,18,24,1.345871,103.875344
534398,2,43,45,1.342808,103.882949
534408,870,13,883,1.336444,103.893493
534409,64,181,245,1.337953,103.891146
534410,4,107,111,1.337684,103.891511
534411,28,11,39,1.338487,103.89213
534412,6,45,51,1.33959,103.892326
534413,428,526,954,1.336209,103.892818
534414,48,291,339,1.335655,103.892303
534415,325,143,468,1.336051,103.892124
534416,120,11,131,1.337059,103.89194
534417,31,65,96,1.338533,103.891456
534418,9,5,14,1.338934,103.89181
534419,21,276,297,1.33778,103.891319
534420,13,12,25,1.338584,103.890675
534421,55,123,178,1.338707,103.889991
534422,1,0,1,1.34737,103.882465
534423,39,452,491,1.357561,103.882605
534424,7,472,479,1.357497,103.882514
534425,0,2,2,1.34737,103.882465
534426,1,0,1,1.342609,103.901251
534428,4,1,5,1.35744,103.882709
534429,0,8,8,1.357368,103.882639
534430,14,0,14,1.35736,103.882789
534431,0,1,1,1.357406,103.88261
534432,0,1,1,1.357392,103.882783
534434,3,0,3,1.34445,103.884737
534436,10,0,10,1.357139,103.882855
534437,16,2,18,1.356938,103.883051
534438,2,5,7,1.357156,103.883006
534439,4,1,5,1.357065,103.883067
534440,30,7,37,1.356972,103.883015
534449,37,0,37,1.36192,103.887566
534451,3,267,270,1.361903,103.887643
534452,8,16,24,1.361723,103.887575
534453,0,3,3,1.357154,103.882974
534454,4,0,4,1.361757,103.887941
534456,5,5,10,1.361788,103.887996
534457,1,3,4,1.361635,103.887741
534458,1,0,1,1.357257,103.882875
534459,2,0,2,1.357487,103.882683
534462,0,1,1,1.361791,103.888154
534463,17,1,18,1.361774,103.888621
534466,13,4,17,1.361786,103.888775
534467,0,2,2,1.361644,103.887934
534468,30,0,30,1.361655,103.888225
534469,0,1,1,1.361774,103.888513
534470,0,1,1,1.361786,103.888957
534471,1,0,1,1.36178,103.889025
534472,5,0,5,1.361774,103.889122
534473,0,3,3,1.361764,103.887873
534474,6,0,6,1.361672,103.888464
534477,2,0,2,1.361786,103.888854
534478,0,2,2,1.361673,103.888634
534480,68,0,68,1.361678,103.888902
534481,4,3,7,1.361678,103.88901
534482,4,1,5,1.361678,103.889078
534483,0,9,9,1.361679,103.889181
534484,2,0,2,1.361678,103.888726
534485,2,3,5,1.361776,103.888096
534486,0,2,2,1.361777,103.88804
534487,2,0,2,1.361791,103.888217
534493,1,206,207,1.34379,103.870882
534494,0,8,8,1.343809,103.870934
534495,3,141,144,1.343497,103.870443
534497,0,28,28,1.343839,103.870892
534498,1,47,48,1.343555,103.870447
534500,1,0,1,1.361661,103.88835
534501,1,8,9,1.34398,103.870889
534502,2,26,28,1.343785,103.870462
534504,0,10,10,1.344039,103.870888
534505,0,16,16,1.3439,103.870469
534506,11,15,26,1.344093,103.870878
534507,8,4,12,1.344112,103.870883
534508,3,7,10,1.344015,103.870477
534509,1,51,52,1.344143,103.870875
534510,0,87,87,1.34418,103.870888
534511,0,132,132,1.34413,103.870484
534512,7,129,136,1.344375,103.870965
534513,20,114,134,1.344245,103.870492
534514,9,53,62,1.344338,103.870931
534515,2,66,68,1.344603,103.870989
534516,1,91,92,1.344679,103.871023
534517,1,75,76,1.344727,103.871038
534518,1,110,111,1.34478,103.871047
534519,221,3,224,1.344813,103.871067
534520,6,102,108,1.344871,103.871084
534521,1,59,60,1.34493,103.871123
534522,1,70,71,1.344978,103.871129
534523,0,42,42,1.345023,103.871155
534524,1,47,48,1.345067,103.871168
534525,3,248,251,1.345095,103.871186
534530,171,98,269,1.345337,103.871271
534531,2,242,244,1.345341,103.870869
534532,13,77,90,1.345658,103.871399
534535,0,307,307,1.345449,103.870908
534537,2,147,149,1.345619,103.871414
534538,2,140,142,1.345649,103.871443
534539,0,63,63,1.345706,103.871476
534540,3,69,72,1.345629,103.870981
534541,0,147,147,1.345755,103.871494
534542,2,17,19,1.345736,103.871045
534543,63,157,220,1.345854,103.87151
534544,0,26,26,1.345842,103.871106
534545,2,298,300,1.345878,103.871531
534546,8,27,35,1.345969,103.871158
534547,7,127,134,1.345926,103.871549
534548,2,44,46,1.346086,103.871188
534549,7,248,255,1.345967,103.871562
534550,2,67,69,1.34618,103.871225
534551,13,76,89,1.345988,103.871573
534552,9,677,686,1.345996,103.871593
534553,2,102,104,1.346592,103.871405
534554,3,270,273,1.346616,103.871414
534555,2,225,227,1.346641,103.871413
534556,4,153,157,1.346717,103.871444
534557,0,119,119,1.346811,103.871455
534558,0,146,146,1.346945,103.871509
534559,2,139,141,1.347014,103.871583
534560,2,289,291,1.347138,103.871621
534561,9,529,538,1.347376,103.871657
534564,219,206,425,1.350706,103.874294
534565,2,246,248,1.350882,103.874513
534566,0,138,138,1.350932,103.874566
534571,4,2633,2637,1.351193,103.874835
534574,0,172,172,1.35148,103.875079
534577,6,760,766,1.352967,103.876683
534578,14,3794,3808,1.351513,103.875733
534579,0,58,58,1.351557,103.87578
534580,4,244,248,1.351616,103.87585
534581,1,583,584,1.351668,103.875924
534583,6,576,582,1.351726,103.876001
534584,0,82,82,1.351749,103.876009
534585,1,35,36,1.351776,103.876043
534586,3,30,33,1.35181,103.876078
534587,4,32,36,1.351834,103.8761
534588,3,27,30,1.351863,103.876124
534589,2,21,23,1.351898,103.876162
534590,0,24,24,1.351926,103.876184
534591,1,19,20,1.351942,103.876203
534592,0,20,20,1.351968,103.876222
534593,3,32,35,1.351993,103.876243
534594,0,17,17,1.352016,103.876272
534595,0,37,37,1.352042,103.876297
534596,1,34,35,1.352066,103.87631
534597,0,16,16,1.352085,103.876329
534598,0,18,18,1.352103,103.876337
534599,0,31,31,1.352119,103.876347
534600,0,28,28,1.352129,103.876359
534601,2,31,33,1.352141,103.876367
534602,0,75,75,1.352771,103.877171
534605,2,343,345,1.353153,103.876896
534606,0,59,59,1.353191,103.876944
534608,0,6,6,1.353239,103.876983
534610,0,18,18,1.353281,103.877021
534612,1,5,6,1.353325,103.877069
534613,61,3232,3293,1.353353,103.877788
534614,0,8,8,1.353364,103.877117
534616,0,3,3,1.361774,103.889185
534618,0,17,17,1.353427,103.877165
534620,0,10,10,1.353453,103.87721
534621,7,130,137,1.353479,103.87723
534622,11,3704,3715,1.353879,103.878292
534623,5,28,33,1.353911,103.878342
534624,3,119,122,1.353943,103.878377
534625,25,106,131,1.354161,103.878068
534626,365,29,394,1.353469,103.878847
534627,17,540,557,1.354222,103.878119
534628,1,145,146,1.354255,103.878174
534629,260,17,277,1.354043,103.878473
534630,0,146,146,1.35429,103.878224
534631,0,742,742,1.354105,103.878548
534632,1,490,491,1.354333,103.878277
534633,1,13,14,1.354176,103.878647
534634,2,277,279,1.354232,103.878719
534635,73,24,97,1.354545,103.878457
534636,743,4481,5224,1.354303,103.878799
534639,4,228,232,1.354662,103.87869
534641,1,109,110,1.354662,103.87869
534643,10,492,502,1.354662,103.87869
534645,118,213,331,1.354652,103.878723
534647,8,102,110,1.354859,103.878899
534648,0,1,1,1.34395,103.870885
534649,183,3917,4100,1.354519,103.879052
534652,19,459,478,1.355187,103.879389
534654,18,3,21,1.355272,103.879345
534655,26,0,26,1.355161,103.879304
534656,0,1,1,1.354998,103.879003
534659,20,14,34,1.355316,103.879537
534660,0,1,1,1.355161,103.879304
534661,2,0,2,1.361791,103.888325
534662,0,8,8,1.355624,103.879996
534663,3,0,3,1.353399,103.877149
534664,2,0,2,1.355435,103.879522
534666,4,126,130,1.355017,103.879838
534667,46,378,424,1.355849,103.880137
534668,16,1,17,1.355018,103.879872
534669,9,836,845,1.355096,103.879899
534670,14,0,14,1.354955,103.879523
534671,277,446,723,1.356618,103.880545
534672,10,0,10,1.355075,103.879658
534673,5,436,441,1.355166,103.879755
534674,1,0,1,1.354728,103.879305
534675,82,32,114,1.356555,103.881001
534676,127,375,502,1.357064,103.881117
534677,49,735,784,1.355838,103.88062
534678,48,8,56,1.357828,103.88158
534679,426,44,470,1.357935,103.881954
534680,2,1,3,1.35469,103.879928
534681,1,28,29,1.358232,103.88195
534682,55,18,73,1.358467,103.881977
534683,78,115,193,1.358089,103.882762
534684,9,488,497,1.357906,103.882891
534685,0,297,297,1.357906,103.882891
534686,6,560,566,1.358332,103.883008
534691,14,580,594,1.358316,103.883334
534694,12,381,393,1.358919,103.884041
534696,3,680,683,1.359062,103.88419
534709,28,1022,1050,1.361309,103.886206
534710,6,79,85,1.361337,103.886244
534711,2,277,279,1.361365,103.886289
534712,2,206,208,1.3614,103.886332
534713,4,188,192,1.36143,103.886366
534714,1,152,153,1.361472,103.886408
534715,2,227,229,1.361502,103.886437
534716,1,2,3,1.357092,103.882073
534717,0,80,80,1.361569,103.886518
534718,0,93,93,1.361599,103.886548
534719,8,323,331,1.361626,103.886585
534720,8,225,233,1.361652,103.886617
534721,75,374,449,1.36181,103.88678
534722,7,1261,1268,1.361781,103.88675
534723,0,49,49,1.361792,103.886754
534725,2,402,404,1.361867,103.886841
534728,5,13,18,1.361936,103.886885
534729,53,8,61,1.361974,103.886935
534730,0,568,568,1.36198,103.886928
534731,3,756,759,1.362012,103.886986
534732,3,148,151,1.36186,103.887195
534733,0,15,15,1.361907,103.887235
534734,1,51,52,1.361935,103.887278
534735,9,469,478,1.361964,103.887307
534736,175,1444,1619,1.362287,103.887666
534737,3,1,4,1.362352,103.887738
534738,2,97,99,1.362399,103.887794
534739,50,1,51,1.362524,103.887469
534740,5,199,204,1.362439,103.887837
534741,3,0,3,1.361537,103.886477
534742,6,359,365,1.362481,103.88788
534743,4,914,918,1.362451,103.887396
534744,9,315,324,1.362525,103.887936
534745,16,0,16,1.362419,103.887336
534746,2,539,541,1.362562,103.887968
534748,42,619,661,1.362588,103.888
534749,15,698,713,1.362598,103.887548
534750,15,815,830,1.36263,103.888034
534752,16,159,175,1.362751,103.888158
534753,59,357,416,1.362684,103.887629
534754,5,236,241,1.362783,103.88821
534755,27,177,204,1.362704,103.887669
534756,5,206,211,1.362818,103.888243
534757,4,68,72,1.362744,103.887725
534758,1,249,250,1.362854,103.888291
534759,6,544,550,1.362787,103.887755
534760,5,251,256,1.362883,103.888329
534761,8,337,345,1.362832,103.887799
534762,1,155,156,1.362912,103.88836
534764,8,150,158,1.362944,103.888408
534765,52,1839,1891,1.363296,103.888158
534766,4,42,46,1.362977,103.888451
534767,38,1605,1643,1.363024,103.888502
534768,638,197,835,1.365172,103.886996
534770,1,131,132,1.367985,103.893136
534771,2,31,33,1.368038,103.893168
534772,0,91,91,1.36808,103.893226
534773,3,0,3,1.36248,103.887428
534774,10,116,126,1.368189,103.893334
534776,0,78,78,1.368291,103.893436
534777,0,1,1,1.355261,103.879877
534778,5,411,416,1.3684,103.893537
534779,3,23,26,1.368439,103.893551
534780,3,0,3,1.368103,103.893266
534781,0,613,613,1.36852,103.89366
534783,2,588,590,1.368604,103.893731
534784,7,604,611,1.368633,103.893782
534785,541,867,1408,1.37073,103.895131
534786,353,351,704,1.371204,103.896018
534787,5,1161,1166,1.370768,103.896423
534788,4,163,167,1.371341,103.897069
534789,0,55,55,1.371436,103.897186
534790,1,337,338,1.371512,103.897271
534791,3,9,12,1.371822,103.897622
534793,324,2801,3125,1.372971,103.898088
534795,253,1054,1307,1.373142,103.898604
534796,54,795,849,1.374078,103.899035
534797,7,298,305,1.363142,103.888644
534798,563,410,973,1.347724,103.871902
534799,1440,15265,16705,1.359923,103.885144
534801,9328,208127,217455,1.349505,103.873768
534802,11,957,968,1.333995,103.888515
534803,1554,8879,10433,1.335047,103.888185
534815,24,6457,6481,1.334573,103.888311
534816,51,1323,1374,1.336194,103.887567
534817,13,1095,1108,1.336401,103.887256
534818,360,661,1021,1.336755,103.886954
534819,46,6105,6151,1.337426,103.887066
534820,8,26,34,1.337451,103.887046
534821,3,67,70,1.337487,103.886983
534822,1,717,718,1.337506,103.887003
534823,3,82,85,1.337589,103.886936
534824,1,1073,1074,1.33762,103.886922
534825,2,1,3,1.368484,103.893611
534826,2,0,2,1.355483,103.879478
534827,1,0,1,1.368341,103.893489
534828,4,531,535,1.337801,103.886825
534829,12,114,126,1.338109,103.886764
534830,13,2956,2969,1.338131,103.886747
534831,2,4,6,1.338169,103.886728
534832,0,116,116,1.338197,103.886705
534833,53,100,153,1.338277,103.886656
534834,36,0,36,1.338345,103.886603
534835,7,55,62,1.338395,103.886565
534836,2,2,4,1.338423,103.886548
534837,5,85,90,1.338448,103.886523
534838,25,2,27,1.338455,103.886514
534839,11,233,244,1.338469,103.886496
534840,37,465,502,1.338532,103.886467
534841,29,1299,1328,1.338684,103.886319
534842,11,28,39,1.338704,103.886239
534843,3,253,256,1.338782,103.886242
534844,23,0,23,1.338801,103.886164
534845,1,226,227,1.338834,103.886179
534846,2,0,2,1.337699,103.886889
534847,3,399,402,1.338924,103.886076
534848,14,208,222,1.338982,103.886033
534849,30,2172,2202,1.339233,103.885903
534850,0,13,13,1.339265,103.885821
534851,17,713,730,1.339333,103.885792
534852,2,35,37,1.339383,103.885717
534853,12,1115,1127,1.33942,103.885717
534854,5,0,5,1.339435,103.885635
534855,22,1405,1427,1.339504,103.885648
534856,15,686,701,1.339546,103.885569
534858,15,316,331,1.339664,103.885469
534859,14,182,196,1.339672,103.885438
534860,29,2,31,1.339736,103.885381
534861,5,68,73,1.339754,103.885393
534862,5,1,6,1.339824,103.885309
534863,2,52,54,1.339831,103.885307
534864,40,2,42,1.339866,103.885233
534865,4,44,48,1.339903,103.885207
534866,0,46,46,1.340021,103.885134
534867,0,13,13,1.340023,103.885094
534868,1,20,21,1.34007,103.885049
534869,34,31,65,1.340096,103.885049
534870,1,19,20,1.340166,103.884996
534871,2,44,46,1.340205,103.884943
534872,18,20,38,1.340249,103.884903
534873,14,55,69,1.34026,103.884891
534874,1,8,9,1.340328,103.884819
534875,0,82,82,1.340335,103.884823
534876,29,155,184,1.340431,103.884743
534878,12,471,483,1.342152,103.884222
534880,1,2,3,1.337629,103.886879
534881,14,80,94,1.34223,103.884143
534882,3,30,33,1.342276,103.884097
534883,8,0,8,1.342321,103.884058
534885,7,358,365,1.342408,103.883973
534886,1,20,21,1.342456,103.883933
534887,5,0,5,1.342504,103.883887
534888,2,38,40,1.342555,103.883842
534889,14,224,238,1.342609,103.883799
534890,0,8,8,1.342663,103.883738
534891,8,0,8,1.342709,103.883687
534892,1,0,1,1.337731,103.886839
534893,0,105,105,1.342793,103.883577
534895,1,11,12,1.34288,103.883495
534896,1,18,19,1.342916,103.883449
534898,0,19,19,1.343003,103.883373
534899,1,73,74,1.343039,103.883343
534900,3,88,91,1.343069,103.883316
534901,0,111,111,1.342995,103.883021
534902,0,11,11,1.343057,103.883025
534903,0,15,15,1.343216,103.883026
534904,0,5,5,1.343264,103.883018
534905,1,13,14,1.343359,103.882998
534907,2,258,260,1.343547,103.882936
534908,3,7,10,1.343073,103.882234
534909,0,4,4,1.34323,103.882114
534911,8,3,11,1.343493,103.8824
534912,3,0,3,1.342188,103.884189
534913,13,1122,1135,1.343855,103.882812
534914,0,24,24,1.343478,103.882546
534915,1,156,157,1.343946,103.882776
534916,1,0,1,1.342754,103.883629
534917,4,11,15,1.34404,103.882738
534918,0,330,330,1.343458,103.882548
534919,1,34,35,1.34412,103.882706
534921,3,64,67,1.344207,103.88267
534922,1,140,141,1.344251,103.882652
534923,1,0,1,1.343458,103.882545
534924,2,173,175,1.344439,103.882543
534925,0,8,8,1.344485,103.882508
534926,1,0,1,1.344348,103.882598
534927,11,22,33,1.344578,103.882449
534928,1,95,96,1.344634,103.882397
534929,345,1393,1738,1.343803,103.882248
534930,1,21,22,1.345301,103.882176
534931,3,28,31,1.345302,103.882176
534932,68,306,374,1.343973,103.882044
534933,1,18,19,1.345304,103.882174
534934,174,49,223,1.34428,103.881883
534935,0,28,28,1.345306,103.882173
534936,0,30,30,1.345308,103.882171
534937,0,59,59,1.34531,103.88217
534938,0,90,90,1.345312,103.882168
534939,3,1006,1009,1.345314,103.882167
534940,27,450,477,1.344572,103.881893
534941,1,73,74,1.344611,103.881834
534942,3,2,5,1.344694,103.881768
534943,5,152,157,1.344723,103.881737
534944,29,312,341,1.344903,103.881618
534945,6,494,500,1.34496,103.881605
534946,12,3,15,1.345009,103.881565
534947,15,347,362,1.345054,103.881542
534948,5,2,7,1.345096,103.881501
534949,12,354,366,1.345145,103.881446
534950,0,1,1,1.344522,103.882488
534951,6,346,352,1.345225,103.881398
534952,2,86,88,1.345291,103.881364
534953,49,565,614,1.345343,103.881288
534954,230,184,414,1.346017,103.880712
534955,46,0,46,1.345834,103.880436
534956,190,47,237,1.346138,103.880458
534957,276,0,276,1.346192,103.88027
534958,278,240,518,1.346767,103.87996
534959,129,0,129,1.347094,103.879967
534960,8,8,16,1.346794,103.879546
534961,1,320,321,1.347412,103.880132
534962,1,36,37,1.347481,103.880158
534963,205,910,1115,1.348077,103.881406
534964,6,95,101,1.347582,103.880123
534965,55,28,83,1.348317,103.880519
534966,1,203,204,1.347816,103.880156
534967,0,254,254,1.347898,103.880128
534968,5,783,788,1.347969,103.880154
534969,152,261,413,1.348146,103.87998
534970,4,559,563,1.348888,103.879883
534971,0,103,103,1.348927,103.880488
534972,110,139,249,1.348932,103.879574
534973,1,14,15,1.349007,103.880444
534974,18,153,171,1.349396,103.879625
534976,5,219,224,1.3491,103.880399
534977,8,0,8,1.349154,103.880396
534978,15,40,55,1.349208,103.880363
534979,69,255,324,1.350142,103.87917
534980,2,1,3,1.343488,103.882579
534981,27,72,99,1.350294,103.879062
534982,7,272,279,1.349314,103.880343
534983,5,91,96,1.349398,103.880324
534984,5,784,789,1.349583,103.880218
534985,1,220,221,1.350654,103.87894
534986,240,6,246,1.349661,103.880158
534987,2,2,4,1.349718,103.880116
534988,3,234,237,1.349738,103.880081
534989,0,110,110,1.349814,103.880094
534990,0,1,1,1.345199,103.881427
534991,2,1,3,1.349298,103.880382
534992,0,78,78,1.349975,103.879996
534993,1,49,50,1.349993,103.880012
534994,0,2,2,1.338872,103.886124
534995,11,0,11,1.350129,103.879955
534996,717,604,1321,1.350475,103.880116
534997,6,194,200,1.350805,103.880054
534998,24,225,249,1.35263,103.877866
535001,0,5,5,1.343326,103.882047
535002,0,7,7,1.343377,103.881988
535003,0,11,11,1.343262,103.882803
535009,17,29,46,1.34281,103.88437
535010,0,9,9,1.342851,103.88445
535011,0,1,1,1.349837,103.880038
535012,4,0,4,1.342998,103.884332
535014,0,2,2,1.350064,103.879982
535015,0,1,1,1.342833,103.884336
535016,8,1,9,1.343194,103.884064
535018,1,0,1,1.342879,103.884273
535019,2,1,3,1.349921,103.880043
535020,1,0,1,1.342915,103.884247
535023,3,1,4,1.344093,103.883542
535024,0,2,2,1.343093,103.884168
535027,0,1,1,1.342945,103.884204
535028,3,1,4,1.343061,103.884094
535030,0,1,1,1.344213,103.883469
535031,1,6,7,1.344391,103.883356
535033,5,3,8,1.344452,103.883308
535034,1,0,1,1.343091,103.884068
535035,4,3,7,1.344524,103.883265
535036,0,1,1,1.343142,103.884011
535037,4,0,4,1.344577,103.883244
535038,53,0,53,1.34433,103.883284
535039,6,0,6,1.344626,103.883208
535041,28,19,47,1.344697,103.883167
535042,7,3,10,1.344405,103.883238
535043,0,1,1,1.343186,103.883971
535044,1,0,1,1.344462,103.883215
535045,7,0,7,1.34456,103.883158
535047,5,1,6,1.344684,103.883083
535049,6,5,11,1.344777,103.883033
535051,2,0,2,1.343011,103.88414
535060,3,1020,1023,1.359962,103.885826
535061,2,202,204,1.359961,103.885823
535062,3,112,115,1.359846,103.886092
535063,1,48,49,1.359869,103.886161
535065,3,84,87,1.359873,103.886284
535066,49,116,165,1.360396,103.886518
535067,88,69,157,1.359955,103.886712
535068,30,53,83,1.359974,103.886867
535069,25,218,243,1.359983,103.887031
535070,4,48,52,1.36001,103.887159
535071,8,258,266,1.360033,103.8873
535079,0,241,241,1.360989,103.88724
535080,0,4,4,1.36098,103.887495
535082,0,7,7,1.361011,103.887394
535084,0,1,1,1.344519,103.883187
535085,0,1,1,1.360972,103.887457
535086,0,4,4,1.360984,103.887543
535087,0,4,4,1.360986,103.887509
535088,2,244,246,1.360848,103.888565
535089,0,43,43,1.36086,103.888628
535090,0,5,5,1.361008,103.887563
535091,0,24,24,1.360854,103.88881
535092,0,4,4,1.361037,103.887596
535093,0,26,26,1.360866,103.888963
535094,0,4,4,1.36101,103.887649
535095,0,24,24,1.360883,103.889123
535096,0,4,4,1.36109,103.887699
535097,0,30,30,1.360917,103.889294
535098,0,6,6,1.361081,103.887734
535099,0,34,34,1.36094,103.88947
535100,0,10,10,1.361069,103.887805
535101,1,35,36,1.360951,103.88962
535102,0,3,3,1.34328,103.883974
535103,10,0,10,1.360969,103.889817
535104,1,12,13,1.361095,103.887913
535105,0,9,9,1.361004,103.889982
535107,0,33,33,1.361021,103.89013
535108,0,64,64,1.361052,103.888017
535109,1,18,19,1.361027,103.890273
535110,1,21,22,1.361091,103.888066
535111,4,16,20,1.361043,103.890387
535112,3,106,109,1.361087,103.888114
535114,8,62,70,1.361063,103.890513
535115,3,117,120,1.361096,103.890785
535116,2,216,218,1.361107,103.890859
535117,7,238,245,1.361137,103.891075
535118,2,0,2,1.344875,103.882959
535119,8,28,36,1.361141,103.888556
535120,0,88,88,1.36114,103.891157
535121,1,23,24,1.36116,103.888828
535122,6,0,6,1.361147,103.891205
535123,0,27,27,1.361182,103.889097
535124,15,150,165,1.361145,103.891239
535125,3,0,3,1.361086,103.887853
535126,1,109,110,1.361174,103.891334
535127,46,168,214,1.361354,103.889397
535129,200,40,240,1.361426,103.889879
535130,0,57,57,1.361198,103.891502
535131,525,270,795,1.361451,103.890754
535133,31,54,85,1.361835,103.891383
535134,1,23,24,1.361204,103.891599
535135,2,153,155,1.361215,103.891645
535136,129,1725,1854,1.361231,103.89231
535137,0,218,218,1.361666,103.8921
535139,2,1,3,1.361163,103.891289
535140,1,5,6,1.361832,103.892088
535141,103,0,103,1.361901,103.892077
535142,1,0,1,1.360999,103.887517
535143,0,1,1,1.361958,103.892077
535144,1,4,5,1.362341,103.892103
535145,5,6,11,1.362335,103.892056
535146,21,0,21,1.362341,103.892004
535147,11,1,12,1.36235,103.891956
535148,3,1,4,1.362355,103.891882
535151,1,0,1,1.362012,103.892077
535152,83,0,83,1.362358,103.891607
535153,2,0,2,1.360931,103.891239
535154,7,2,9,1.362299,103.892383
535155,2,4,6,1.36231,103.892446
535156,5,3,8,1.362316,103.892514
535158,7,1224,1231,1.362305,103.892558
535159,3,2,5,1.362294,103.892356
535160,0,12,12,1.361674,103.892295
535161,1,26,27,1.361676,103.892374
535162,3,0,3,1.361769,103.892094
535163,7,5,12,1.361683,103.892476
535165,3,84,87,1.361682,103.892618
535166,2,654,656,1.361684,103.892719
535187,0,3,3,1.361671,103.892435
535188,2,21,23,1.361038,103.890341
535190,25,0,25,1.360954,103.889889
535191,9,579,588,1.375277,103.912337
535192,3,1458,1461,1.299509,103.837
535193,481,245,726,1.361234,103.892184
535194,6,14,20,1.353584,103.879628
535195,15,6,21,1.353593,103.879536
535196,11,12,23,1.353556,103.879594
535197,7,1,8,1.353529,103.879429
535198,4,7,11,1.353507,103.879555
535200,2,3,5,1.353487,103.87952
535201,9,6,15,1.35342,103.879323
535202,0,3,3,1.360951,103.88962
535203,11,4,15,1.353413,103.87944
535204,5,43,48,1.353338,103.879361
535205,1,9,10,1.353298,103.879327
535206,12,107,119,1.353113,103.879047
535215,3592,1496,5088,1.337195,103.892767
535216,898,331,1229,1.337641,103.892974
535217,388,167,555,1.338138,103.893207
535218,257,76,333,1.339019,103.893254
535219,406,571,977,1.337989,103.894337
535220,605,374,979,1.337702,103.894895
535221,148,139,287,1.337695,103.8941
535222,1197,244,1441,1.338016,103.893798
535223,623,940,1563,1.337487,103.893167
535224,1082,4816,5898,1.337105,103.893005
535225,57,105,162,1.337645,103.894484
535226,18,546,564,1.338136,103.894081
535227,1334,526,1860,1.338322,103.893651
535233,1,5,6,1.34841,103.885157
535234,1,2,3,1.353453,103.87948
535235,30,0,30,1.34839,103.885199
535236,5,0,5,1.34839,103.885179
535239,12,1,13,1.348313,103.885364
535241,0,1,1,1.362352,103.891676
535242,4,2,6,1.348274,103.885426
535243,5,0,5,1.348236,103.885529
535244,3,0,3,1.34841,103.885137
535245,9,6,15,1.348197,103.885591
535247,6,0,6,1.348158,103.885674
535249,2,1,3,1.348236,103.885509
535250,72,1,73,1.348091,103.885849
535251,4,1,5,1.348081,103.885839
535260,5,2,7,1.346395,103.884214
535261,3,1,4,1.346362,103.884242
535263,0,1,1,1.348274,103.885446
535264,3,1,4,1.346168,103.884412
535265,4,1,5,1.346103,103.884468
535266,5,0,5,1.346038,103.884525
535267,74,4,78,1.345973,103.884581
535268,2,0,2,1.362293,103.892321
535269,0,4,4,1.345843,103.884694
535270,2,2,4,1.345778,103.88475
535271,71,0,71,1.345714,103.884807
535273,2,3,5,1.345584,103.88492
535274,2,10,12,1.345551,103.884935
535283,5,3,8,1.346447,103.883574
535284,2,1,3,1.34812,103.885756
535285,6,1,7,1.346567,103.88358
535286,1,0,1,1.346232,103.884355
535288,0,4,4,1.34683,103.883751
535289,44,0,44,1.346834,103.883618
535290,0,2,2,1.345908,103.884637
535291,2,1,3,1.346602,103.883691
535292,81,0,81,1.346968,103.883816
535293,2,3,5,1.34705,103.883686
535295,4,4,8,1.347077,103.883865
535296,28,2,30,1.347235,103.883764
535297,14,2,16,1.347134,103.883878
535298,5,1,6,1.347362,103.883808
535300,6,0,6,1.347455,103.883855
535301,5,0,5,1.347302,103.883945
535302,16,29,45,1.347548,103.883917
535303,0,17,17,1.34741,103.883993
535305,81,0,81,1.347489,103.884035
535306,4,2,6,1.347744,103.883992
535308,0,2,2,1.346906,103.883786
535309,39,1,40,1.347647,103.884097
535310,1,4,5,1.347965,103.884095
535311,37,3,40,1.347717,103.88413
535312,8,0,8,1.348042,103.884133
535313,77,0,77,1.347776,103.884167
535314,28,3,31,1.348166,103.884176
535315,1,1,2,1.347835,103.884045
535317,0,1,1,1.346755,103.883723
535318,1,1,2,1.347838,103.884177
535319,4,0,4,1.347974,103.884252
535320,0,1,1,1.347909,103.884227
535321,31,5,36,1.348038,103.884284
535322,16,3,19,1.348552,103.884385
535323,1,0,1,1.34845,103.884323
535324,20,0,20,1.348623,103.884404
535326,1,2,3,1.346945,103.883661
535327,68,0,68,1.348233,103.884392
535328,35,0,35,1.348821,103.88451
535329,0,1,1,1.348095,103.884324
535330,1,0,1,1.348292,103.884424
535331,4,0,4,1.348359,103.884459
535332,1,3,4,1.34901,103.884604
535333,0,3,3,1.348744,103.884464
535334,3,4,7,1.349047,103.884732
535335,1,2,3,1.348423,103.884479
535336,2,1,3,1.3485,103.884524
535337,5,0,5,1.348564,103.884547
535339,1,2,3,1.349052,103.88483
535340,1,2,3,1.348618,103.884569
535341,9,5,14,1.348685,103.884611
535342,0,2,2,1.348367,103.88427
535343,6,3,9,1.348762,103.884646
535344,2,7,9,1.348958,103.885381
535346,8,1,9,1.348928,103.885458
535347,4,3,7,1.348885,103.884696
535348,10,0,10,1.348898,103.885528
535349,12,1,13,1.348839,103.885418
535350,1,0,1,1.348932,103.884542
535352,1,0,1,1.34887,103.885597
535355,0,1,1,1.348837,103.885657
535356,2,0,2,1.348984,103.885319
535357,4,0,4,1.348734,103.885634
535358,0,1,1,1.348761,103.88558
535359,2,1,3,1.349031,103.885055
535360,0,2,2,1.348775,103.885785
535361,26,0,26,1.348673,103.885741
535362,1,3,4,1.348698,103.885952
535363,11,0,11,1.348642,103.885801
535364,0,12,12,1.348681,103.885988
535365,1,0,1,1.348744,103.885854
535366,3,3,6,1.348663,103.886032
535367,1,4,5,1.346825,103.885957
535368,4,77,81,1.348648,103.886077
535369,17,0,17,1.346862,103.885895
535370,9,0,9,1.34863,103.886126
535375,5,0,5,1.346951,103.885731
535376,9,2,11,1.348478,103.885984
535377,0,1,1,1.348613,103.885863
535378,1,0,1,1.346975,103.885665
535381,0,6,6,1.347012,103.885572
535383,3,0,3,1.348703,103.885682
535385,8,1,9,1.347077,103.885443
535386,44,0,44,1.348015,103.885844
535387,11,0,11,1.347112,103.885371
535388,111,20,131,1.34795,103.885829
535389,6,0,6,1.347125,103.885326
535390,20,0,20,1.347839,103.885819
535391,0,1,1,1.348379,103.885953
535392,1,0,1,1.347155,103.885253
535393,5,0,5,1.347182,103.885195
535394,0,3,3,1.347045,103.885502
535396,1,0,1,1.347731,103.885858
535397,3,0,3,1.347619,103.885899
535398,10,0,10,1.347576,103.885923
535399,4,2,6,1.347256,103.885022
535400,0,5,5,1.347543,103.885937
535401,18,0,18,1.347159,103.884911
535402,0,23,23,1.347511,103.885951
535403,1,0,1,1.347593,103.885916
535404,9,0,9,1.347478,103.885965
535406,2,0,2,1.348719,103.885904
535407,0,1,1,1.347132,103.884964
535408,156,2,158,1.347412,103.885994
535409,7,0,7,1.347054,103.885119
535410,10,0,10,1.347379,103.886008
535411,0,6,6,1.347029,103.885184
535412,6,22,28,1.347346,103.886022
535413,34,0,34,1.347009,103.885242
535414,4,0,4,1.347314,103.886036
535415,0,2,2,1.347445,103.885979
535418,74,3,77,1.347248,103.886064
535419,4,3,7,1.34693,103.88543
535420,95,3,98,1.347229,103.886069
535422,2,1,3,1.34724,103.88508
535423,4,3,7,1.346893,103.885554
535424,2,0,2,1.346982,103.8853
535425,10,0,10,1.346842,103.885673
535426,3,0,3,1.34719,103.886078
535427,1,1,2,1.346864,103.885614
535429,41,2,43,1.346743,103.885916
535430,11,1,12,1.346701,103.885996
535431,204,2,206,1.346229,103.885836
535432,1,25,26,1.346288,103.885753
535433,31,0,31,1.346191,103.886071
535434,7,0,7,1.346321,103.8857
535435,1,0,1,1.34708,103.885064
535436,4,2,6,1.346347,103.885635
535437,1,3,4,1.34605,103.885968
535438,2,0,2,1.346799,103.885786
535439,79,0,79,1.345964,103.885926
535440,1,0,1,1.346138,103.886055
535441,5,0,5,1.346434,103.885483
535442,4,0,4,1.346457,103.885429
535443,0,2,2,1.346377,103.885592
535444,30,0,30,1.346501,103.88532
535445,0,4,4,1.346521,103.885274
535446,8,2,10,1.346548,103.885198
535448,12,1,13,1.346613,103.885039
535449,1,0,1,1.346404,103.885539
535450,68,8,76,1.345261,103.884495
535451,17,1,18,1.34531,103.884451
535453,17,1,18,1.345414,103.884362
535454,1,6,7,1.345453,103.884328
535455,10,0,10,1.345499,103.884298
535456,3,0,3,1.346821,103.885721
535457,0,1,1,1.346645,103.884963
535460,8,1,9,1.345477,103.884194
535461,4,0,4,1.345728,103.884065
535462,17,2,19,1.34556,103.884004
535463,0,5,5,1.345775,103.884014
535466,35,0,35,1.345888,103.88393
535467,1,2,3,1.345546,103.884262
535468,3,1,4,1.345991,103.883847
535469,0,4,4,1.346096,103.883761
535470,0,5,5,1.345252,103.884304
535471,3,0,3,1.345934,103.883879
535472,15,5,20,1.345131,103.884191
535473,7,0,7,1.345113,103.884152
535475,2,0,2,1.346479,103.88536
535476,0,3,3,1.345181,103.884231
535477,3,3,6,1.345873,103.885559
535478,6,0,6,1.345851,103.885526
535479,11,1,12,1.345808,103.885458
535480,5,0,5,1.345766,103.885391
535481,2,3,5,1.345723,103.885323
535482,1,1,2,1.345023,103.884081
535483,45,1,46,1.345637,103.885188
535485,33,5,38,1.347871,103.885032
535486,4,0,4,1.347713,103.885129
535487,8,1,9,1.347845,103.88509
535488,3,1,4,1.34769,103.885192
535490,2,0,2,1.34568,103.885256
535491,3,0,3,1.345008,103.884001
535493,11,0,11,1.347769,103.885256
535494,19,0,19,1.347637,103.885327
535495,1,10,11,1.347745,103.885318
535496,18,8,26,1.347612,103.88537
535498,12,0,12,1.347591,103.885419
535499,34,0,34,1.347702,103.885441
535500,16,2,18,1.347567,103.885477
535502,1,0,1,1.3456,103.884183
535503,2,26,28,1.347658,103.885535
535504,0,1,1,1.34755,103.885526
535507,0,1,1,1.347533,103.885579
535508,10,5,15,1.347494,103.885668
535510,15,2,17,1.347517,103.885773
535511,9,1,10,1.347529,103.885814
535519,4,445,449,1.355533,103.880298
535520,0,397,397,1.355453,103.880278
535521,0,2,2,1.347676,103.885236
535522,3,1,4,1.35519,103.88056
535523,1,1,2,1.355456,103.880372
535524,4,0,4,1.35519,103.88056
535525,1,0,1,1.347619,103.885668
535526,0,1,1,1.355276,103.880534
535527,5,1,6,1.355173,103.880645
535528,1,2,3,1.347789,103.885196
535530,1,7,8,1.355007,103.88066
535531,24,4,28,1.35519,103.88056
535532,0,8,8,1.354906,103.880876
535533,0,6,6,1.35519,103.88056
535534,1,2,3,1.355058,103.88062
535542,11,5,16,1.354478,103.88113
535543,3,5,8,1.354696,103.881173
535545,4,0,4,1.354653,103.881127
535546,0,2,2,1.355344,103.880466
535547,2,1,3,1.354984,103.880791
535548,3,2,5,1.354515,103.881199
535549,5,8,13,1.354453,103.881148
535550,8,2,10,1.354369,103.881206
535552,8,0,8,1.354158,103.881227
535553,0,1,1,1.35512,103.880563
535554,50,0,50,1.354305,103.881156
535555,17,10,27,1.354017,103.881244
535556,13,4,17,1.354045,103.881176
535557,7,0,7,1.35411,103.881173
535560,4,1,5,1.35376,103.881185
535561,17,1,18,1.353538,103.881288
535562,2,0,2,1.354472,103.881244
535563,3,1,4,1.353559,103.881309
535565,1,0,1,1.354167,103.881258
535566,1,2,3,1.354573,103.881145
535567,6,1,7,1.353749,103.881213
535569,1,0,1,1.353979,103.881193
535572,1,0,1,1.353813,103.881203
535573,109,11,120,1.354067,103.881286
535576,0,2,2,1.353631,103.881198
535577,0,8,8,1.353984,103.879556
535578,1,0,1,1.354619,103.881142
535579,5,1,6,1.354047,103.879671
535580,5,0,5,1.354068,103.879732
535581,0,1,1,1.354013,103.879624
535582,24,1,25,1.354141,103.879834
535583,0,5,5,1.354317,103.880261
535584,5,8,13,1.354488,103.880203
535585,4,2,6,1.354407,103.880247
535587,8,0,8,1.35449,103.880313
535588,0,2,2,1.354111,103.879562
535589,1,0,1,1.354099,103.879784
535590,0,14,14,1.354488,103.880203
535591,3,0,3,1.353904,103.881188
535592,3,0,3,1.354446,103.880323
535593,1,8,9,1.354531,103.880395
535594,4,0,4,1.354469,103.880371
535595,106,2,108,1.354579,103.880389
535596,2,0,2,1.354368,103.880397
535597,1,0,1,1.354578,103.880497
535598,6,0,6,1.354616,103.880582
535599,11,0,11,1.354645,103.880629
535600,0,2,2,1.354599,103.880477
535601,0,3,3,1.354551,103.880445
535603,0,25,25,1.354835,103.881084
535604,0,2,2,1.35446,103.880599
535605,2,7,9,1.354827,103.881041
535606,1,0,1,1.354494,103.880433
535607,4,0,4,1.354827,103.881041
535608,1,0,1,1.35487,103.881142
535609,3,0,3,1.354493,103.880682
535610,1,0,1,1.354908,103.881201
535611,2,3,5,1.35512,103.881849
535612,1,0,1,1.35498,103.881348
535615,5,3,8,1.355096,103.88179
535616,8,4,12,1.355159,103.88173
535620,2,16,18,1.355207,103.881796
535621,6,1,7,1.355191,103.881738
535622,0,2,2,1.354854,103.88113
535623,1,4,5,1.355191,103.881738
535624,15,6,21,1.355131,103.881858
535625,10,2,12,1.355247,103.881884
535626,10,3,13,1.355262,103.882169
535627,5,2,7,1.35531,103.882002
535628,2,0,2,1.355191,103.881738
535629,1,1,2,1.35531,103.882002
535630,3,2,5,1.355318,103.882294
535631,8,0,8,1.355378,103.88216
535632,0,2,2,1.35531,103.882002
535633,21,16,37,1.355378,103.88216
535634,168,13,181,1.355371,103.882392
535635,23,0,23,1.355472,103.882335
535636,7,0,7,1.355472,103.882335
535637,1,1,2,1.355378,103.88216
535638,352,29,381,1.355441,103.882531
535639,7,30,37,1.355484,103.882403
535641,5,130,135,1.355571,103.882538
535642,0,1,1,1.355009,103.881391
535645,23,0,23,1.355685,103.882787
535646,4,6,10,1.35572,103.882846
535647,0,1,1,1.355607,103.882602
535649,3,4,7,1.355788,103.883022
535650,6,5,11,1.355827,103.883102
535651,5,53,58,1.356361,103.884549
535652,13,4,17,1.356424,103.884581
535653,1,0,1,1.355828,103.883079
535654,3,2,5,1.356495,103.884743
535655,6,1,7,1.356547,103.884851
535656,3,5,8,1.356708,103.885126
535657,37,0,37,1.356659,103.8852
535658,4,1,5,1.356788,103.885303
535659,0,15,15,1.356722,103.885371
535660,3,4,7,1.356874,103.885479
535661,1,0,1,1.356447,103.884764
535662,8,1,9,1.35689,103.885724
535663,0,4,4,1.356989,103.885741
535665,0,3,3,1.354948,103.881286
535666,35,12,47,1.357063,103.886091
535667,1,5,6,1.357167,103.886077
535668,1,5,6,1.357226,103.886345
535669,14,2,16,1.357226,103.88641
535670,57,4,61,1.357288,103.886521
535671,2,2,4,1.357288,103.886521
535672,55,5,60,1.357358,103.886672
535673,0,2,2,1.355472,103.882335
535675,0,6,6,1.357457,103.886893
535676,3,11,14,1.357544,103.887064
535677,54,0,54,1.357544,103.887064
535678,3,0,3,1.356981,103.885929
535679,0,72,72,1.357619,103.88717
535681,26,13,39,1.356581,103.884925
535682,13,53,66,1.354857,103.881464
535684,1,8,9,1.357754,103.8873
535685,19,0,19,1.357776,103.887387
535686,15,8,23,1.357781,103.887453
535688,20,14,34,1.357876,103.88755
535689,662,156,818,1.346255,103.87202
535690,15,10,25,1.345533,103.872408
535691,5,6,11,1.345533,103.872408
535692,5,0,5,1.345533,103.872408
535693,0,11,11,1.345533,103.872408
535694,2,5,7,1.345533,103.872408
535695,15,18,33,1.345337,103.872425
535696,15,2,17,1.345379,103.872472
535697,1,0,1,1.356808,103.885572
535699,2,0,2,1.35738,103.886712
535700,4,50,54,1.345524,103.872986
535701,1,15,16,1.345524,103.872986
535702,3,11,14,1.345524,103.872986
535703,0,13,13,1.345498,103.873102
535704,2,0,2,1.345545,103.872525
535705,3,17,20,1.345498,103.873102
535707,128,2,130,1.345464,103.87329
535708,16,20,36,1.345555,103.873214
535710,0,1,1,1.345427,103.872488
535711,1,1,2,1.345498,103.873102
535712,11,4,15,1.345495,103.873482
535713,0,1,1,1.345535,103.873314
535714,0,1,1,1.345482,103.873571
535716,41,1,42,1.345445,103.873798
535717,11,0,11,1.34543,103.873877
535718,18,2,20,1.345417,103.87395
535719,20,1,21,1.345404,103.874005
535720,3,7,10,1.345427,103.873453
535721,3,1,4,1.345477,103.873204
535728,3,1,4,1.37178,103.897968
535729,4,0,4,1.371735,103.898023
535730,0,3,3,1.357619,103.88717
535732,1,2,3,1.371691,103.898072
535733,10,0,10,1.371509,103.898182
535734,0,1,1,1.345466,103.873649
535735,0,2,2,1.345516,103.873398
535736,11,1,12,1.371303,103.898365
535737,4,1,5,1.371237,103.89844
535738,0,4,4,1.3712,103.89846
535739,9,937,946,1.299509,103.837
535740,3,8,11,1.299509,103.837
535746,3,39,42,1.347748,103.877114
535747,10,38,48,1.347592,103.877174
535748,6,0,6,1.347803,103.877107
535749,77,11,88,1.347654,103.877175
535751,6,2,8,1.347777,103.877178
535752,0,1,1,1.371452,103.898231
535754,1,4,5,1.347981,103.87711
535755,10,12,22,1.347993,103.877229
535756,0,1,1,1.347921,103.877107
535757,3,4,7,1.348074,103.877345
535758,2,0,2,1.371415,103.898269
535759,4,0,4,1.348155,103.877461
535760,24,0,24,1.348069,103.877195
535761,0,1,1,1.348019,103.87714
535762,9,1,10,1.348091,103.877231
535763,0,1,1,1.3481,103.877493
535764,0,1,1,1.347991,103.877556
535765,2,1,3,1.371573,103.898135
535766,0,1,1,1.348235,103.877472
535767,6,7,13,1.347772,103.877682
535768,0,1,1,1.348192,103.877508
535769,2,1,3,1.347881,103.877619
535770,13,1,14,1.348114,103.877555
535771,3,1,4,1.347552,103.877808
535772,5,1,6,1.348083,103.877578
535773,0,3,3,1.347662,103.877745
535774,4,0,4,1.34804,103.877599
535775,1,0,1,1.348151,103.877529
535776,8,2,10,1.348001,103.877623
535777,9,0,9,1.347965,103.877641
535778,3,10,13,1.347927,103.87766
535779,9,0,9,1.347891,103.877682
535780,1,3,4,1.347853,103.877702
535782,1,0,1,1.347398,103.877893
535783,30,1,31,1.347725,103.877797
535784,10,1,11,1.347677,103.87782
535785,2,0,2,1.34805,103.877167
535786,1,4,5,1.347597,103.87787
535787,4,0,4,1.34756,103.877892
535788,42,0,42,1.347517,103.877928
535797,5,31,36,1.346146,103.877706
535798,19,56,75,1.346105,103.877709
535799,22,3,25,1.346153,103.877747
535800,76,0,76,1.346112,103.877757
535802,1,4,5,1.346124,103.877857
535803,0,1,1,1.347768,103.877772
535804,15,0,15,1.346129,103.877814
535805,96,0,96,1.346141,103.877899
535816,2,0,2,1.347635,103.877846
535818,4,0,4,1.343125,103.883218
535820,0,1,1,1.346161,103.877899
535821,1,2,3,1.347443,103.877871
535822,2,0,2,1.34307,103.883119
535823,3,0,3,1.343214,103.883415
535827,0,5,5,1.343434,103.883809
535829,21,0,21,1.343399,103.88371
535830,6,1,7,1.343514,103.883962
535831,2,0,2,1.343234,103.883415
535832,7,0,7,1.343594,103.884114
535833,0,2,2,1.343444,103.883799
535834,0,1,1,1.34318,103.883316
535835,0,4,4,1.343493,103.883884
535836,8,0,8,1.343753,103.88442
535838,1,10,11,1.343913,103.884725
535839,3,1,4,1.343614,103.884114
535841,2,2,4,1.343773,103.88442
535842,7,1,8,1.343853,103.884572
535843,12,0,12,1.343923,103.884715
535845,13,0,13,1.343493,103.883884
535846,1,0,1,1.343494,103.883885
535847,1,0,1,1.343852,103.884571
535852,7,0,7,1.344684,103.881537
535853,7,0,7,1.344622,103.881468
535854,1,0,1,1.343752,103.884419
535856,1,0,1,1.344578,103.881426
535857,26,0,26,1.344483,103.881324
535858,1,0,1,1.344512,103.881354
535859,75,0,75,1.344429,103.881236
535860,6,0,6,1.344397,103.881198
535862,2,0,2,1.343593,103.884113
535863,35,0,35,1.344275,103.881038
535864,1,0,1,1.344462,103.881273
535865,4,0,4,1.344201,103.880959
535866,4,0,4,1.344167,103.880917
535867,2,19,21,1.344139,103.880856
535876,1,2,3,1.343288,103.883546
535877,2,0,2,1.344305,103.881086
535878,3,0,3,1.34777,103.880239
535880,17,1,18,1.3477,103.880159
535881,1,0,1,1.344242,103.881005
535882,0,2,2,1.347744,103.880217
535889,0,4,4,1.347511,103.879946
535890,1,0,1,1.347674,103.880122
535891,0,2,2,1.347745,103.880125
535892,30,2,32,1.347468,103.879892
535893,4,5,9,1.347417,103.879831
535894,2,0,2,1.34756,103.87991
535896,2,3,5,1.347361,103.879776
535897,3,0,3,1.347813,103.880207
535899,0,4,4,1.347325,103.879656
535901,2,6,8,1.347249,103.879639
535903,0,3,3,1.347315,103.879727
535904,1,0,1,1.347594,103.879957
535906,0,6,6,1.347225,103.879527
535909,0,1,1,1.347218,103.879597
535910,4,3,7,1.347153,103.879446
535912,4,3,7,1.347072,103.879419
535913,1,0,1,1.34712,103.879474
535915,0,4,4,1.347033,103.879307
535916,5,5,10,1.346944,103.879282
535926,15,403,418,1.348482,103.880393
535927,0,6,6,1.348489,103.880438
535928,1,0,1,1.347037,103.879381
535929,0,5,5,1.348518,103.880616
535930,1,0,1,1.348503,103.880527
535931,29,2,31,1.348546,103.880796
535933,22,2,24,1.348591,103.880932
535934,0,40,40,1.348476,103.880482
535935,10,0,10,1.348647,103.881007
535936,14,5,19,1.348498,103.880616
535937,1,2,3,1.347267,103.879584
535938,1,8,9,1.34854,103.880885
535940,0,1,1,1.348532,103.880706
535942,13,0,13,1.34868,103.881268
535944,0,1,1,1.348639,103.88103
535945,0,1,1,1.34872,103.881506
535946,14,0,14,1.348761,103.881744
535947,1,0,1,1.348724,103.881408
535948,2,9,11,1.348733,103.881741
535949,0,1,1,1.348738,103.881492
535950,1,1,2,1.347513,103.879858
535951,1,0,1,1.348752,103.881576
535952,3,1,4,1.34862,103.881763
535953,2,1,3,1.348666,103.881072
535954,0,1,1,1.348767,103.88166
535955,1,0,1,1.348544,103.881778
535956,9,11,20,1.348469,103.881792
535957,31,0,31,1.3489,103.881727
535959,11,2,13,1.348781,103.881744
535960,3,1,4,1.348746,103.881759
535961,3,1,4,1.348721,103.881764
535962,1,1,2,1.348695,103.881748
535963,0,2,2,1.34867,103.881773
535964,14,2,16,1.34857,103.881793
535966,4,0,4,1.348479,103.881802
535967,6,0,6,1.348482,103.880393
535975,77,7,84,1.338957,103.884964
535976,2,0,2,1.34862,103.881783
535977,0,5,5,1.33902,103.884925
535978,1,0,1,1.348933,103.88172
535979,6,1,7,1.339113,103.884834
535980,0,2,2,1.339005,103.885052
535981,0,6,6,1.339361,103.884739
535982,7,0,7,1.339389,103.884756
535983,15,3,18,1.339437,103.884828
535984,1,0,1,1.339057,103.884884
535985,2,7,9,1.339497,103.884884
535986,1736,979,2715,1.382984,103.880464
535991,2,155,157,1.299509,103.837
535994,2,7,9,1.349332,103.881475
535995,2,1,3,1.348781,103.881744
535996,4,1,5,1.349312,103.881374
535997,169,4,173,1.349296,103.88128
535999,2,0,2,1.33928,103.884756
536001,4,2,6,1.34928,103.881404
536002,2,0,2,1.349265,103.881323
536003,2,5,7,1.349293,103.881493
536005,0,5,5,1.349309,103.881575
536006,28,0,28,1.349316,103.881616
536007,34,9,43,1.349325,103.881653
536008,11,0,11,1.349329,103.881689
536009,2,0,2,1.349289,103.881446
536019,326,9,335,1.349839,103.880735
536020,2,20,22,1.349507,103.88074
536021,0,1,1,1.339482,103.884868
536022,7,0,7,1.349339,103.880755
536023,0,1,1,1.349408,103.880744
536025,12,0,12,1.349507,103.88074
536026,2,0,2,1.349338,103.881726
536027,10,0,10,1.349507,103.88074
536028,6,20,26,1.349437,103.880893
536029,7,1,8,1.349374,103.880904
536030,7,0,7,1.34952,103.880812
536031,2,2,4,1.34952,103.880812
536032,25,0,25,1.34952,103.880812
536033,0,1,1,1.34927,103.880767
536035,0,1,1,1.34952,103.880812
536036,1,0,1,1.34952,103.880812
536037,125,6,131,1.349677,103.881563
536038,2,2,4,1.349691,103.881621
536039,1,5,6,1.34987,103.881285
536040,14,0,14,1.349781,103.881321
536041,1,1,2,1.349507,103.88074
536042,6,1,7,1.349997,103.88125
536043,2,1,3,1.349325,103.881445
536045,14,0,14,1.349694,103.881694
536047,0,4,4,1.3497,103.881746
536048,34,2,36,1.349752,103.881706
536049,1,0,1,1.34952,103.880812
536050,0,10,10,1.349889,103.882327
536051,2,41,43,1.349718,103.881869
536052,48,4,52,1.350016,103.882375
536053,1,0,1,1.349706,103.881791
536054,64,4,68,1.350095,103.8824
536055,0,4,4,1.349729,103.882019
536056,2,0,2,1.349694,103.881649
536057,0,7,7,1.349734,103.882093
536058,6,10,16,1.35017,103.882486
536059,4,0,4,1.350126,103.882469
536060,2,3,5,1.34974,103.882161
536061,3,12,15,1.350075,103.882445
536062,45,2,47,1.350015,103.882426
536063,14,28,42,1.349486,103.882311
536064,3,1,4,1.349381,103.882355
536065,15,0,15,1.349152,103.882412
536066,0,1,1,1.349733,103.881941
536067,169,151,320,1.349085,103.882431
536068,6,0,6,1.348702,103.882503
536069,23,0,23,1.348817,103.882501
536070,1,0,1,1.348876,103.882456
536071,2,4,6,1.348068,103.882677
536072,10,0,10,1.347909,103.882482
536073,11,0,11,1.347983,103.882724
536074,12,0,12,1.347696,103.882372
536075,9,1,10,1.347767,103.882786
536077,6,5,11,1.349957,103.882397
536078,3,10,13,1.3499,103.882379
536079,1,0,1,1.348194,103.882635
536080,8,23,31,1.348518,103.88256
536081,1,2,3,1.349997,103.88125
536082,12,8,20,1.349322,103.882714
536083,5,0,5,1.349264,103.882725
536084,1,0,1,1.348444,103.882587
536085,1,1,2,1.350169,103.882444
536086,1,0,1,1.349109,103.882583
536087,7,0,7,1.348835,103.882822
536088,4,0,4,1.348715,103.882669
536091,29,0,29,1.348348,103.882919
536093,1,1,2,1.349007,103.882621
536094,1,0,1,1.348978,103.882776
536095,4,0,4,1.348267,103.882773
536096,4,4,8,1.347905,103.882963
536097,19,0,19,1.348067,103.882987
536098,0,5,5,1.347976,103.883004
536099,1,0,1,1.34848,103.882745
536104,22,0,22,1.349682,103.882614
536108,8,0,8,1.349682,103.882614
536109,1,0,1,1.349682,103.882614
536119,0,1,1,1.349613,103.88281
536121,1,0,1,1.349565,103.882931
536122,0,2,2,1.348165,103.882964
536124,2,3,5,1.349445,103.883099
536125,5,24,29,1.349385,103.883095
536128,44,0,44,1.349231,103.883324
536129,110,9,119,1.34944,103.883261
536130,19,19,38,1.349104,103.883175
536131,10,3,13,1.349053,103.883197
536132,25,3,28,1.34942,103.883322
536133,14,1,15,1.348919,103.883395
536134,7,0,7,1.348919,103.883395
536135,2,0,2,1.349379,103.882941
536136,10,12,22,1.348743,103.8833
536137,34,15,49,1.349326,103.883595
536138,10,5,15,1.348664,103.883499
536139,30,0,30,1.349274,103.883703
536140,2,8,10,1.348365,103.883467
536141,7,0,7,1.349195,103.883763
536142,5,0,5,1.349194,103.883762
536146,1,7,8,1.348277,103.883438
536147,11,0,11,1.349111,103.883801
536149,4,2,6,1.349025,103.883816
536150,4,0,4,1.349024,103.883815
536151,8,4,12,1.347781,103.88297
536153,0,1,1,1.349458,103.88301
536154,4,1,5,1.348904,103.883815
536155,5,3,8,1.348903,103.883814
536156,1,5,6,1.347678,103.882965
536157,149,3,152,1.348764,103.883756
536158,8,0,8,1.348763,103.883755
536159,9,1,10,1.348461,103.883586
536160,9,0,9,1.34846,103.883585
536161,7,0,7,1.348305,103.883516
536162,2,0,2,1.349377,103.883456
536164,26,0,26,1.348162,103.883451
536165,1,0,1,1.347729,103.88297
536166,2,0,2,1.348304,103.883515
536167,8,3,11,1.34741,103.882578
536168,2,0,2,1.347861,103.883289
536171,13,5,18,1.347577,103.883145
536172,1,29,30,1.347577,103.883145
536173,37,0,37,1.347341,103.882377
536174,6,1,7,1.347436,103.883083
536175,6,2,8,1.347001,103.882926
536176,0,5,5,1.347001,103.882926
536178,2,0,2,1.347722,103.883222
536179,16,12,28,1.347087,103.882995
536180,3,9,12,1.347086,103.882994
536181,73,8,81,1.346784,103.883062
536182,2,0,2,1.346932,103.882939
536183,13,2,15,1.346583,103.88309
536186,21,10,31,1.34663,103.882959
536187,2,52,54,1.346514,103.882995
536188,4,0,4,1.348963,103.882429
536189,10,0,10,1.349032,103.882412
536190,18,1,19,1.349231,103.882393
536192,1,8,9,1.34856,103.883317
536193,12,0,12,1.348329,103.883105
536194,4,0,4,1.349231,103.883324
536195,2,14,16,1.347479,103.882821
536196,1081,723,1804,1.342085,103.885046
536197,171,7,178,1.342611,103.88514
536198,7,1077,1084,1.341633,103.884933
536199,230,4036,4266,1.341949,103.885092
536200,253,84,337,1.342054,103.885598
536201,765,629,1394,1.342482,103.885421
536202,394,516,910,1.342757,103.885526
536203,197,28,225,1.343046,103.885704
536204,648,274,922,1.343213,103.885781
536205,477,274,751,1.34343,103.885863
536206,8,59,67,1.343544,103.885933
536207,22,156,178,1.34279,103.885435
536208,2298,67,2365,1.343855,103.886073
536209,588,33,621,1.343223,103.885575
536210,179,232,411,1.344455,103.886438
536211,263,34,297,1.343575,103.885735
536212,20,317,337,1.343891,103.885904
536213,202,353,555,1.344198,103.886086
536214,8,29,37,1.34451,103.886246
536266,0,28,28,1.346658,103.877286
536267,0,53,53,1.346638,103.877235
536268,10,2,12,1.3466,103.877134
536270,3,0,3,1.349522,103.882719
536272,16,1,17,1.346417,103.876666
536273,7,0,7,1.346541,103.876753
536274,16,0,16,1.346666,103.876644
536275,7,2,9,1.346712,103.876554
536276,207,0,207,1.346649,103.876529
536277,8,6,14,1.346421,103.876784
536278,1,0,1,1.348028,103.883372
536279,2,1,3,1.346522,103.87693
536280,2,0,2,1.347109,103.882894
536281,0,4,4,1.346309,103.876515
536283,1,0,1,1.34667,103.876471
536284,14,1,15,1.346215,103.876209
536285,2,9,11,1.346158,103.876065
536287,7,0,7,1.346043,103.875777
536288,0,4,4,1.346011,103.875739
536289,6,9,15,1.34598,103.875664
536290,28,0,28,1.345949,103.875613
536300,22,31,53,1.339082,103.885581
536301,4,2,6,1.339161,103.88539
536302,3,3,6,1.339122,103.885542
536304,3,0,3,1.346394,103.876719
536305,1,2,3,1.339148,103.885507
536306,0,7,7,1.339187,103.885484
536308,1,0,1,1.346273,103.876353
536309,21,6,27,1.339325,103.885244
536310,2,3,5,1.33927,103.885417
536311,4,0,4,1.339359,103.885204
536313,23,3,26,1.339399,103.885163
536314,92,19,111,1.339382,103.885318
536315,4,15,19,1.339772,103.884715
536317,0,3,3,1.33925,103.885317
536318,3,2,5,1.339484,103.885199
536319,0,2,2,1.34634,103.876617
536320,18,0,18,1.339515,103.885185
536321,0,2,2,1.339705,103.884646
536322,6,0,6,1.339565,103.88513
536323,9,2,11,1.33962,103.884556
536324,18,0,18,1.339607,103.885108
536325,62,3,65,1.339583,103.884515
536326,0,1,1,1.339229,103.885451
536327,3,0,3,1.339736,103.884677
536329,6,0,6,1.339666,103.884393
536330,1,2,3,1.339549,103.884476
536336,2,0,2,1.339668,103.884612
536338,0,1,1,1.339666,103.88506
536339,5,0,5,1.33985,103.884609
536340,1,1,2,1.339944,103.884767
536341,0,6,6,1.339879,103.884649
536345,1,0,1,1.33999,103.884715
536346,4,0,4,1.340201,103.884529
536347,1,30,31,1.340233,103.8845
536356,53,1287,1340,1.348717,103.880064
536357,2,9,11,1.348717,103.880064
536358,75,13,88,1.348465,103.879597
536359,0,1,1,1.340172,103.884546
536360,2,9,11,1.348443,103.879575
536361,2,3,5,1.348663,103.87997
536362,5,9,14,1.348663,103.87997
536363,2,0,2,1.340033,103.884671
536364,13,1,14,1.348554,103.879784
536365,10,2,12,1.348554,103.879784
536367,11,7,18,1.348455,103.879607
536368,2,9,11,1.348684,103.879486
536369,0,1,1,1.348401,103.879587
536370,0,1,1,1.348242,103.879524
536372,3,1,4,1.34804,103.879578
536373,1,0,1,1.348135,103.879553
536374,42,1,43,1.347831,103.879622
536376,2,0,2,1.348512,103.879562
536378,0,1,1,1.348915,103.879385
536379,3,0,3,1.339825,103.884913
536380,9,7,16,1.348039,103.879556
536381,3,15,18,1.349201,103.879267
536382,2,3,5,1.348228,103.879515
536383,9,0,9,1.348228,103.879515
536384,5,0,5,1.34824,103.87951
536385,6,3,9,1.34824,103.87951
536386,40,10,50,1.347815,103.879091
536387,5,0,5,1.347815,103.879091
536388,0,4,4,1.347738,103.879113
536389,2,0,2,1.34782,103.879611
536390,1,8,9,1.348247,103.879485
536391,9,0,9,1.348247,103.879485
536392,0,4,4,1.348247,103.879485
536393,0,2,2,1.347738,103.879113
536394,0,2,2,1.348247,103.879485
536395,1,0,1,1.349152,103.879283
536396,18,1,19,1.348227,103.879453
536397,0,2,2,1.347689,103.879117
536399,8,3,11,1.348227,103.879453
536400,2,0,2,1.348227,103.879453
536401,0,1,1,1.347689,103.879117
536402,0,2,2,1.347584,103.879132
536403,6,10,16,1.34741,103.879132
536404,16,0,16,1.34869,103.878974
536405,5,3,8,1.348821,103.878922
536406,8,21,29,1.348855,103.878904
536407,698,58,756,1.349385,103.8792
536408,172,37,209,1.349706,103.87908
536409,26,4,30,1.348075,103.878952
536410,1,0,1,1.347584,103.879132
536411,2,0,2,1.34863,103.878964
536412,143,58,201,1.349062,103.878649
536413,6,4,10,1.34818,103.878912
536415,2,0,2,1.347695,103.878409
536416,2,1,3,1.348039,103.879556
536417,8,0,8,1.347903,103.878392
536418,0,1,1,1.34773,103.878466
536419,0,2,2,1.347782,103.878367
536420,15,0,15,1.347961,103.878346
536421,39,0,39,1.347906,103.87828
536422,0,1,1,1.347843,103.878319
536425,12,5,17,1.348557,103.878734
536427,1,0,1,1.348478,103.878782
536428,0,6,6,1.348644,103.878695
536429,1,2,3,1.348286,103.878878
536430,4,0,4,1.348175,103.878139
536431,4,9,13,1.348735,103.878648
536432,1,3,4,1.348313,103.87815
536433,7,8,15,1.348235,103.878094
536434,4,10,14,1.348836,103.878504
536435,3,1,4,1.348768,103.878403
536436,3,1,4,1.348675,103.878303
536437,21,0,21,1.348618,103.878245
536438,30,1,31,1.348538,103.878148
536439,47,7,54,1.348478,103.878068
536440,2,0,2,1.348373,103.878844
536441,5,3,8,1.34804,103.879578
536442,13,36,49,1.347235,103.879149
536443,304,12,316,1.346262,103.879641
536444,30,39,69,1.346198,103.879313
536445,613,3,616,1.345769,103.879053
536449,25,307,332,1.366191,103.892302
536450,100,93,193,1.36587,103.892721
536451,20,163,183,1.366573,103.893711
536452,1,7,8,1.366308,103.893594
536453,1,4,5,1.366307,103.893593
536456,8,2,10,1.366251,103.893726
536457,24,3,27,1.36625,103.893725
536466,6,13,19,1.351165,103.876117
536467,351,102,453,1.35028,103.877719
536468,60,41,101,1.35028,103.877719
536469,190,22,212,1.351007,103.87825
536470,622,83,705,1.350791,103.878613
536471,302,37,339,1.35028,103.877719
536472,33,10,43,1.349852,103.878136
536473,38,1,39,1.349883,103.878176
536475,13,11,24,1.349953,103.878268
536477,4,0,4,1.350014,103.878348
536478,1,1,2,1.348436,103.877992
536479,0,4,4,1.350074,103.878425
536480,1,8,9,1.350369,103.87844
536481,0,2,2,1.350044,103.878385
536482,1,0,1,1.34808,103.878202
536483,21,4,25,1.350263,103.87854
536484,1,0,1,1.350298,103.878498
536485,3,5,8,1.350166,103.878606
536486,4,2,6,1.349716,103.87794
536487,1,6,7,1.349662,103.877973
536488,1,12,13,1.349593,103.878026
536489,0,84,84,1.349546,103.878073
536490,1,11,12,1.349762,103.877904
536491,195,7,202,1.350076,103.878569
536492,466,7,473,1.349959,103.878442
536493,7,77,84,1.350926,103.876442
536498,2,23,25,1.344088,103.880665
536499,6,7,13,1.34413,103.880631
536500,0,5,5,1.344213,103.880563
536501,0,3,3,1.348233,103.878191
536502,0,2,2,1.350335,103.878471
536503,58,0,58,1.344413,103.880426
536504,0,3,3,1.344254,103.880529
536505,1,3,4,1.344576,103.880331
536506,1,3,4,1.344658,103.880284
536507,57,39,96,1.34474,103.880237
536508,45,0,45,1.345041,103.880044
536509,3,16,19,1.345052,103.880423
536510,0,2,2,1.344331,103.880473
536512,3,1,4,1.345052,103.880423
536513,1,0,1,1.350226,103.878577
536514,10,5,15,1.345052,103.880423
536515,2,0,2,1.345052,103.880423
536517,2,3,5,1.345052,103.880423
536518,7,0,7,1.345257,103.880681
536519,1,0,1,1.345052,103.880423
536520,0,2,2,1.345052,103.880423
536521,4,13,17,1.34517,103.880239
536522,1,0,1,1.345198,103.880738
536523,26,1,27,1.34517,103.880239
536524,8,0,8,1.34517,103.880239
536525,1,0,1,1.34517,103.880239
536526,9,0,9,1.34517,103.880239
536527,0,1,1,1.34517,103.880239
536531,4,0,4,1.34521,103.879952
536532,19,7,26,1.345396,103.879988
536533,0,6,6,1.345396,103.879988
536534,1,0,1,1.34517,103.880239
536535,0,1,1,1.345396,103.879988
536536,5,0,5,1.345656,103.880101
536537,2,0,2,1.345097,103.880014
536539,4,1,5,1.345767,103.880228
536540,8,0,8,1.345784,103.880298
536541,1,7,8,1.345312,103.879901
536542,0,7,7,1.345807,103.879846
536543,162,0,162,1.345806,103.879845
536544,1,1,2,1.345703,103.88014
536545,23,0,23,1.345806,103.879845
536547,0,16,16,1.345806,103.879845
536549,51,0,51,1.345806,103.879845
536550,0,10,10,1.345371,103.879866
536551,0,1,1,1.345604,103.880079
536552,2,0,2,1.345806,103.879845
536553,7,4,11,1.345605,103.879748
536554,0,2,2,1.345517,103.879789
536555,0,1,1,1.34542,103.87984
536556,0,4,4,1.345788,103.879613
536557,3,2,5,1.345864,103.879561
536558,1635,17,1652,1.343258,103.881432
536559,918,443,1361,1.343258,103.881432
536560,808,767,1575,1.343258,103.881432
536561,352,6,358,1.343258,103.881432
536562,851,312,1163,1.343258,103.881432
536563,677,60,737,1.343258,103.881432
536564,615,1478,2093,1.343258,103.881432
536565,492,1727,2219,1.343258,103.881432
536569,6,4,10,1.389447,103.921571
536570,0,2,2,1.345658,103.879707
536573,0,1,1,1.345701,103.879676
536580,0,1,1,1.389976,103.921413
536583,13,3,16,1.383946,103.926263
536584,20,10,30,1.39209,103.925851
536585,6,30,36,1.386283,103.924365
536587,54,11,65,1.395575,103.922882
536591,0,1,1,1.389586,103.920822
536592,11,0,11,1.345256,103.875826
536593,203,0,203,1.345285,103.875902
536594,1,0,1,1.345241,103.875788
536595,6,3,9,1.345344,103.876054
536596,1,0,1,1.345314,103.875978
536597,4,3,7,1.345403,103.876207
536598,1,0,1,1.345374,103.876131
536599,82,3,85,1.345462,103.876359
536600,23,0,23,1.345462,103.876308
536601,1,0,1,1.345432,103.876283
536602,36,1,37,1.345437,103.876229
536603,0,4,4,1.345425,103.876193
536604,2,5,7,1.345413,103.876157
536605,2,4,6,1.345413,103.876116
536606,0,2,2,1.389648,103.921589
536607,28,0,28,1.345392,103.875871
536609,0,5,5,1.345394,103.875872
536610,0,1,1,1.345443,103.876258
536611,2,11,13,1.344931,103.875874
536612,3,1,4,1.345226,103.87575
536613,28,0,28,1.3453,103.875682
536614,7,1,8,1.345513,103.875513
536615,33,0,33,1.345587,103.875477
536617,53,0,53,1.345871,103.875344
536618,4,1,5,1.345885,103.875334
536619,3,3,6,1.345885,103.875334
536620,1,3,4,1.345885,103.875334
536621,15,7,22,1.345756,103.874817
536622,1,7,8,1.345756,103.874817
536623,0,2,2,1.345393,103.875872
536624,1,0,1,1.3454,103.87567
536625,14,0,14,1.345504,103.874734
536626,21,12,33,1.344889,103.874727
536627,0,2,2,1.345504,103.874735
536628,2,2,4,1.344889,103.874727
536629,0,2,2,1.344889,103.874727
536630,3,0,3,1.344494,103.880379
536631,13,2,15,1.344889,103.874727
536632,2,0,2,1.344889,103.874727
536633,2,0,2,1.344889,103.874727
536634,1,0,1,1.345504,103.874734
536635,0,1,1,1.344889,103.874727
536636,10,1,11,1.344954,103.874566
536637,0,2,2,1.344889,103.874727
536638,2,3,5,1.344954,103.874566
536639,2,0,2,1.344954,103.874566
536640,0,3,3,1.344889,103.874727
536641,1,2,3,1.344954,103.874566
536642,3,1,4,1.344954,103.874566
536643,0,2,2,1.344954,103.874566
536644,4,7,11,1.344954,103.874566
536645,0,3,3,1.344954,103.874566
536646,3,0,3,1.344954,103.874566
536647,1,2,3,1.345504,103.874715
536648,32,4,36,1.346062,103.874808
536649,17,0,17,1.345798,103.874703
536650,1,2,3,1.345504,103.874714
536651,1,0,1,1.344954,103.874566
536652,8,3,11,1.346131,103.8745
536653,51,3,54,1.346239,103.874307
536654,4,0,4,1.345756,103.874817
536656,3,0,3,1.345973,103.874729
536658,2,19,21,1.345648,103.875539
536659,6,1,7,1.345726,103.875488
536660,15,9,24,1.345773,103.87544
536661,5,23,28,1.345827,103.875398
536662,35,1314,1349,1.371098,103.896997
536663,0,7,7,1.370969,103.897094
536664,0,8,8,1.370893,103.89715
536665,9,9,18,1.370764,103.897284
536666,7,19,26,1.370715,103.897329
536668,76,1,77,1.370644,103.897383
536669,29,5,34,1.370539,103.897512
536670,21,55,76,1.370394,103.897627
536698,57,21,78,1.350963,103.880665
536699,2,0,2,1.344954,103.874566
536700,8,301,309,1.350862,103.88131
536701,41,86,127,1.350846,103.881457
536702,13,84,97,1.350813,103.881788
536703,0,93,93,1.350817,103.8819
536704,1,50,51,1.350829,103.882075
536705,6,1,7,1.350835,103.882121
536707,4,0,4,1.350834,103.882268
536708,42,0,42,1.350846,103.882349
536709,7,0,7,1.350846,103.882349
536710,4,0,4,1.350846,103.882349
536716,2,0,2,1.350901,103.881131
536718,16,0,16,1.350869,103.882556
536719,35,424,459,1.350871,103.882651
536720,7,0,7,1.350886,103.882775
536721,5,0,5,1.350898,103.882887
536722,11,245,256,1.35091,103.883003
536723,2,0,2,1.350856,103.882418
536724,1,1,2,1.351006,103.883471
536725,5,447,452,1.351059,103.8838
536726,9,1982,1991,1.350988,103.884126
536727,4,77,81,1.350919,103.884141
536728,5,6,11,1.350839,103.884145
536729,12,7,19,1.350774,103.884154
536730,0,8,8,1.350717,103.884156
536731,0,2,2,1.351021,103.883628
536732,0,1,1,1.346518,103.874456
536733,0,1,1,1.350604,103.884169
536734,2,0,2,1.350662,103.884165
536735,0,2,2,1.3505,103.884176
536738,0,2,2,1.350453,103.884181
536739,0,1,1,1.350551,103.884172
536740,19,842,861,1.350969,103.884094
536741,139,71,210,1.351003,103.884813
536742,286,23,309,1.350731,103.885565
536743,3,24,27,1.350862,103.88131
536744,72,11,83,1.350862,103.88131
536745,0,57,57,1.350862,103.88131
536746,5,5,10,1.350846,103.881457
536747,73,0,73,1.350846,103.881457
536748,27,0,27,1.350846,103.881457
536751,6,1,7,1.34337,103.880989
536752,3,9,12,1.343452,103.881091
536760,3,71,74,1.368499,103.887624
536761,47,32,79,1.368436,103.887611
536762,0,32,32,1.368548,103.8877
536763,0,3,3,1.345414,103.874954
536764,6,7,13,1.368595,103.887749
536765,13,1,14,1.368504,103.887714
536766,0,2,2,1.350823,103.884108
536767,1,1,2,1.368636,103.887804
536768,1,48,49,1.368672,103.887854
536769,2,0,2,1.368533,103.887779
536770,10,28,38,1.36871,103.887915
536771,0,6,6,1.368609,103.88788
536772,0,1,1,1.350908,103.884102
536773,3,47,50,1.368751,103.887963
536775,34,20,54,1.368784,103.888029
536777,1,3,4,1.368838,103.888104
536778,3,0,3,1.368466,103.887661
536779,9,342,351,1.368897,103.888172
536781,1,1,2,1.368564,103.887819
536782,133,0,133,1.368878,103.888277
536784,3,2,5,1.368905,103.888319
536785,1,15,16,1.369032,103.888369
536786,0,1,1,1.368686,103.888003
536787,4,0,4,1.369072,103.888424
536788,2,0,2,1.368946,103.888237
536789,0,23,23,1.369113,103.888474
536790,129,4,133,1.369033,103.888494
536791,1,15,16,1.369162,103.888544
536793,16,1,17,1.369223,103.888623
536794,4,47,51,1.369223,103.888623
536795,4,1,5,1.369105,103.888601
536796,2,2,4,1.369266,103.888682
536797,9,131,140,1.369266,103.888682
536798,6,1,7,1.369138,103.888661
536799,6,230,236,1.369393,103.88884
536801,0,1,1,1.368941,103.888371
536802,40,6,46,1.369256,103.888818
536803,5,8,13,1.369356,103.888926
536804,1,17,18,1.369393,103.888978
536805,11,48,59,1.369435,103.889046
536806,3,83,86,1.369476,103.88911
536807,12,2041,2053,1.369493,103.889182
536815,1,127,128,1.367927,103.887864
536816,6,662,668,1.367942,103.887988
536817,0,13,13,1.367955,103.887913
536818,5,5,10,1.36797,103.888047
536820,7,0,7,1.368008,103.888099
536821,2,0,2,1.368992,103.888431
536822,1,0,1,1.369213,103.888764
536824,27,10,37,1.368068,103.88821
536827,3,0,3,1.368807,103.888167
536828,1,0,1,1.368039,103.888155
536829,63,0,63,1.368192,103.888398
536830,13,2,15,1.368234,103.888327
536831,1,0,1,1.368135,103.888183
536832,12,0,12,1.368272,103.888375
536833,0,3,3,1.368147,103.888334
536834,0,1,1,1.368238,103.888454
536835,1,0,1,1.368299,103.888432
536836,1,0,1,1.368304,103.888569
536837,1,2,3,1.368265,103.888513
536838,0,2,2,1.36802,103.888004
536840,3,1,4,1.368409,103.888583
536841,13,5,18,1.368415,103.888723
536842,3,1,4,1.368449,103.888646
536843,5,2,7,1.368457,103.888784
536844,13,1,14,1.368496,103.888712
536846,1,0,1,1.368334,103.888479
536847,131,2,133,1.368599,103.888945
536848,20,5,25,1.368564,103.888809
536849,2,0,2,1.368376,103.888529
536852,1,0,1,1.36854,103.888766
536853,201,4,205,1.368714,103.889128
536854,1,0,1,1.368646,103.888925
536857,15,10,25,1.368805,103.889257
536858,3,1,4,1.368777,103.889094
536859,2,1,3,1.368335,103.888612
536860,1,1,2,1.368637,103.889008
536861,1,0,1,1.368688,103.888979
536862,0,3,3,1.368847,103.889314
536863,1,0,1,1.368889,103.88937
536864,9,2,11,1.368943,103.889339
536867,88,2,90,1.36898,103.889524
536869,2,51,53,1.369009,103.889554
536870,0,1,1,1.368922,103.889429
536871,7,112,119,1.369058,103.88952
536880,0,2,2,1.368815,103.889165
536881,9,1,10,1.368072,103.889081
536882,20,0,20,1.368043,103.889041
536885,12,0,12,1.367937,103.888874
536886,1,361,362,1.367903,103.888824
536887,6,0,6,1.367869,103.888767
536888,3,0,3,1.368901,103.889275
536889,1,79,80,1.367804,103.888677
536890,0,129,129,1.367774,103.888636
536892,67,92,159,1.367708,103.888532
536900,1,5,6,1.368208,103.889258
536902,188,0,188,1.368252,103.889318
536903,1,1,2,1.368103,103.889131
536904,0,1,1,1.369031,103.889488
536905,10,0,10,1.368467,103.889683
536906,287,1,288,1.368337,103.889424
536907,2,16,18,1.368497,103.88973
536908,1,0,1,1.368298,103.88937
536909,4,6,10,1.368524,103.889774
536910,2,2,4,1.368401,103.889504
536911,4,65,69,1.368558,103.889803
536912,24,0,24,1.36846,103.889594
536913,2,1,3,1.36783,103.888717
536916,2,121,123,1.368581,103.889771
536925,14,1283,1297,1.366622,103.891541
536926,104,985,1089,1.366721,103.891581
536927,68,71,139,1.366665,103.891465
536928,1,21,22,1.366773,103.891484
536929,3,4,7,1.366702,103.891397
536930,1,10,11,1.366818,103.891405
536931,1,0,1,1.368364,103.889468
536932,9,18,27,1.366893,103.891266
536933,10,0,10,1.366867,103.891069
536934,5,11,16,1.366969,103.891142
536935,3,3,6,1.366888,103.891013
536936,1,7,8,1.367,103.891076
536937,1,0,1,1.366738,103.891327
536938,1,6,7,1.366956,103.890911
536939,0,1,1,1.367026,103.891029
536940,24,0,24,1.366997,103.890852
536941,6,0,6,1.367071,103.890929
536942,0,9,9,1.367033,103.890772
536943,4,17,21,1.367101,103.890878
536944,0,1,1,1.36705,103.890978
536945,54,0,54,1.367137,103.890814
536946,26,2,28,1.367101,103.890623
536947,0,17,17,1.36716,103.890757
536948,1,8,9,1.367139,103.890562
536949,2,7,9,1.367189,103.890695
536950,4,45,49,1.367171,103.890481
536951,11,26,37,1.367223,103.890634
536952,6,148,154,1.367211,103.890418
536953,17,18,35,1.367345,103.890548
536954,4,1,5,1.367384,103.890488
536955,6,11,17,1.367418,103.890431
536956,2,3,5,1.367451,103.890363
536957,23,10,33,1.367485,103.890307
536958,17,1,18,1.367526,103.890248
536959,19,40,59,1.367549,103.890187
536961,3,9,12,1.367601,103.890083
536962,6,6,12,1.367628,103.89001
536963,11,22,33,1.367737,103.889646
536964,54,0,54,1.367774,103.889611
536965,3,5,8,1.367805,103.889574
536967,0,1,1,1.367066,103.8907
536969,8,9,17,1.367941,103.88945
536970,7,1,8,1.367972,103.889423
536971,1,0,1,1.367873,103.88951
536972,1,7,8,1.368028,103.889372
536973,19,37,56,1.368056,103.889346
536974,7,9,16,1.366846,103.891355
536978,764,297,1061,1.380004,103.879382
536980,797,1964,2761,1.380524,103.881081
536981,61,44,105,1.338515,103.885934
536982,78,1,79,1.338414,103.886012
536983,280,320,600,1.338365,103.885752
536984,10,103,113,1.338461,103.885547
536985,324,87,411,1.338046,103.885461
536986,173,288,461,1.338604,103.885206
536987,107,234,341,1.338492,103.884762
536988,70,163,233,1.337933,103.885091
536991,0,5,5,1.299509,103.837
536997,7,0,7,1.343016,103.88474
536998,4,3,7,1.343602,103.884857
536999,22,2,24,1.343676,103.884857
537002,2,10,12,1.344269,103.885019
537003,72,6,78,1.344699,103.885362
537004,2,0,2,1.368433,103.889637
537013,25,1,26,1.349326,103.877968
537014,10,1,11,1.349326,103.877968
537016,22,3,25,1.299509,103.837
537018,9,1,10,1.299509,103.837
537019,8,0,8,1.299509,103.837
537020,23,0,23,1.299509,103.837
537024,47,5,52,1.339286,103.890813
537026,1,3,4,1.339455,103.89066
537028,4,9,13,1.339597,103.890551
537029,1,11,12,1.340212,103.890262
537030,6,0,6,1.339739,103.890431
537031,4,1,5,1.340308,103.890164
537032,15,1,16,1.339848,103.890355
537033,16,1,17,1.340359,103.890119
537034,4,1,5,1.339994,103.890214
537035,2,1,3,1.368489,103.889633
537036,1,2,3,1.340424,103.890076
537037,24,5,29,1.340114,103.890095
537038,7,0,7,1.340587,103.889928
537039,27,4,31,1.340234,103.889992
537040,2,44,46,1.340699,103.889839
537041,23,0,23,1.340332,103.889913
537042,17,6,23,1.34044,103.889825
537043,1,3,4,1.340544,103.889736
537044,3,1,4,1.340635,103.889645
537045,0,5,5,1.34073,103.889542
537054,107,1123,1230,1.340416,103.887892
537055,4080,3039,7119,1.339337,103.889632
537056,15,0,15,1.340601,103.888847
537059,3,0,3,1.340522,103.889996
537060,2,2,4,1.344713,103.89322
537064,1,5,6,1.345485,103.894222
537065,459,1654,2113,1.340456,103.886553
537066,1996,0,1996,1.340194,103.888821
537067,1,20,21,1.299509,103.837
537068,10,1,11,1.339667,103.891668
537069,59,96,155,1.339563,103.891545
537070,8,1,9,1.339354,103.8913
537071,20,23,43,1.339156,103.891065
537072,246,3,249,1.339357,103.891169
537080,672,59,731,1.341195,103.890424
537081,51,30,81,1.341195,103.890424
537082,1,10,11,1.34038,103.891191
537083,382,25,407,1.340232,103.89126
537084,7,92,99,1.341408,103.890102
537085,0,15,15,1.341394,103.890263
537086,2,16,18,1.34133,103.891039
537087,0,14,14,1.341325,103.890602
537088,0,8,8,1.341251,103.890803
537089,5,36,41,1.341077,103.890922
537090,3,7,10,1.340937,103.891028
537091,49,59,108,1.340807,103.891106
537092,93,75,168,1.340616,103.89116
537093,4,87,91,1.340471,103.891276
537094,1,8,9,1.34032,103.891366
537095,1,31,32,1.340175,103.891478
537096,0,36,36,1.340072,103.89161
537097,0,27,27,1.339947,103.891731
537098,0,21,21,1.339856,103.891875
537099,0,28,28,1.339804,103.892031
537100,0,38,38,1.339594,103.892227
537101,3,41,44,1.339525,103.892388
537102,1,21,22,1.339473,103.892521
537103,2,177,179,1.339878,103.89218
537112,4,77,81,1.341351,103.889157
537121,1,103,104,1.354143,103.879163
537122,5,10,15,1.353693,103.879665
537123,5,0,5,1.353638,103.879691
537124,11,0,11,1.353615,103.87971
537126,25,0,25,1.353524,103.879789
537129,5,0,5,1.353387,103.879907
537132,0,3,3,1.34338,103.894207
537133,0,1,1,1.368005,103.889394
537141,8,172,180,1.344909,103.882487
537142,7,295,302,1.344791,103.882559
537143,2,2,4,1.344942,103.882545
537144,29,1,30,1.344841,103.882611
537145,1,2,3,1.35325,103.880025
537147,1,4,5,1.345026,103.882642
537148,1,1,2,1.344245,103.885433
537149,22,7,29,1.345051,103.88269
537150,18,0,18,1.344957,103.882758
537151,1,15,16,1.34508,103.882732
537152,0,4,4,1.344986,103.882814
537153,0,17,17,1.345113,103.882794
537154,5,2,7,1.34513,103.882951
537155,0,20,20,1.345171,103.882858
537156,1,4,5,1.345167,103.882998
537157,7,27,34,1.345202,103.882915
537158,0,1,1,1.353296,103.879986
537159,0,12,12,1.345236,103.882956
537160,1,1,2,1.344926,103.882723
537161,0,19,19,1.345275,103.883013
537162,2,2,4,1.345258,103.88313
537163,0,9,9,1.34532,103.883068
537165,0,13,13,1.345366,103.883135
537167,4,12,16,1.345408,103.883188
537169,6,20,26,1.345446,103.883234
537170,2,2,4,1.345379,103.883298
537171,2,11,13,1.345483,103.883288
537173,3,9,12,1.345516,103.883334
537174,3,0,3,1.344977,103.882582
537175,2,2,4,1.345568,103.883395
537176,2,0,2,1.345225,103.883084
537177,17,2,19,1.345593,103.883437
537179,3,3,6,1.345622,103.883469
537182,0,2,2,1.345505,103.883471
537183,31,0,31,1.345682,103.883546
537184,1,2,3,1.345472,103.883424
537185,0,1,1,1.345192,103.883041
537186,5,0,5,1.345716,103.88372
537187,0,1,1,1.345712,103.883583
537188,5,1,6,1.345758,103.883776
537190,25,1,26,1.345795,103.883689
537191,4,0,4,1.345817,103.883719
537233,0,23,23,1.364356,103.907523
537235,1,18,19,1.364293,103.90748
537237,1,3,4,1.364161,103.907386
537239,0,13,13,1.364092,103.907352
537241,0,10,10,1.364047,103.90729
537242,0,17,17,1.364058,103.907189
537243,0,14,14,1.364097,103.9071
537244,0,11,11,1.364128,103.906995
537245,3,63,66,1.364194,103.906863
537254,5,389,394,1.35492,103.88477
537255,4,26,30,1.354967,103.884864
537256,0,11,11,1.354823,103.884813
537257,28,1,29,1.354913,103.884881
537258,1,14,15,1.354714,103.884858
537259,6,0,6,1.354861,103.884914
537260,4,8,12,1.35462,103.884871
537261,175,9,184,1.354794,103.884953
537262,2,0,2,1.345631,103.883625
537263,3,0,3,1.345674,103.883668
537264,2,4,6,1.354269,103.88494
537265,1,2,3,1.354752,103.884981
537266,3,2,5,1.354173,103.884976
537267,9,1,10,1.354617,103.885027
537268,30,0,30,1.354117,103.884994
537269,1,0,1,1.345744,103.883616
537271,5,1,6,1.354471,103.885037
537272,14,0,14,1.353997,103.885076
537273,40,0,40,1.354411,103.885046
537274,2,0,2,1.354476,103.884921
537275,14,0,14,1.35431,103.885056
537276,0,1,1,1.354543,103.885039
537285,3,461,464,1.360257,103.888731
537286,3,1799,1802,1.360117,103.888795
537287,0,4,4,1.360266,103.888794
537288,19,6,25,1.360136,103.888891
537289,31,3,34,1.36015,103.88897
537291,3,0,3,1.354694,103.885008
537292,7,1,8,1.36016,103.889081
537293,1,0,1,1.353734,103.885211
537294,2,5,7,1.360166,103.889128
537295,5,1,6,1.360174,103.889204
537296,8,2,10,1.360183,103.889283
537297,1,12,13,1.360199,103.889358
537298,2,0,2,1.353841,103.885173
537299,4,0,4,1.360204,103.889403
537300,17,0,17,1.360208,103.889415
537301,23,1,24,1.36034,103.889299
537302,3,0,3,1.360154,103.889043
537303,43,0,43,1.360239,103.889606
537304,0,2,2,1.360317,103.889142
537305,0,2,2,1.360348,103.889364
537307,3,1,4,1.360384,103.889486
537312,0,1,1,1.360297,103.888955
537313,24,2,26,1.360445,103.889995
537314,0,4,4,1.360323,103.8902
537315,5,0,5,1.360329,103.890274
537316,2,0,2,1.360256,103.889684
537317,2,15,17,1.360346,103.890374
537319,11,0,11,1.36049,103.890322
537320,13,0,13,1.360354,103.890524
537321,0,8,8,1.360364,103.890579
537322,0,1,1,1.360307,103.890102
537323,14,2,16,1.360511,103.890483
537325,49,7,56,1.360395,103.890764
537326,4,1,5,1.360525,103.890607
537328,3,0,3,1.360234,103.88954
537329,5,117,122,1.360408,103.890851
537330,11,7,18,1.360552,103.890816
537331,1,14,15,1.360607,103.891131
537332,3,8,11,1.360604,103.891213
537333,2,0,2,1.360474,103.890183
537334,8,5,13,1.360617,103.891358
537336,0,1,1,1.360364,103.89065
537337,4,0,4,1.360639,103.891532
537338,0,4,4,1.360643,103.891574
537340,1,3,4,1.360648,103.891662
537342,5,5,10,1.360321,103.889194
537343,27,3,30,1.360431,103.889839
537348,1,98,99,1.299509,103.837
537349,15,998,1013,1.364502,103.907684
537350,3,7,10,1.36454,103.90759
537351,4,17,21,1.364661,103.907431
537352,0,18,18,1.364683,103.907375
537354,1,11,12,1.364729,103.907208
537356,0,3,3,1.360533,103.890712
537357,2,1,3,1.364759,103.90714
537360,0,66,66,1.364931,103.906787
537363,0,78,78,1.364858,103.90669
537365,75,78,153,1.364876,103.90664
537376,14,8,22,1.299509,103.837
537383,18,0,18,1.355913,103.885158
537384,1,1,2,1.360611,103.891287
537385,53,0,53,1.355836,103.884992
537386,2,0,2,1.35587,103.885065
537388,1,0,1,1.360632,103.891479
537389,22,3,25,1.355925,103.884828
537390,11,18,29,1.355957,103.884951
537391,23,0,23,1.355994,103.885043
537392,5,8,13,1.35606,103.885152
537393,9,4,13,1.356144,103.885334
537394,18,4,22,1.356033,103.885452
537395,11,0,11,1.356192,103.88543
537397,1,0,1,1.355882,103.884735
537398,9,0,9,1.356122,103.885652
537399,5,15,20,1.356288,103.885623
537400,1,2,3,1.364905,103.906843
537401,3,0,3,1.356173,103.885738
537402,8,13,21,1.35622,103.885833
537403,5,3,8,1.356385,103.885815
537404,2,2,4,1.356258,103.885895
537406,55,11,66,1.356435,103.885933
537407,1,0,1,1.35624,103.885526
537408,1,0,1,1.356356,103.886085
537411,11,0,11,1.35644,103.886247
537412,2,0,2,1.355789,103.884911
537413,1,0,1,1.356483,103.886023
537414,0,1,1,1.356497,103.886342
537415,204,2,206,1.356538,103.886424
537416,6,3,9,1.356656,103.886368
537417,3,4,7,1.356635,103.886613
537418,7,6,13,1.356739,103.886558
537419,1,0,1,1.356619,103.886283
537420,33,1,34,1.356786,103.88665
537421,0,6,6,1.356725,103.886786
537422,39,1,40,1.35683,103.886742
537423,1,9,10,1.356772,103.886868
537425,1,0,1,1.356682,103.886691
537426,0,3,3,1.356337,103.885719
537427,1,2,3,1.356907,103.886902
537428,5,5,10,1.356953,103.886987
537429,1,4,5,1.356899,103.887126
537430,0,3,3,1.356847,103.887035
537432,5,8,13,1.35704,103.88716
537433,193,17,210,1.356979,103.887293
537434,1,2,3,1.357005,103.887086
537435,3,0,3,1.357087,103.887241
537436,0,1,1,1.356809,103.886956
537437,0,7,7,1.357073,103.887476
537438,45,2,47,1.35717,103.887425
537439,2,0,2,1.356576,103.886188
537440,0,1,1,1.35712,103.88732
537443,6,0,6,1.3572,103.887724
537445,7,0,7,1.357244,103.887806
537446,5,1,6,1.357341,103.887778
537447,3,10,13,1.357291,103.88793
537448,3,25,28,1.357398,103.88786
537449,2,2,4,1.356262,103.885103
537457,4,4,8,1.355957,103.886765
537458,14,0,14,1.355902,103.886798
537459,12,0,12,1.355847,103.886818
537461,1,0,1,1.357207,103.887506
537464,0,8,8,1.355597,103.886932
537465,8,0,8,1.355547,103.886955
537466,2,0,2,1.357117,103.887564
537470,0,3,3,1.357015,103.887363
537472,40,0,40,1.355144,103.887145
537473,0,5,5,1.355097,103.887181
537474,6,0,6,1.355042,103.887211
537475,1915,2156,4071,1.376207,103.900135
537476,104,2996,3100,1.377417,103.903692
537483,0,71,71,1.34489,103.877316
537485,8,127,135,1.344975,103.877311
537486,1,0,1,1.355747,103.886859
537487,39,1,40,1.344962,103.877136
537488,1,0,1,1.344939,103.877198
537489,121,4,125,1.344977,103.877092
537490,20,1,21,1.345008,103.877213
537491,3,0,3,1.355247,103.887099
537492,2,55,57,1.344977,103.876973
537493,2,0,2,1.355484,103.886992
537494,2,0,2,1.345026,103.877165
537495,0,13,13,1.344953,103.87689
537496,7,22,29,1.345042,103.877118
537497,4,1,5,1.344943,103.876849
537498,0,5,5,1.344935,103.876803
537499,1,11,12,1.345306,103.877065
537500,0,1,1,1.344992,103.877258
537501,8,3,11,1.34534,103.877062
537502,33,3,36,1.344904,103.876688
537503,4,16,20,1.344887,103.87662
537504,5,8,13,1.345375,103.877061
537505,3,43,46,1.34488,103.876572
537506,22,0,22,1.344863,103.876514
537507,6,15,21,1.345425,103.877056
537509,22,0,22,1.344842,103.876407
537510,6,10,16,1.34483,103.876352
537511,8,0,8,1.344858,103.876329
537512,0,1,1,1.344922,103.876744
537514,6,14,20,1.344921,103.876563
537515,2,2,4,1.344958,103.876688
537516,6,0,6,1.345278,103.877004
537518,30,0,30,1.345395,103.876988
537519,1,24,25,1.345458,103.876979
537520,1,0,1,1.344874,103.87639
537521,43,2,45,1.345591,103.877046
537522,5,0,5,1.345541,103.876978
537523,2,22,24,1.34567,103.877036
537524,20,5,25,1.345743,103.877029
537525,3,0,3,1.344988,103.877018
537526,1,49,50,1.345884,103.877203
537527,7,8,15,1.3459,103.87724
537528,5,0,5,1.345692,103.876954
537529,0,6,6,1.345914,103.877272
537530,7,17,24,1.345932,103.877284
537531,1,0,1,1.345529,103.877052
537532,0,2,2,1.344965,103.87693
537533,2,13,15,1.34593,103.877249
537535,3,8,11,1.345924,103.877018
537537,3,9,12,1.346,103.877009
537538,27,0,27,1.345939,103.876934
537539,2,5,7,1.346106,103.876997
537540,2,0,2,1.345914,103.877226
537541,0,3,3,1.345598,103.876963
537542,1,0,1,1.345752,103.876951
537544,28,0,28,1.346154,103.876913
537546,3,0,3,1.346166,103.876989
537547,10,0,10,1.346417,103.876968
537548,10,3,13,1.346462,103.876965
537549,1,3,4,1.344986,103.876777
537551,0,21,21,1.345032,103.876963
537557,1,5,6,1.362476,103.888578
537558,1,0,1,1.346075,103.876919
537559,2,0,2,1.346018,103.876928
537560,0,1,1,1.362431,103.88831
537562,1,1,2,1.362421,103.88834
537564,2,1,3,1.346362,103.876974
537565,1,15,16,1.362414,103.888441
537566,2,6,8,1.362468,103.888825
537567,10,0,10,1.362414,103.888478
537568,4,7,11,1.362464,103.888877
537569,0,1,1,1.362472,103.888637
537571,1,10,11,1.362457,103.888991
537572,0,1,1,1.362413,103.888518
537573,0,1,1,1.362412,103.888607
537574,14,2,16,1.362411,103.888648
537577,6,31,37,1.362452,103.889175
537579,4,3,7,1.362455,103.889237
537581,1,88,89,1.362453,103.889307
537582,15,5,20,1.362409,103.888878
537585,2,1,3,1.36247,103.888764
537586,1,0,1,1.362456,103.889061
537587,0,1,1,1.362402,103.889119
537588,1,2,3,1.362405,103.889054
537589,0,1,1,1.362402,103.88918
537590,0,1,1,1.362399,103.889286
537591,1,2,3,1.362401,103.889238
537592,1,9,10,1.362395,103.889463
537593,11,0,11,1.362458,103.888919
537601,10,5,15,1.353669,103.885341
537602,2,0,2,1.362471,103.888702
537604,2,0,2,1.353686,103.885375
537605,0,5,5,1.353787,103.885574
537607,6,1,7,1.353854,103.885708
537609,1,0,1,1.362397,103.889338
537611,31,3,34,1.353989,103.885974
537614,4,0,4,1.35409,103.886174
537615,2,0,2,1.353753,103.885508
537616,7,0,7,1.354157,103.886307
537617,2,17,19,1.354191,103.886374
537618,10,0,10,1.354225,103.88644
537619,0,1,1,1.353921,103.885841
537620,2,1,3,1.362399,103.889392
537621,1,11,12,1.354326,103.88664
537622,1,1,2,1.354124,103.88624
537623,2,3,5,1.354393,103.886773
537624,0,1,1,1.354258,103.886507
537625,0,5,5,1.35446,103.886906
537626,4,0,4,1.354484,103.886963
537627,1,3,4,1.354512,103.88701
537628,1,4,5,1.35453,103.887047
537629,3,2,5,1.354566,103.887122
537630,5,3,8,1.354602,103.887196
537631,0,1,1,1.354427,103.88684
537632,2,4,6,1.354675,103.887344
537633,1,3,4,1.354711,103.887419
537634,1,113,114,1.354737,103.887483
537635,7,102,109,1.354764,103.887527
537636,2,0,2,1.354359,103.886707
537637,6,16,22,1.354815,103.887628
537638,4,0,4,1.354849,103.887696
537639,4,12,16,1.354883,103.887763
537640,1,29,30,1.354916,103.88783
537641,0,10,10,1.35495,103.887898
537642,3,0,3,1.354292,103.886573
537643,903,1,904,1.355018,103.888033
537644,4,17,21,1.355052,103.888101
537645,1,13,14,1.355086,103.888168
537646,4,0,4,1.35512,103.888236
537647,1,1,2,1.354781,103.88756
537648,3,31,34,1.355188,103.88837
537649,3,3,6,1.355221,103.888438
537650,5,22,27,1.355255,103.888506
537651,0,14,14,1.355289,103.888573
537652,157,62,219,1.355323,103.88864
537653,288,24,312,1.355347,103.888698
537670,246,387,633,1.368019,103.892919
537671,3,59,62,1.368396,103.892667
537672,2,0,2,1.355154,103.888303
537677,166,0,166,1.368567,103.892867
537679,2,1,3,1.354984,103.887966
537681,0,1,1,1.354639,103.88727
537682,13,0,13,1.368684,103.893024
537683,5,1,6,1.368713,103.893055
537684,1,0,1,1.368669,103.893001
537685,1,0,1,1.369039,103.893386
537687,1,0,1,1.369038,103.893385
537688,0,1,1,1.369038,103.893385
537689,4,0,4,1.369038,103.893385
537691,0,3,3,1.368611,103.892926
537692,1,0,1,1.369038,103.893385
537693,1,2,3,1.369038,103.893385
537694,42,1,43,1.369057,103.893337
537695,2,0,2,1.368064,103.89287
537696,1,2,3,1.369057,103.893337
537697,13,0,13,1.369057,103.893337
537698,1,1,2,1.369057,103.893337
537699,1,4,5,1.369057,103.893337
537700,0,1,1,1.369058,103.893338
537701,1,0,1,1.368768,103.893011
537702,33,2,35,1.368673,103.892918
537704,0,5,5,1.368603,103.892852
537705,0,1,1,1.3687,103.89295
537706,0,1,1,1.368577,103.892825
537707,4,1,5,1.368461,103.892715
537708,42,9,51,1.368439,103.892673
537709,3,10,13,1.368832,103.892268
537712,13,4,17,1.369016,103.892481
537714,102,0,102,1.369083,103.892572
537715,2,0,2,1.369057,103.893337
537716,35,19,54,1.369146,103.892646
537718,1,0,1,1.368551,103.892811
537719,3,0,3,1.369057,103.893337
537720,0,2,2,1.369105,103.892608
537721,2,1,3,1.369446,103.892971
537722,0,2,2,1.369446,103.892971
537723,0,3,3,1.369446,103.892971
537725,0,2,2,1.369446,103.892971
537726,6,6,12,1.369446,103.892971
537727,13,6,19,1.369235,103.892644
537728,5,0,5,1.369181,103.892586
537729,56,6,62,1.369129,103.892544
537730,0,1,1,1.369447,103.892972
537731,2,3,5,1.369056,103.892467
537740,1,10,11,1.299509,103.837
537741,16,7,23,1.35528,103.885355
537742,5,0,5,1.3552,103.885399
537743,3,0,3,1.369446,103.892971
537744,3,0,3,1.355119,103.885443
537745,2,0,2,1.369446,103.892971
537746,3,2,5,1.354877,103.885574
537747,3,0,3,1.355039,103.885487
537748,6,0,6,1.354716,103.885662
537749,3,0,3,1.354797,103.885618
537750,21,3,24,1.354555,103.88575
537751,3,3,6,1.354192,103.885067
537752,6,1,7,1.354209,103.8851
537753,0,2,2,1.354958,103.88553
537754,2,0,2,1.354242,103.885166
537755,0,1,1,1.369112,103.892506
537756,3,0,3,1.354636,103.885706
537757,2,0,2,1.354276,103.885232
537759,1,1,2,1.354377,103.88543
537760,1,0,1,1.35431,103.885298
537761,7,3,10,1.354511,103.885694
537762,0,2,2,1.354444,103.885562
537763,27,6,33,1.354563,103.885796
537764,1,1,2,1.354545,103.88576
537765,91,3,94,1.354618,103.885902
537766,5,3,8,1.354655,103.885973
537767,1,0,1,1.354478,103.885628
537768,0,1,1,1.354691,103.886044
537770,0,1,1,1.354728,103.886115
537772,8,2,10,1.354874,103.8864
537773,40,0,40,1.35491,103.886471
537774,0,1,1,1.354801,103.886258
537775,3,1,4,1.354983,103.886613
537776,0,2,2,1.354582,103.885831
537777,20,8,28,1.3558,103.88628
537778,2,2,4,1.355767,103.886298
537779,7,0,7,1.3557,103.886334
537780,5,0,5,1.355633,103.88637
537781,2,1,3,1.354343,103.885364
537783,1,1,2,1.35502,103.886684
537785,1,0,1,1.354947,103.886542
537786,4,0,4,1.355231,103.886586
537787,6,0,6,1.355164,103.886622
537788,0,2,2,1.355432,103.886478
537789,2,1,3,1.355566,103.886406
537790,1,0,1,1.355298,103.88655
537791,2,0,2,1.355097,103.886658
537793,1,0,1,1.354962,103.88673
537794,1,0,1,1.35489,103.886796
537803,0,1,1,1.354837,103.886821
537804,4,2,6,1.34463,103.883872
537805,6,0,6,1.344706,103.883914
537806,4,4,8,1.344647,103.883919
537807,8,0,8,1.344747,103.883977
537808,1,0,1,1.344647,103.883856
537810,3,0,3,1.35504,103.886684
537811,2,0,2,1.355015,103.886716
537812,1,0,1,1.344687,103.883981
537821,9,391,400,1.37155,103.897491
537822,1,0,1,1.344696,103.884109
537823,7,1,8,1.371436,103.897589
537824,0,6,6,1.37126,103.897606
537825,15,1,16,1.37133,103.897662
537826,1,3,4,1.37133,103.897662
537827,1,0,1,1.37136,103.897522
537828,1,6,7,1.371205,103.89778
537829,2,2,4,1.371047,103.897767
537830,11,2,13,1.371015,103.897786
537831,4,6,10,1.371118,103.897866
537832,10,8,18,1.371047,103.897919
537833,26,0,26,1.370944,103.897859
537834,4,0,4,1.370944,103.897859
537835,3,1,4,1.370928,103.898051
537836,4,19,23,1.370954,103.898008
537837,6,38,44,1.370879,103.897925
537839,3,0,3,1.344713,103.884002
537846,634,9,643,1.345366,103.882526
537847,14,234,248,1.345737,103.882232
537848,3,0,3,1.370771,103.898141
537849,1,0,1,1.371145,103.897699
537850,11,42,53,1.345761,103.882037
537851,3,0,3,1.345718,103.881923
537852,30,14,44,1.345801,103.88213
537853,1,9,10,1.345394,103.882573
537854,6,5,11,1.345757,103.88225
537855,0,3,3,1.345778,103.882074
537856,0,5,5,1.345776,103.882294
537857,0,5,5,1.345558,103.882617
537858,8,20,28,1.345814,103.882382
537859,1,7,8,1.345588,103.882649
537860,0,2,2,1.344735,103.884043
537861,1,5,6,1.345627,103.882706
537862,0,6,6,1.345658,103.882736
537863,0,16,16,1.345681,103.88277
537864,0,6,6,1.345757,103.882894
537865,2,53,55,1.345958,103.882623
537866,1,2,3,1.345533,103.882569
537867,3,0,3,1.345784,103.882943
537868,0,1,1,1.345742,103.881978
537869,1,0,1,1.345842,103.883018
537870,0,1,1,1.346068,103.882988
537871,0,2,2,1.345851,103.88247
537874,16,26,42,1.346277,103.883338
537875,1,24,25,1.346168,103.883171
537876,1,3,4,1.346316,103.88364
537877,7,0,7,1.346437,103.884196
537878,0,3,3,1.34604,103.88291
537879,0,1,1,1.34589,103.883065
537880,3,0,3,1.346464,103.884245
537881,3,0,3,1.34653,103.884269
537882,3,2,5,1.346684,103.884299
537884,0,1,1,1.346501,103.884254
537885,4,0,4,1.346911,103.884379
537886,4,0,4,1.346985,103.884409
537887,22,13,35,1.347019,103.884425
537888,2,0,2,1.345944,103.883103
537889,3,0,3,1.346606,103.884282
537890,1,0,1,1.346838,103.884349
537891,9,1,10,1.347288,103.884552
537892,12,1,13,1.347355,103.884584
537893,1,0,1,1.347221,103.88452
537894,15,1,16,1.34749,103.884647
537895,0,2,2,1.347086,103.884457
537896,0,3,3,1.347153,103.884488
537898,0,1,1,1.347423,103.884616
537899,4,0,4,1.347135,103.88452
537900,12,0,12,1.347692,103.884743
537901,5,4,9,1.347231,103.884566
537902,10,2,12,1.347759,103.884774
537903,4,1,5,1.347326,103.88459
537904,2,0,2,1.346941,103.884448
537907,177,2,179,1.34778,103.884804
537908,5,0,5,1.347939,103.88486
537909,4,4,8,1.347884,103.884848
537910,9,0,9,1.347983,103.884881
537911,0,2,2,1.347827,103.884806
537912,0,3,3,1.347557,103.884679
537913,0,2,2,1.348072,103.884924
537914,5,2,7,1.34834,103.885053
537915,0,1,1,1.347625,103.884711
537916,1,1,2,1.348251,103.88501
537917,13,4,17,1.348947,103.885041
537918,3,6,9,1.346359,103.884028
537926,0,4,4,1.355514,103.887138
537927,1,9,10,1.355494,103.887138
537928,3,0,3,1.348162,103.884967
537930,15,2,17,1.35556,103.887229
537931,4,0,4,1.35554,103.887229
537932,9,0,9,1.355592,103.887289
537933,1,3,4,1.355572,103.887289
537934,1,0,1,1.348429,103.885096
537935,21,0,21,1.355603,103.88735
537936,3,0,3,1.355529,103.887168
537937,7,0,7,1.355634,103.88741
537938,1,0,1,1.355623,103.88735
537941,3,2,5,1.355747,103.887591
537944,2,0,2,1.348439,103.885106
537945,8,0,8,1.35581,103.887712
537946,1,0,1,1.355665,103.88747
537947,3,0,3,1.355654,103.88741
537948,0,3,3,1.355841,103.887773
537949,1,0,1,1.35579,103.887712
537950,1,0,1,1.355872,103.887833
537951,5,4,9,1.355903,103.887893
537952,2,0,2,1.355759,103.887652
537953,1,0,1,1.355852,103.887833
537955,2,0,2,1.355883,103.887893
537956,1,0,1,1.355934,103.887954
537957,4,0,4,1.355997,103.888075
537958,2,2,4,1.355977,103.888075
537959,45,0,45,1.356028,103.888135
537960,0,2,2,1.355966,103.888014
537961,1,9,10,1.356075,103.88815
537962,23,0,23,1.356065,103.88816
537971,0,16,16,1.345901,103.874111
537972,98,125,223,1.34597,103.874081
537973,7,1,8,1.345905,103.874081
537975,1,8,9,1.34592,103.873961
537977,3,0,3,1.355821,103.887773
537978,1,5,6,1.34594,103.873732
537981,1007,142,1149,1.380516,103.879259
537983,5,129,134,1.382299,103.879069
537984,1943,167,2110,1.382342,103.880844
537987,10,3,13,1.345438,103.873529
537988,21,0,21,1.345178,103.8735
537989,23,1,24,1.344938,103.873304
537990,20,0,20,1.345041,103.873527
537991,4,1,5,1.344967,103.873149
537992,0,1,1,1.355946,103.888014
537993,73,2,75,1.344996,103.872993
537994,4,0,4,1.34483,103.873452
537995,17,0,17,1.345035,103.872827
537996,9,7,16,1.345034,103.872826
537997,5,0,5,1.34475,103.873445
537998,24,1,25,1.344883,103.872608
537999,5,0,5,1.344807,103.872717
538000,1,0,1,1.344869,103.873456
538002,2,0,2,1.356008,103.888135
538003,0,3,3,1.345935,103.873842
538004,2,7,9,1.344748,103.873297
538005,0,1,1,1.34481,103.872894
538006,2,2,4,1.344711,103.873312
538008,1,0,1,1.344433,103.873414
538009,10,0,10,1.344364,103.873396
538011,11,2,13,1.344924,103.873382
538012,6,2,8,1.344621,103.873257
538013,7,2,9,1.344632,103.873413
538014,38,0,38,1.299509,103.837
538018,4,31,35,1.343956,103.87424
538019,10,0,10,1.343956,103.87424
538021,1,0,1,1.344354,103.873406
538024,0,10,10,1.343945,103.874162
538025,6,92,98,1.343959,103.874063
538026,111,6,117,1.343958,103.874177
538027,7,0,7,1.344027,103.873869
538028,20,2,22,1.343963,103.874125
538029,3,0,3,1.344513,103.873421
538030,0,1,1,1.343956,103.87424
538031,4,0,4,1.344219,103.873872
538033,41,0,41,1.344302,103.87388
538034,1,7,8,1.344036,103.873904
538036,17,0,17,1.34412,103.87389
538037,32,2,34,1.344515,103.873896
538038,1,0,1,1.343973,103.874021
538040,5,7,12,1.34429,103.873918
538042,3,0,3,1.344143,103.873841
538043,5,0,5,1.344792,103.873936
538045,4,0,4,1.344889,103.873965
538046,2,0,2,1.344782,103.873074
538047,52,3,55,1.344972,103.87397
538048,4,10,14,1.34463,103.873975
538049,0,1,1,1.344205,103.873904
538050,11,0,11,1.344715,103.87399
538051,6,9,15,1.345157,103.874022
538052,6,0,6,1.3448,103.874004
538053,2,2,4,1.344885,103.874018
538054,60,1,61,1.34497,103.874032
538055,0,1,1,1.345081,103.873998
538056,30,3,33,1.34514,103.874061
538057,1,7,8,1.345225,103.874075
538058,3,1,4,1.34531,103.874089
538059,16,0,16,1.345343,103.874086
538060,2,1,3,1.344375,103.873933
538061,1,0,1,1.345055,103.874046
538063,2,0,2,1.344545,103.873961
538065,1,0,1,1.345489,103.874112
538066,19,1,20,1.345778,103.874185
538067,12,7,19,1.345929,103.874221
538068,0,13,13,1.346069,103.874246
538077,0,36,36,1.344802,103.883175
538078,6,9,15,1.345018,103.883616
538079,97,0,97,1.344847,103.883232
538082,13,1,14,1.345082,103.883717
538083,1,1,2,1.345761,103.874145
538084,37,0,37,1.345122,103.883762
538085,0,5,5,1.344959,103.883384
538086,8,4,12,1.345145,103.883799
538087,122,2,124,1.344988,103.883428
538088,4,0,4,1.345013,103.883457
538089,32,9,41,1.345043,103.883509
538090,3,0,3,1.345421,103.874104
538091,8,12,20,1.345108,103.883618
538092,306,0,306,1.345136,103.88368
538093,2,0,2,1.344914,103.883336
538094,24,0,24,1.34522,103.883804
538095,1,1,2,1.345187,103.883742
538104,97,1,98,1.344254,103.883954
538105,1,0,1,1.345778,103.874185
538106,8,0,8,1.344394,103.883882
538107,1,1,2,1.345299,103.883865
538109,3,0,3,1.345069,103.883547
538112,2,0,2,1.344487,103.883835
538113,9,0,9,1.344929,103.88357
538114,2,8,10,1.345006,103.883526
538123,108,98,206,1.346539,103.879118
538124,5,4,9,1.346532,103.879039
538125,10,0,10,1.346519,103.878881
538126,0,3,3,1.344624,103.88376
538127,0,14,14,1.346499,103.87876
538128,187,0,187,1.346482,103.878692
538129,0,1,1,1.3443,103.88393
538130,4,1,5,1.346393,103.878425
538131,7,1,8,1.346296,103.878434
538132,2,2,4,1.346198,103.878443
538133,4,0,4,1.34646,103.878399
538134,2,4,6,1.3461,103.878453
538135,49,2,51,1.346429,103.878402
538136,2,0,2,1.344842,103.883624
538137,8,1,9,1.346367,103.878408
538138,2,1,3,1.346497,103.878806
538139,2,0,2,1.346002,103.878462
538140,0,1,1,1.346442,103.878421
538141,1,1,2,1.346304,103.878413
538142,3,0,3,1.345905,103.878471
538143,1,1,2,1.346242,103.878419
538144,1,1,2,1.346118,103.878431
538145,3,0,3,1.34618,103.878425
538148,1,5,6,1.345807,103.87846
538157,6,162,168,1.346179,103.881583
538158,1,141,142,1.346056,103.88145
538159,4,33,37,1.346184,103.881583
538160,1,3,4,1.346082,103.881483
538161,5,0,5,1.346082,103.881483
538162,0,43,43,1.346484,103.881493
538163,23,6,29,1.346133,103.88155
538164,6,132,138,1.346763,103.881402
538165,0,5,5,1.346184,103.881603
538166,1,112,113,1.346893,103.881367
538168,2,0,2,1.346056,103.878437
538169,0,1,1,1.345817,103.87847
538170,0,2,2,1.346368,103.88155
538171,1,1,2,1.346533,103.881497
538172,9,0,9,1.346697,103.881443
538173,0,4,4,1.34678,103.881417
538174,0,1,1,1.346451,103.881523
538175,0,12,12,1.346903,103.881377
538176,7,401,408,1.346911,103.881413
538177,1,0,1,1.346862,103.88139
538178,8,0,8,1.346641,103.881442
538179,3,0,3,1.345994,103.878443
538180,5,0,5,1.347026,103.881178
538182,6,0,6,1.34708,103.881253
538183,10,16,26,1.346932,103.881496
538185,1,0,1,1.346816,103.881385
538186,6,0,6,1.346927,103.88148
538187,6,2,8,1.346912,103.881431
538189,1,4,5,1.346905,103.881397
538190,9,0,9,1.346895,103.881394
538191,3,16,19,1.347097,103.881944
538192,1,3,4,1.347395,103.881724
538193,23,6,29,1.346886,103.88134
538194,2,75,77,1.359479,103.889184
538195,15,0,15,1.35954,103.889315
538196,3,0,3,1.347046,103.881095
538197,21,11,32,1.359593,103.889482
538199,4,0,4,1.359651,103.889693
538200,0,4,4,1.359675,103.889817
538201,13,1,14,1.359713,103.889935
538203,1,0,1,1.346925,103.88147
538204,35,0,35,1.359815,103.890212
538205,0,1,1,1.359784,103.890136
538206,123,0,123,1.359845,103.890355
538207,0,1,1,1.359829,103.890292
538208,4,0,4,1.359909,103.89057
538210,0,3,3,1.359559,103.889375
538211,0,75,75,1.360015,103.890962
538212,198,0,198,1.359368,103.88911
538215,26,1,27,1.359467,103.889393
538218,0,1,1,1.359883,103.890472
538220,3,0,3,1.359974,103.890807
538221,3,0,3,1.35949,103.890172
538222,10,0,10,1.359294,103.890217
538223,3,0,3,1.359414,103.890185
538224,9,1,10,1.358968,103.890285
538226,2,0,2,1.346615,103.88147
538227,0,2,2,1.359092,103.889661
538228,2,20,22,1.358916,103.889859
538229,0,4,4,1.358851,103.889876
538232,0,1,1,1.359139,103.889733
538233,2,0,2,1.358985,103.889811
538234,1,0,1,1.359741,103.890227
538235,0,3,3,1.359216,103.890236
538239,21,0,21,1.359852,103.890681
538240,2,0,2,1.35975,103.890276
538241,7,63,70,1.359905,103.890886
538242,9,0,9,1.358774,103.889788
538243,1,1,2,1.359882,103.890777
538244,46,0,46,1.359207,103.890474
538245,1,3,4,1.359247,103.890573
538246,0,6,6,1.359262,103.890668
538247,0,2,2,1.359182,103.890366
538248,2,17,19,1.359297,103.890926
538249,26,2,28,1.358717,103.889818
538250,0,7,7,1.3591,103.890548
538252,2,2,4,1.35911,103.890599
538253,25,3,28,1.359127,103.890687
538254,8,1,9,1.359152,103.890789
538255,82,2,84,1.359162,103.890867
538256,28,24,52,1.359171,103.89096
538264,0,8,8,1.359565,103.889721
538265,0,5,5,1.359507,103.889832
538267,0,1,1,1.359772,103.890362
538268,1,6,7,1.358725,103.890311
538269,3,15,18,1.359021,103.889691
538270,0,5,5,1.358929,103.889727
538284,0,4,4,1.34428,103.884059
538285,1,10,11,1.344004,103.88364
538286,7,0,7,1.344303,103.884123
538287,1,0,1,1.358784,103.890322
538288,2,0,2,1.359293,103.890841
538289,4,1,5,1.344053,103.883759
538291,4,0,4,1.344081,103.883816
538292,2,2,4,1.344366,103.884284
538293,2,1,3,1.359787,103.89043
538295,1,0,1,1.34403,103.883703
538297,0,1,1,1.344116,103.883919
538298,10,0,10,1.344189,103.88405
538299,4,0,4,1.344207,103.884108
538300,3,0,3,1.344106,103.883871
538301,1,0,1,1.344165,103.884013
538302,64,0,64,1.344274,103.884248
538303,3,0,3,1.344231,103.884154
538305,34,0,34,1.344359,103.884396
538314,2,3,5,1.354337,103.880121
538315,2,0,2,1.344321,103.884171
538316,6,0,6,1.354234,103.880182
538317,1,0,1,1.344252,103.884193
538318,10,1,11,1.354098,103.880264
538319,6,0,6,1.35403,103.880304
538321,5,1,6,1.353879,103.880502
538325,3,0,3,1.344294,103.884295
538326,24,0,24,1.354011,103.880766
538327,3,0,3,1.353978,103.880704
538328,26,4,30,1.353825,103.880426
538330,2,5,7,1.353739,103.880441
538331,0,3,3,1.353893,103.880385
538332,0,1,1,1.354166,103.880223
538335,2,0,2,1.354303,103.880142
538336,13,2,15,1.35363,103.8805
538337,0,2,2,1.353645,103.880546
538338,12,0,12,1.353602,103.880519
538339,2,0,2,1.353556,103.880596
538340,0,1,1,1.353698,103.880468
538342,1,0,1,1.353578,103.880536
538343,2,1,3,1.35378,103.880471
538344,1,1,2,1.353466,103.880645
538353,6,91,97,1.350653,103.877035
538354,58,72,130,1.350649,103.87714
538355,0,6,6,1.350705,103.877097
538356,4,207,211,1.350701,103.877216
538358,0,1,1,1.353546,103.880556
538359,0,1,1,1.35075,103.877263
538360,1,8,9,1.350802,103.877317
538361,133,0,133,1.350834,103.877249
538362,1,4,5,1.350844,103.877366
538363,0,6,6,1.350873,103.877298
538364,0,3,3,1.353296,103.880735
538365,0,2,2,1.353526,103.880574
538366,0,4,4,1.350923,103.877472
538368,21,4,25,1.350967,103.877522
538369,1,7,8,1.351007,103.877443
538370,0,2,2,1.350914,103.877337
538371,1,1,2,1.350999,103.877569
538372,2,0,2,1.351061,103.877497
538373,3,7,10,1.351125,103.877569
538374,2,3,5,1.351073,103.877659
538375,0,1,1,1.350787,103.877198
538376,0,2,2,1.351034,103.877624
538377,0,11,11,1.351211,103.877681
538378,4,3,7,1.35117,103.877748
538380,0,3,3,1.350887,103.877421
538381,1,5,6,1.351299,103.877789
538382,2,0,2,1.351134,103.877699
538383,1,459,460,1.351347,103.877848
538384,5,1,6,1.35131,103.877909
538385,1,1,2,1.351258,103.877852
538386,0,1,1,1.351166,103.877626
538387,10,914,924,1.351436,103.877942
538388,57,154,211,1.351407,103.878006
538389,14,1071,1085,1.351444,103.878059
538398,5,16,21,1.340158,103.884333
538399,1,16,17,1.340116,103.884256
538401,5,1,6,1.340028,103.884096
538403,1199,45,1244,1.340275,103.882831
538404,0,18,18,1.339701,103.883555
538406,2,0,2,1.351391,103.877883
538407,8,68,76,1.339567,103.883333
538409,6,0,6,1.33948,103.883205
538410,40,10,50,1.339428,103.883134
538411,4,8,12,1.339383,103.883068
538412,15,212,227,1.339336,103.882991
538413,5,0,5,1.339298,103.882932
538414,1,0,1,1.351353,103.877953
538415,1,0,1,1.339255,103.882859
538416,1,87,88,1.339149,103.882431
538420,780,1,781,1.338625,103.882832
538421,323,0,323,1.338568,103.882905
538422,559,0,559,1.338498,103.882957
538423,14,472,486,1.344274,103.878356
538424,6,29,35,1.344269,103.878379
538425,8,3,11,1.344314,103.878329
538426,4,0,4,1.344305,103.878355
538427,19,0,19,1.344396,103.878276
538428,1,2,3,1.351222,103.877806
538429,1,3,4,1.344477,103.878223
538430,8,0,8,1.34445,103.878261
538432,1,4,5,1.344522,103.878214
538433,3,1,4,1.344586,103.878124
538434,9,1,10,1.344594,103.878167
538435,3,0,3,1.344377,103.878308
538436,9,2,11,1.344666,103.87812
538437,2,1,3,1.344665,103.878086
538438,12,0,12,1.344704,103.878112
538439,13,11,24,1.344651,103.877902
538440,1,1,2,1.339612,103.883403
538441,1,2,3,1.344685,103.878061
538442,20,1,21,1.344796,103.878061
538443,2,154,156,1.344503,103.877836
538444,12,2,14,1.34493,103.877979
538445,15,118,133,1.344492,103.877783
538446,70,1,71,1.344977,103.877978
538447,4,6,10,1.344515,103.877794
538448,50,0,50,1.345071,103.877978
538449,1,12,13,1.344561,103.877814
538450,0,1,1,1.339196,103.882502
538451,0,4,4,1.344607,103.877835
538452,0,2,2,1.344753,103.878086
538453,1,11,12,1.344653,103.877856
538454,26,3,29,1.345358,103.877973
538455,0,2,2,1.345259,103.877976
538456,3,4,7,1.345465,103.87796
538457,11,12,23,1.344745,103.877897
538458,10,13,23,1.345518,103.877953
538459,1,2,3,1.344469,103.877793
538460,7,8,15,1.344837,103.877938
538461,3,2,5,1.344883,103.877959
538462,252,6,258,1.344925,103.877959
538463,2,5,7,1.344967,103.877958
538464,5,8,13,1.34505,103.877958
538465,2,19,21,1.345407,103.877943
538466,12,12,24,1.345465,103.877936
538467,18,7,25,1.3455,103.877931
538469,5,10,15,1.345542,103.87795
538470,54,1,55,1.345535,103.87796
538473,490,825,1315,1.376686,103.901699
538479,3,18,21,1.344677,103.88132
538480,1,15,16,1.34466,103.88141
538482,1,0,1,1.345165,103.877977
538483,0,2,2,1.344699,103.877876
538484,6,0,6,1.344772,103.881318
538486,1,0,1,1.344697,103.88138
538488,1,2,3,1.344791,103.877918
538489,1,2,3,1.344921,103.881196
538490,0,1,1,1.344846,103.881257
538493,4,2,6,1.344999,103.881052
538494,0,8,8,1.345144,103.881012
538496,0,3,3,1.344935,103.881105
538497,2,4,6,1.345428,103.880998
538498,2,2,4,1.345428,103.880998
538499,2,2,4,1.345428,103.880998
538500,4,2,6,1.345428,103.880998
538501,5,2,7,1.345428,103.880998
538502,18,1,19,1.345428,103.880998
538503,45,5,50,1.345428,103.880998
538504,0,2,2,1.344774,103.881239
538506,64,0,64,1.345746,103.880659
538507,3,244,247,1.345592,103.881223
538508,1,21,22,1.345592,103.881223
538509,0,24,24,1.345592,103.881223
538510,0,13,13,1.345592,103.881223
538511,12,21,33,1.345592,103.881223
538512,1,23,24,1.345592,103.881223
538513,3,23,26,1.345592,103.881223
538514,0,18,18,1.345592,103.881223
538515,3,37,40,1.345592,103.881223
538516,8,694,702,1.345592,103.881223
538526,173,735,908,1.344107,103.878318
538527,16,0,16,1.344881,103.879198
538529,2,0,2,1.345428,103.880998
538530,16,0,16,1.344864,103.87917
538531,28,6,34,1.344864,103.87917
538533,5,0,5,1.344833,103.879126
538534,14,0,14,1.344833,103.879126
538535,4,0,4,1.344833,103.879126
538536,13,0,13,1.344818,103.879085
538537,11,0,11,1.344817,103.879084
538538,2,5,7,1.344817,103.879084
538539,1,7,8,1.344503,103.878939
538540,10,3,13,1.344594,103.878829
538541,19,15,34,1.344593,103.878828
538543,6,1,7,1.344593,103.878828
538544,10,1,11,1.344435,103.878984
538545,18,0,18,1.344623,103.878858
538546,5,0,5,1.344622,103.878857
538547,1,0,1,1.344964,103.88107
538548,2,0,2,1.344881,103.879198
538549,3,0,3,1.345104,103.880956
538550,12,42,54,1.344651,103.878904
538551,17,0,17,1.34465,103.878903
538552,15,0,15,1.34465,103.878903
538553,20,1,21,1.34465,103.878903
538554,7,27,34,1.344164,103.879165
538555,5,0,5,1.344673,103.878933
538557,4,0,4,1.344672,103.878932
538558,4,0,4,1.344672,103.878932
538559,1,0,1,1.344622,103.878857
538560,2,30,32,1.344695,103.878961
538561,6,0,6,1.344694,103.87896
538562,3,0,3,1.3443,103.879075
538563,138,0,138,1.344694,103.87896
538564,0,1,1,1.344232,103.87914
538565,18,2,20,1.345091,103.87854
538566,44,0,44,1.345085,103.878536
538567,1,0,1,1.3443,103.879095
538568,141,0,141,1.345094,103.878531
538570,12,0,12,1.345317,103.878477
538571,15,0,15,1.345295,103.878449
538572,5,1,6,1.345284,103.878474
538573,33,2,35,1.345292,103.878441
538574,1,14,15,1.344526,103.878956
538575,5,0,5,1.345388,103.878475
538576,8,0,8,1.345395,103.878499
538578,5,14,19,1.345393,103.8785
538579,1,20,21,1.344827,103.879378
538580,11,1,12,1.345456,103.878555
538581,1,0,1,1.345092,103.878534
538584,6,0,6,1.344757,103.879431
538585,0,4,4,1.345552,103.878583
538586,1,3,4,1.345544,103.878556
538587,6,0,6,1.345543,103.878584
538588,0,1,1,1.345454,103.878549
538589,2,24,26,1.344616,103.879538
538590,12,0,12,1.345556,103.87868
538591,52,0,52,1.345554,103.878672
538593,5,0,5,1.345549,103.878651
538594,92,0,92,1.344476,103.879645
538596,6,0,6,1.345655,103.878681
538597,15,13,28,1.345652,103.878708
538599,10,0,10,1.344546,103.879612
538600,8,2,10,1.345078,103.879433
538601,6,0,6,1.345076,103.879432
538602,16,0,16,1.345076,103.879432
538604,4,2,6,1.34512,103.879489
538605,22,0,22,1.345119,103.879488
538607,2,0,2,1.344622,103.878857
538610,0,1,1,1.345515,103.878548
538611,5,15,20,1.344827,103.879424
538612,25,0,25,1.345171,103.879564
538613,2,0,2,1.344757,103.879451
538614,1,0,1,1.345145,103.879524
538615,2,1,3,1.344694,103.87896
538616,1,0,1,1.34517,103.879563
538617,4,0,4,1.345136,103.879508
538618,19,1,20,1.345158,103.879543
538619,2,0,2,1.34517,103.879563
538620,1,0,1,1.345136,103.879508
538621,18,1,19,1.344615,103.879557
538629,7,54,61,1.343574,103.881302
538630,6,179,185,1.343556,103.881305
538631,12,1,13,1.343592,103.881326
538632,0,32,32,1.343577,103.881332
538633,42,11,53,1.343629,103.881373
538634,30,4,34,1.343618,103.881384
538635,3,0,3,1.345137,103.879509
538636,6,3,9,1.343659,103.881437
538637,27,5,32,1.343701,103.881466
538638,15,0,15,1.3437,103.88149
538639,3,0,3,1.343665,103.881419
538640,1,20,21,1.34374,103.881542
538641,0,1,1,1.345157,103.879542
538642,4,0,4,1.34381,103.881606
538643,9,0,9,1.343822,103.881647
538644,0,2,2,1.345157,103.879542
538645,39,7,46,1.343863,103.8817
538655,2,15,17,1.344361,103.881057
538656,0,24,24,1.344363,103.881076
538657,72,0,72,1.344381,103.881042
538658,6,1,7,1.344386,103.881058
538659,0,2,2,1.343847,103.881653
538660,0,4,4,1.344431,103.881024
538662,1,1,2,1.344422,103.881011
538664,40,2,42,1.34452,103.880955
538665,9,0,9,1.344542,103.880918
538667,1,0,1,1.343781,103.881595
538668,3,1,4,1.344623,103.880855
538669,4,0,4,1.344654,103.880851
538670,1,1,2,1.344475,103.880989
538671,1,0,1,1.34461,103.880886
538673,1,0,1,1.344699,103.880817
538674,10,0,10,1.344734,103.880772
538683,837,333,1170,1.374267,103.8785
538684,261,10,271,1.374253,103.878099
538685,893,2505,3398,1.374387,103.877965
538686,892,1291,2183,1.374443,103.877714
538687,1520,422,1942,1.374174,103.877683
538688,1588,168,1756,1.374141,103.877945
538692,4040,623,4663,1.376022,103.879482
538698,557,639,1196,1.375722,103.888738
538699,14,300,314,1.376099,103.888752
538719,594,307,901,1.379502,103.888221
538720,218,3416,3634,1.377792,103.885447
538728,187,1825,2012,1.355771,103.891521
538738,211,2486,2697,1.357854,103.885855
538746,7,8,15,1.353047,103.879984
538747,5,2,7,1.352974,103.88007
538748,1,1,2,1.344663,103.880824
538749,743,61,804,1.353015,103.878484
538750,488,191,679,1.352972,103.878345
538751,1254,559,1813,1.351777,103.881277
538752,560,896,1456,1.299509,103.837
538753,428,918,1346,1.351768,103.880987
538754,1340,1364,2704,1.299509,103.837
538755,482,56,538,1.351777,103.881277
538756,416,32,448,1.351777,103.881277
538757,77,3,80,1.371037,103.893106
538758,2095,38671,40766,1.371908,103.89199
538766,3654,34959,38613,1.372629,103.893938
538767,107,1673,1780,1.371673,103.894345
538768,19,2541,2560,1.376962,103.898519
538775,94,6747,6841,1.374278,103.884815
538776,730,324,1054,1.375014,103.882752
538784,273,2781,3054,1.371069,103.883029
538785,318,98,416,1.373518,103.888992
538786,397,4596,4993,1.373864,103.889614
538787,240,1970,2210,1.37819,103.894746
538789,310,62,372,1.372635,103.883077
538790,24,552,576,1.371268,103.885489
538791,117,349,466,1.374516,103.897954
538792,56,1320,1376,1.37501,103.898161
538793,561,1259,1820,1.374325,103.888008
538797,4,811,815,1.36474,103.895024
538798,5,16,21,1.363294,103.895576
538799,10,82,92,1.354566,103.942332
538800,2069,606,2675,1.368555,103.899124
538801,196,3233,3429,1.368594,103.899638
538802,1185,131,1316,1.368849,103.899705
538803,656,190,846,1.369601,103.89967
538804,1639,2242,3881,1.372953,103.900304
538805,1503,646,2149,1.373681,103.90017
538806,85,6,91,1.373833,103.900548
538807,649,478,1127,1.374193,103.900746
538808,122,658,780,1.374143,103.891883
538817,7,50,57,1.365876,103.895481
538818,8,377,385,1.365359,103.895731
538819,2,3,5,1.365875,103.895598
538820,5,0,5,1.365746,103.895532
538829,1812,3374,5186,1.370032,103.889024
538830,153,73,226,1.370036,103.886994
538832,144,280,424,1.370934,103.888035
538840,121,2558,2679,1.364614,103.892336
538841,8,4161,4169,1.358851,103.89294
538842,2,5,7,1.358757,103.892918
538843,0,73,73,1.358571,103.892876
538844,11,458,469,1.358871,103.892187
538845,4,1,5,1.361929,103.892849
538846,8,1322,1330,1.349386,103.889993
538847,0,1439,1439,1.348581,103.889955
538848,6,1249,1255,1.299509,103.837
538849,4,411,415,1.299509,103.837
538856,195,280,475,1.369468,103.886035
538858,181,1217,1398,1.368567,103.884308
538866,8,4,12,1.359833,103.888802
538867,3,127,130,1.359796,103.888825
538868,7,54,61,1.359758,103.888827
538869,3,54,57,1.359662,103.888855
538870,7,321,328,1.359596,103.888861
538871,0,188,188,1.359243,103.889048
538872,3,595,598,1.35916,103.889107
538873,3,81,84,1.358941,103.889184
538874,1,590,591,1.358879,103.889219
538875,13,168,181,1.358766,103.889266
538876,6,250,256,1.35869,103.889296
538877,3,138,141,1.3586,103.889344
538878,0,98,98,1.358524,103.889378
538879,25,29,54,1.358395,103.889446
538880,3,142,145,1.35831,103.889476
538881,0,86,86,1.358204,103.889512
538882,137,1667,1804,1.357861,103.889918
538884,221,2516,2737,1.356754,103.890092
538885,53,204,257,1.360329,103.888267
538886,6,59,65,1.348946,103.887279
538900,512,175,687,1.349877,103.887607
538901,4,535,539,1.352417,103.886004
538905,0,9,9,1.366176,103.893697
538906,7,0,7,1.365863,103.893464
538907,3,0,3,1.343738,103.881513
538908,11,2,13,1.365828,103.893445
538909,11,1,12,1.365952,103.893551
538910,9,1,10,1.365774,103.893398
538911,1,1,2,1.352888,103.880153
538912,0,8,8,1.365716,103.89336
538913,18,2,20,1.365697,103.893368
538915,6,2,8,1.365562,103.893265
538916,2,0,2,1.365802,103.893454
538917,6,0,6,1.365573,103.893236
538918,1,0,1,1.344744,103.880782
538919,8,1,9,1.365557,103.893224
538920,5,0,5,1.365443,103.893202
538921,1,1,2,1.365601,103.893253
538922,24,0,24,1.365386,103.893078
538924,0,10,10,1.365297,103.89302
538925,1,0,1,1.365482,103.893221
538926,5,3,8,1.365167,103.892945
538927,1,0,1,1.365244,103.893001
538928,30,17,47,1.365081,103.892875
538929,0,2,2,1.365448,103.893133
538930,5,22,27,1.364939,103.892764
538939,8,4,12,1.365091,103.893054
538940,6,24,30,1.365119,103.892986
538941,0,1,1,1.365119,103.892905
538942,2,0,2,1.365005,103.892814
538943,34,0,34,1.364864,103.893383
538944,1,2,3,1.366101,103.893649
538945,0,6,6,1.364953,103.8937
538946,2,1,3,1.365033,103.893109
538947,6,0,6,1.365085,103.893738
538949,2,3,5,1.36512,103.89377
538950,42,5,47,1.364863,103.893356
538952,86,3,89,1.365143,103.893801
538954,22,5,27,1.36529,103.893871
538955,12,5,17,1.364702,103.893592
538956,8,7,15,1.365437,103.89394
538957,9,6,15,1.365584,103.89401
538958,7,1,8,1.365731,103.89408
538959,3,4,7,1.365878,103.894149
538960,16,4,20,1.36573,103.894079
538961,3,23,26,1.365993,103.894189
538962,13,3,16,1.364864,103.893383
538964,0,5,5,1.299509,103.837
538968,4,0,4,1.344724,103.874433
538969,7,0,7,1.344202,103.874207
538970,1,1,2,1.36509,103.893027
538971,3,5,8,1.344357,103.874516
538972,10,5,15,1.344422,103.874693
538974,19,2,21,1.34455,103.875048
538975,15,3,18,1.344614,103.875225
538976,274,148,422,1.344665,103.875672
538977,181,2,183,1.344678,103.875402
538978,44,48,92,1.344743,103.875579
538980,1,10,11,1.344807,103.875756
538982,573,91,664,1.344648,103.875668
538995,1,0,1,1.365015,103.893164
539051,36,20,56,1.34385,103.871474
539053,0,4,4,1.343919,103.871467
539054,2,0,2,1.344293,103.874339
539055,0,5,5,1.343984,103.871459
539056,20,2,22,1.344568,103.871815
539059,5,17,22,1.344368,103.872263
539060,457,50,507,1.344474,103.872608
539061,5,0,5,1.344838,103.871853
539062,2,9,11,1.344837,103.871852
539063,0,11,11,1.344838,103.871853
539065,0,1,1,1.36344,103.902885
539066,1,2,3,1.364976,103.893191
539067,1,27,28,1.343794,103.871399
539068,49,44,93,1.345169,103.871952
539069,2,1,3,1.344837,103.871852
539070,6,1,7,1.343911,103.8714
539071,51,3,54,1.345433,103.87203
539072,4,4,8,1.34406,103.871373
539073,2,1,3,1.343912,103.871401
539074,1,1,2,1.343953,103.871455
539075,1,0,1,1.344837,103.871852
539076,0,1,1,1.34415,103.871391
539077,6,1,7,1.344296,103.871472
539078,2,7,9,1.344376,103.871506
539079,26,4,30,1.344375,103.871505
539080,39,6,45,1.344455,103.87154
539081,0,4,4,1.344534,103.871573
539082,1,0,1,1.344297,103.871473
539083,2,0,2,1.344151,103.871392
539084,7,2,9,1.344775,103.871636
539085,5,0,5,1.344809,103.87165
539086,4,0,4,1.344843,103.871664
539087,52,1,53,1.344912,103.871692
539088,7,0,7,1.34498,103.87172
539089,2,2,4,1.345048,103.871748
539090,8,0,8,1.345117,103.871776
539091,5,1,6,1.345185,103.871804
539092,0,5,5,1.345253,103.871832
539093,2,2,4,1.345321,103.871859
539094,5,0,5,1.34539,103.871887
539095,1,1,2,1.344693,103.87164
539096,2,0,2,1.345458,103.871915
539097,25,1,26,1.345595,103.871971
539098,2,0,2,1.345526,103.871943
539099,10,0,10,1.345731,103.872027
539100,1,0,1,1.344614,103.871606
539101,2,94,96,1.345868,103.872083
539102,101,14,115,1.344464,103.872598
539110,10,302,312,1.340032,103.894387
539112,18,43,61,1.340102,103.894234
539113,5,0,5,1.340639,103.894447
539114,0,4,4,1.340166,103.894047
539115,2,1,3,1.344059,103.871372
539116,2,44,46,1.340232,103.893899
539117,1,2,3,1.340092,103.894665
539118,1,1,2,1.345663,103.871999
539119,1,2,3,1.340006,103.894844
539123,4,3,7,1.340983,103.894342
539124,54,2,56,1.339422,103.895763
539125,4,1,5,1.340927,103.894495
539126,12,1,13,1.340827,103.89473
539127,3,4,7,1.340442,103.895914
539128,2,4,6,1.340779,103.894926
539129,3,2,5,1.340455,103.89574
539130,0,3,3,1.339864,103.895153
539131,3,0,3,1.340705,103.895317
539132,1,5,6,1.340649,103.895579
539133,4,2,6,1.34056,103.895247
539134,17,14,31,1.340619,103.895953
539135,1,9,10,1.340634,103.896358
539136,1,13,14,1.340875,103.897237
539137,0,6,6,1.340691,103.896719
539138,1,14,15,1.340951,103.897399
539139,26,49,75,1.341062,103.897651
539140,2,175,177,1.340831,103.897601
539141,0,8,8,1.340788,103.897141
539142,19,21,40,1.340646,103.896809
539143,3,67,70,1.340255,103.89682
539144,2,20,22,1.339959,103.896734
539145,1,16,17,1.339569,103.896452
539146,18,38,56,1.339338,103.896251
539147,44,261,305,1.33907,103.89589
539148,2,59,61,1.339216,103.895725
539149,0,77,77,1.339331,103.895586
539150,2,261,263,1.339516,103.89532
539151,11,4,15,1.339559,103.895229
539152,8,1047,1055,1.33971,103.895032
539153,1,18,19,1.339779,103.894854
539162,2,190,192,1.343041,103.892612
539163,6,9,15,1.34298,103.89255
539164,7,3,10,1.342724,103.892568
539165,6,205,211,1.342534,103.892626
539166,3,148,151,1.342247,103.892735
539167,1,14,15,1.342405,103.892848
539168,33,10,43,1.341932,103.892856
539169,16,7,23,1.342228,103.892916
539170,103,1,104,1.341694,103.893065
539171,2,31,33,1.34183,103.893161
539172,1,2,3,1.340516,103.895491
539173,3,2,5,1.341674,103.893268
539174,590,194,784,1.349319,103.888378
539182,40,201,241,1.358745,103.893721
539183,66,41,107,1.358732,103.893824
539184,82,70,152,1.359776,103.894729
539185,124,765,889,1.359794,103.895074
539186,160,18,178,1.359412,103.894503
539187,17,58,75,1.359148,103.894447
539188,14,159,173,1.358891,103.894393
539189,26,42,68,1.358516,103.89429
539190,121,32,153,1.358297,103.894191
539191,10,36,46,1.357826,103.894085
539192,28,33,61,1.357571,103.893984
539193,8,31,39,1.357309,103.89389
539194,29,123,152,1.35705,103.893837
539195,30,46,76,1.356765,103.893713
539196,12,30,42,1.356559,103.893662
539197,17,41,58,1.356289,103.893518
539198,14,29,43,1.35605,103.893446
539199,20,12,32,1.355751,103.893329
539200,37,6,43,1.35555,103.893238
539201,7,12,19,1.355297,103.893132
539202,16,147,163,1.355031,103.893065
539203,13,15,28,1.354729,103.892897
539204,11,50,61,1.354574,103.892816
539205,2,58,60,1.354269,103.892665
539206,4,12,16,1.354095,103.892579
539207,19,14,33,1.35378,103.892458
539208,27,21,48,1.353585,103.892408
539209,27,9,36,1.3533,103.892272
539210,21,16,37,1.352991,103.892151
539211,79,95,174,1.352521,103.891908
539212,52,120,172,1.351809,103.891605
539213,586,241,827,1.351219,103.891341
539214,65,799,864,1.352041,103.890991
539215,46,48,94,1.352262,103.891253
539216,30,86,116,1.350487,103.891019
539217,60,90,150,1.349728,103.890719
539218,413,607,1020,1.349821,103.890621
539219,179,310,489,1.350261,103.890761
539220,36,7,43,1.350622,103.89087
539221,241,1369,1610,1.351083,103.891082
539222,179,71,250,1.353041,103.891968
539223,310,585,895,1.353586,103.892196
539224,31,144,175,1.354056,103.892391
539225,811,191,1002,1.354463,103.89256
539226,131,286,417,1.354769,103.892708
539227,61,127,188,1.355146,103.892864
539228,12,22,34,1.355473,103.892987
539229,34,28,62,1.355658,103.893119
539230,70,44,114,1.356027,103.893259
539231,38,342,380,1.3564,103.893385
539232,88,85,173,1.356765,103.89355
539233,59,59,118,1.357079,103.893627
539234,83,901,984,1.357515,103.893779
539243,5,0,5,1.354357,103.894887
539244,14,121,135,1.354372,103.894711
539245,4,2,6,1.354127,103.89478
539246,84,113,197,1.354178,103.894639
539247,9,8,17,1.353846,103.894676
539248,2,9,11,1.353904,103.894508
539249,9,0,9,1.353673,103.894596
539250,5,4,9,1.353724,103.894465
539252,6,17,23,1.353464,103.894282
539253,84,1,85,1.353247,103.8944
539254,1,10,11,1.35332,103.894246
539255,3,9,12,1.353003,103.89413
539256,9,0,9,1.352966,103.894268
539257,34,9,43,1.352855,103.894087
539258,3,0,3,1.341441,103.893273
539259,1,5,6,1.352576,103.89394
539260,3,0,3,1.352811,103.894213
539261,56,58,114,1.352421,103.893852
539262,1,2,3,1.352508,103.894095
539263,4,10,14,1.352101,103.89376
539264,3,1,4,1.35209,103.893901
539265,12,19,31,1.351962,103.893685
539266,7,0,7,1.351912,103.893836
539267,3,31,34,1.351659,103.893539
539268,0,138,138,1.351538,103.893447
539269,143,3,146,1.35114,103.893506
539270,27,147,174,1.351073,103.893257
539271,152,10,162,1.350991,103.893445
539272,11,147,158,1.350901,103.893192
539273,6,1,7,1.350719,103.893322
539274,1,5,6,1.350652,103.893049
539276,4,245,249,1.3505,103.892981
539277,65,8,73,1.350271,103.893115
539278,2,143,145,1.350049,103.892811
539279,0,2,2,1.340401,103.893868
539280,9,9,18,1.349786,103.892726
539281,5,0,5,1.349813,103.892921
539282,14,10,24,1.349543,103.892607
539283,76,9,85,1.349691,103.89287
539284,13,170,183,1.349351,103.892569
539285,5,0,5,1.349226,103.892732
539286,761,85,846,1.348977,103.892494
539287,12,56,68,1.348981,103.892663
539288,15,3,18,1.348839,103.892515
539289,2,1,3,1.352363,103.894023
539290,3,5,8,1.348548,103.892531
539291,9,1,10,1.348405,103.892738
539292,6,81,87,1.34838,103.892552
539293,20,28,48,1.348089,103.892645
539294,0,62,62,1.347732,103.89262
539295,51,33,84,1.347457,103.892672
539296,12,1000,1012,1.347361,103.892414
539305,7,54,61,1.355271,103.89547
539306,95,0,95,1.355217,103.895657
539307,141,53,194,1.355949,103.895024
539308,3,14,17,1.355603,103.895815
539309,22,5,27,1.356017,103.895797
539310,11,75,86,1.356863,103.895904
539311,25,13,38,1.355944,103.89596
539312,5,12,17,1.3571,103.896146
539313,18,4,22,1.356309,103.896115
539314,13,0,13,1.35719,103.896372
539315,30,3,33,1.356987,103.896592
539316,1,14,15,1.35714,103.896652
539317,101,0,101,1.357044,103.897202
539318,30,18,48,1.357162,103.896811
539319,136,0,136,1.357215,103.89708
539320,7,9,16,1.357219,103.897271
539329,8,142,150,1.355053,103.894557
539330,0,2,2,1.350088,103.893057
539331,4,6,10,1.354896,103.89496
539332,3,2,5,1.354812,103.895084
539333,4,2,6,1.354599,103.895545
539334,16,2,18,1.354164,103.896542
539335,0,1,1,1.3458,103.872055
539336,22,0,22,1.354325,103.896626
539337,1,0,1,1.354533,103.895668
539338,1,0,1,1.354613,103.896743
539339,40,4,44,1.354786,103.896827
539340,2,2,4,1.354303,103.89622
539341,1,0,1,1.354353,103.896063
539342,10,3,13,1.355185,103.897006
539343,6,1,7,1.355502,103.897136
539344,0,1,1,1.35503,103.896911
539345,201,4,205,1.355901,103.89732
539346,26,2,28,1.356089,103.897399
539347,7,0,7,1.356395,103.897505
539348,1,0,1,1.355657,103.897197
539349,8,0,8,1.356783,103.897673
539350,1,0,1,1.356556,103.897567
539351,42,0,42,1.3575,103.897734
539352,0,1,1,1.356967,103.897779
539353,16,1,17,1.357617,103.897772
539355,71,34,105,1.358128,103.89812
539356,136,34,170,1.358567,103.898097
539357,3,23,26,1.357827,103.898184
539365,31,280,311,1.360062,103.896164
539366,0,53,53,1.359953,103.89617
539367,6,28,34,1.359761,103.896238
539368,18,0,18,1.359823,103.896506
539369,1,2,3,1.348624,103.892691
539370,13,7,20,1.359868,103.896969
539371,7,1,8,1.359893,103.89719
539372,54,0,54,1.35995,103.89759
539373,6,2,8,1.359965,103.897806
539374,2,4,6,1.360212,103.89861
539375,35,3,38,1.36027,103.898886
539376,29,0,29,1.360056,103.898794
539377,2,1,3,1.359837,103.896679
539378,1,5,6,1.360108,103.899068
539379,2,1,3,1.360263,103.89911
539380,48,1,49,1.360122,103.899357
539381,1,1,2,1.354996,103.894684
539382,0,3,3,1.360309,103.899331
539383,3,0,3,1.360484,103.900246
539392,8,7,15,1.360506,103.898187
539393,3,2,5,1.360377,103.898187
539394,8,6,14,1.359955,103.898395
539395,34,1,35,1.359937,103.898271
539406,23,66,89,1.357754,103.895698
539407,7,270,277,1.358884,103.896051
539408,28,0,28,1.358632,103.896064
539409,21,0,21,1.35804,103.896531
539410,178,21,199,1.358904,103.896697
539411,73,0,73,1.358735,103.89684
539412,0,13,13,1.358919,103.896815
539413,19,23,42,1.358783,103.897194
539414,13,73,86,1.358813,103.897573
539415,0,43,43,1.358979,103.897213
539416,1,36,37,1.358985,103.897424
539417,1,0,1,1.357227,103.89788
539418,2,0,2,1.360194,103.899888
539419,0,7,7,1.359057,103.898076
539420,0,16,16,1.359082,103.898244
539421,135,7,142,1.357758,103.899226
539422,0,27,27,1.35916,103.898672
539423,147,27,174,1.358968,103.899281
539424,134,1,135,1.359257,103.899225
539425,7,6,13,1.358998,103.899598
539426,0,1,1,1.35899,103.897697
539427,32,4,36,1.359322,103.9001
539428,1,1,2,1.359039,103.897858
539429,1,0,1,1.358998,103.899797
539439,18,29,47,1.358475,103.8993
539440,6,0,6,1.358337,103.899606
539441,94,7,101,1.358082,103.89972
539442,2,22,24,1.358272,103.899901
539443,55,5,60,1.358286,103.900166
539444,6,0,6,1.35735,103.900677
539445,1,6,7,1.357328,103.901047
539446,0,5,5,1.358203,103.901339
539447,1,48,49,1.358292,103.90179
539448,0,79,79,1.358413,103.902482
539449,54,2,56,1.35884,103.9025
539450,2,36,38,1.358713,103.902711
539451,6,4,10,1.359318,103.902802
539452,1,28,29,1.359001,103.902886
539453,1,36,37,1.359332,103.903066
539454,1,46,47,1.35973,103.903295
539455,0,4,4,1.360842,103.903537
539456,2,80,82,1.360465,103.903693
539457,1,1024,1025,1.356814,103.901617
539465,85,94,179,1.361077,103.902462
539466,47,0,47,1.360694,103.902501
539467,5,24,29,1.360407,103.902666
539468,3,1,4,1.360154,103.902548
539477,41,566,607,1.360588,103.895966
539478,16,14,30,1.360461,103.896446
539479,55,230,285,1.360616,103.896422
539480,2,1,3,1.360259,103.900419
539481,4,6,10,1.360654,103.896742
539482,7,0,7,1.360541,103.896998
539483,11,1,12,1.360722,103.897135
539484,4,4,8,1.360556,103.897178
539485,84,3,87,1.361425,103.897478
539486,2,3,5,1.360589,103.897539
539487,3,2,5,1.360769,103.897951
539488,10,4,14,1.360829,103.898367
539489,7,0,7,1.360624,103.897727
539490,6,13,19,1.360898,103.898816
539491,16,5,21,1.361068,103.899356
539492,8,76,84,1.361177,103.899721
539493,221,35,256,1.361178,103.900193
539494,12,18,30,1.360818,103.899532
539495,0,34,34,1.360945,103.900197
539496,1,8,9,1.36107,103.900441
539497,2,174,176,1.361342,103.902075
539498,1,4,5,1.361414,103.902499
539499,0,16,16,1.361441,103.902935
539500,1,2,3,1.360484,103.896666
539501,14,223,237,1.361549,103.903728
539516,33,189,222,1.361843,103.900999
539517,4,4,8,1.361359,103.901043
539518,1,13,14,1.360904,103.90119
539519,1,9,10,1.36061,103.901181
539521,20,1,21,1.359867,103.901567
539522,10,13,23,1.359686,103.901005
539523,0,1,1,1.359143,103.900561
539525,6,0,6,1.358853,103.901427
539526,3,2,5,1.358488,103.901441
539527,10,5,15,1.358549,103.90121
539536,249,2378,2627,1.346128,103.893084
539537,51,10,61,1.347064,103.89433
539538,89,120,209,1.34975,103.891743
539539,308,164,472,1.349427,103.891597
539540,1798,481,2279,1.346406,103.891571
539548,60,65,125,1.35598,103.880813
539549,10,10,20,1.355979,103.880812
539550,2,1,3,1.361468,103.9033
539551,0,5,5,1.355922,103.880863
539552,2,2,4,1.356075,103.881565
539553,0,5,5,1.356075,103.881565
539554,2,2,4,1.355806,103.880965
539555,12,3,15,1.356075,103.881565
539556,15,11,26,1.356075,103.881565
539557,8,78,86,1.35569,103.881066
539558,5,68,73,1.356075,103.881565
539559,2,0,2,1.35915,103.900325
539560,0,34,34,1.355619,103.881018
539562,0,4,4,1.355619,103.881018
539563,4,0,4,1.355573,103.881168
539564,25,0,25,1.356075,103.881565
539565,5,0,5,1.356075,103.881565
539566,3,0,3,1.355979,103.880812
539569,4,0,4,1.355457,103.881269
539570,33,0,33,1.355456,103.881268
539571,8,0,8,1.355456,103.881268
539591,1,10,11,1.355064,103.88161
539593,4,11,15,1.355063,103.881609
539594,0,3,3,1.355619,103.881018
539595,1,0,1,1.359552,103.90128
539596,0,1,1,1.355063,103.882429
539597,1,16,17,1.354197,103.882053
539598,67,10,77,1.354274,103.882049
539599,1,1,2,1.356075,103.881565
539600,4,0,4,1.354273,103.882048
539601,5,11,16,1.354273,103.882048
539602,1,1,2,1.354273,103.882048
539603,8,0,8,1.354768,103.882615
539604,2,2,4,1.354131,103.882067
539605,13,12,25,1.353998,103.882094
539606,62,6,68,1.353865,103.882122
539607,0,1,1,1.355109,103.882535
539608,14,5,19,1.353731,103.882149
539609,4,12,16,1.35373,103.882148
539610,104,4,108,1.353798,103.882156
539611,3,0,3,1.355013,103.882295
539612,0,1,1,1.354031,103.882107
539613,3,5,8,1.353797,103.882155
539615,3,0,3,1.353797,103.882155
539616,3,2,5,1.353597,103.882176
539617,72,0,72,1.353597,103.882176
539618,6,3,9,1.353597,103.882176
539619,5,0,5,1.353565,103.882204
539620,26,2,28,1.353465,103.882204
539621,144,14,158,1.353342,103.882242
539622,20,2,22,1.353332,103.882232
539623,4,14,18,1.354147,103.882083
539624,3,0,3,1.353597,103.882176
539625,1,3,4,1.353597,103.882176
539626,2,0,2,1.354752,103.882546
539627,1,1,2,1.299509,103.837
539628,8,119,127,1.299509,103.837
539629,17,0,17,1.299509,103.837
539631,104,15,119,1.355563,103.881539
539632,2,8,10,1.3558,103.88199
539633,0,4,4,1.355846,103.881955
539634,9,1,10,1.355904,103.881907
539635,0,2,2,1.299509,103.837
539636,2,4,6,1.355987,103.881837
539639,0,1,1,1.353797,103.882155
539640,0,3,3,1.353597,103.882176
539641,0,9,9,1.356296,103.881609
539642,10,250,260,1.356357,103.881558
539643,30,147,177,1.356418,103.881513
539644,4,3,7,1.35576,103.882012
539645,3,3,6,1.355759,103.882011
539647,1,2,3,1.356229,103.88166
539648,1,0,1,1.356157,103.881722
539649,0,3,3,1.355759,103.882011
539650,15,0,15,1.355759,103.882011
539651,0,9,9,1.355759,103.882011
539652,1,10,11,1.355759,103.882011
539653,0,4,4,1.355799,103.882055
539654,2,1,3,1.355759,103.882011
539655,4,0,4,1.355798,103.882054
539657,3,20,23,1.356613,103.881678
539658,0,9,9,1.35665,103.881715
539659,0,11,11,1.356652,103.88178
539660,1,1,2,1.355954,103.881868
539662,8,1,9,1.356593,103.882026
539663,0,2,2,1.355803,103.882082
539664,4,0,4,1.355867,103.882153
539665,1,0,1,1.355759,103.882011
539666,2,1,3,1.355798,103.882054
539667,2,0,2,1.356576,103.881982
539670,2,0,2,1.356069,103.882355
539671,2,0,2,1.356147,103.882442
539672,0,6,6,1.355994,103.882294
539673,20,12,32,1.356225,103.882529
539674,0,6,6,1.356224,103.882528
539675,1,1,2,1.356147,103.882442
539680,3,19,22,1.356121,103.882435
539681,1,2,3,1.356069,103.882355
539682,0,3,3,1.356184,103.882505
539683,2,1,3,1.356183,103.882504
539684,6,0,6,1.356448,103.882777
539685,2,0,2,1.356224,103.882528
539686,1,0,1,1.35607,103.882356
539688,1,0,1,1.356311,103.882646
539689,8,0,8,1.355798,103.882054
539690,20,3,23,1.355798,103.882054
539691,5,0,5,1.355798,103.882054
539692,3,1,4,1.355798,103.882054
539693,14,0,14,1.355838,103.882098
539694,65,0,65,1.355837,103.882097
539695,15,1,16,1.355837,103.882097
539696,3,1,4,1.356439,103.881905
539697,19,13,32,1.339733,103.883771
539698,7,1,8,1.339351,103.883922
539699,1,8,9,1.339697,103.883807
539700,2,0,2,1.356248,103.882576
539701,10,0,10,1.339664,103.883836
539702,36,6,42,1.339262,103.883845
539705,2,0,2,1.3393,103.883875
539706,3,0,3,1.356183,103.882504
539707,0,1,1,1.356438,103.882787
539708,1,0,1,1.339529,103.883951
539709,4,0,4,1.339116,103.883678
539710,2,0,2,1.339572,103.883918
539711,0,1,1,1.339157,103.883724
539712,0,5,5,1.339402,103.884091
539713,4,0,4,1.339037,103.883592
539714,2,0,2,1.339475,103.883998
539715,20,0,20,1.338987,103.883536
539716,2,0,2,1.339367,103.884116
539717,3,4,7,1.339306,103.884177
539718,7,0,7,1.339275,103.884207
539719,2,3,5,1.33924,103.88424
539720,0,5,5,1.33929,103.88396
539721,13,153,166,1.338855,103.883058
539722,14,0,14,1.339243,103.883922
539723,1,1,2,1.339337,103.884144
539724,24,0,24,1.339198,103.883883
539725,9,0,9,1.33875,103.882833
539727,1,1,2,1.338809,103.882735
539728,2,0,2,1.33867,103.882938
539729,1,0,1,1.339072,103.883639
539730,4,0,4,1.339095,103.883765
539731,3,70,73,1.338366,103.883425
539732,1,1,2,1.339136,103.88381
539733,10,64,74,1.339181,103.884289
539735,5,113,118,1.33851,103.883176
539736,3,2,5,1.338937,103.883592
539737,5,1,6,1.338454,103.883261
539738,2,13,15,1.338411,103.883336
539739,1,0,1,1.338614,103.883029
539740,1,0,1,1.339181,103.884289
539742,11,1,12,1.339181,103.884289
539743,1,0,1,1.33924,103.88424
539744,2,0,2,1.339052,103.88371
539746,1,0,1,1.339181,103.884289
539747,1990,126,2116,1.383077,103.885005
539748,665,1820,2485,1.379946,103.887516
539749,486,349,835,1.382104,103.887857
539750,203,47,250,1.382542,103.887352
539751,167,866,1033,1.382098,103.887346
539752,44,103,147,1.381688,103.887286
539753,90,403,493,1.381213,103.887681
539754,5,81,86,1.381046,103.887461
539755,34,91,125,1.380564,103.886679
539756,1,0,1,1.339181,103.884289
539757,3,1,4,1.344054,103.871925
539758,18,4,22,1.343991,103.871999
539759,4,0,4,1.34409,103.872085
539760,17,0,17,1.343972,103.872164
539761,0,8,8,1.343979,103.872271
539762,0,8,8,1.343984,103.872327
539763,127,19,146,1.343962,103.872481
539764,4,160,164,1.343927,103.872968
539765,218,110,328,1.343856,103.872997
539766,38,12,50,1.344002,103.873052
539771,2,18,20,1.343851,103.873527
539773,0,13,13,1.343842,103.873285
539775,623,93,716,1.336677,103.888874
539777,18,105,123,1.344022,103.874579
539778,76,5,81,1.343997,103.874589
539779,6,1,7,1.343859,103.874903
539780,4,6,10,1.344205,103.874972
539781,0,15,15,1.343958,103.87509
539782,9,40,49,1.344256,103.87517
539783,7,30,37,1.344317,103.875238
539784,675,980,1655,1.344273,103.880173
539785,4,1,5,1.343846,103.873131
539786,211,13,224,1.342194,103.878086
539787,9,106,115,1.343278,103.877991
539788,603,1375,1978,1.342294,103.880402
539789,611,2,613,1.299509,103.837
539794,0,12,12,1.353574,103.882893
539795,3,1,4,1.353574,103.882893
539796,8,0,8,1.353979,103.883092
539797,8,1,9,1.353855,103.882918
539798,10,1,11,1.353792,103.882943
539799,7,1,8,1.353908,103.882765
539801,2,0,2,1.339181,103.884289
539802,11,3,14,1.353613,103.882986
539803,8,50,58,1.353679,103.882836
539805,1,16,17,1.353473,103.883029
539806,61,0,61,1.353427,103.883061
539807,3,57,60,1.353474,103.883206
539808,0,13,13,1.299509,103.837
539816,4,9,13,1.354667,103.881555
539817,5,7,12,1.354266,103.881932
539818,0,9,9,1.354307,103.882155
539819,5,0,5,1.354309,103.881577
539820,14,0,14,1.354453,103.882312
539821,5,1,6,1.354384,103.881429
539822,0,13,13,1.354506,103.882405
539823,8,0,8,1.354292,103.881425
539824,7,9,16,1.354585,103.882581
539825,3,2,5,1.35422,103.882187
539826,16,7,23,1.354241,103.882251
539827,2,17,19,1.354626,103.882665
539828,0,29,29,1.354385,103.882425
539830,71,20,91,1.354759,103.883081
539831,46,17,63,1.354275,103.882432
539832,23,0,23,1.353999,103.882722
539836,1,8,9,1.354384,103.882767
539837,2,16,18,1.354463,103.883011
539838,9,0,9,1.354512,103.883233
539839,0,3,3,1.339194,103.88376
539840,12,1,13,1.354254,103.882992
539841,6,7,13,1.35428,103.88305
539842,2264,33,2297,1.354758,103.883979
539843,18,2,20,1.353615,103.884298
539844,2,1,3,1.354241,103.882974
539845,6,1,7,1.355338,103.885197
539847,3,0,3,1.355307,103.885141
539848,0,2,2,1.353799,103.882794
539849,0,8,8,1.355468,103.885445
539850,61,24,85,1.355513,103.885509
539851,45,32,77,1.355622,103.885398
539852,7,10,17,1.355709,103.88558
539853,7,2,9,1.355782,103.885692
539854,6,3,9,1.355642,103.885772
539855,0,1,1,1.343967,103.871899
539856,0,1,1,1.355695,103.885867
539857,5,3,8,1.356086,103.886883
539858,2,2,4,1.355781,103.886055
539860,21,0,21,1.355816,103.88613
539861,0,2,2,1.35543,103.885367
539862,11,1,12,1.355866,103.886201
539865,2,0,2,1.356125,103.886971
539866,4,0,4,1.355956,103.886396
539867,1,0,1,1.35573,103.885941
539869,3,12,15,1.356222,103.887145
539870,16,2,18,1.356051,103.886574
539871,9,0,9,1.356235,103.887171
539872,0,2,2,1.356192,103.887094
539873,1,0,1,1.35621,103.887137
539874,4,1,5,1.356364,103.886798
539875,1,1,2,1.356315,103.886735
539876,3,0,3,1.355395,103.885318
539877,2,0,2,1.356297,103.887285
539878,13,0,13,1.356275,103.887033
539879,0,3,3,1.356227,103.886912
539880,1,0,1,1.356256,103.887233
539881,2,3,5,1.356369,103.887431
539882,16,0,16,1.356349,103.887214
539883,5,0,5,1.356396,103.887476
539884,2,0,2,1.35633,103.887397
539885,3,0,3,1.356315,103.887353
539886,13,0,13,1.356443,103.887359
539887,6,20,26,1.356455,103.887625
539888,3,0,3,1.356424,103.887551
539890,34,1,35,1.356552,103.88754
539891,1,1,2,1.356391,103.887264
539893,2,0,2,1.356521,103.887761
539894,4,1,5,1.356649,103.88781
539895,2,0,2,1.356654,103.887746
539896,0,1,1,1.356314,103.887107
539897,0,23,23,1.356964,103.888049
539898,3,20,23,1.35483,103.883791
539906,5,17,22,1.354138,103.898265
539920,3,0,3,1.356488,103.887466
539926,104,2292,2396,1.343411,103.898567
539927,13,125,138,1.342096,103.898903
539931,595,349,944,1.347751,103.89618
539932,17,0,17,1.34804,103.894975
539933,13,0,13,1.348629,103.89454
539934,19,0,19,1.350002,103.89453
539935,6,0,6,1.350734,103.895207
539936,4,0,4,1.352366,103.895805
539937,0,2,2,1.356701,103.887899
539938,8158,834,8992,1.350066,103.896786
539939,47,1866,1913,1.333317,103.890216
539942,71,0,71,1.354214,103.898273
539943,3,16,19,1.352961,103.897052
539944,4,4,8,1.345029,103.897877
539945,693,0,693,1.342749,103.900239
539946,25,112,137,1.350262,103.89971
539947,9,1189,1198,1.350847,103.883187
539948,5,3,8,1.350766,103.883201
539949,2,0,2,1.351938,103.896508
539950,0,3,3,1.344656,103.898388
539951,1,32,33,1.350768,103.883176
539952,15,22,37,1.350234,103.88331
539953,1,0,1,1.356736,103.887989
539954,98,0,98,1.350594,103.883202
539956,0,3,3,1.350574,103.883224
539957,12,1,13,1.350442,103.883217
539958,11,2,13,1.350343,103.883229
539960,9,5,14,1.350255,103.883239
539961,18,4,22,1.350253,103.883523
539962,7,9,16,1.350201,103.883304
539963,1,1,2,1.350683,103.88321
539964,56,0,56,1.350261,103.883593
539965,1,1,2,1.350213,103.883411
539966,2,2,4,1.350277,103.883738
539967,1,0,1,1.350676,103.883188
539968,2,0,2,1.35027,103.883666
539969,1,0,1,1.350231,103.883519
539971,1,0,1,1.350254,103.883673
539972,2,0,2,1.350244,103.883596
539973,3,2,5,1.350304,103.883925
539974,1,1,2,1.350293,103.883814
539975,2,5,7,1.350302,103.884107
539976,5,4,9,1.350249,103.884172
539977,22,11,33,1.350294,103.883992
539978,0,3,3,1.350237,103.883379
539979,12,2,14,1.350094,103.884185
539980,31,0,31,1.350178,103.884154
539981,1,0,1,1.350322,103.884025
539982,8,10,18,1.35003,103.884189
539983,12,1,13,1.349965,103.884199
539984,88,7,95,1.349903,103.884205
539985,52,0,52,1.349966,103.884179
539986,4,0,4,1.349846,103.884219
539987,12,1,13,1.34974,103.884209
539988,144,0,144,1.349796,103.884226
539991,103,0,103,1.349659,103.884248
539992,2,9,11,1.350259,103.884085
539993,1,0,1,1.350089,103.884163
539994,10,14,24,1.299509,103.837
539996,1,41,42,1.350247,103.883232
539997,0,2,2,1.350273,103.88382
540101,929,980,1909,1.382678,103.899465
540102,1103,558,1661,1.381822,103.900911
540103,1006,499,1505,1.382447,103.90121
540104,476,399,875,1.382713,103.900848
540105,387,330,717,1.382166,103.900701
540106,429,204,633,1.382464,103.90021
540107,512,265,777,1.38279,103.900367
540108,512,323,835,1.382801,103.899861
540109,554,741,1295,1.383152,103.89967
540110,1405,2049,3454,1.383446,103.900249
540111,466,307,773,1.38349,103.90081
540112,583,674,1257,1.38349,103.90081
540113,428,243,671,1.383816,103.901676
540114,340,837,1177,1.38349,103.90081
540115,342,597,939,1.384747,103.901153
540117,27,13,40,1.385087,103.901366
540118,2570,20144,22714,1.385427,103.901579
540119,36,102,138,1.384252,103.90336
540120,22,578,600,1.386259,103.904084
540121,1001,1958,2959,1.38665,103.904662
540122,1006,282,1288,1.386536,103.906743
540123,541,1974,2515,1.386498,103.90343
540124,384,1685,2069,1.387391,103.902262
540125,830,361,1191,1.388828,103.9033
540126,535,2268,2803,1.389051,103.902327
540127,971,1482,2453,1.390597,103.902208
540128,799,232,1031,1.39014,103.90284
540129,233,257,490,1.389918,103.902593
540130,450,170,620,1.389334,103.902644
540131,490,43,533,1.388828,103.9033
540132,896,229,1125,1.390072,103.903512
540133,766,891,1657,1.388716,103.903524
540134,471,1690,2161,1.388216,103.904276
540135,538,464,1002,1.388148,103.905033
540136,750,271,1021,1.388674,103.905038
540137,681,868,1549,1.389213,103.904676
540138,834,521,1355,1.388216,103.904276
540139,355,535,890,1.388946,103.904311
540140,1053,156,1209,1.389373,103.9037
540141,320,303,623,1.389409,103.904116
540142,609,580,1189,1.390587,103.904825
540143,754,93,847,1.390083,103.905738
540144,673,1761,2434,1.389168,103.90595
540145,1234,930,2164,1.389939,103.906545
540146,839,1464,2303,1.389939,103.906545
540147,798,88,886,1.390509,103.905596
540148,558,715,1273,1.390587,103.904825
540149,543,1866,2409,1.391559,103.905399
540150,464,338,802,1.392232,103.906248
540151,356,2432,2788,1.392068,103.905923
540152,408,1130,1538,1.391738,103.90621
540153,305,1260,1565,1.391541,103.907111
540154,404,1827,2231,1.391541,103.907111
540155,963,646,1609,1.390688,103.907209
540156,904,334,1238,1.390968,103.90741
540159,100,970,1070,1.388502,103.907337
540160,11,641,652,1.387173,103.907764
540161,12,592,604,1.387573,103.908623
540162,125,2716,2841,1.299509,103.837
540164,17,70,87,1.299509,103.837
540178,69,513,582,1.299509,103.837
540179,1,396,397,1.299509,103.837
540180,24,93,117,1.299509,103.837
540181,8,281,289,1.299509,103.837
540182,2017,596,2613,1.390561,103.908568
540183,41,44,85,1.391757,103.90815
540184,86,151,237,1.392101,103.908291
540185,22,301,323,1.393753,103.906726
540186,32,166,198,1.393345,103.906133
540188,42,19,61,1.394587,103.904339
540192,14,279,293,1.394183,103.903041
540193,1106,1365,2471,1.393637,103.901864
540194,723,55,778,1.39275,103.901562
540195,792,230,1022,1.392794,103.902423
540196,568,1311,1879,1.392721,103.90326
540197,269,2602,2871,1.392471,103.903706
540200,23,872,895,1.387452,103.891986
540201,42,1310,1352,1.388387,103.892395
540202,446,585,1031,1.38875,103.893254
540203,62,1491,1553,1.386548,103.896177
540204,49,510,559,1.388068,103.89541
540208,107,143,250,1.384107,103.898039
540209,32,222,254,1.383924,103.898427
540210,9,197,206,1.385331,103.900092
540211,29,24,53,1.385039,103.899153
540212,5,85,90,1.385641,103.900419
540213,28,345,373,1.386045,103.899735
540214,3,786,789,1.385385,103.900847
540215,13,498,511,1.299509,103.837
540216,54,3499,3553,1.299509,103.837
540217,14,44,58,1.299509,103.837
540229,765,534,1299,1.388552,103.900785
540230,1046,969,2015,1.388552,103.900785
540231,673,877,1550,1.389131,103.901347
540232,1100,860,1960,1.390149,103.901023
540233,596,383,979,1.38994,103.900728
540234,853,596,1449,1.390699,103.900227
540235,372,1077,1449,1.3909,103.899558
540236,1102,378,1480,1.390492,103.899458
540237,832,382,1214,1.389688,103.897945
540238,301,50,351,1.390428,103.898659
540239,742,1295,2037,1.391338,103.8983
540240,609,1083,1692,1.39096,103.898066
540241,398,755,1153,1.389691,103.897531
540244,326,613,939,1.393554,103.899001
540245,755,117,872,1.392981,103.899307
540246,605,252,857,1.392554,103.899052
540247,470,165,635,1.392129,103.899267
540248,646,902,1548,1.391988,103.898586
540249,297,952,1249,1.391772,103.899166
540251,785,156,941,1.393622,103.900025
540252,556,258,814,1.393679,103.900791
540253,544,155,699,1.393951,103.900299
540254,816,766,1582,1.394155,103.899767
540255,721,1148,1869,1.394276,103.899317
540256,461,634,1095,1.393697,103.899015
540257,35,405,440,1.392939,103.897979
540258,10,96,106,1.393596,103.896807
540259,5,84,89,1.393527,103.896582
540260,8,105,113,1.393725,103.895816
540261,26,865,891,1.394823,103.894608
540262,48,298,346,1.395132,103.895124
540263,293,207,500,1.39484,103.895953
540264,464,197,661,1.381716,103.895288
540265,46,209,255,1.381988,103.89524
540266,87,2181,2268,1.38191,103.897061
540267,117,1348,1465,1.38376,103.897067
540268,12,8,20,1.384504,103.89595
540269,131,266,397,1.38434,103.895546
540270,149,1238,1387,1.386175,103.893848
540271,46,1,47,1.385796,103.894562
540272,56,997,1053,1.384711,103.893738
540273,64,527,591,1.384435,103.89472
540274,77,83,160,1.299509,103.837
540275,35,78,113,1.383017,103.89437
540276,160,534,694,1.382659,103.894666
540277,18,76,94,1.382043,103.894203
540278,31,229,260,1.299509,103.837
540279,162,918,1080,1.386381,103.893443
540280,13,119,132,1.299509,103.837
540281,35,1366,1401,1.299509,103.837
540282,37,258,295,1.299509,103.837
540286,145,530,675,1.299509,103.837
540288,57,311,368,1.299509,103.837
540289,15,120,135,1.299509,103.837
540290,33,297,330,1.396461,103.897165
540291,19,186,205,1.396304,103.89803
540292,17,68,85,1.396602,103.899043
540293,9,7,16,1.299509,103.837
540294,36,319,355,1.299509,103.837
540295,31,270,301,1.397599,103.898748
540296,107,602,709,1.397144,103.899098
540297,188,6061,6249,1.394913,103.900113
540299,23,669,692,1.396694,103.901982
540301,72,344,416,1.388896,103.891536
540302,43,1454,1497,1.388117,103.891439
540303,118,225,343,1.387447,103.890621
540304,66,1959,2025,1.387874,103.889323
540305,117,304,421,1.388723,103.887761
540306,27,128,155,1.390465,103.888391
540307,45,131,176,1.390352,103.886765
540308,164,471,635,1.38957,103.886444
540309,38,7,45,1.391343,103.885413
540310,25,576,601,1.390379,103.885154
540311,38,3,41,1.39133,103.884799
540312,20,195,215,1.392241,103.885176
540313,90,792,882,1.392463,103.887065
540314,15,178,193,1.391441,103.888424
540317,26,307,333,1.393776,103.88871
540318,74,793,867,1.392637,103.890113
540319,24,318,342,1.390518,103.890495
540320,58,195,253,1.390572,103.891209
540321,34,515,549,1.390213,103.891533
540323,30,609,639,1.393476,103.892196
540324,30,250,280,1.393161,103.891898
540325,41,786,827,1.393518,103.89167
540326,60,952,1012,1.395302,103.888071
540327,41,319,360,1.396163,103.888509
540328,38,2729,2767,1.299509,103.837
540329,11,67,78,1.299509,103.837
540330,78,304,382,1.396869,103.889165
540331,57,205,262,1.299509,103.837
540332,6,57,63,1.394768,103.891622
540333,15,12,27,1.394768,103.891622
540334,28,82,110,1.299509,103.837
540335,22,568,590,1.299509,103.837
540336,58,65,123,1.299509,103.837
540337,1,74,75,1.299509,103.837
540338,18,108,126,1.299509,103.837
540350,1576,477,2053,1.299509,103.837
540351,4,6,10,1.299509,103.837
540352,3,5,8,1.299509,103.837
541102,25,669,694,1.382171,103.900064
541103,7,464,471,1.383446,103.900249
541107,6,303,309,1.382873,103.900628
541111,5,443,448,1.38349,103.90081
541116,1134,908,2042,1.382687,103.902111
541117,739,119,858,1.383171,103.902613
541119,559,295,854,1.384013,103.903333
541120,525,1788,2313,1.386259,103.904084
541121,580,108,688,1.386912,103.904704
541122,1162,289,1451,1.386636,103.906014
541123,316,1711,2027,1.386047,103.902888
541124,887,2391,3278,1.387972,103.902292
541126,31,3378,3409,1.389923,103.902185
541128,48,1368,1416,1.299509,103.837
541133,10,761,771,1.388216,103.904276
541135,6,521,527,1.299509,103.837
541142,21,451,472,1.389817,103.905373
541143,14,30,44,1.389939,103.906545
541146,62,775,837,1.390887,103.905928
541148,20,286,306,1.390725,103.904875
541156,56,1117,1173,1.391685,103.906945
541157,1091,233,1324,1.387909,103.908315
541158,741,2713,3454,1.38875,103.906885
541159,1297,1097,2394,1.387863,103.907281
541162,614,45,659,1.390331,103.907665
541163,301,785,1086,1.389904,103.908742
541164,747,1682,2429,1.390111,103.907478
541178,1489,1517,3006,1.389015,103.909665
541180,737,124,861,1.299509,103.837
541182,342,5923,6265,1.390561,103.908568
541183,665,1757,2422,1.39161,103.90794
541184,602,707,1309,1.392121,103.907499
541185,565,140,705,1.393309,103.907146
541186,595,253,848,1.392916,103.905784
541187,678,466,1144,1.393737,103.905399
541188,649,478,1127,1.394264,103.905154
541189,966,470,1436,1.395527,103.904018
541190,523,2564,3087,1.395207,103.902973
541191,664,3844,4508,1.393868,103.903446
541192,603,244,847,1.394104,103.903414
541194,137,315,452,1.392971,103.901857
541195,50,991,1041,1.393296,103.90257
541200,541,1153,1694,1.387452,103.891986
541201,566,969,1535,1.38875,103.893254
541202,679,88,767,1.38875,103.893254
541203,660,1416,2076,1.386378,103.89557
541204,762,514,1276,1.387878,103.894855
541205,691,537,1228,1.385536,103.897503
541206,1012,209,1221,1.386494,103.896738
541207,59,461,520,1.385706,103.898031
541208,214,21,235,1.38438,103.898481
541209,337,983,1320,1.383452,103.898529
541210,417,1120,1537,1.38473,103.900014
541211,67,7,74,1.384643,103.899276
541212,860,299,1159,1.386567,103.900593
541213,356,203,559,1.385858,103.90031
541215,527,708,1235,1.389849,103.893227
541216,243,125,368,1.389798,103.893106
541217,535,853,1388,1.389095,103.894233
541223,551,791,1342,1.388151,103.897281
541224,634,1314,1948,1.387839,103.898171
541225,437,772,1209,1.387648,103.898725
541226,471,1149,1620,1.387809,103.899906
541227,742,2005,2747,1.387066,103.900351
541228,233,2404,2637,1.387456,103.901392
541233,8,180,188,1.389406,103.900936
541236,14,395,409,1.390183,103.899933
541241,10,272,282,1.390385,103.898162
541247,24,10,34,1.299509,103.837
541248,19,579,598,1.392835,103.898693
541250,1076,432,1508,1.39164,103.899895
541252,26,230,256,1.393745,103.900496
541256,7,166,173,1.393638,103.899523
541257,686,1149,1835,1.392383,103.897668
541258,360,172,532,1.393069,103.896931
541259,408,128,536,1.394033,103.896862
541260,393,42203,42596,1.393125,103.895591
541261,363,303,666,1.393531,103.894507
541262,1013,612,1625,1.395574,103.894962
541264,144,2086,2230,1.381104,103.896881
541265,386,403,789,1.382282,103.895375
541266,358,230,588,1.382474,103.896852
541267,586,977,1563,1.383001,103.897782
541268,784,650,1434,1.384262,103.896552
541269,590,757,1347,1.383666,103.895533
541270,533,736,1269,1.385768,103.894137
541271,386,1665,2051,1.385843,103.894787
541272,262,381,643,1.385281,103.893953
541273,338,446,784,1.383661,103.895324
541274,377,143,520,1.382355,103.890653
541275,411,66,477,1.382518,103.895157
541277,661,194,855,1.381886,103.894502
541278,621,246,867,1.299509,103.837
541279,572,1048,1620,1.385836,103.893086
541280,690,631,1321,1.385725,103.892287
541281,392,1324,1716,1.385744,103.891711
541282,684,9,693,1.385725,103.892287
541286,858,241,1099,1.39623,103.896726
541287,546,363,909,1.299509,103.837
541288,380,48,428,1.397508,103.897847
541289,149,517,666,1.398219,103.896851
541290,948,2437,3385,1.395992,103.89691
541291,864,1145,2009,1.395639,103.897959
541292,527,820,1347,1.395956,103.899064
541293,740,576,1316,1.396847,103.896041
541294,804,1330,2134,1.396197,103.895824
541295,1619,256,1875,1.398287,103.899296
541296,915,154,1069,1.39706,103.899223
541297,912,4297,5209,1.394859,103.900273
541298,1255,2743,3998,1.395017,103.90177
541299,1539,1383,2922,1.396023,103.90249
541301,501,882,1383,1.389602,103.891611
541302,579,927,1506,1.387559,103.891225
541303,429,801,1230,1.387011,103.890942
541304,1012,3936,4948,1.387881,103.888914
541305,904,1312,2216,1.38849,103.888566
541306,452,1258,1710,1.389962,103.889105
541307,531,42,573,1.389375,103.887916
541308,565,1859,2424,1.389739,103.886026
541309,722,934,1656,1.391709,103.886047
541310,791,219,1010,1.390935,103.88502
541311,856,2108,2964,1.39098,103.884141
541312,1117,277,1394,1.391746,103.885179
541313,571,462,1033,1.391582,103.887545
541314,859,1578,2437,1.390977,103.88928
541315,421,153,574,1.391957,103.889043
541316,571,64,635,1.392474,103.889503
541317,761,919,1680,1.393291,103.887781
541318,821,661,1482,1.393729,103.889603
541319,922,1156,2078,1.390657,103.88982
541320,714,1152,1866,1.390038,103.89154
541321,834,916,1750,1.390038,103.89154
541322,557,70,627,1.39146,103.892407
541323,492,1982,2474,1.392696,103.893021
541324,224,821,1045,1.393476,103.892043
541325,498,613,1111,1.393833,103.890798
541326,751,1616,2367,1.39478,103.888121
541327,250,46,296,1.299509,103.837
541329,840,19,859,1.299509,103.837
541330,973,441,1414,1.299509,103.837
541331,987,835,1822,1.395681,103.890285
541332,626,539,1165,1.394679,103.892298
541333,472,1424,1896,1.394792,103.891184
541334,794,172,966,1.397711,103.888971
541335,1507,308,1815,1.397711,103.888971
541336,520,370,890,1.397827,103.888117
541338,54,528,582,1.299509,103.837
541350,168,2775,2943,1.299509,103.837
541351,4,287,291,1.299509,103.837
542116,1186,2604,3790,1.382059,103.902366
542117,725,871,1596,1.383776,103.902711
542119,483,1008,1491,1.384125,103.902699
542120,420,320,740,1.385686,103.90439
542121,430,251,681,1.386912,103.904704
542122,580,1214,1794,1.386956,103.906554
542123,744,1070,1814,1.386083,103.902528
542124,645,537,1182,1.388373,103.90303
542156,60,1539,1599,1.392034,103.906502
542157,954,238,1192,1.387611,103.908128
542158,848,1680,2528,1.388555,103.906694
542162,543,879,1422,1.299509,103.837
542163,421,1478,1899,1.389045,103.908434
542164,275,430,705,1.390331,103.907665
542178,1473,114,1587,1.38874,103.910007
542180,585,2645,3230,1.299509,103.837
542182,17,1271,1288,1.390561,103.908568
542183,864,797,1661,1.391138,103.908352
542184,769,1629,2398,1.392321,103.907265
542185,774,1520,2294,1.392768,103.906776
542186,255,1586,1841,1.392916,103.905784
542187,819,590,1409,1.39435,103.905997
542188,1187,386,1573,1.39495,103.905318
542189,791,832,1623,1.395833,103.90362
542190,769,894,1663,1.39418,103.902375
542191,568,168,736,1.394653,103.903928
542192,642,1037,1679,1.394206,103.902772
542200,1061,863,1924,1.387111,103.892584
542201,1374,429,1803,1.388281,103.893762
542202,943,226,1169,1.388109,103.892735
542203,322,1067,1389,1.386902,103.894636
542204,742,403,1145,1.387242,103.894446
542205,625,725,1350,1.385557,103.896732
542206,791,1002,1793,1.387449,103.896954
542207,635,1331,1966,1.385705,103.89803
542208,364,54,418,1.384545,103.89883
542209,570,1449,2019,1.38369,103.898819
542210,483,1268,1751,1.384547,103.899785
542211,863,686,1549,1.385083,103.898739
542212,535,812,1347,1.386567,103.900593
542213,508,111,619,1.385539,103.900794
542215,616,170,786,1.390243,103.893388
542216,382,430,812,1.390303,103.89356
542217,437,760,1197,1.389428,103.893996
542223,450,192,642,1.388298,103.897587
542224,675,393,1068,1.388193,103.89796
542225,296,318,614,1.387819,103.899024
542226,367,274,641,1.387809,103.899906
542227,266,219,485,1.387241,103.900648
542228,629,88,717,1.387903,103.901196
542250,623,279,902,1.392063,103.899896
542257,239,554,793,1.392579,103.896967
542258,634,215,849,1.39278,103.897402
542259,752,113,865,1.393906,103.897501
542260,542,236,778,1.393541,103.895288
542261,583,1220,1803,1.393531,103.894507
542262,815,380,1195,1.395249,103.895461
542264,453,402,855,1.381375,103.896538
542265,373,180,553,1.38223,103.895741
542266,359,148,507,1.382523,103.897172
542267,706,1397,2103,1.383156,103.897525
542268,511,532,1043,1.384401,103.896332
542269,449,226,675,1.383666,103.895533
542271,738,56,794,1.385503,103.894588
542272,602,21,623,1.384806,103.893852
542273,356,470,826,1.384547,103.895027
542274,350,182,532,1.382181,103.890817
542275,532,273,805,1.383235,103.894541
542277,192,234,426,1.382338,103.894509
542278,513,229,742,1.382255,103.890361
542279,762,162,924,1.385725,103.892287
542280,512,349,861,1.385725,103.892287
542281,650,17,667,1.385725,103.892287
542282,575,298,873,1.385725,103.892287
542286,593,1339,1932,1.340544,103.94292
542287,222,540,762,1.398712,103.896335
542288,263,40,303,1.299509,103.837
542289,153,161,314,1.397508,103.897847
542290,859,546,1405,1.396847,103.896838
542291,511,146,657,1.395834,103.898493
542292,849,1385,2234,1.395418,103.898739
542293,796,367,1163,1.396847,103.896041
542295,1394,383,1777,1.397975,103.900069
542296,937,516,1453,1.397618,103.899308
542297,971,985,1956,1.394702,103.901115
542298,1658,2978,4636,1.395017,103.90177
542299,1500,698,2198,1.39683,103.901379
542301,936,534,1470,1.389608,103.891609
542302,424,347,771,1.38786,103.89069
542303,903,4127,5030,1.387423,103.889867
542304,523,520,1043,1.388593,103.88892
542305,1512,888,2400,1.389101,103.888609
542306,889,275,1164,1.389553,103.888609
542307,836,260,1096,1.389574,103.887468
542308,317,261,578,1.38993,103.886585
542309,771,1066,1837,1.390851,103.885842
542310,842,328,1170,1.390936,103.884715
542311,601,292,893,1.391837,103.88439
542312,835,248,1083,1.391725,103.885487
542313,692,217,909,1.391377,103.888021
542314,699,437,1136,1.391084,103.888715
542315,904,233,1137,1.39218,103.88845
542316,871,198,1069,1.393008,103.888944
542317,819,717,1536,1.393885,103.888393
542318,662,294,956,1.393986,103.889014
542319,766,2254,3020,1.391598,103.890317
542320,203,84,287,1.391208,103.890801
542321,1061,1364,2425,1.390587,103.892262
542322,637,138,775,1.39146,103.892407
542323,605,4628,5233,1.392214,103.89251
542324,208,23,231,1.392562,103.892359
542325,702,932,1634,1.392969,103.89061
542326,794,740,1534,1.395302,103.888071
542327,897,29,926,1.395348,103.888141
542329,714,258,972,1.299509,103.837
542330,756,800,1556,1.299509,103.837
542331,679,233,912,1.395681,103.890285
542332,907,320,1227,1.394768,103.891622
542333,685,1672,2357,1.394768,103.891622
542334,933,471,1404,1.397711,103.888971
542335,664,163,827,1.398842,103.888745
542336,1267,926,2193,1.299509,103.837
542338,34,7,41,1.39921,103.889434
542350,14,29,43,1.299509,103.837
542351,4,288,292,1.299509,103.837
543116,732,961,1693,1.382106,103.902968
543117,424,342,766,1.383378,103.903215
543119,630,904,1534,1.384721,103.903279
543120,634,106,740,1.385129,103.904015
543121,365,388,753,1.386274,103.905378
543122,743,768,1511,1.387603,103.90626
543123,433,1069,1502,1.386443,103.902137
543124,362,358,720,1.387934,103.903291
543157,917,255,1172,1.387868,103.907752
543158,815,733,1548,1.388255,103.907046
543162,537,413,950,1.389834,103.908086
543163,660,180,840,1.390331,103.907665
543164,267,138,405,1.389717,103.908013
543178,1290,412,1702,1.299509,103.837
543180,1416,1144,2560,1.389542,103.909639
543183,403,1436,1839,1.390827,103.908487
543184,898,300,1198,1.392731,103.907717
543185,933,340,1273,1.393039,103.906353
543186,605,17976,18581,1.392778,103.905158
543188,1160,493,1653,1.395358,103.904632
543189,892,368,1260,1.395412,103.903399
543190,50,2618,2668,1.394793,103.902437
543191,10,262,272,1.394146,103.903824
543192,435,243,678,1.394314,103.902995
543200,2,257,259,1.387452,103.891986
543201,844,171,1015,1.387131,103.893629
543202,381,155,536,1.387665,103.89283
543203,512,74,586,1.386923,103.895177
543204,654,11,665,1.387383,103.894803
543205,552,564,1116,1.386084,103.896503
543206,730,430,1160,1.386795,103.897555
543207,531,135,666,1.384789,103.898214
543209,255,388,643,1.383965,103.89907
543210,308,1908,2216,1.384201,103.899454
543211,825,265,1090,1.385161,103.899315
543212,590,744,1334,1.386015,103.901006
543215,17,559,576,1.389839,103.892916
543216,222,307,529,1.39074,103.894246
543217,401,70,471,1.389922,103.894066
543223,370,204,574,1.389217,103.897923
543224,250,143,393,1.389217,103.897923
543225,1328,129,1457,1.388546,103.898937
543226,1006,728,1734,1.387809,103.899906
543227,478,1396,1874,1.386776,103.901124
543228,328,115,443,1.387747,103.900654
543250,607,41,648,1.392649,103.899902
543257,260,89,349,1.392786,103.896414
543258,808,295,1103,1.39325,103.897604
543259,537,1530,2067,1.393385,103.898109
543260,647,204,851,1.394168,103.895473
543261,371,2509,2880,1.393531,103.894507
543262,397,189,586,1.394689,103.895101
543264,774,167,941,1.38155,103.896217
543265,284,250,534,1.382146,103.896062
543266,413,857,1270,1.38258,103.897436
543268,799,695,1494,1.384657,103.896048
543269,529,174,703,1.383502,103.896391
543271,353,62,415,1.385085,103.894541
543272,677,518,1195,1.384317,103.893694
543273,683,18,701,1.384541,103.894498
543274,218,111,329,1.382448,103.891249
543275,405,116,521,1.383236,103.89396
543277,389,75,464,1.382377,103.893796
543278,151,152,303,1.382307,103.889914
543279,479,12,491,1.385721,103.89266
543282,381,96,477,1.385725,103.892287
543286,1169,144,1313,1.397457,103.896122
543287,404,31,435,1.299509,103.837
543288,126,108,234,1.398204,103.898076
543289,30,413,443,1.299509,103.837
543290,546,106,652,1.39672,103.897454
543291,842,172,1014,1.396363,103.898608
543293,718,393,1111,1.396904,103.895506
543295,706,262,968,1.397255,103.900094
543296,734,382,1116,1.397327,103.89977
543297,58,1220,1278,1.394667,103.901369
543298,1234,285,1519,1.396131,103.901121
543299,1135,171,1306,1.396306,103.901809
543301,698,66,764,1.38852,103.89097
543302,1185,296,1481,1.388028,103.890303
543303,736,114,850,1.387692,103.890021
543304,12,198,210,1.388593,103.88892
543305,455,59,514,1.389079,103.888002
543306,907,325,1232,1.389883,103.888116
543307,774,223,997,1.389849,103.887002
543308,629,2860,3489,1.389219,103.886871
543309,763,855,1618,1.390851,103.885842
543311,1007,312,1319,1.391837,103.88439
543313,550,79,629,1.391988,103.88812
543314,623,236,859,1.39166,103.888853
543315,943,317,1260,1.392459,103.887941
543316,1039,180,1219,1.393291,103.887781
543317,598,104,702,1.393291,103.887781
543318,255,143,398,1.393372,103.88914
543319,815,116,931,1.390292,103.890438
543320,579,239,818,1.391283,103.891297
543321,344,289,633,1.390038,103.89154
543322,313,129,442,1.39146,103.892407
543323,358,140,498,1.393476,103.892196
543324,570,149,719,1.39255,103.8918
543325,496,256,752,1.39356,103.891368
543326,1001,855,1856,1.395483,103.888083
543327,476,183,659,1.396399,103.888694
543329,3,75,78,1.396323,103.889298
543331,542,419,961,1.299509,103.837
543332,496,209,705,1.394768,103.891622
543333,791,1181,1972,1.394768,103.891622
543334,768,691,1459,1.397711,103.888971
543335,889,63,952,1.398525,103.888182
543336,605,290,895,1.398113,103.889048
543338,28,7,35,1.39921,103.889434
543351,1,80,81,1.299509,103.837
544116,19,465,484,1.382687,103.902111
544117,2,188,190,1.382838,103.90306
544119,280,1012,1292,1.385293,103.903633
544120,6,41,47,1.38485,103.90374
544121,1464,209,1673,1.385794,103.905409
544122,467,218,685,1.387091,103.905733
544123,230,1218,1448,1.386833,103.902185
544124,3,87,90,1.38757,103.902721
544157,747,252,999,1.388157,103.907918
544158,906,292,1198,1.388502,103.907337
544178,1053,314,1367,1.299509,103.837
544180,417,164,581,1.390734,103.908939
544183,869,269,1138,1.391512,103.908772
544184,7,253,260,1.393221,103.907127
544185,191,155,346,1.393887,103.906343
544186,861,255,1116,1.392916,103.905784
544188,1089,294,1383,1.394587,103.904339
544200,740,682,1422,1.387234,103.893176
544201,914,433,1347,1.387131,103.893629
544202,10,4,14,1.387483,103.8933
544203,629,296,925,1.387009,103.895541
544204,1040,164,1204,1.387542,103.895347
544205,68,261,329,1.386198,103.897542
544206,550,19,569,1.386874,103.897153
544207,522,192,714,1.384616,103.897945
544211,889,160,1049,1.385825,103.899465
544216,282,350,632,1.389931,103.894247
544223,945,1454,2399,1.389217,103.897923
544224,423,367,790,1.38875,103.89858
544225,2,172,174,1.388521,103.899389
544226,5,176,181,1.38852,103.899462
544227,448,1550,1998,1.387021,103.901366
544228,13,261,274,1.388356,103.900728
544250,536,243,779,1.39308,103.899956
544258,262,165,427,1.393525,103.897089
544260,445,105,550,1.394152,103.895983
544261,453,276,729,1.393531,103.894507
544262,663,54,717,1.394229,103.89499
544264,311,75,386,1.381629,103.895967
544265,478,132,610,1.381978,103.896452
544266,5,19,24,1.38168,103.896641
544268,944,868,1812,1.384911,103.895782
544269,718,74,792,1.38339,103.896726
544272,389,993,1382,1.383785,103.893673
544273,507,10,517,1.384049,103.894449
544274,35,131,166,1.382302,103.891027
544275,253,73,326,1.382748,103.893938
544277,282,316,598,1.381849,103.893933
544278,53,59,112,1.299509,103.837
544287,23,442,465,1.299509,103.837
544288,9,78,87,1.299509,103.837
544291,1192,738,1930,1.39683,103.898484
544293,451,421,872,1.396847,103.896041
544297,32,34,66,1.395296,103.901
544298,1463,749,2212,1.395814,103.900912
544299,6,17,23,1.396139,103.901696
544301,673,1197,1870,1.38837,103.891421
544302,727,181,908,1.388203,103.889734
544305,767,1127,1894,1.388851,103.887398
544306,12,19,31,1.390124,103.888442
544307,672,908,1580,1.390367,103.886062
544309,624,1946,2570,1.390765,103.885787
544311,728,394,1122,1.391837,103.88439
544313,759,40,799,1.392022,103.887708
544314,1021,1099,2120,1.391575,103.889396
544317,594,609,1203,1.393291,103.887781
544318,540,88,628,1.393038,103.889615
544320,298,15,313,1.390908,103.891812
544324,189,90,279,1.39287,103.891338
544326,580,223,803,1.396183,103.888141
544327,7,37,44,1.299509,103.837
544333,434,884,1318,1.394249,103.892157
544336,434,725,1159,1.397711,103.888971
544338,7,141,148,1.39921,103.889434
544351,2,0,2,1.299509,103.837
544619,0,2,2,1.299509,103.837
544624,23,1339,1362,1.397267,103.893304
544625,4,365,369,1.299509,103.837
544626,1,20,21,1.299509,103.837
544627,13,151,164,1.299509,103.837
544628,8,265,273,1.299509,103.837
544634,3,0,3,1.350177,103.884175
544641,3,0,3,1.299509,103.837
544642,2,2,4,1.299509,103.837
544643,0,3,3,1.299509,103.837
544644,356,187,543,1.389241,103.900316
544649,10,31,41,1.299509,103.837
544650,3,10,13,1.299509,103.837
544651,1,79,80,1.299509,103.837
544652,0,4,4,1.299509,103.837
544654,0,1,1,1.350286,103.8839
544655,4,5,9,1.299509,103.837
544656,0,21,21,1.299509,103.837
544657,0,18,18,1.299509,103.837
544658,0,16,16,1.299509,103.837
544659,6,22,28,1.399141,103.891291
544660,52,76,128,1.299509,103.837
544661,13,3,16,1.299509,103.837
544662,3,2,5,1.299509,103.837
544663,79,23,102,1.299509,103.837
544674,0,11,11,1.299509,103.837
544675,1,15,16,1.299509,103.837
544679,9,20,29,1.299509,103.837
544684,469,274,743,1.381099,103.89215
544685,777,156,933,1.381391,103.892409
544686,482,40,522,1.380732,103.891773
544687,405,37,442,1.380303,103.892079
544688,237,155,392,1.380622,103.892269
544689,122,201,323,1.299509,103.837
544690,37,285,322,1.299509,103.837
544694,16,36,52,1.299509,103.837
544699,389,207,596,1.392501,103.894364
544700,376,289,665,1.389375,103.895801
544701,568,4,572,1.389375,103.895801
544702,554,6,560,1.299509,103.837
544703,539,51,590,1.299509,103.837
544704,405,7,412,1.389913,103.895329
544705,523,517,1040,1.390165,103.896014
544706,488,422,910,1.389721,103.895539
544707,348,398,746,1.389375,103.895801
544708,39,16,55,1.299509,103.837
544714,4,1,5,1.361223,103.884821
544715,175,0,175,1.299509,103.837
544716,6,1,7,1.299509,103.837
544718,26,0,26,1.299509,103.837
544719,2,0,2,1.299509,103.837
544720,31,0,31,1.299509,103.837
544721,2,1,3,1.299509,103.837
544722,15,1,16,1.299509,103.837
544723,84,0,84,1.299509,103.837
544724,3,0,3,1.299509,103.837
544725,26,0,26,1.299509,103.837
544726,11,17,28,1.299509,103.837
544727,311,3,314,1.362639,103.885801
544728,555,4,559,1.362639,103.885801
544729,385,19,404,1.361216,103.884835
544730,321,1289,1610,1.363301,103.885222
544734,1049,66,1115,1.361327,103.884887
544735,491,1,492,1.360792,103.883574
544736,559,0,559,1.360543,103.883
544737,16,2,18,1.299509,103.837
544738,223,0,223,1.36129,103.884892
544740,1139,309,1448,1.381175,103.903052
544741,708,144,852,1.381171,103.902452
544742,588,52,640,1.381171,103.902452
544743,950,505,1455,1.381171,103.902452
544749,614,865,1479,1.388841,103.896552
544750,71,3,74,1.388841,103.896552
544751,488,55,543,1.388841,103.896552
544752,624,190,814,1.388841,103.896552
544753,750,10,760,1.388841,103.896552
544754,601,23,624,1.388841,103.896552
544755,548,200,748,1.388841,103.896552
544756,365,17,382,1.388841,103.896552
544757,396,130,526,1.388841,103.896552
544758,598,1256,1854,1.388841,103.896552
544759,506,1020,1526,1.388841,103.896552
544764,6,4,10,1.299509,103.837
544765,7,0,7,1.299509,103.837
544766,4,0,4,1.299509,103.837
544767,21,1,22,1.299509,103.837
544768,6,1,7,1.299509,103.837
544769,25,0,25,1.299509,103.837
544770,12,0,12,1.299509,103.837
544771,2,0,2,1.299509,103.837
544773,15,48,63,1.299509,103.837
544774,939,615,1554,1.36839,103.877029
544775,388,3,391,1.368468,103.876834
544776,513,3,516,1.368468,103.876834
544777,663,0,663,1.368468,103.876834
544778,498,0,498,1.368468,103.876834
544779,905,8,913,1.368468,103.876834
544780,335,0,335,1.368468,103.876834
544781,201,0,201,1.299509,103.837
544782,52,9,61,1.299509,103.837
544799,345,1469,1814,1.395119,103.890112
544804,498,591,1089,1.381059,103.901039
544805,638,982,1620,1.380767,103.901179
544806,415,365,780,1.381124,103.901703
544807,233,23,256,1.299509,103.837
544808,587,232,819,1.380767,103.901179
544809,686,288,974,1.380767,103.901179
544810,961,113,1074,1.380767,103.901179
544811,1136,1211,2347,1.381472,103.903005
544813,707,659,1366,1.381171,103.902452
544814,814,537,1351,1.38134,103.891311
544815,373,187,560,1.38134,103.891311
544816,743,117,860,1.38134,103.891311
544817,375,39,414,1.38134,103.891311
544818,367,28,395,1.38134,103.891311
544819,833,119,952,1.38134,103.891311
544820,405,40,445,1.38134,103.891311
544821,402,19,421,1.38134,103.891311
544822,378,332,710,1.383907,103.890795
544823,388,692,1080,1.381311,103.891762
544824,39,0,39,1.299509,103.837
544829,205,1413,1618,1.391443,103.893593
544830,629,797,1426,1.390165,103.896014
544831,342,52,394,1.299509,103.837
544832,894,17,911,1.299509,103.837
544833,592,191,783,1.299509,103.837
544834,63,304,367,1.398154,103.884047
544835,6,83,89,1.299509,103.837
544840,8,0,8,1.358546,103.87826
544841,2,0,2,1.299509,103.837
544843,1,1,2,1.358546,103.87826
544844,15,0,15,1.299509,103.837
544845,1,0,1,1.299509,103.837
544848,0,1,1,1.299509,103.837
544851,19,0,19,1.365525,103.883193
544852,1,0,1,1.299509,103.837
544853,0,1,1,1.365525,103.883193
544855,2,0,2,1.358546,103.87826
544856,3,0,3,1.299509,103.837
544858,7,1,8,1.365525,103.883193
544860,38,0,38,1.365525,103.883193
544861,3,21,24,1.365525,103.883193
544869,1,0,1,1.365525,103.883193
544870,69,0,69,1.357014,103.879485
544872,4,0,4,1.357014,103.879485
544874,1,0,1,1.357113,103.879573
544875,6,0,6,1.357014,103.879485
544876,25,0,25,1.357014,103.879485
544877,11,17,28,1.357014,103.879485
544878,7,0,7,1.299509,103.837
544879,2,0,2,1.365525,103.883193
544884,11,123,134,1.390478,103.903987
544885,100,1329,1429,1.39121,103.898967
544889,0,28,28,1.36277,103.875274
544890,1,14,15,1.299509,103.837
544894,797,439,1236,1.361462,103.884451
544895,1220,479,1699,1.360869,103.884989
544896,582,13,595,1.361192,103.884176
544897,858,519,1377,1.360601,103.884686
544898,64,322,386,1.361438,103.88521
544899,5,0,5,1.357113,103.879573
544900,22,0,22,1.357113,103.879573
544901,1,0,1,1.357014,103.879485
544903,91,0,91,1.357113,103.879573
544904,0,3,3,1.365525,103.883193
544909,3,0,3,1.384088,103.882316
544910,8,0,8,1.358546,103.87826
544911,3,0,3,1.361391,103.875419
544912,1,0,1,1.357113,103.879573
544914,135,20,155,1.354867,103.877951
544915,1138,95,1233,1.361811,103.885224
544916,518,312,830,1.361258,103.88547
544917,1107,639,1746,1.3616,103.884912
544918,707,246,953,1.361068,103.885261
544919,107,2,109,1.360154,103.880233
544920,7,0,7,1.360114,103.880272
544921,2,5,7,1.360076,103.880303
544922,6,1,7,1.360035,103.880323
544923,0,6,6,1.36,103.880369
544924,5,10,15,1.359965,103.8804
544925,1,3,4,1.35992,103.880439
544926,2,3,5,1.359883,103.880478
544927,28,3,31,1.359843,103.880515
544928,4,12,16,1.3598,103.880554
544929,2,0,2,1.365292,103.877594
544930,17,25,42,1.359712,103.880633
544934,3,0,3,1.358546,103.87826
544940,24,21,45,1.366082,103.884212
544941,38,2,40,1.366158,103.884134
544942,1,6,7,1.36617,103.884097
544944,1,0,1,1.358546,103.87826
544945,4,0,4,1.360572,103.878106
544946,2,0,2,1.359763,103.880594
544947,9,0,9,1.360385,103.878376
544948,2,0,2,1.360385,103.878376
544949,3,0,3,1.361569,103.879313
544950,12,0,12,1.36076,103.877949
544951,1,0,1,1.360563,103.878133
544953,1,5,6,1.360867,103.877888
544954,39,0,39,1.360748,103.877782
544955,8,0,8,1.360687,103.877817
544957,2,0,2,1.360385,103.878376
544958,8,1,9,1.360237,103.878226
544959,4,84,88,1.360257,103.878263
544964,956,33,989,1.396759,103.886691
544965,871,1313,2184,1.397034,103.886688
544969,340,673,1013,1.390652,103.887283
544974,321,110,431,1.382913,103.89588
544975,7,15,22,1.384123,103.894045
544976,99,372,471,1.384919,103.895245
544979,3,0,3,1.360385,103.878376
544980,20,0,20,1.363638,103.877178
544981,1,0,1,1.360803,103.877919
544982,4,0,4,1.363631,103.877303
544983,17,28,45,1.363637,103.877259
544984,555,994,1549,1.380797,103.894101
544985,611,455,1066,1.381145,103.894173
544986,409,48,457,1.381066,103.893909
544987,455,26,481,1.380859,103.89376
544988,735,3,738,1.380633,103.893697
544989,374,8,382,1.380576,103.893483
544990,535,277,812,1.380506,103.893268
544991,54,35,89,1.380492,103.893765
544992,246,25,271,1.380485,103.894081
544993,553,156,709,1.380461,103.894306
544994,67,1025,1092,1.380834,103.893206
544995,74,176,250,1.380904,103.894293
544996,15,30,45,1.380989,103.895773
544997,323,2323,2646,1.383673,103.890223
544998,652,233,885,1.38134,103.891311
544999,2,0,2,1.360219,103.878208
545000,4,0,4,1.353722,103.874465
545001,2,10,12,1.353942,103.874395
545003,14,0,14,1.361529,103.879356
545004,7,30,37,1.363031,103.884162
545005,2,6,8,1.363147,103.884094
545006,7,1,8,1.363204,103.88404
545007,6,30,36,1.363339,103.883938
545008,11,7,18,1.362723,103.879852
545009,6,1,7,1.362748,103.879881
545011,6,0,6,1.35929,103.880344
545012,2,0,2,1.353693,103.874491
545013,1,0,1,1.363631,103.877332
545014,1,0,1,1.359196,103.880236
545015,245,3623,3868,1.39144,103.892774
545016,4,0,4,1.359957,103.880889
545017,6,13,19,1.359879,103.88082
545018,743,102,845,1.359285,103.882647
545019,638,84,722,1.359119,103.882829
545020,727,34,761,1.359071,103.883138
545021,496,29,525,1.359123,103.88335
545022,471,23,494,1.359249,103.883518
545023,507,89,596,1.359437,103.883715
545024,513,55,568,1.360665,103.883613
545025,606,2258,2864,1.392501,103.894364
545026,7,3,10,1.362652,103.877521
545027,8,0,8,1.361633,103.879274
545028,7,735,742,1.388287,103.911598
545029,141,468,609,1.388678,103.908114
545030,10,36,46,1.381713,103.895797
545033,2,225,227,1.352248,103.874016
545034,15,0,15,1.351466,103.874752
545035,1,0,1,1.359196,103.880236
545037,2,0,2,1.35929,103.880344
545038,42,0,42,1.351466,103.874752
545039,1,33,34,1.351466,103.874752
545040,1194,389,1583,1.380211,103.899741
545041,409,1105,1514,1.380836,103.900344
545042,762,71,833,1.380564,103.899736
545043,950,85,1035,1.380319,103.900398
545044,645,65,710,1.380997,103.899737
545045,916,365,1281,1.381169,103.899737
545046,180,2430,2610,1.384327,103.897182
545047,239,209,448,1.396058,103.893811
545048,417,880,1297,1.396809,103.889694
545049,121,2313,2434,1.386712,103.890526
545050,333,3939,4272,1.389284,103.885833
545051,82,1244,1326,1.39019,103.883953
545052,290,5061,5351,1.383734,103.901884
545053,248,3817,4065,1.387966,103.9051
545054,332,2752,3084,1.391526,103.906039
545055,249,3506,3755,1.394434,103.900537
545056,74,535,609,1.392229,103.886431
545057,20,334,354,1.388741,103.90785
545059,8,0,8,1.360047,103.880177
545060,16,389,405,1.393537,103.890042
545061,2397,15877,18274,1.382662,103.893007
545062,238,81,319,1.391809,103.895539
545063,19,2,21,1.361756,103.879205
545064,80,380,460,1.380059,103.895617
545065,9,10,19,1.361807,103.879173
545066,1,28,29,1.39199,103.903152
545067,2,3,5,1.391919,103.903158
545068,0,10,10,1.391954,103.903155
545069,12,8,20,1.392158,103.903163
545070,6,4,10,1.392169,103.903165
545071,33,1219,1252,1.393858,103.890284
545072,804,32,836,1.388024,103.887406
545073,73,1021,1094,1.393443,103.890234
545074,1,0,1,1.351466,103.874752
545075,1840,227,2067,1.391367,103.895991
545076,432,639,1071,1.391608,103.896569
545077,18,191,209,1.391772,103.896103
545078,6694,47959,54653,1.392272,103.894775
545079,383,3726,4109,1.388713,103.890283
545080,366,110,476,1.391841,103.890834
545081,478,341,819,1.381017,103.899463
545082,2954,4990,7944,1.392002,103.904984
545083,276,638,914,1.396086,103.899711
545084,1868,227,2095,1.390982,103.904487
545085,1671,183,1854,1.39129,103.904647
545086,1602,581,2183,1.391466,103.904697
545087,56,1270,1326,1.389155,103.907046
545088,393,546,939,1.386881,103.903609
545089,62,1,63,1.353542,103.874591
545090,373,162,535,1.385933,103.898397
545091,359,209,568,1.39418,103.897901
545092,222,183,405,1.393196,103.904383
545093,14,1,15,1.368104,103.88334
545094,0,122,122,1.368057,103.884313
545095,4,1,5,1.368051,103.883331
545096,5,279,284,1.368044,103.884381
545097,6,1,7,1.367999,103.88332
545098,3,3,6,1.367938,103.883314
545099,2,0,2,1.351466,103.874752
545100,0,7,7,1.367843,103.883242
545101,6,0,6,1.36789,103.883251
545102,6,8,14,1.367942,103.883255
545103,0,5,5,1.367992,103.883264
545104,0,1,1,1.366737,103.883284
545105,4,2,6,1.368106,103.883284
545106,9,44,53,1.368172,103.883298
545107,2,111,113,1.368239,103.882913
545108,6,1,7,1.368182,103.882902
545109,2,2,4,1.368128,103.882893
545110,2,0,2,1.367877,103.883305
545111,4,6,10,1.368012,103.882871
545113,23,0,23,1.367898,103.882845
545114,3,17,20,1.368349,103.882753
545115,0,1,1,1.368044,103.883269
545116,0,127,127,1.368377,103.882618
545117,14,0,14,1.366198,103.883764
545118,3475,630,4105,1.380007,103.898756
545119,2255,864,3119,1.37986,103.897739
545120,106,551,657,1.380463,103.897484
545121,16,481,497,1.386274,103.906103
545122,830,1559,2389,1.387927,103.905845
545123,248,134,382,1.38663,103.902741
545124,2,130,132,1.38702,103.902539
545125,1688,1083,2771,1.381,103.897905
545126,3,15,18,1.36766,103.878373
545127,7,13,20,1.367545,103.878324
545128,9,10,19,1.367555,103.878369
545129,4,1,5,1.367489,103.87832
545130,23,21,44,1.367402,103.878377
545131,1,0,1,1.36836,103.882695
545132,0,16,16,1.367276,103.878471
545133,34,4,38,1.367398,103.878336
545134,3,3,6,1.367204,103.878616
545135,188,9,197,1.367353,103.878353
545136,2,10,12,1.367195,103.87873
545137,19,2,21,1.367314,103.87838
545138,2,4,6,1.367188,103.878901
545139,5,4,9,1.367266,103.878411
545140,0,5,5,1.367149,103.879008
545141,7,0,7,1.367229,103.878462
545142,2,40,42,1.367088,103.879135
545143,125,0,125,1.367204,103.878514
545144,2,16,18,1.367027,103.879262
545146,6,20,26,1.366966,103.879389
545148,17,10,27,1.366915,103.879506
545149,28,0,28,1.367171,103.878713
545150,3,0,3,1.363633,103.877221
545151,2,0,2,1.368075,103.882885
545152,14,0,14,1.367155,103.8789
545153,0,2,2,1.367171,103.878835
545154,9,4,13,1.367101,103.879034
545155,55,9,64,1.367076,103.879084
545157,1,0,1,1.367446,103.878314
545159,5,0,5,1.366989,103.879259
545160,31,0,31,1.366973,103.879297
545161,10,3,13,1.366955,103.879332
545162,0,2,2,1.367128,103.878985
545163,0,2,2,1.366936,103.879376
545164,1,1,2,1.366916,103.879412
545165,18,1,19,1.366882,103.879495
545166,310,224,534,1.389041,103.899312
545167,1,1,2,1.366897,103.879454
545168,4,0,4,1.36619,103.876722
545169,11,9,20,1.366202,103.876697
545170,2,0,2,1.36617,103.876722
545171,14,0,14,1.366268,103.876646
545172,11,0,11,1.366288,103.876646
545173,4,2,6,1.366333,103.876595
545174,2,0,2,1.366222,103.876697
545175,1,0,1,1.367039,103.879174
545176,5,8,13,1.366418,103.876544
545177,1,4,5,1.366423,103.876491
545178,9,0,9,1.366443,103.876491
545179,1,5,6,1.366101,103.876097
545180,0,2,2,1.366353,103.876595
545181,8,0,8,1.36599,103.876176
545182,1,1,2,1.366064,103.876123
545183,2,1,3,1.367169,103.878775
545184,6,0,6,1.365871,103.876242
545185,2,1,3,1.365851,103.876273
545186,60,0,60,1.36596,103.876178
545188,12,28,40,1.394717,103.904566
545189,0,1,1,1.366398,103.876544
545190,6,3,9,1.366128,103.87606
545191,0,11,11,1.365791,103.875653
545193,5,1,6,1.365724,103.875696
545194,0,2,2,1.365915,103.87623
545195,0,2,2,1.365656,103.87574
545196,13,2,15,1.365532,103.875816
545197,2,3,5,1.365544,103.875792
545198,5,3,8,1.365567,103.875777
545199,22,2,24,1.365612,103.875748
545200,5,0,5,1.365656,103.87572
545201,8,0,8,1.365701,103.875691
545202,6,3,9,1.365746,103.875662
545203,884,333,1217,1.387353,103.895952
545204,9,288,297,1.388059,103.895812
545205,9,1,10,1.365791,103.875633
545206,15,367,382,1.386624,103.897188
545207,2,1,3,1.3659,103.87622
545209,6,242,248,1.389129,103.89806
545210,4,12,16,1.385122,103.882842
545211,58,0,58,1.36029,103.879428
545212,1,1,2,1.365589,103.875783
545214,5,17,22,1.363813,103.883453
545215,5,8,13,1.392269,103.903166
545216,6,1,7,1.392234,103.90316
545217,3,0,3,1.36584,103.875639
545218,8,0,8,1.392136,103.903157
545219,15,7,22,1.392088,103.903155
545220,12,2,14,1.391768,103.903177
545221,1,1,2,1.36029,103.879428
545222,1,0,1,1.366079,103.876093
545223,3,118,121,1.392283,103.903142
545225,1,6,7,1.39225,103.903141
545226,1,3,4,1.39179,103.90317
545227,0,3,3,1.392185,103.903159
545228,1,15,16,1.391545,103.903187
545229,9,1,10,1.392185,103.903139
545230,3,0,3,1.392218,103.90314
545231,0,1,1,1.391812,103.903167
545232,1,9,10,1.391513,103.903196
545233,1,0,1,1.392153,103.903138
545234,33,0,33,1.391599,103.903184
545235,3,0,3,1.39167,103.903178
545236,0,2,2,1.391848,103.903164
545237,0,1,1,1.39212,103.903136
545238,0,1,1,1.392055,103.903134
545240,0,10,10,1.391493,103.903193
545241,3,1,4,1.392006,103.903133
545242,4,84,88,1.391475,103.903195
545243,25,2,27,1.39198,103.903142
545244,3,30,33,1.391447,103.903186
545245,2,2,4,1.391923,103.903138
545246,0,7,7,1.391399,103.903189
545247,2,0,2,1.391564,103.903187
545248,1,5,6,1.391341,103.903182
545249,7,0,7,1.39179,103.903148
545250,5,0,5,1.391283,103.903175
545251,1,1,2,1.391857,103.903143
545252,3,0,3,1.392088,103.903135
545253,5,1,6,1.391657,103.90316
545255,1,1,2,1.391724,103.903154
545256,2,1,3,1.391226,103.903168
545257,1,102,103,1.391524,103.90317
545258,1,0,1,1.391528,103.90319
545259,5,23,28,1.39149,103.903173
545260,7,19,26,1.391244,103.903178
545261,1,21,22,1.391457,103.903176
545262,0,1,1,1.391266,103.903182
545263,7,7,14,1.391307,103.903158
545264,0,4,4,1.391023,103.90315
545265,7,0,7,1.391156,103.90314
545266,1,0,1,1.391077,103.903165
545267,4,0,4,1.391129,103.903127
545268,1,23,24,1.390913,103.903144
545269,5,10,15,1.391054,103.903103
545270,6,334,340,1.390876,103.903144
545271,13,175,188,1.390988,103.903093
545272,62,32,94,1.368711,103.880264
545273,2,0,2,1.39159,103.903165
545274,0,4,4,1.368596,103.880254
545275,25,0,25,1.368534,103.880244
545276,0,392,392,1.368721,103.880254
545277,5,11,16,1.368502,103.880239
545278,1,2,3,1.391259,103.903201
545279,24,20,44,1.368461,103.880224
545280,1,1,2,1.368658,103.880264
545281,16,12,28,1.36841,103.880227
545282,4,0,4,1.368534,103.880224
545283,4,0,4,1.368349,103.88022
545284,2,19,21,1.368502,103.880219
545285,1,2,3,1.368658,103.880244
545286,2,4,6,1.36793,103.880163
545287,1,0,1,1.390959,103.903144
545288,1,7,8,1.367922,103.88011
545289,0,1,1,1.368226,103.880207
545290,7,0,7,1.367925,103.880046
545291,3,0,3,1.368287,103.880214
545292,0,9,9,1.367927,103.879983
545293,22,1,23,1.368042,103.880187
545294,11,0,11,1.36793,103.879919
545295,58,1,59,1.367981,103.88018
545296,46,1,47,1.367931,103.879888
545297,8,4,12,1.367951,103.880176
545298,9,0,9,1.367922,103.879846
545299,25,2,27,1.36791,103.880163
545300,1,9,10,1.36793,103.879899
545302,4,0,4,1.367927,103.879963
545303,3,4,7,1.36778,103.880162
545304,3,5,8,1.367925,103.880026
545305,4,1,5,1.36771,103.880156
545307,1,2,3,1.368104,103.880193
545308,5,8,13,1.367921,103.880121
545309,4,3,7,1.367569,103.880145
545310,4,3,7,1.367371,103.880096
545312,1,2,3,1.36764,103.88015
545313,79,0,79,1.367429,103.880134
545314,2,0,2,1.368596,103.880234
545316,41,1,42,1.367382,103.87994
545317,29,7,36,1.367349,103.880118
545318,48,0,48,1.367389,103.879877
545319,16,4,20,1.367251,103.880111
545320,3,0,3,1.367367,103.880065
545321,16,6,22,1.367144,103.880094
545322,139,12,151,1.367362,103.879979
545323,3,12,15,1.36709,103.880086
545324,22,40,62,1.367221,103.879974
545325,21,7,28,1.367547,103.87891
545326,8,2,10,1.367676,103.878932
545327,4,4,8,1.36776,103.878935
545328,27,1,28,1.36783,103.878942
545329,13,6,19,1.367886,103.878943
545330,12,24,36,1.367957,103.878953
545331,133,1,134,1.368041,103.879051
545333,106,6,112,1.368009,103.878572
545335,1,15,16,1.368006,103.878446
545336,7,0,7,1.367998,103.878386
545337,2,0,2,1.367374,103.880002
545338,14,0,14,1.367994,103.878236
545339,6,2,8,1.368002,103.878186
545340,2,0,2,1.367998,103.878305
545341,3,0,3,1.367393,103.879845
545342,5,8,13,1.368,103.878057
545343,7,0,7,1.367994,103.878025
545344,11,11,22,1.367994,103.877989
545345,5,0,5,1.36799,103.877848
545346,1,1,2,1.367998,103.878141
545347,2,1,3,1.368,103.878091
545348,14,4,18,1.367596,103.878825
545349,0,7,7,1.367973,103.877703
545350,0,3,3,1.367973,103.877739
545351,16,4,20,1.367973,103.877669
545352,1,3,4,1.367808,103.878856
545353,13,2,15,1.367967,103.877637
545354,21,12,33,1.367931,103.878887
545355,2,5,7,1.367974,103.877615
545356,1,0,1,1.368165,103.8802
545357,29,2,31,1.367972,103.877586
545358,10,1,11,1.367968,103.878419
545359,19,1,20,1.367969,103.877555
545360,4,3,7,1.367967,103.878365
545361,1,3,4,1.367969,103.877519
545362,2,1,3,1.367701,103.878855
545363,7,3,10,1.367969,103.877485
545364,4,4,8,1.367964,103.878247
545365,35,5,40,1.367963,103.877453
545366,7,0,7,1.367957,103.87805
545367,37,3,40,1.367966,103.877426
545368,1,0,1,1.367966,103.878456
545369,4,14,18,1.367964,103.877397
545370,1,8,9,1.367939,103.877712
545371,86,3,89,1.367961,103.877366
545373,0,1,1,1.367949,103.877926
545374,2,4,6,1.367929,103.87756
545375,17,8,25,1.367961,103.877296
545376,0,1,1,1.367961,103.87733
545377,1,5,6,1.367955,103.877264
545378,0,6,6,1.367926,103.877431
545379,7,8,15,1.367961,103.877241
545380,6,2,8,1.367919,103.877371
545381,19,10,29,1.367959,103.877212
545382,24,4,28,1.367918,103.877304
545383,1,18,19,1.367956,103.877181
545384,0,2,2,1.367976,103.87777
545385,2,6,8,1.367956,103.877111
545386,1,3,4,1.367915,103.877178
545387,0,29,29,1.36795,103.877079
545388,2,6,8,1.367907,103.877118
545389,0,3,3,1.367967,103.878307
545390,9,5,14,1.367907,103.877037
545391,0,44,44,1.367949,103.876998
545392,0,2,2,1.367915,103.877238
545393,10,408,418,1.367886,103.876907
545394,8,15,23,1.367797,103.876946
545395,2,17,19,1.367824,103.876899
545396,2,10,12,1.367743,103.876942
545397,0,8,8,1.36777,103.876895
545398,0,5,5,1.3677,103.876934
545399,0,8,8,1.367727,103.876887
545400,1,2,3,1.367952,103.877036
545401,4,3,7,1.367693,103.876879
545402,3,11,14,1.367614,103.876921
545403,0,4,4,1.367641,103.876874
545404,8,7,15,1.367567,103.876915
545405,20,1,21,1.367594,103.876868
545406,38,133,171,1.367536,103.876903
545407,2,135,137,1.36754,103.876856
545408,17,5,22,1.368459,103.880157
545409,6,0,6,1.368449,103.880076
545410,4,0,4,1.368516,103.880061
545411,2,1,3,1.367666,103.876926
545412,0,10,10,1.36851,103.880127
545413,2,0,2,1.367859,103.876954
545414,0,11,11,1.368501,103.880171
545415,6,0,6,1.368491,103.879768
545416,1,0,1,1.367922,103.877499
545417,27,0,27,1.368502,103.879663
545418,20,71,91,1.368533,103.879807
545419,0,1,1,1.368518,103.880002
545420,16,7,23,1.368571,103.879615
545421,6,0,6,1.36845,103.879557
545422,25,1,26,1.368386,103.879551
545423,7,2,9,1.368309,103.879542
545424,0,2,2,1.36847,103.879896
545425,92,2,94,1.368226,103.879468
545426,0,4,4,1.368105,103.879521
545427,6,3,9,1.36814,103.879476
545428,3,3,6,1.368043,103.879518
545429,1,2,3,1.368463,103.87999
545430,26,1,27,1.367992,103.879524
545431,2,0,2,1.368156,103.879535
545432,18,14,32,1.367924,103.879514
545433,2,0,2,1.368025,103.879452
545434,0,4,4,1.367851,103.879507
545435,1,2,3,1.368087,103.87946
545436,25,4,29,1.3678,103.879493
545437,52,2,54,1.367835,103.879448
545438,2,6,8,1.367738,103.87949
545439,210,5,215,1.367782,103.879432
545441,0,3,3,1.367912,103.879458
545442,1,0,1,1.368494,103.879578
545443,1,1,2,1.367985,103.879465
545444,3,0,3,1.36772,103.879424
545446,2,1,3,1.36752,103.879456
545447,9,0,9,1.367504,103.879397
545448,36,3,39,1.367407,103.879439
545450,16,8,24,1.367356,103.879445
545451,7,6,13,1.367389,103.879373
545464,1,0,1,1.367593,103.879463
545465,1,0,1,1.36035,103.879682
545466,6,0,6,1.36035,103.879682
545467,2,1,3,1.367469,103.879442
545468,5,0,5,1.36035,103.879682
545469,22,1,23,1.36035,103.879682
545470,2,1,3,1.36035,103.879682
545471,5,0,5,1.36029,103.879428
545472,2,2,4,1.36029,103.879428
545473,1,8,9,1.36029,103.879428
545474,1,1,2,1.367654,103.879414
545475,0,6,6,1.358327,103.874596
545476,28,0,28,1.358762,103.874966
545478,3,1,4,1.358803,103.875024
545479,1,0,1,1.36035,103.879682
545480,1,0,1,1.358447,103.874721
545481,3,0,3,1.36035,103.879682
545482,4,3,7,1.358902,103.875125
545483,1,1,2,1.358691,103.874893
545484,1,0,1,1.358861,103.87507
545485,7,4,11,1.358686,103.874971
545486,12,4,16,1.358965,103.875193
545487,3,0,3,1.358526,103.874804
545488,11,0,11,1.359004,103.875236
545489,14,13,27,1.358845,103.875138
545490,2,0,2,1.358606,103.874888
545491,2,0,2,1.359024,103.875272
545492,1,1,2,1.358925,103.875222
545493,2,14,16,1.359005,103.875305
545506,7,215,222,1.354016,103.877697
545507,0,2,2,1.359056,103.875292
545509,6,40,46,1.354171,103.877534
545510,1,51,52,1.354171,103.877534
545512,1,0,1,1.35893,103.875158
545513,10,53,63,1.354171,103.877534
545514,1,36,37,1.354171,103.877534
545515,0,8,8,1.354171,103.877534
545516,10,45,55,1.354171,103.877534
545517,0,48,48,1.354171,103.877534
545518,0,1,1,1.354171,103.877534
545519,3,0,3,1.358766,103.875055
545521,125,33,158,1.354407,103.877751
545522,10,0,10,1.354476,103.877671
545523,563,59,622,1.354713,103.876947
545524,11,0,11,1.354545,103.877615
545525,13,0,13,1.354611,103.877556
545526,8,131,139,1.354691,103.87748
545527,77,21,98,1.35477,103.877397
545528,28,0,28,1.35477,103.877397
545531,1,0,1,1.354171,103.877534
545532,0,36,36,1.35477,103.877397
545533,21,380,401,1.355201,103.876529
545534,1,168,169,1.355289,103.876455
545535,554,411,965,1.355269,103.877023
545536,25,0,25,1.355756,103.875809
545537,2,3,5,1.355755,103.875808
545538,0,9,9,1.355755,103.875808
545539,10,21,31,1.355758,103.875809
545540,1,36,37,1.355757,103.875808
545542,235,0,235,1.355761,103.875809
545543,13,271,284,1.35576,103.875808
545544,0,10,10,1.35576,103.875808
545545,4,8,12,1.35576,103.875808
545546,9,4,13,1.35576,103.875808
545547,1,1,2,1.354171,103.877534
545548,1,0,1,1.35477,103.877397
545549,1,2,3,1.354255,103.877886
545550,313,2,315,1.356735,103.875939
545551,491,1,492,1.356782,103.875926
545552,57,439,496,1.357082,103.874689
545553,53,622,675,1.356853,103.875881
545554,1,4,5,1.356907,103.875857
545555,24,437,461,1.356713,103.875894
545556,11,95,106,1.356958,103.875833
545557,13,536,549,1.356998,103.875812
545558,5,68,73,1.357026,103.875794
545559,8,529,537,1.357062,103.875777
545560,3,46,49,1.35711,103.875748
545561,20,849,869,1.35714,103.875734
545562,3,3,6,1.357171,103.875718
545563,5,799,804,1.357227,103.875691
545564,0,88,88,1.357285,103.875658
545565,15,460,475,1.357321,103.875634
545566,2,13,15,1.357359,103.875612
545567,7,364,371,1.357417,103.875582
545568,15,348,363,1.357464,103.875554
545569,9,69,78,1.357514,103.875526
545570,26,168,194,1.357567,103.87521
545571,78,198,276,1.357674,103.87514
545572,9,142,151,1.357935,103.875086
545573,6,17,23,1.358011,103.874993
545574,4,17,21,1.35808,103.874921
545575,1,44,45,1.358166,103.874811
545576,38,42,80,1.358229,103.874735
545578,4,89,93,1.35845,103.874517
545579,0,24,24,1.358509,103.874484
545580,2,5,7,1.358565,103.874441
545581,2,4,6,1.358641,103.874388
545583,1,290,291,1.359544,103.873759
545584,3,18,21,1.359682,103.873728
545585,0,20,20,1.359738,103.873716
545586,11,4,15,1.359782,103.87371
545587,4,151,155,1.359139,103.874147
545588,2,87,89,1.359139,103.874147
545589,12,227,239,1.359139,103.874147
545590,1,66,67,1.35991,103.873654
545591,0,10,10,1.359973,103.873632
545592,1,33,34,1.360032,103.873628
545593,2,7,9,1.360086,103.873612
545594,2,28,30,1.360181,103.873579
545595,12,212,224,1.360261,103.873541
545596,0,178,178,1.35938,103.874091
545597,0,59,59,1.359486,103.874072
545598,3,0,3,1.35576,103.875808
545599,0,195,195,1.361302,103.873398
545600,0,85,85,1.359591,103.874052
545601,0,44,44,1.361428,103.873372
545602,1,0,1,1.35576,103.875808
545603,0,59,59,1.359924,103.87395
545604,0,5,5,1.361519,103.873327
545605,1,23,24,1.361577,103.873316
545607,1,31,32,1.361688,103.873287
545608,20,30,50,1.361779,103.873252
545609,5,31,36,1.361885,103.873212
545610,10,177,187,1.360047,103.873917
545611,1,1,2,1.35576,103.875808
545612,11,199,210,1.360734,103.873717
545613,0,44,44,1.362054,103.873125
545614,14,167,181,1.36089,103.873692
545615,2,77,79,1.361251,103.8737
545616,1,5,6,1.361337,103.873677
545617,36,164,200,1.362752,103.873155
545618,1,0,1,1.361428,103.873372
545619,54,218,272,1.361419,103.873641
545620,7,139,146,1.363341,103.87337
545621,4,91,95,1.361508,103.873621
545623,1,10,11,1.361591,103.873608
545624,14,3,17,1.36168,103.873565
545625,1,239,240,1.361759,103.873552
545626,4,43,47,1.361861,103.873529
545627,0,25,25,1.36192,103.873505
545628,7,93,100,1.361983,103.873442
545629,5,62,67,1.362063,103.873423
545630,52,150,202,1.364508,103.873978
545632,3,1,4,1.364565,103.873953
545633,0,39,39,1.362194,103.873453
545634,7,2,9,1.364651,103.873919
545635,1,9,10,1.362276,103.873364
545636,5,0,5,1.364747,103.873889
545637,1,8,9,1.362278,103.873364
545638,0,2,2,1.361974,103.873172
545639,0,103,103,1.36228,103.873364
545640,0,1,1,1.362752,103.873155
545641,32,0,32,1.362283,103.873364
545642,1,0,1,1.364933,103.87386
545643,1,1,2,1.364829,103.873869
545644,1,3,4,1.365115,103.873997
545645,0,29,29,1.362289,103.873365
545646,0,2,2,1.362286,103.873365
545647,6,614,620,1.362291,103.873365
545648,63,1,64,1.365215,103.874152
545649,3,4,7,1.365295,103.874302
545650,2,350,352,1.363435,103.874278
545651,5,17,22,1.365363,103.874394
545652,34,71,105,1.363467,103.874323
545653,72,58,130,1.366578,103.875785
545654,3,22,25,1.366881,103.875904
545655,3,2,5,1.366862,103.876355
545656,7,0,7,1.366952,103.87592
545657,1,0,1,1.365054,103.873919
545658,0,8,8,1.367005,103.875921
545659,0,180,180,1.367368,103.876604
545660,0,23,23,1.367041,103.875955
545661,8,0,8,1.367107,103.875965
545662,6,52,58,1.367172,103.875994
545663,2,0,2,1.365174,103.874086
545664,4,5,9,1.367219,103.876058
545665,9,129,138,1.36728,103.876069
545666,28,0,28,1.367328,103.876115
545667,12,0,12,1.367378,103.876117
545668,13,103,116,1.367431,103.876136
545669,5,667,672,1.367471,103.876166
545670,0,94,94,1.36753,103.876177
545671,112,854,966,1.367971,103.876376
545674,4,19,23,1.362372,103.87337
545676,181,6,187,1.355344,103.877768
545677,227,459,686,1.355857,103.874406
545678,294,7,301,1.356275,103.87635
545679,427,1649,2076,1.354624,103.876902
545680,4,80,84,1.299509,103.837
545689,8,6,14,1.362342,103.879612
545690,17,3,20,1.362294,103.879642
545691,1,3,4,1.362203,103.879616
545692,1,0,1,1.366938,103.876747
545693,6,1,7,1.362158,103.879646
545694,2,2,4,1.362206,103.879709
545695,79,0,79,1.36214,103.879675
545696,26,0,26,1.362158,103.879741
545697,7,7,14,1.362082,103.879694
545698,2,1,3,1.361302,103.873398
545699,1,0,1,1.362251,103.879681
545700,3,1,4,1.361985,103.879761
545701,8,0,8,1.362044,103.879819
545702,71,0,71,1.361931,103.87978
545703,0,2,2,1.367205,103.876
545705,6,0,6,1.361955,103.879884
545706,1,13,14,1.361864,103.879882
545707,9,0,9,1.36185,103.87994
545708,132,5,137,1.361793,103.879904
545720,14,528,542,1.353125,103.876604
545721,5,33,38,1.353152,103.876645
545722,8,0,8,1.353178,103.876672
545723,12,38,50,1.353206,103.876701
545724,9,0,9,1.353237,103.87674
545725,12,24,36,1.353271,103.876781
545726,5,1,6,1.35331,103.876821
545727,9,24,33,1.353338,103.876858
545728,6,0,6,1.353364,103.876889
545729,14,1,15,1.353392,103.876909
545730,6,0,6,1.353418,103.876936
545731,9,8,17,1.353446,103.876971
545732,4,1,5,1.353472,103.876997
545733,21,33,54,1.353508,103.877034
545734,53,3,56,1.353536,103.877079
545747,0,7,7,1.357667,103.876288
545748,1,0,1,1.362024,103.879722
545749,7,3,10,1.357667,103.876288
545750,1,6,7,1.357971,103.875844
545752,6,0,6,1.357596,103.876378
545753,1,0,1,1.357667,103.876288
545754,0,1,1,1.357596,103.876378
545755,0,1,1,1.357928,103.875894
545758,4,1,5,1.357842,103.875995
545760,9,3,12,1.357492,103.876488
545761,3,0,3,1.362115,103.879776
545762,13,1,14,1.357757,103.876096
545763,11,0,11,1.357804,103.875961
545764,0,1,1,1.357916,103.875838
545765,2,0,2,1.362003,103.879847
545767,0,3,3,1.357492,103.876488
545768,3,9,12,1.357296,103.876672
545770,10,22,32,1.357394,103.876612
545772,210,16,226,1.357365,103.876667
545774,3,1,4,1.35732,103.876725
545776,5,1,6,1.35728,103.876784
545778,2,14,16,1.357193,103.876858
545779,53,23,76,1.356965,103.877005
545781,20,1,21,1.357141,103.87692
545782,180,2,182,1.356798,103.877197
545783,6,7,13,1.357091,103.876989
545784,3,11,14,1.356779,103.877177
545785,2,1,3,1.35768,103.876186
545786,1,2,3,1.357045,103.877049
545787,0,3,3,1.35675,103.877147
545788,1,1,2,1.35745,103.876536
545789,3,1,4,1.356913,103.877184
545790,32,0,32,1.356635,103.877027
545791,0,9,9,1.356835,103.877259
545792,6,4,10,1.356577,103.876967
545793,36,87,123,1.356768,103.877347
545794,0,2,2,1.356693,103.877087
545795,46,2,48,1.356462,103.876847
545796,7,11,18,1.356467,103.876873
545797,4,17,21,1.356491,103.876898
545798,2,9,11,1.356541,103.87695
545799,1,19,20,1.35659,103.877001
545800,2,20,22,1.35664,103.877053
545801,39,18,57,1.356689,103.877104
545802,8,45,53,1.356739,103.877156
545803,7,93,100,1.356788,103.877207
545816,3,7,10,1.358325,103.875539
545817,0,14,14,1.35808,103.875844
545818,1,1,2,1.35652,103.876907
545820,4,1,5,1.358248,103.875462
545821,0,3,3,1.356983,103.877106
545822,0,1,1,1.35745,103.876536
545823,2,0,2,1.358295,103.875505
545825,3,1,4,1.358291,103.875812
545826,1,0,1,1.358212,103.875422
545827,4,1,5,1.358336,103.875782
545828,4,1,5,1.358375,103.875743
545829,10,2,12,1.358411,103.875705
545830,0,5,5,1.358453,103.875662
545832,20,2,22,1.358525,103.875596
545835,18,0,18,1.358616,103.875496
545836,2,5,7,1.358394,103.875463
545837,2,1,3,1.358188,103.875851
545838,2,1,3,1.358356,103.875427
545839,5,0,5,1.358293,103.87535
545840,0,3,3,1.35832,103.875389
545841,6,0,6,1.358241,103.875287
545842,12,0,12,1.358217,103.875255
545855,3,46,49,1.362454,103.885039
545856,6,18,24,1.362513,103.885012
545857,0,3,3,1.358264,103.87532
545858,0,1,1,1.358145,103.875351
545859,3,0,3,1.362418,103.884989
545860,0,1,1,1.362464,103.884964
545861,3,1,4,1.362378,103.884923
545862,0,10,10,1.362366,103.884847
545863,13,8,21,1.362361,103.884905
545864,0,3,3,1.362398,103.884959
545865,1,2,3,1.362276,103.884716
545866,0,4,4,1.36231,103.884851
545867,14,4,18,1.362222,103.884667
545868,97,4,101,1.362183,103.884615
545869,3,0,3,1.362335,103.884887
545870,2,8,10,1.362143,103.884556
545871,1,4,5,1.362183,103.884704
545872,12,5,17,1.36216,103.884671
545873,1,2,3,1.362229,103.88476
545874,1,7,8,1.362092,103.884583
545875,1,1,2,1.358229,103.875839
545876,0,3,3,1.362128,103.884628
545877,1,0,1,1.362424,103.884922
545878,1,3,4,1.362006,103.884432
545891,6,131,137,1.361567,103.886004
545892,23,11,34,1.361613,103.885978
545893,40,67,107,1.361641,103.885948
545894,4,28,32,1.361684,103.885915
545895,14,89,103,1.361718,103.885889
545896,1,2,3,1.362036,103.884505
545897,2,45,47,1.361773,103.885794
545898,1,3,4,1.36179,103.885813
545899,0,23,23,1.361802,103.885827
545900,1,1,2,1.362056,103.884541
545901,7,0,7,1.362698,103.88492
545902,0,80,80,1.361894,103.885768
545903,5,9,14,1.362765,103.884872
545904,1,0,1,1.362018,103.884479
545905,1,3,4,1.361938,103.885719
545906,3,1,4,1.362797,103.884846
545907,292,122,414,1.361971,103.88568
545908,55,9,64,1.362887,103.884798
545909,13,0,13,1.362,103.885616
545910,1,52,53,1.362017,103.885639
545912,16,167,183,1.362061,103.8856
545913,0,3,3,1.361764,103.885862
545914,2,10,12,1.363066,103.884649
545915,2,5,7,1.363125,103.884615
545916,21,21,42,1.363194,103.884574
545917,48,30,78,1.363235,103.884541
545930,0,10,10,1.363668,103.884589
545932,10,0,10,1.36398,103.884451
545933,0,1,1,1.361917,103.885695
545934,0,4,4,1.363804,103.884458
545935,4,22,26,1.364149,103.884342
545936,0,2,2,1.361848,103.885794
545937,12,1,13,1.363944,103.884373
545939,4,0,4,1.363898,103.884306
545940,11,5,16,1.364471,103.884533
545941,1,1,2,1.364185,103.884378
545942,4,1,5,1.364432,103.884413
545943,2,0,2,1.36448,103.88449
545944,8,0,8,1.364002,103.88429
545947,10,4,14,1.364359,103.884351
545948,1,0,1,1.363774,103.884485
545949,27,0,27,1.364175,103.884189
545950,15,0,15,1.364304,103.884314
545951,3,9,12,1.364255,103.884251
545952,3,48,51,1.364157,103.884228
545953,9,0,9,1.364204,103.884198
545955,1,0,1,1.364088,103.88427
545956,8,0,8,1.364704,103.883909
545957,25,0,25,1.36475,103.883894
545958,9,1,10,1.364491,103.883957
545959,1,2,3,1.363012,103.88469
545960,1,14,15,1.364888,103.88349
545961,23,4,27,1.364587,103.88388
545962,0,6,6,1.364926,103.883466
545963,20,0,20,1.364631,103.883833
545964,4,0,4,1.364992,103.883456
545965,8,0,8,1.364677,103.883816
545966,54,0,54,1.365074,103.883445
545967,9,6,15,1.364765,103.88374
545968,11,3,14,1.364755,103.883505
545969,48,0,48,1.365166,103.883435
545970,8,0,8,1.365216,103.883438
545971,1,0,1,1.364576,103.883995
545972,100,3,103,1.3653,103.88343
545973,14,26,40,1.365461,103.883434
545974,4,2,6,1.364937,103.88336
545975,1,2,3,1.364544,103.883914
545977,0,8,8,1.36498,103.883207
545978,9,5,14,1.365937,103.883403
545979,9,0,9,1.365005,103.883083
545980,1,0,1,1.364821,103.883437
545981,0,3,3,1.365617,103.88343
545982,148,0,148,1.365065,103.883152
545983,66,0,66,1.365081,103.883177
545984,1,27,28,1.366111,103.883419
545985,1,0,1,1.365034,103.883104
545986,2,0,2,1.364021,103.884326
545987,1,5,6,1.36515,103.883335
545988,10,20,30,1.365407,103.883207
545989,121,0,121,1.365407,103.883207
545990,64,0,64,1.365407,103.883207
545991,1,0,1,1.365084,103.883225
545992,31,0,31,1.365407,103.883207
545993,1,1,2,1.365115,103.883273
545994,9,0,9,1.36568,103.883267
545995,3,0,3,1.366024,103.883415
545996,6,0,6,1.36568,103.883267
545997,1,23,24,1.365833,103.88325
545999,6,0,6,1.365833,103.88325
546000,1,0,1,1.365407,103.883207
546001,12,0,12,1.365833,103.88325
546002,2,0,2,1.365407,103.883207
546003,3,0,3,1.36568,103.883267
546004,5,0,5,1.364027,103.884478
546005,3,20,23,1.365683,103.88341
546006,18,15,33,1.365785,103.883391
546007,6,0,6,1.365833,103.88325
546008,4,0,4,1.365833,103.88325
546009,2,0,2,1.365833,103.88325
546011,271,0,271,1.365833,103.88325
546012,3,0,3,1.364612,103.883979
546013,3,0,3,1.365833,103.88325
546014,3,0,3,1.365833,103.88325
546015,16,9,25,1.362314,103.883736
546018,255,0,255,1.36279,103.883299
546019,336,0,336,1.36276,103.883902
546020,1,18,19,1.36276,103.883902
546022,2,1,3,1.365525,103.883193
546023,2,19,21,1.362387,103.884077
546024,1,0,1,1.365833,103.88325
546025,5,0,5,1.362323,103.884301
546026,33,0,33,1.363257,103.884244
546027,5,0,5,1.363257,103.884244
546028,52,0,52,1.363257,103.884244
546029,16,0,16,1.363257,103.884244
546030,0,8,8,1.362639,103.884013
546031,1,14,15,1.362716,103.884052
546032,15,3,18,1.363408,103.884446
546033,1,0,1,1.362236,103.884265
546035,14,0,14,1.363408,103.884446
546036,3,0,3,1.36245,103.883991
546038,1,12,13,1.362794,103.884137
546039,77,14,91,1.363679,103.884713
546040,41,1,42,1.362913,103.884251
546041,0,3,3,1.363408,103.884446
546042,0,2,2,1.365833,103.88325
546043,0,1,1,1.363408,103.884446
546044,6,1,7,1.363881,103.884893
546045,2,0,2,1.363775,103.884792
546046,0,17,17,1.363967,103.884975
546047,2,0,2,1.363921,103.884937
546048,2,0,2,1.36401,103.885012
546049,2,0,2,1.364056,103.885046
546050,65,8,73,1.364134,103.885113
546051,8,0,8,1.364175,103.885155
546052,8,21,29,1.364219,103.885193
546053,310,170,480,1.299509,103.837
546054,133,1,134,1.299509,103.837
546055,176,2,178,1.299509,103.837
546056,224,1,225,1.36263,103.883897
546057,91,171,262,1.299509,103.837
546065,21,24,45,1.361438,103.878161
546066,152,0,152,1.361662,103.878163
546067,1,67,68,1.361573,103.878253
546068,15,1,16,1.361782,103.878172
546069,49,87,136,1.361662,103.878245
546070,2,0,2,1.3641,103.885087
546071,1,70,71,1.361705,103.87828
546072,7,0,7,1.361899,103.878149
546073,0,2,2,1.361845,103.878174
546075,9,0,9,1.362016,103.878175
546077,0,3,3,1.363734,103.884759
546078,2,3,5,1.361923,103.878265
546079,89,0,89,1.362227,103.878204
546080,18,4,22,1.361953,103.878256
546081,1,0,1,1.363829,103.884844
546082,51,32,83,1.362024,103.87826
546083,8,16,24,1.362258,103.878298
546084,19,7,26,1.36228,103.878289
546085,5,2,7,1.362324,103.878284
546086,5,1,6,1.362395,103.878281
546087,11,4,15,1.362475,103.87829
546088,43,0,43,1.362914,103.878347
546089,5,2,7,1.363013,103.878359
546090,3,0,3,1.361877,103.878277
546092,64,0,64,1.363288,103.878371
546093,6,6,12,1.363345,103.878345
546095,16,2,18,1.364019,103.878295
546096,0,3,3,1.36316,103.878371
546097,12,3,15,1.364099,103.87829
546098,4,12,16,1.364024,103.878407
546099,5,0,5,1.364178,103.878293
546100,3,15,18,1.364141,103.878416
546101,3,0,3,1.363853,103.878387
546102,6,7,13,1.364225,103.878304
546103,0,10,10,1.363659,103.878289
546104,9,0,9,1.363722,103.878295
546105,8,0,8,1.363802,103.878298
546106,0,2,2,1.361924,103.878286
546107,12,1,13,1.363916,103.878306
546115,343,4,347,1.362975,103.876448
546116,11,0,11,1.362943,103.87659
546117,6,5,11,1.363045,103.876445
546119,0,1,1,1.362121,103.878277
546120,3,0,3,1.364268,103.878301
546121,26,123,149,1.38678,103.905633
546122,20,1273,1293,1.387286,103.90523
546133,211,1002,1213,1.362897,103.873579
546134,54,4,58,1.362861,103.873944
546135,27,16,43,1.362825,103.874351
546136,1,7,8,1.362832,103.873643
546137,0,16,16,1.362823,103.873726
546138,0,22,22,1.362814,103.873839
546139,1,16,17,1.362801,103.873935
546140,0,16,16,1.362792,103.87404
546141,25,12,37,1.362779,103.874145
546142,1,35,36,1.362766,103.87425
546143,117,6,123,1.362845,103.874351
546144,54,68,122,1.362831,103.874427
546145,0,1,1,1.363098,103.876465
546146,0,1,1,1.362828,103.874457
546148,1,0,1,1.362827,103.874493
546149,4,7,11,1.362832,103.875402
546150,10,0,10,1.362814,103.875568
546151,43,0,43,1.362808,103.874803
546152,5,0,5,1.363025,103.875672
546153,53,0,53,1.362795,103.875034
546154,13,0,13,1.362794,103.875033
546155,0,4,4,1.362988,103.875724
546156,0,2,2,1.363862,103.878301
546157,7,1,8,1.363075,103.875865
546159,9,17,26,1.36277,103.875474
546160,2,1,3,1.3631,103.876578
546161,1,17,18,1.362769,103.875473
546162,16,10,26,1.362769,103.875473
546163,15,11,26,1.362769,103.875473
546165,15,0,15,1.363064,103.876087
546166,37,0,37,1.363024,103.876179
546167,7,1,8,1.362759,103.875684
546168,11,0,11,1.362758,103.875683
546169,16,3,19,1.362952,103.876286
546170,1,1,2,1.362771,103.875275
546171,9,1,10,1.362936,103.876399
546172,8,14,22,1.36287,103.876486
546173,13,9,22,1.362738,103.876102
546174,14,0,14,1.362737,103.876101
546177,37,1,38,1.362737,103.876101
546178,0,9,9,1.362779,103.876706
546179,3,2,5,1.362778,103.876705
546180,5,2,7,1.362778,103.876705
546181,10,1,11,1.362778,103.876705
546182,1,0,1,1.36282,103.874571
546187,2,0,2,1.362939,103.876339
546188,0,5,5,1.362724,103.877215
546189,33,1,34,1.362696,103.876805
546190,52,3,55,1.363368,103.877916
546191,8,5,13,1.362609,103.878387
546192,3,19,22,1.362602,103.8785
546195,209,0,209,1.36259,103.878727
546196,1,12,13,1.362589,103.878726
546197,3,3,6,1.362589,103.878726
546198,5,3,8,1.362645,103.877668
546200,153,20,173,1.362577,103.878955
546201,4,0,4,1.362576,103.878954
546202,43,1,44,1.36263,103.87796
546203,0,2,2,1.362706,103.876662
546204,3,0,3,1.362769,103.875473
546205,15,0,15,1.362564,103.879181
546206,12,14,26,1.362605,103.878263
546207,2,0,2,1.362629,103.877959
546208,49,0,49,1.362607,103.878395
546209,1,0,1,1.362706,103.876531
546210,5,0,5,1.362584,103.878821
546211,19,6,25,1.362582,103.87882
546212,12,0,12,1.362582,103.87882
546213,0,75,75,1.362582,103.87882
546214,19,0,19,1.362582,103.87882
546215,15,1,16,1.362582,103.87882
546216,83,0,83,1.362552,103.879389
546217,21,7,28,1.362679,103.87709
546218,94,6,100,1.362678,103.877089
546219,6,4,10,1.36265,103.877385
546220,1,7,8,1.362649,103.877384
546221,4,1,5,1.362758,103.875683
546222,47,21,68,1.362758,103.875683
546223,2,30,32,1.362568,103.879105
546224,19,30,49,1.362449,103.879578
546225,8,3,11,1.362697,103.876806
546226,0,7,7,1.362649,103.877384
546227,2,2,4,1.362649,103.877384
546228,0,5,5,1.362649,103.877384
546231,13,3,16,1.362558,103.877388
546232,2,0,2,1.362552,103.879409
546233,3,0,3,1.362565,103.879182
546234,1,0,1,1.362459,103.879588
546235,0,1,1,1.362184,103.877344
546236,23,2,25,1.361946,103.877329
546237,0,1,1,1.362252,103.877369
546238,23,0,23,1.361709,103.877314
546239,1,4,5,1.361845,103.877342
546240,0,1,1,1.362048,103.877356
546242,23,0,23,1.361437,103.877316
546243,10,4,14,1.361366,103.877357
546244,4,0,4,1.362251,103.877368
546245,7,2,9,1.361641,103.877329
546246,11,5,16,1.362047,103.877355
546247,67,0,67,1.361756,103.877269
546256,157,2,159,1.367163,103.882034
546257,10,2,12,1.367141,103.882114
546259,4,13,17,1.366588,103.882225
546260,3,7,10,1.36685,103.882225
546262,6,0,6,1.367044,103.882275
546263,2,4,6,1.367341,103.881746
546264,0,9,9,1.367341,103.881822
546265,1,2,3,1.362456,103.877382
546266,0,2,2,1.362422,103.87736
546267,11,13,24,1.3676,103.881833
546268,5,0,5,1.367293,103.882617
546270,1,1,2,1.367187,103.882385
546271,1,0,1,1.361716,103.877244
546273,6,3,9,1.367855,103.881722
546274,13,2,15,1.367965,103.881722
546275,5,0,5,1.367708,103.882473
546277,12,0,12,1.367824,103.882441
546278,3,1,4,1.367875,103.882428
546279,0,2,2,1.367462,103.882513
546280,2,2,4,1.368017,103.882392
546281,0,15,15,1.367998,103.88224
546282,24,0,24,1.367941,103.882264
546283,4,11,15,1.367879,103.882278
546284,4,0,4,1.367813,103.882286
546285,2,0,2,1.367935,103.882415
546286,1,2,3,1.367105,103.882234
546288,0,1,1,1.367539,103.882504
546289,17,0,17,1.368161,103.881677
546290,255,1,256,1.368013,103.882337
546291,0,42,42,1.368012,103.882336
546292,0,23,23,1.368012,103.882336
546293,0,27,27,1.368012,103.882336
546294,1,32,33,1.368012,103.882336
546295,1,37,38,1.368012,103.882336
546296,1,80,81,1.368012,103.882336
546297,0,6,6,1.368012,103.882336
546298,1,0,1,1.368075,103.881692
546299,46,0,46,1.367195,103.88212
546300,0,18,18,1.36821,103.881707
546301,8,0,8,1.367244,103.882049
546302,1,2,3,1.367702,103.88231
546303,0,10,10,1.367629,103.881846
546304,5,4,9,1.367628,103.881845
546305,1,1,2,1.367758,103.882297
546306,0,11,11,1.367746,103.881819
546307,54,16,70,1.367984,103.881769
546308,2,117,119,1.36822,103.881717
546309,1,1,2,1.367747,103.88182
546310,1,9,10,1.367599,103.881832
546311,2,2,4,1.367599,103.881832
546312,5,0,5,1.367599,103.881832
546313,12,4,16,1.368213,103.881897
546321,24,31,55,1.361042,103.881329
546322,7,0,7,1.361086,103.881293
546323,6,1,7,1.361173,103.881223
546324,7,1,8,1.361261,103.881152
546325,2,0,2,1.367628,103.881845
546326,5,3,8,1.361348,103.881082
546327,1,19,20,1.361341,103.880912
546329,14,0,14,1.361284,103.880865
546330,2,1,3,1.367282,103.881986
546331,5,7,12,1.361193,103.880766
546332,27,1,28,1.361168,103.880739
546333,5,0,5,1.361126,103.880675
546334,86,0,86,1.361087,103.880619
546335,3,2,5,1.361062,103.880585
546337,0,2,2,1.361261,103.881152
546338,4,9,13,1.361421,103.880884
546340,30,0,30,1.361369,103.88079
546341,0,1,1,1.367149,103.882188
546342,16,0,16,1.3613,103.880718
546343,5,4,9,1.361225,103.880647
546345,1,0,1,1.361326,103.880743
546346,7,0,7,1.361556,103.88092
546347,0,2,2,1.361496,103.880966
546348,7,0,7,1.36169,103.880828
546349,3,0,3,1.361251,103.880834
546350,3,18,21,1.36182,103.880523
546351,77,0,77,1.361743,103.880457
546352,4,9,13,1.361692,103.880394
546354,21,0,21,1.361683,103.880381
546355,0,12,12,1.36169,103.880279
546356,29,3,32,1.361751,103.880348
546357,10,5,15,1.361817,103.880402
546358,1,3,4,1.361862,103.880465
546359,1,1,2,1.361624,103.880879
546360,148,2,150,1.362288,103.880403
546361,7,0,7,1.36212,103.880436
546362,0,2,2,1.362226,103.880444
546363,1,4,5,1.362229,103.880381
546365,7,0,7,1.362288,103.880342
546366,0,1,1,1.361108,103.880494
546367,0,1,1,1.362475,103.880281
546368,2,2,4,1.362537,103.88024
546370,0,4,4,1.362599,103.880199
546371,2,0,2,1.36235,103.880362
546373,19,0,19,1.362537,103.88022
546374,4,0,4,1.362723,103.880118
546375,9,3,12,1.36264,103.880152
546376,2,6,8,1.362785,103.880077
546377,6,0,6,1.362744,103.880084
546378,8,5,13,1.362817,103.88007
546379,44,9,53,1.36278,103.880036
546380,1,0,1,1.362352,103.880309
546383,15,0,15,1.361646,103.880313
546384,12,0,12,1.362153,103.880418
546385,7,3,10,1.299509,103.837
546386,3,2,5,1.299509,103.837
546394,2,15,17,1.360565,103.880973
546395,1,0,1,1.361048,103.880497
546397,17,16,33,1.360781,103.881168
546398,0,18,18,1.360781,103.881168
546399,3,3,6,1.360854,103.881214
546401,5,0,5,1.360946,103.881398
546402,4,5,9,1.360977,103.881425
546403,1,11,12,1.361034,103.881238
546404,5,8,13,1.361034,103.881238
546405,1,0,1,1.360709,103.881083
546406,2,0,2,1.362433,103.880288
546407,11,23,34,1.361436,103.881868
546408,227,1,228,1.361436,103.881868
546409,18,1,19,1.361436,103.881868
546410,26,4,30,1.361436,103.881868
546411,2,2,4,1.361436,103.881868
546412,9,3,12,1.361518,103.881854
546414,5,6,11,1.361518,103.881854
546415,92,3,95,1.361186,103.882571
546416,9,1,10,1.36107,103.882697
546417,6,10,16,1.360853,103.882661
546418,10,3,13,1.36156,103.88176
546419,11,11,22,1.361715,103.881767
546420,2,2,4,1.361715,103.881767
546421,2,1,3,1.361859,103.880725
546422,27,7,34,1.361715,103.881767
546423,54,4,58,1.361715,103.881767
546424,4,3,7,1.361715,103.881767
546425,9,0,9,1.361747,103.88172
546426,0,9,9,1.361968,103.881654
546427,10,1,11,1.361842,103.881701
546428,2,4,6,1.362083,103.881597
546429,0,1,1,1.361061,103.881501
546430,322,4,326,1.361852,103.881691
546431,1,0,1,1.362083,103.881597
546432,7,0,7,1.362314,103.881484
546433,5,0,5,1.362083,103.881577
546437,22,4,26,1.362555,103.88136
546438,2,0,2,1.36154,103.88176
546440,3,4,7,1.362798,103.881192
546441,3,0,3,1.361715,103.881767
546443,1,5,6,1.362964,103.881048
546444,0,1,1,1.362314,103.881484
546446,0,10,10,1.363302,103.881258
546447,32,2,34,1.363301,103.881257
546448,2,4,6,1.362955,103.881816
546450,3,3,6,1.363165,103.88139
546451,16,2,18,1.363164,103.88139
546453,4,4,8,1.363018,103.881533
546454,10,1,11,1.363017,103.881532
546455,3,0,3,1.362596,103.881314
546456,10,52,62,1.362954,103.881038
546457,1,0,1,1.362646,103.881279
546458,8,38,46,1.362929,103.881005
546460,4,1,5,1.362904,103.880971
546461,26,1,27,1.363429,103.881153
546462,1,0,1,1.363341,103.881239
546463,3,2,5,1.363487,103.881095
546464,11,0,11,1.362804,103.880838
546465,5,6,11,1.363098,103.880924
546466,1,1,2,1.362535,103.88136
546467,1,0,1,1.362854,103.880905
546468,1,1,2,1.362753,103.880772
546469,0,1,1,1.363441,103.880695
546471,66,3,69,1.362648,103.880605
546472,1,0,1,1.362653,103.880639
546473,3,6,9,1.362723,103.880705
546474,86,0,86,1.362773,103.880772
546475,42,1,43,1.362824,103.880838
546476,3,0,3,1.36287,103.88111
546477,5,2,7,1.362924,103.880971
546478,2,1,3,1.362874,103.880905
546479,3,2,5,1.361968,103.881654
546482,5,0,5,1.362818,103.881964
546483,15,0,15,1.362741,103.882031
546484,3,4,7,1.362654,103.882071
546485,61,0,61,1.361518,103.881854
546487,0,4,4,1.299509,103.837
546491,14,102,116,1.351687,103.87538
546492,5,4,9,1.351719,103.875353
546493,0,2,2,1.362703,103.880705
546494,1,6,7,1.351941,103.875083
546496,0,1,1,1.362673,103.880639
546497,1,0,1,1.352024,103.87501
546498,63,2,65,1.352112,103.874931
546500,2,1,3,1.362964,103.881028
546501,65,3,68,1.352273,103.874854
546502,1,0,1,1.35206,103.874977
546503,3,0,3,1.352274,103.874855
546504,7,18,25,1.352326,103.87481
546505,12,0,12,1.351907,103.875191
546506,0,1,1,1.351844,103.875245
546507,1,0,1,1.352433,103.874722
546508,12,1,13,1.35197,103.875136
546509,2,0,2,1.3519,103.875122
546510,6,0,6,1.352644,103.874543
546514,2,1,3,1.352327,103.874811
546516,1,0,1,1.352432,103.874721
546517,1,0,1,1.352856,103.874365
546519,0,1,1,1.352855,103.874364
546520,3,14,17,1.352259,103.874888
546521,0,9,9,1.352297,103.874856
546522,15,240,255,1.353173,103.874097
546523,11,23,34,1.352372,103.874793
546524,1,96,97,1.353269,103.874018
546525,3,1,4,1.352448,103.874729
546526,1,0,1,1.352962,103.874276
546527,3,0,3,1.352749,103.874453
546528,2,16,18,1.352674,103.874538
546529,2,0,2,1.352033,103.875082
546530,68,9,77,1.352826,103.87441
546532,10,0,10,1.352977,103.874283
546534,1,4,5,1.353128,103.874155
546535,2,0,2,1.35275,103.874474
546536,102,60,162,1.353279,103.874028
546537,13,0,13,1.352825,103.874409
546538,1,1,2,1.353203,103.874092
546539,2,0,2,1.352825,103.874409
546540,2,0,2,1.352825,103.874409
546542,0,3,3,1.352599,103.874601
546549,5,168,173,1.35127,103.87494
546550,4,0,4,1.351269,103.874939
546551,0,124,124,1.351309,103.874902
546552,0,4,4,1.351308,103.874901
546553,2,0,2,1.3529,103.874346
546555,0,3,3,1.352855,103.874364
546556,138,12,150,1.351388,103.874828
546557,1,6,7,1.351387,103.874827
546558,11,0,11,1.351436,103.874803
546559,1,3,4,1.351435,103.874802
546560,2,0,2,1.351367,103.874868
546561,3,0,3,1.351366,103.874867
546562,1,2,3,1.351467,103.874753
546563,2,10,12,1.351546,103.874678
546564,1,1,2,1.351435,103.874802
546565,1,0,1,1.352523,103.874665
546566,72,0,72,1.351641,103.874609
546567,5,0,5,1.351704,103.874529
546569,5,0,5,1.351784,103.874454
546570,0,1,1,1.351625,103.874604
546571,2,110,112,1.351863,103.874379
546572,0,1,1,1.351778,103.874479
546573,4,4,8,1.351942,103.874305
546574,2,0,2,1.351573,103.874673
546575,2,2,4,1.352021,103.87423
546576,16,11,27,1.351984,103.874285
546577,0,7,7,1.3521,103.874155
546578,2,0,2,1.351915,103.87435
546579,1,17,18,1.352179,103.874081
546580,0,1,1,1.351847,103.874414
546581,81,7,88,1.352189,103.874091
546582,29,97,126,1.352258,103.874026
546583,5,5,10,1.351264,103.874965
546588,3,1,4,1.351466,103.874752
546589,2,0,2,1.352052,103.87422
546591,1,4,5,1.351466,103.874752
546592,3,2,5,1.351466,103.874752
546593,1,55,56,1.351466,103.874752
546594,3,0,3,1.351504,103.874738
546609,2,7,9,1.405931,103.903904
546636,89,102,191,1.380224,103.896888
546637,93,483,576,1.380326,103.896388
546638,7,565,572,1.391578,103.901168
546639,0,15,15,1.391596,103.901165
546640,0,14,14,1.391631,103.901158
546642,2,72,74,1.391667,103.901151
546643,0,60,60,1.391703,103.901143
546644,8,23,31,1.391739,103.901136
546645,2,17,19,1.391775,103.901129
546646,8,31,39,1.39181,103.901122
546647,5,8,13,1.391846,103.901115
546648,0,17,17,1.391882,103.901107
546649,11,3,14,1.391917,103.9011
546650,31,17,48,1.391953,103.901093
546651,2,0,2,1.351466,103.874752
546652,2,21,23,1.392014,103.901082
546653,13,0,13,1.392039,103.901077
546654,4,14,18,1.392088,103.901069
546655,1,6,7,1.392138,103.90106
546656,0,18,18,1.392188,103.901052
546657,121,1,122,1.392237,103.901043
546658,31,36,67,1.392287,103.901034
546659,1,20,21,1.392337,103.901026
546660,5,1,6,1.392387,103.901017
546661,0,20,20,1.392436,103.901009
546662,1,91,92,1.392476,103.90101
546663,6,92,98,1.392537,103.900994
546664,2,192,194,1.392588,103.900987
546665,3,305,308,1.392691,103.900974
546666,2,291,293,1.392795,103.900967
546667,7,349,356,1.392901,103.900963
546668,4,94,98,1.393008,103.900961
546669,0,200,200,1.393114,103.900957
546670,4,639,643,1.393157,103.900966
546672,42,600,642,1.420178,103.910201
546673,31,1336,1367,1.385113,103.900599
546674,37,147,184,1.39217,103.901473
546684,494,211,705,1.36747,103.877155
546685,817,0,817,1.367169,103.877867
546686,48,0,48,1.367013,103.87771
546687,222,0,222,1.366886,103.877299
546692,202,20,222,1.367421,103.87664
546693,243,14,257,1.367421,103.87664
546694,106,0,106,1.367421,103.87664
546695,153,1,154,1.367421,103.87664
546700,0,10,10,1.365158,103.885009
546701,0,25,25,1.36523,103.885029
546702,1,0,1,1.352121,103.874155
546703,512,93,605,1.365716,103.884247
546704,33,4,37,1.365233,103.884927
546705,3,28,31,1.365275,103.884895
546706,5,22,27,1.36532,103.884871
546707,32,56,88,1.365431,103.884743
546708,1,1,2,1.391979,103.901096
546709,6,8,14,1.366192,103.883815
546710,1,0,1,1.365196,103.884961
546711,8,0,8,1.366049,103.88384
546712,6,2,8,1.366222,103.883672
546713,21,0,21,1.366265,103.883594
546714,1,0,1,1.366219,103.883699
546715,1,4,5,1.366276,103.883517
546718,28,0,28,1.366316,103.883381
546719,8,7,15,1.366218,103.883314
546720,14,2,16,1.36624,103.88324
546721,3,20,23,1.366325,103.883314
546722,98,0,98,1.366078,103.883126
546724,1,0,1,1.36613,103.883705
546725,23,1,24,1.366293,103.883028
546726,2,0,2,1.365987,103.883899
546727,6,8,14,1.366336,103.883168
546728,6,0,6,1.366836,103.88326
546729,13,0,13,1.366697,103.883259
546730,10,3,13,1.366764,103.883254
546732,3,14,17,1.366895,103.883305
546733,24,1,25,1.366361,103.882801
546734,26,2,28,1.366367,103.88276
546735,0,1,1,1.366335,103.883258
546736,2,2,4,1.366377,103.882654
546737,3,2,5,1.366392,103.883008
546738,0,3,3,1.351466,103.874752
546739,4,17,21,1.366439,103.882908
546742,9,0,9,1.366737,103.883105
546743,1,0,1,1.366371,103.882706
546744,1,1,2,1.366331,103.882969
546745,2,2,4,1.366895,103.883208
546746,19,1,20,1.366947,103.883194
546747,119,0,119,1.367023,103.883028
546748,0,3,3,1.366403,103.882954
546749,13,0,13,1.36638,103.882593
546750,6,0,6,1.366404,103.88253
546751,27,0,27,1.366426,103.882463
546752,52,1,53,1.366404,103.882463
546753,8,1,9,1.366442,103.882396
546754,4,0,4,1.366472,103.882635
546755,2,7,9,1.366475,103.882605
546756,6,0,6,1.36651,103.882532
546757,0,11,11,1.366547,103.882483
546758,0,6,6,1.366483,103.882287
546759,0,1,1,1.366812,103.883129
546760,34,3,37,1.366513,103.882135
546761,0,2,2,1.366855,103.88314
546762,1,7,8,1.366547,103.882015
546763,7,1,8,1.366571,103.882255
546764,5,0,5,1.366548,103.881956
546765,62,4,66,1.366589,103.882171
546766,14,3,17,1.366552,103.88188
546767,0,10,10,1.366603,103.882053
546768,0,2,2,1.366659,103.882387
546769,0,16,16,1.366621,103.881918
546770,1,0,1,1.366554,103.88234
546771,3,32,35,1.366626,103.881817
546772,3,1,4,1.366695,103.881334
546773,3,10,13,1.366729,103.881235
546774,4,0,4,1.366745,103.881164
546775,6,0,6,1.366753,103.8811
546776,300,84,384,1.366779,103.880148
546777,413,12,425,1.366565,103.880274
546778,28,17,45,1.366328,103.880371
546779,132,24,156,1.365781,103.88034
546782,27,35,62,1.36584,103.880055
546785,456,187,643,1.366271,103.87997
546787,78,8,86,1.366664,103.879942
546789,67,25,92,1.366837,103.879949
546791,11,1,12,1.366213,103.881713
546792,13,4,17,1.366274,103.881701
546793,1,2,3,1.367147,103.88301
546794,2,9,11,1.366263,103.88163
546795,4,0,4,1.366193,103.881577
546796,12,4,16,1.366248,103.881551
546797,7,3,10,1.366185,103.881522
546798,8,6,14,1.366237,103.881463
546799,15,0,15,1.366169,103.881478
546800,0,6,6,1.36622,103.881401
546801,5,2,7,1.366164,103.881424
546803,7,0,7,1.366154,103.881371
546804,1,1,2,1.366617,103.881998
546805,29,14,43,1.366148,103.881322
546806,3,0,3,1.366208,103.881646
546808,25,1,26,1.366156,103.881092
546809,5,1,6,1.366129,103.881231
546812,2,7,9,1.366125,103.880924
546813,0,1,1,1.366623,103.881863
546814,0,1,1,1.366105,103.881112
546815,138,0,138,1.366093,103.881064
546816,5,0,5,1.36622,103.880793
546817,24,1,25,1.366077,103.880995
546818,2,0,2,1.366184,103.881249
546819,0,1,1,1.366118,103.880842
546820,2,0,2,1.36637,103.88076
546821,5,2,7,1.366054,103.880891
546822,46,7,53,1.366704,103.880713
546823,3,0,3,1.366171,103.88118
546824,5,5,10,1.366083,103.880752
546825,2,0,2,1.366507,103.88075
546827,40,4,44,1.3662,103.880713
546828,0,4,4,1.366305,103.880694
546829,2,2,4,1.366345,103.880692
546830,1,1,2,1.366138,103.880724
546831,16,0,16,1.366519,103.880662
546832,9,1,10,1.366559,103.880664
546833,25,2,27,1.366632,103.880648
546834,1,1,2,1.36647,103.880661
546835,15,39,54,1.366797,103.880611
546848,4,2,6,1.366829,103.881361
546849,3,2,5,1.366901,103.881367
546850,5,0,5,1.366951,103.881374
546851,137,1,138,1.367026,103.881387
546852,21,1,22,1.367099,103.881402
546853,2,0,2,1.366705,103.880622
546854,1,6,7,1.367227,103.881418
546855,46,11,57,1.367305,103.881427
546856,1,0,1,1.366068,103.880949
546857,3,1,4,1.367481,103.881435
546859,1,0,1,1.3674,103.88144
546860,35,1,36,1.36784,103.881321
546861,3,0,3,1.366044,103.880775
546862,0,1,1,1.367665,103.881364
546863,6,13,19,1.368425,103.881286
546865,0,6,6,1.367199,103.881468
546866,1,1,2,1.367171,103.881415
546867,10,38,48,1.36852,103.881089
546868,10,0,10,1.368283,103.881005
546869,1,18,19,1.368556,103.880997
546870,0,3,3,1.367983,103.881317
546871,8,90,98,1.368609,103.880836
546872,5,3,8,1.368273,103.880816
546873,3,1,4,1.368553,103.880816
546874,1,4,5,1.36819,103.8808
546875,9,3,12,1.36847,103.8808
546876,7,0,7,1.368105,103.880783
546877,9,0,9,1.368385,103.880783
546878,2,1,3,1.368306,103.880911
546879,2,8,10,1.368311,103.88077
546880,27,1,28,1.367963,103.880759
546881,12,2,14,1.368243,103.880759
546882,0,2,2,1.368262,103.881096
546883,15,1,16,1.368183,103.880756
546884,9,2,11,1.367837,103.880748
546886,173,0,173,1.367761,103.880741
546887,5,6,11,1.368051,103.880719
546888,8,1,9,1.367673,103.880734
546889,8,1,9,1.367983,103.880708
546890,1,0,1,1.368197,103.881287
546891,10,0,10,1.367923,103.880705
546892,2,0,2,1.367903,103.880756
546893,15,2,17,1.367857,103.880697
546894,4,0,4,1.367325,103.880716
546895,71,2,73,1.367781,103.88069
546896,2,0,2,1.367423,103.880716
546897,48,0,48,1.367693,103.880683
546898,3,2,5,1.367115,103.880694
546899,2,1,3,1.368031,103.88077
546900,7,0,7,1.366976,103.880682
546901,0,1,1,1.367552,103.880727
546902,4,2,6,1.367504,103.880667
546903,0,3,3,1.367632,103.880681
546904,1,0,1,1.367564,103.88067
546905,0,1,1,1.367362,103.880652
546906,1,0,1,1.367274,103.880645
546907,4,1,5,1.367162,103.880639
546908,1,2,3,1.367438,103.880659
546909,28,9,37,1.367015,103.880629
546920,283,0,283,1.363739,103.87453
546921,17,2,19,1.363708,103.874738
546922,0,1,1,1.367228,103.880647
546923,5,0,5,1.363749,103.875297
546925,9,10,19,1.363696,103.874691
546926,1,0,1,1.363755,103.875216
546927,16,0,16,1.363677,103.874949
546928,37,0,37,1.363687,103.875026
546929,2,0,2,1.367243,103.880702
546930,10,0,10,1.36373,103.875769
546931,0,3,3,1.367086,103.880632
546932,1,3,4,1.363711,103.876009
546934,26,6,32,1.363697,103.876105
546935,3,0,3,1.363718,103.875907
546936,1,0,1,1.363738,103.875501
546937,1,0,1,1.36366,103.875675
546938,19,23,42,1.363681,103.876358
546939,4,11,15,1.363663,103.876455
546940,2,0,2,1.363725,103.875663
546941,1,0,1,1.363651,103.875707
546942,42,0,42,1.363671,103.876505
546943,7,2,9,1.363655,103.876629
546944,8,2,10,1.363631,103.876189
546945,1,1,2,1.363635,103.875879
546946,21,11,32,1.36365,103.876737
546947,59,2,61,1.363644,103.876818
546948,11,0,11,1.363583,103.87639
546949,0,4,4,1.363576,103.876445
546950,21,5,26,1.363655,103.876987
546951,5,0,5,1.363643,103.877076
546953,9,12,21,1.363636,103.877426
546954,5,3,8,1.363577,103.876857
546955,11,3,14,1.36358,103.876892
546956,2,0,2,1.363621,103.876297
546957,4,0,4,1.363565,103.877008
546958,9,3,12,1.363623,103.877637
546959,4,0,4,1.363552,103.877238
546960,0,2,2,1.363646,103.877463
546961,1,0,1,1.363624,103.875915
546963,2,0,2,1.363608,103.877704
546964,4,2,6,1.363563,103.878701
546965,3,3,6,1.363533,103.878793
546966,0,2,2,1.363549,103.878655
546967,10,4,14,1.363543,103.878917
546969,5,2,7,1.363529,103.879146
546970,2,0,2,1.363457,103.878823
546972,2,1,3,1.363696,103.876214
546973,43,0,43,1.363518,103.879455
546975,2,0,2,1.363536,103.879191
546976,0,25,25,1.363535,103.879597
546977,0,1,1,1.363579,103.877888
546978,2,0,2,1.363442,103.879021
546979,1,0,1,1.36346,103.879131
546980,3,1,4,1.363519,103.879784
546981,1,0,1,1.363474,103.879183
546982,1,0,1,1.363518,103.879903
546983,1,0,1,1.36345,103.879421
546984,30,1,31,1.363512,103.879989
546985,1,1,2,1.363437,103.879173
546986,6,0,6,1.363396,103.879622
546987,6,0,6,1.363396,103.879622
546989,3,0,3,1.363523,103.879349
546990,7,1,8,1.363494,103.880105
546991,0,1,1,1.36345,103.879421
546992,2,0,2,1.363509,103.88002
546993,4,0,4,1.363386,103.879887
546994,20,20,40,1.364181,103.880221
546995,3,0,3,1.363494,103.880105
546996,294,2,296,1.36418,103.88022
546997,7,0,7,1.36418,103.88022
546998,0,1,1,1.363391,103.879752
546999,0,1,1,1.363382,103.880171
547001,1,1,2,1.363379,103.879812
547002,4,0,4,1.363206,103.88017
547003,41,1,42,1.363769,103.880204
547004,1,1,2,1.363934,103.880211
547005,4,0,4,1.363605,103.880198
547006,1,0,1,1.364098,103.880217
547007,5,0,5,1.36344,103.880191
547008,4,0,4,1.363689,103.874778
547010,0,2,2,1.363089,103.88017
547011,0,1,1,1.363033,103.880099
547012,0,17,17,1.36377,103.874982
547013,0,1,1,1.363785,103.874903
547014,3,1,4,1.363761,103.875132
547015,9,29,38,1.363776,103.874866
547016,6,0,6,1.363521,103.879728
547017,7,1,8,1.363556,103.878531
547018,322,9,331,1.36356,103.878413
547019,3,1,4,1.365926,103.877874
547020,4,20,24,1.365922,103.877965
547021,0,1,1,1.363764,103.875091
547023,3,0,3,1.36418,103.88022
547024,56,1,57,1.365948,103.87806
547025,45,2,47,1.366009,103.878041
547026,20,0,20,1.365991,103.878181
547027,0,2,2,1.363657,103.877506
547028,15,8,23,1.366005,103.878289
547029,4,0,4,1.366041,103.878143
547030,12,0,12,1.365999,103.878345
547031,0,3,3,1.365987,103.878004
547032,5,8,13,1.366006,103.878414
547033,7,0,7,1.366069,103.878255
547034,7,0,7,1.365974,103.878549
547036,4,2,6,1.365945,103.878635
547037,1,8,9,1.366065,103.878393
547038,4,0,4,1.366063,103.878437
547039,1,4,5,1.366048,103.878486
547040,20,0,20,1.366053,103.87854
547041,2,5,7,1.366038,103.878572
547042,4,0,4,1.366027,103.878616
547043,3,0,3,1.366062,103.878194
547044,2,0,2,1.366009,103.878095
547046,0,3,3,1.366013,103.878717
547047,4,0,4,1.366057,103.878985
547048,1,1,2,1.365998,103.878755
547061,35,8,43,1.365346,103.878442
547062,15,0,15,1.365146,103.878676
547064,5,3,8,1.365286,103.878609
547065,1,1,2,1.366057,103.878999
547066,2,2,4,1.365311,103.878674
547067,1,0,1,1.365953,103.877932
547068,3,0,3,1.366023,103.878851
547070,0,1,1,1.365405,103.878649
547071,6,10,16,1.365491,103.87872
547072,2,0,2,1.365385,103.878613
547074,5,0,5,1.365456,103.87893
547075,7,0,7,1.365617,103.878808
547076,126,0,126,1.365542,103.878928
547077,1,0,1,1.365307,103.87883
547079,0,2,2,1.365381,103.878883
547081,91,4,95,1.365678,103.87888
547082,0,2,2,1.365783,103.878777
547083,0,1,1,1.365711,103.878729
547084,2,6,8,1.365743,103.87907
547085,9,7,16,1.365833,103.879106
547086,12,2,14,1.366507,103.879602
547088,0,2,2,1.365656,103.878955
547100,17,0,17,1.366334,103.877243
547101,2,4,6,1.366422,103.877647
547102,2,1,3,1.365279,103.87867
547103,1,0,1,1.365687,103.879026
547104,0,2,2,1.299509,103.837
547105,17,1,18,1.36648,103.877852
547107,16,0,16,1.366508,103.87796
547108,1,1,2,1.366357,103.877309
547109,3,5,8,1.366528,103.878022
547111,1,0,1,1.366445,103.877755
547112,0,1,1,1.366547,103.878086
547113,4,3,7,1.366564,103.878145
547114,20,0,20,1.366416,103.87751
547116,1,3,4,1.366434,103.877571
547117,0,3,3,1.366344,103.877276
547118,7,0,7,1.366451,103.877632
547119,9,0,9,1.366572,103.878364
547121,4,1,5,1.366567,103.878434
547122,0,6,6,1.366487,103.877754
547123,4,3,7,1.366557,103.878502
547124,3,3,6,1.366504,103.877816
547125,3,0,3,1.366578,103.878283
547126,15,3,18,1.366522,103.877877
547127,14,8,22,1.36654,103.87864
547128,1,0,1,1.366407,103.877479
547129,1,0,1,1.36654,103.877938
547130,37,7,44,1.366558,103.877999
547131,2,0,2,1.366382,103.877386
547132,5,0,5,1.366575,103.87806
547133,6,0,6,1.366517,103.878819
547134,1,5,6,1.366593,103.878121
547135,19,2,21,1.366502,103.878892
547136,9,0,9,1.366602,103.878152
547138,1,0,1,1.366533,103.878704
547139,4,6,10,1.366461,103.878996
547140,0,4,4,1.366609,103.878317
547141,1,3,4,1.366433,103.879057
547143,6,1,7,1.366393,103.879115
547144,7,1,8,1.366591,103.878441
547145,14,7,21,1.366361,103.879175
547146,1,0,1,1.366613,103.878266
547147,8,0,8,1.366334,103.879227
547148,23,3,26,1.366573,103.878565
547149,41,2,43,1.366307,103.879264
547150,22,0,22,1.366564,103.878627
547151,2,6,8,1.366288,103.879311
547152,6,1,7,1.366555,103.878689
547153,4,1,5,1.366334,103.879478
547155,1,0,1,1.366582,103.878503
547156,22,1,23,1.366537,103.878813
547157,9,7,16,1.366271,103.87957
547158,1,1,2,1.366524,103.878752
547159,6,0,6,1.366256,103.879606
547160,5,0,5,1.366515,103.878936
547161,0,7,7,1.366234,103.879624
547162,0,7,7,1.366492,103.878996
547164,2,0,2,1.366528,103.878875
547165,48,2,50,1.366173,103.879706
547166,6,12,18,1.36643,103.879109
547167,17,0,17,1.366162,103.879747
547168,1,1,2,1.366462,103.879054
547169,1,1,2,1.366398,103.879164
547170,7,3,10,1.366344,103.879258
547171,23,0,23,1.366324,103.879296
547172,8,4,12,1.366304,103.879331
547173,0,1,1,1.3663,103.879538
547174,30,2,32,1.366276,103.879616
547175,2,1,3,1.366547,103.878568
547188,12,24,36,1.364438,103.878343
547189,16,3,19,1.364531,103.878357
547190,1,3,4,1.364597,103.878361
547191,31,2,33,1.364911,103.878442
547192,5,1,6,1.364741,103.878359
547193,4,19,23,1.365021,103.87844
547194,0,2,2,1.366367,103.879218
547195,2,0,2,1.364795,103.878363
547196,3,0,3,1.366186,103.879755
547197,3,0,3,1.365211,103.87828
547199,15,0,15,1.365414,103.878262
547201,4,2,6,1.365554,103.878095
547202,4,2,6,1.365576,103.878086
547203,12,1,13,1.36561,103.878063
547207,673,2518,3191,1.384394,103.897511
547216,11,3,14,1.364437,103.876452
547217,1,1,2,1.365099,103.878507
547218,5,25,30,1.364511,103.876617
547219,6,10,16,1.364498,103.876809
547220,0,7,7,1.364498,103.876809
547221,58,2,60,1.364478,103.876981
547222,1,1,2,1.364437,103.876452
547223,4,0,4,1.36442,103.876674
547224,6,0,6,1.364478,103.877132
547225,1,1,2,1.364437,103.876586
547226,2,2,4,1.364418,103.876783
547227,17,0,17,1.364418,103.876783
547228,0,1,1,1.366375,103.879467
547231,0,3,3,1.365243,103.878292
547234,1,2,3,1.364442,103.877618
547235,1,5,6,1.364434,103.877712
547236,10,0,10,1.364434,103.877712
547237,5,16,21,1.364434,103.877712
547238,0,1,1,1.364466,103.877235
547239,0,2,2,1.364478,103.877132
547241,5,0,5,1.364417,103.878059
547242,25,0,25,1.36436,103.877646
547243,12,1,13,1.364354,103.877768
547244,11,6,17,1.364334,103.878611
547245,8,2,10,1.36433,103.878743
547246,0,6,6,1.36433,103.878743
547247,1,6,7,1.364318,103.878889
547248,3,14,17,1.364314,103.878999
547249,0,34,34,1.364314,103.878999
547250,14,5,19,1.36431,103.87908
547251,1,4,5,1.36429,103.879186
547252,19,3,22,1.364285,103.879292
547253,0,4,4,1.364269,103.879564
547254,1,4,5,1.364265,103.879656
547255,5,0,5,1.365561,103.879965
547257,3,2,5,1.364253,103.879891
547258,9,1,10,1.364279,103.881137
547260,11,4,15,1.364247,103.879971
547261,70,9,79,1.364205,103.880603
547262,4,1,5,1.363972,103.88079
547263,1,0,1,1.364372,103.877524
547264,1,2,3,1.364399,103.877
547265,4,8,12,1.364182,103.880973
547268,36,0,36,1.364399,103.877
547269,3,8,11,1.36436,103.877646
547270,58,11,69,1.36436,103.877646
547271,4,1,5,1.364407,103.876911
547272,21,70,91,1.364407,103.876911
547273,1,1,2,1.364372,103.877524
547274,25,0,25,1.364275,103.879451
547278,3,14,17,1.361205,103.879453
547279,9,2,11,1.361179,103.87942
547280,5,0,5,1.361133,103.879349
547281,0,6,6,1.361085,103.879275
547282,1,0,1,1.3642,103.880754
547283,0,4,4,1.360985,103.879214
547284,4,4,8,1.36129,103.879325
547285,2,5,7,1.36116,103.879251
547286,70,55,125,1.361111,103.879167
547287,1,7,8,1.360857,103.87893
547288,0,1,1,1.361027,103.879265
547289,18,6,24,1.36027,103.879013
547290,4,0,4,1.36071,103.878787
547291,1,0,1,1.360816,103.878884
547293,4,9,13,1.360601,103.878672
547295,2,0,2,1.364282,103.879416
547297,20,38,58,1.360319,103.878362
547312,373,217,590,1.360555,103.877706
547313,14,14,28,1.359939,103.877918
547314,6,3,9,1.359857,103.877863
547315,791,18,809,1.359533,103.878804
547319,3,0,3,1.364196,103.880838
547320,467,3,470,1.36008,103.878227
547324,3,6,9,1.359696,103.877726
547325,193,31,224,1.359779,103.878031
547330,19,0,19,1.359656,103.877681
547331,7,1,8,1.35959,103.87773
547332,44,0,44,1.359627,103.877771
547333,10,24,34,1.359679,103.877836
547334,2,0,2,1.360511,103.878524
547335,5,1,6,1.359468,103.877625
547337,20,5,25,1.359536,103.877539
547338,1,6,7,1.360946,103.879163
547339,1,4,5,1.360902,103.879121
547341,24,8,32,1.360823,103.879025
547342,5,0,5,1.360779,103.878964
547343,2,2,4,1.360743,103.878912
547345,1,6,7,1.360656,103.878836
547346,136,15,151,1.360615,103.878793
547347,4,0,4,1.360356,103.878372
547348,5,0,5,1.36048,103.878205
547349,1,0,1,1.360687,103.878758
547350,10,637,647,1.299509,103.837
547352,1,5,6,1.299509,103.837
547354,0,9,9,1.299509,103.837
547356,0,3,3,1.359742,103.877778
547358,0,18,18,1.372179,103.858254
547361,2,41,43,1.360607,103.884216
547362,0,6,6,1.36056,103.884292
547363,0,2,2,1.359616,103.877635
547364,0,2,2,1.360402,103.88441
547365,0,2,2,1.360497,103.884348
547367,1,5,6,1.360423,103.884452
547368,2,6,8,1.360509,103.884305
547370,2,4,6,1.360676,103.884136
547375,4,10,14,1.361474,103.883319
547377,1,23,24,1.361549,103.883389
547378,2,0,2,1.360456,103.884356
547380,7,2,9,1.361595,103.88344
547381,0,13,13,1.361635,103.883486
547384,12,1,13,1.36171,103.883582
547385,2,2,4,1.361759,103.883641
547386,1,0,1,1.360541,103.878168
547388,0,2,2,1.361549,103.883389
547389,28,1,29,1.361892,103.883772
547390,0,1,1,1.361796,103.883673
547393,0,9,9,1.361558,103.883297
547394,0,8,8,1.361603,103.883343
547395,12,2,14,1.361649,103.883389
547396,6,0,6,1.361692,103.883447
547398,104,1,105,1.361775,103.883531
547399,11,2,13,1.361821,103.883576
547400,1,0,1,1.361927,103.883827
547401,1,2,3,1.299509,103.837
547402,1,0,1,1.361867,103.883622
547403,1,9,10,1.361974,103.883762
547404,8,7,15,1.361869,103.882938
547405,11,3,14,1.361903,103.882989
547406,0,1,1,1.361953,103.883707
547407,5,1,6,1.361966,103.88308
547408,6,0,6,1.362006,103.883125
547409,6,5,11,1.362047,103.883171
547410,0,1,1,1.361932,103.883034
547411,0,6,6,1.362127,103.883262
547412,4,0,4,1.362167,103.883313
547413,1,2,3,1.361908,103.883689
547414,3,20,23,1.361021,103.883569
547415,1,3,4,1.361058,103.883494
547416,3,29,32,1.361911,103.882831
547418,2,3,5,1.361057,103.883494
547420,3,0,3,1.362213,103.883359
547421,6,5,11,1.361141,103.883417
547424,6,19,25,1.361162,103.883388
547425,1,7,8,1.360917,103.88328
547426,91,16,107,1.360838,103.883194
547429,84,9,93,1.361266,103.883222
547430,2,0,2,1.361854,103.883743
547431,2,16,18,1.361168,103.883058
547432,0,10,10,1.361089,103.883017
547433,0,14,14,1.361046,103.882965
547434,0,4,4,1.360993,103.882898
547435,1,8,9,1.360969,103.882877
547436,3,0,3,1.362055,103.883036
547437,15,3,18,1.360912,103.882766
547439,1,8,9,1.3613,103.88323
547440,0,7,7,1.361367,103.883154
547441,111,3,114,1.361369,103.883125
547442,24,0,24,1.361279,103.88297
547444,11,1,12,1.361414,103.882891
547446,1,0,1,1.362087,103.883222
547447,8,0,8,1.361619,103.882609
547448,33,2,35,1.361704,103.88255
547449,7,0,7,1.361734,103.882492
547450,1,0,1,1.361503,103.882665
547453,183,0,183,1.36302,103.88246
547455,1,3,4,1.361921,103.882159
547456,10,50,60,1.361949,103.88185
547457,0,62,62,1.361905,103.881887
547458,26,0,26,1.361672,103.882163
547459,6,0,6,1.361981,103.881918
547460,3,2,5,1.362042,103.882059
547461,74,0,74,1.362025,103.882008
547462,0,31,31,1.362099,103.882181
547463,9,8,17,1.362,103.881963
547464,14,0,14,1.299509,103.837
547528,216,1140,1356,1.371525,103.877715
547529,394,3330,3724,1.370117,103.877649
547530,1507,23,1530,1.371523,103.877834
547531,408,5,413,1.372663,103.87882
547532,492,432,924,1.373027,103.878757
547533,244,540,784,1.372032,103.878488
547556,3,7,10,1.38331,103.87802
547557,2,2,4,1.383309,103.878136
547558,7,1,8,1.383213,103.878075
547559,1,5,6,1.383319,103.878265
547561,1,0,1,1.361819,103.882408
547562,4,36,40,1.383329,103.878457
547563,1,0,1,1.383319,103.878365
547564,5,0,5,1.383333,103.878591
547565,0,1,1,1.383333,103.878591
547566,0,40,40,1.383313,103.87903
547568,0,6,6,1.383889,103.878622
547569,11,0,11,1.38394,103.878753
547570,0,1,1,1.384003,103.87892
547571,1,0,1,1.384344,103.879388
547573,0,1,1,1.38441,103.879525
547577,2,0,2,1.36119,103.883102
547578,0,1,1,1.384301,103.879309
547580,3,0,3,1.360975,103.882794
547581,0,1,1,1.384035,103.87897
547587,4,0,4,1.384875,103.880042
547588,11,0,11,1.385011,103.880091
547596,2,0,2,1.384113,103.879071
547686,10,336,346,1.391421,103.900402
547687,29,28,57,1.391389,103.900468
547690,1,60,61,1.391414,103.900687
547691,1,1,2,1.385169,103.880173
547692,8,176,184,1.391439,103.900797
547693,7,0,7,1.391453,103.90087
547694,0,84,84,1.391413,103.900928
547695,1,2,3,1.384514,103.879701
547697,2,3,5,1.385927,103.883636
547709,2,0,2,1.391461,103.900764
547710,1,42,43,1.353689,103.877101
547711,13,226,239,1.353635,103.877059
547712,2,15,17,1.353675,103.87702
547713,2,9,11,1.353715,103.876968
547714,15,12,27,1.353865,103.876935
547715,2,16,18,1.353885,103.876826
547716,1,7,8,1.353761,103.876934
547717,4,1,5,1.353801,103.8769
547718,5,0,5,1.353747,103.877031
547719,1,29,30,1.354219,103.876543
547721,0,1,1,1.384674,103.879913
547723,2,0,2,1.384494,103.879632
547725,87,26,113,1.353781,103.877002
547726,1022,0,1022,1.353828,103.876874
547727,7,0,7,1.353938,103.876658
547728,3,0,3,1.391412,103.900961
547730,1,0,1,1.354123,103.876612
547731,6,0,6,1.353865,103.876767
547733,1,0,1,1.354054,103.876598
547734,7,414,421,1.35427,103.876495
547735,9,26,35,1.353897,103.876898
547736,6,10,16,1.354316,103.876443
547737,3,0,3,1.353899,103.876724
547738,1,0,1,1.353828,103.87697
547739,1,6,7,1.354381,103.876374
547740,2,1,3,1.353829,103.876037
547741,17,9,26,1.354499,103.876245
547742,0,6,6,1.354504,103.875984
547744,2,4,6,1.354415,103.875849
547745,1,0,1,1.353928,103.876867
547746,3,0,3,1.354446,103.876295
547747,3,1,4,1.354295,103.875714
547748,108,2,110,1.354318,103.875747
547749,13,0,13,1.354251,103.875647
547751,2,0,2,1.35396,103.87674
547752,7,14,21,1.353962,103.87684
547753,14,10,24,1.354694,103.876068
547754,0,10,10,1.354694,103.876068
547755,4,81,85,1.354903,103.875889
547756,126,1,127,1.354973,103.875825
547757,4,0,4,1.354621,103.875975
547758,2,1,3,1.354251,103.875647
547759,7,0,7,1.354509,103.875836
547760,3,2,5,1.354438,103.875752
547761,20,0,20,1.354694,103.876068
547762,14,1,15,1.354388,103.875695
547763,6,0,6,1.354331,103.875642
547764,11,1,12,1.354343,103.87544
547765,1,0,1,1.354376,103.875801
547766,9,69,78,1.355059,103.875746
547767,1,8,9,1.354029,103.876783
547768,5,5,10,1.355275,103.875387
547769,0,3,3,1.354571,103.875918
547770,1,4,5,1.355275,103.875387
547771,6,1,7,1.355275,103.875387
547772,29,0,29,1.354048,103.876765
547773,3,28,31,1.35407,103.876744
547775,0,10,10,1.354123,103.876702
547776,4,1,5,1.354164,103.876662
547777,0,19,19,1.354096,103.876733
547778,2,0,2,1.354251,103.875647
547779,0,36,36,1.354249,103.876583
547780,21,0,21,1.354295,103.876543
547781,0,11,11,1.354341,103.876503
547782,1,0,1,1.353994,103.876815
547783,4,8,12,1.354438,103.876415
547784,7,0,7,1.354473,103.876378
547785,1,5,6,1.35453,103.876344
547787,5,5,10,1.354633,103.876264
547788,2,2,4,1.354673,103.876218
547789,4,1,5,1.354713,103.876178
547790,1,12,13,1.354753,103.876144
547791,379,1,380,1.35487,103.876035
547792,13,66,79,1.355165,103.875762
547793,0,1,1,1.354387,103.876463
547794,3,1,4,1.355123,103.87579
547795,9,0,9,1.355081,103.875822
547796,1,0,1,1.354909,103.876003
547797,1,4,5,1.355169,103.875292
547798,2,0,2,1.354204,103.876617
547799,2,0,2,1.355129,103.875239
547800,3,0,3,1.355223,103.875332
547801,0,8,8,1.35511,103.875696
547802,272,4,276,1.354713,103.875382
547803,875,1,876,1.353863,103.87632
547809,35,73,108,1.363206,103.887728
547810,54,28,82,1.363206,103.887728
547811,2,0,2,1.355072,103.875195
547812,1,0,1,1.355212,103.875709
547813,28,1,29,1.36341,103.887387
547814,1,20,21,1.363369,103.887572
547817,2,0,2,1.363343,103.887029
547820,3,7,10,1.363744,103.887111
547821,10,3,13,1.363407,103.887529
547822,318,0,318,1.363863,103.886943
547823,0,5,5,1.363445,103.887508
547824,25,3,28,1.363493,103.88747
547825,0,17,17,1.363541,103.887429
547826,0,38,38,1.364144,103.886669
547827,24,7,31,1.364049,103.886439
547828,53,16,69,1.364088,103.886465
547829,0,2,2,1.363428,103.887768
547830,9,5,14,1.364013,103.886415
547831,10,0,10,1.363984,103.886343
547832,1,3,4,1.363864,103.886312
547834,2,16,18,1.363629,103.887341
547835,0,2,2,1.364142,103.886532
547837,86,40,126,1.364593,103.886348
547838,0,34,34,1.363709,103.887268
547839,22,25,47,1.364822,103.886136
547840,9,41,50,1.363909,103.887096
547842,0,16,16,1.36395,103.887034
547844,0,84,84,1.364031,103.886997
547845,32,27,59,1.364093,103.886958
547846,0,9,9,1.365015,103.885945
547847,4,0,4,1.365189,103.885748
547848,10,9,19,1.365218,103.885853
547849,0,2,2,1.364497,103.886433
547862,21,2,23,1.360636,103.874335
547863,1,0,1,1.363532,103.887316
547864,11,8,19,1.360946,103.874644
547865,0,3,3,1.355043,103.875129
547866,1,0,1,1.360593,103.874212
547867,0,1,1,1.360679,103.874471
547868,2,15,17,1.360673,103.874163
547869,7,2,9,1.360696,103.874225
547870,22,2,24,1.360713,103.874288
547871,2,14,16,1.360731,103.874351
547872,18,0,18,1.360748,103.874425
547873,0,9,9,1.360765,103.874482
547874,12,2,14,1.361131,103.874706
547875,8,2,10,1.361109,103.874305
547876,7,3,10,1.361136,103.874267
547877,14,1,15,1.361186,103.874299
547878,4,1,5,1.361206,103.874732
547879,11,3,14,1.36118,103.874637
547880,1,2,3,1.360679,103.874471
547881,4,1,5,1.361225,103.874659
547882,10,1,11,1.361265,103.874682
547883,2,0,2,1.365298,103.885788
547884,12,0,12,1.361362,103.87485
547885,10,6,16,1.361425,103.874879
547887,1,0,1,1.361042,103.874682
547888,4,5,9,1.361609,103.874941
547890,9,0,9,1.361715,103.874977
547891,1,7,8,1.361798,103.875021
547892,1,0,1,1.361546,103.874919
547893,3,5,8,1.362013,103.875058
547894,42,0,42,1.361583,103.874809
547895,5,2,7,1.362245,103.875159
547896,7,0,7,1.361652,103.874826
547897,1,0,1,1.361466,103.874781
547899,2,0,2,1.361306,103.874705
547901,0,3,3,1.36118,103.874637
547902,8,0,8,1.362046,103.875012
547903,0,1,1,1.361726,103.874854
547904,0,1,1,1.362105,103.875035
547905,75,10,85,1.36221,103.875061
547906,6,4,10,1.362355,103.875143
547907,1,4,5,1.362453,103.875183
547908,72,40,112,1.362915,103.875247
547909,1,0,1,1.362166,103.875058
547911,4,0,4,1.363163,103.875254
547912,2,5,7,1.363351,103.875236
547913,2,9,11,1.363421,103.875253
547914,1,1,2,1.361852,103.8749
547915,1,13,14,1.363617,103.875246
547916,1,1,2,1.363523,103.875248
547917,22,6,28,1.363354,103.875383
547918,61,1,62,1.363482,103.875381
547919,1,8,9,1.363606,103.875498
547920,23,0,23,1.362077,103.875078
547922,1,2,3,1.361982,103.874966
547923,43,3,46,1.36216,103.875136
547924,18,3,21,1.362522,103.875221
547925,2,1,3,1.360946,103.874644
547926,23,0,23,1.299509,103.837
547927,2,0,2,1.363308,103.875391
547928,3,17,20,1.362189,103.874133
547929,4,0,4,1.362499,103.874204
547930,1,0,1,1.363008,103.875254
547931,4,2,6,1.362368,103.874142
547933,190,0,190,1.362179,103.874083
547934,8,1,9,1.362251,103.874159
547935,0,1,1,1.362143,103.874119
547937,15,0,15,1.362354,103.874198
547938,3,0,3,1.299509,103.837
547939,18,0,18,1.361951,103.874508
547940,24,0,24,1.361723,103.874574
547941,2,0,2,1.299509,103.837
547942,3,0,3,1.362386,103.874208
547944,12,0,12,1.361747,103.874385
547945,1,9,10,1.361841,103.874337
547946,15,0,15,1.361792,103.874256
547947,0,2,2,1.361762,103.874538
547948,5,3,8,1.361826,103.874149
547949,1,0,1,1.362283,103.87417
547950,7,0,7,1.361749,103.873977
547952,0,1,1,1.361804,103.874017
547953,0,3,3,1.36171,103.874469
547954,5,0,5,1.361607,103.873901
547955,9,0,9,1.361562,103.873894
547956,36,0,36,1.361816,103.873928
547958,42,12,54,1.361742,103.873907
547959,8,3,11,1.361947,103.873982
547960,2,0,2,1.361883,103.87422
547961,2,0,2,1.362321,103.874125
547962,6,0,6,1.36213,103.874056
547963,39,0,39,1.362004,103.874006
547964,3,5,8,1.361849,103.873954
547965,2,0,2,1.361876,103.873965
547968,3,8,11,1.357851,103.876251
547970,0,1,1,1.361913,103.874059
547971,7,4,11,1.358029,103.876319
547972,7,1,8,1.358092,103.876347
547975,4,0,4,1.357949,103.876424
547977,2,0,2,1.362266,103.874099
547978,5,0,5,1.35834,103.876487
547979,2,2,4,1.358066,103.876482
547980,25,1,26,1.358372,103.876502
547981,1,0,1,1.357966,103.876296
547982,6,0,6,1.358457,103.876539
547983,0,30,30,1.358512,103.876551
547984,0,4,4,1.358631,103.876776
547985,58,0,58,1.358651,103.876822
547987,1,0,1,1.358395,103.876509
547988,9,0,9,1.358785,103.876955
547990,13,3,16,1.359003,103.877412
547991,5,1,6,1.358728,103.877022
547992,0,1,1,1.358672,103.876872
547993,2,0,2,1.358008,103.876449
548001,10,0,10,1.359003,103.877412
548004,1,0,1,1.358982,103.877371
548008,583,363,946,1.36194,103.884927
548009,5,84,89,1.361681,103.8846
548010,3,9,12,1.361539,103.88443
548012,0,5,5,1.361489,103.884361
548013,9,0,9,1.36145,103.88432
548014,5,1,6,1.361379,103.88421
548015,2,5,7,1.361337,103.88418
548017,1,27,28,1.361196,103.884086
548018,6,0,6,1.361183,103.884035
548019,8,0,8,1.361137,103.883998
548020,95,3,98,1.361108,103.883966
548021,1,16,17,1.361078,103.883918
548022,1,43,44,1.361023,103.883898
548023,7,19,26,1.360654,103.883527
548024,9,3,12,1.360627,103.88349
548025,3,6,9,1.360609,103.883464
548026,2,10,12,1.360571,103.883442
548027,3,13,16,1.36053,103.883394
548028,116,22,138,1.360508,103.883369
548029,3,43,46,1.360484,103.8832
548030,0,2,2,1.359015,103.877463
548031,11,1,12,1.360563,103.883121
548032,8,5,13,1.360614,103.883054
548033,2,14,16,1.360668,103.882991
548034,5,2,7,1.360745,103.882916
548035,17,1,18,1.360755,103.882899
548036,9,30,39,1.360501,103.883162
548037,2,10,12,1.360354,103.882846
548038,0,2,2,1.360522,103.883144
548039,2,3,5,1.360446,103.882719
548040,2,2,4,1.360596,103.883082
548041,10,0,10,1.360636,103.883031
548042,37,3,40,1.360682,103.88298
548043,2,2,4,1.360728,103.882929
548045,1,27,28,1.360061,103.882658
548046,0,2,2,1.360571,103.883095
548047,0,2,2,1.360139,103.882599
548048,0,1,1,1.358806,103.877162
548049,15,1,16,1.360268,103.882458
548050,3,0,3,1.361965,103.874076
548051,3,0,3,1.360322,103.882386
548053,3,0,3,1.360348,103.882353
548055,0,1,1,1.360213,103.882512
548058,0,8,8,1.360041,103.882609
548059,2,12,14,1.360075,103.882556
548060,1,3,4,1.360054,103.882572
548061,4,21,25,1.359892,103.882579
548070,0,14,14,1.358217,103.880868
548071,1,0,1,1.360322,103.882105
548072,18,2,20,1.358303,103.880782
548073,3,4,7,1.358337,103.880742
548074,1,0,1,1.358262,103.880828
548076,4,7,11,1.358434,103.880623
548077,2,1,3,1.360382,103.882301
548078,5,8,13,1.358139,103.880797
548079,7,8,15,1.358186,103.880763
548080,1,0,1,1.358371,103.880703
548081,6,0,6,1.358139,103.880797
548082,5,0,5,1.358272,103.880655
548083,2,3,5,1.3583,103.880632
548084,12,0,12,1.358335,103.880603
548086,62,0,62,1.358033,103.880273
548091,1,0,1,1.358215,103.880723
548102,113,0,113,1.356844,103.87941
548103,73,13,86,1.356798,103.879365
548112,5,0,5,1.356704,103.879254
548115,15,4,19,1.356829,103.879373
548116,3,87,90,1.359204,103.882259
548117,3,3,6,1.359169,103.882225
548118,2,0,2,1.360196,103.88254
548119,16,0,16,1.359093,103.882164
548120,0,1,1,1.35803,103.880265
548122,0,1,1,1.359055,103.882128
548123,2,0,2,1.359135,103.882197
548124,0,4,4,1.299509,103.837
548125,0,1,1,1.358986,103.882049
548126,0,1,1,1.299509,103.837
548127,0,2,2,1.35666,103.87922
548128,0,1,1,1.299509,103.837
548129,6,1,7,1.358693,103.881444
548130,118,1,119,1.358266,103.881
548131,0,6,6,1.355888,103.878365
548132,187,0,187,1.358003,103.880734
548135,238,150,388,1.357943,103.880657
548136,189,118,307,1.357583,103.880771
548137,14,0,14,1.357759,103.880453
548140,0,1,1,1.356632,103.879187
548145,9,0,9,1.35754,103.880252
548146,110,0,110,1.357603,103.880314
548147,143,0,143,1.357461,103.880151
548148,12,4,16,1.357362,103.88005
548149,13,0,13,1.357067,103.879733
548150,8,8,16,1.357032,103.879684
548151,26,1,27,1.356936,103.879586
548152,0,3,3,1.358457,103.880589
548153,2,6,8,1.356819,103.879468
548154,85,2,87,1.356778,103.879427
548155,0,4,4,1.356512,103.879128
548156,2,4,6,1.356819,103.879468
548159,1,16,17,1.356474,103.879079
548160,2,14,16,1.356334,103.878937
548161,7,0,7,1.356139,103.878763
548162,3,0,3,1.3569,103.879556
548165,1,0,1,1.35783,103.880539
548166,4,10,14,1.355934,103.878532
548167,3,8,11,1.355993,103.878588
548168,6,0,6,1.356103,103.878712
548169,6,48,54,1.356054,103.878648
548173,584,18,602,1.355692,103.878259
548176,7,121,128,1.35561,103.878177
548177,339,32,371,1.355219,103.87774
548178,327,79,406,1.354843,103.877579
548179,0,212,212,1.354817,103.877603
548180,0,4,4,1.355258,103.877807
548181,5,0,5,1.355174,103.877696
548182,15,0,15,1.356749,103.87939
548183,3,0,3,1.356219,103.878844
548184,203,9,212,1.356749,103.87939
548185,10,0,10,1.356656,103.879281
548186,4,2,6,1.356594,103.87922
548187,0,3,3,1.356749,103.87939
548188,55,551,606,1.360069,103.883871
548189,976,678,1654,1.35957,103.883021
548190,633,41,674,1.359706,103.883223
548191,541,34,575,1.36,103.883357
548192,269,37,306,1.3603,103.883231
548193,312,25,337,1.360496,103.883406
548194,1,36,37,1.358665,103.881231
548195,6,15,21,1.358687,103.881294
548196,2,8,10,1.358727,103.881157
548197,11,6,17,1.358729,103.881289
548198,4,0,4,1.35879,103.881083
548199,0,3,3,1.356629,103.879254
548200,1,2,3,1.358763,103.881243
548201,193,16,209,1.358803,103.881198
548202,0,8,8,1.358877,103.880979
548203,11,5,16,1.358834,103.881162
548204,3,1,4,1.358874,103.881141
548205,11,3,14,1.358914,103.881101
548206,29,5,34,1.358944,103.88107
548207,18,39,57,1.358994,103.881016
548208,60,11,71,1.359031,103.880989
548209,9,12,21,1.358922,103.880996
548223,0,16,16,1.365547,103.881408
548224,24,6,30,1.365474,103.881458
548225,11,3,14,1.365535,103.881336
548226,98,0,98,1.365478,103.881407
548227,28,0,28,1.365539,103.881279
548228,3,1,4,1.365475,103.881361
548229,1,4,5,1.365533,103.881231
548230,5,0,5,1.365473,103.881311
548231,1,0,1,1.355934,103.878532
548232,8,3,11,1.365474,103.881253
548233,2,0,2,1.299509,103.837
548234,7,0,7,1.365468,103.881208
548235,1,0,1,1.36552,103.881143
548236,3,4,7,1.36546,103.881144
548237,7,42,49,1.3655,103.880992
548238,18,0,18,1.36546,103.881051
548239,5,0,5,1.365498,103.880935
548240,15,1,16,1.365458,103.881004
548241,1,0,1,1.365503,103.881043
548242,4,0,4,1.36545,103.880959
548243,2,0,2,1.365517,103.881094
548244,2,0,2,1.365491,103.880856
548246,11,0,11,1.365444,103.880869
548247,2,0,2,1.36545,103.880912
548251,1,13,14,1.365485,103.880677
548253,3,0,3,1.358848,103.881014
548264,290,36,326,1.381739,103.89555
548265,321,55,376,1.381906,103.896722
548266,5,0,5,1.365907,103.881868
548267,4,1,5,1.365862,103.881861
548268,11,2,13,1.365803,103.881874
548269,1,3,4,1.365722,103.881885
548270,7,12,19,1.365646,103.881895
548271,3,0,3,1.365422,103.880643
548272,0,3,3,1.365736,103.882422
548273,0,1,1,1.365493,103.880882
548274,0,3,3,1.365873,103.881799
548275,3,0,3,1.365542,103.882257
548276,5,18,23,1.365566,103.882428
548278,8,4,12,1.365566,103.882428
548279,17,0,17,1.365566,103.882428
548280,3,4,7,1.365457,103.881932
548281,11,1,12,1.365432,103.881935
548282,1,1,2,1.365494,103.880759
548283,1,1,2,1.365398,103.881939
548284,0,1,1,1.365828,103.881802
548285,16,0,16,1.365202,103.882582
548286,12,4,16,1.365224,103.882649
548287,3,0,3,1.36553,103.882203
548288,1,2,3,1.365203,103.882695
548289,1,0,1,1.365283,103.881959
548291,11,0,11,1.365026,103.881987
548292,3,5,8,1.364993,103.881989
548293,9,1,10,1.365641,103.881814
548294,3,1,4,1.364962,103.881994
548295,0,2,2,1.365244,103.881972
548296,2,2,4,1.364893,103.881983
548299,5,2,7,1.365501,103.881829
548300,8,1,9,1.364794,103.881994
548301,3,2,5,1.36546,103.881842
548303,12,6,18,1.365358,103.881852
548305,5,1,6,1.365262,103.881858
548306,15,0,15,1.364615,103.882017
548307,19,1,20,1.364565,103.882017
548308,2,0,2,1.36559,103.881823
548309,4,0,4,1.364454,103.882028
548310,4,0,4,1.365736,103.882422
548311,4,1,5,1.365736,103.882422
548312,3,0,3,1.365241,103.882784
548313,10,0,10,1.365736,103.882422
548314,2,1,3,1.365736,103.882422
548315,121,8,129,1.365722,103.882448
548316,0,4,4,1.364388,103.882081
548322,2,4,6,1.352686,103.875362
548323,0,5,5,1.352714,103.875328
548324,0,1,1,1.365243,103.882802
548325,0,17,17,1.352774,103.875265
548327,4,15,19,1.352857,103.875174
548329,0,2,2,1.364519,103.882023
548330,3,0,3,1.366063,103.881853
548331,1,0,1,1.352749,103.875293
548332,1,0,1,1.35301,103.875069
548334,1,0,1,1.353135,103.87497
548335,6,0,6,1.353401,103.874726
548336,12,1,13,1.353665,103.874521
548337,26,16,42,1.353137,103.875056
548339,0,5,5,1.353186,103.875031
548340,10,2,12,1.353831,103.874356
548341,3,1,4,1.353234,103.874987
548342,2,8,10,1.353878,103.874325
548343,3,2,5,1.353271,103.874965
548344,0,204,204,1.353921,103.874299
548345,28,2,30,1.353324,103.874913
548346,3,3,6,1.353384,103.874886
548347,6,18,24,1.353567,103.874696
548348,10,7,17,1.353613,103.874649
548349,1,0,1,1.353192,103.87491
548350,3,4,7,1.353702,103.874581
548351,1,11,12,1.353746,103.874554
548352,0,2,2,1.352932,103.8751
548353,14,27,41,1.353812,103.874491
548354,2,0,2,1.353775,103.87452
548355,5,2,7,1.353436,103.87484
548356,1,0,1,1.353662,103.87462
548357,31,233,264,1.352293,103.875647
548358,1,3,4,1.352425,103.875562
548359,1,3,4,1.352488,103.875505
548360,2,0,2,1.353872,103.874451
548361,29,2,31,1.352602,103.875412
548362,3,0,3,1.353056,103.875032
548363,3,0,3,1.353221,103.874881
548364,10,5,15,1.353278,103.874807
548365,25,15,40,1.353441,103.874686
548366,1,0,1,1.353531,103.874725
548367,1,2,3,1.353249,103.874847
548368,10,0,10,1.364011,103.887377
548369,0,1,1,1.353501,103.874622
548370,1,0,1,1.363965,103.887486
548373,3,1,4,1.364037,103.887571
548374,8,1,9,1.364093,103.887479
548387,4,0,4,1.358679,103.878148
548390,184,10,194,1.358821,103.878028
548391,1,18,19,1.358717,103.877949
548393,5,3,8,1.358942,103.877895
548395,5,2,7,1.359011,103.877843
548396,2,3,5,1.358797,103.877874
548397,16,6,22,1.359187,103.877711
548402,7,0,7,1.358856,103.877796
548403,1,2,3,1.363925,103.887445
548404,7,4,11,1.358984,103.877687
548405,1,12,13,1.359184,103.877505
548406,3,1,4,1.359225,103.877468
548407,1,2,3,1.358931,103.877722
548408,7,9,16,1.359305,103.877399
548409,5,9,14,1.359412,103.87721
548410,0,1,1,1.364027,103.887411
548411,215,2,217,1.359662,103.877224
548412,1,0,1,1.359364,103.877148
548413,16,0,16,1.35932,103.876971
548415,17,5,22,1.359376,103.877031
548416,4,5,9,1.359403,103.877063
548417,1,2,3,1.359262,103.877431
548418,211,0,211,1.359459,103.877132
548419,21,39,60,1.359535,103.877178
548420,7,4,11,1.359754,103.877115
548421,4,0,4,1.359801,103.877054
548422,22,0,22,1.359686,103.877027
548423,0,4,4,1.359739,103.876972
548424,166,0,166,1.359776,103.876928
548425,3,4,7,1.359835,103.876893
548427,3,18,21,1.359921,103.876802
548428,5,1,6,1.359841,103.87701
548429,68,0,68,1.360088,103.876692
548430,0,9,9,1.360087,103.876765
548431,321,75,396,1.360127,103.876729
548432,70,55,125,1.360205,103.876559
548433,11,0,11,1.360286,103.876632
548435,2,1,3,1.359433,103.8771
548436,2,0,2,1.352546,103.875451
548437,4,0,4,1.360775,103.876016
548438,14,6,20,1.360512,103.876405
548440,1,13,14,1.360558,103.876365
548443,2,0,2,1.36046,103.87646
548444,1,0,1,1.359297,103.876947
548445,2,43,45,1.361221,103.875591
548446,17,0,17,1.361307,103.875605
548447,140,37,177,1.36132,103.87549
548448,1,0,1,1.361128,103.875843
548449,1,0,1,1.36135,103.875562
548450,3,11,14,1.361511,103.875428
548451,6,0,6,1.361554,103.875381
548452,2,1,3,1.360385,103.876518
548453,1,0,1,1.361385,103.875525
548454,0,1,1,1.361597,103.875348
548455,7,0,7,1.361635,103.875291
548456,1,5,6,1.361552,103.875278
548457,5,1,6,1.361676,103.875252
548458,3,2,5,1.361712,103.875222
548459,2,5,7,1.359322,103.877094
548460,14,4,18,1.35928,103.877038
548461,76,9,85,1.359047,103.877809
548462,2,1,3,1.361461,103.875359
548463,13,3,16,1.361155,103.875644
548464,12,1,13,1.361155,103.875644
548465,15,0,15,1.361155,103.875644
548467,2,1,3,1.361155,103.875644
548469,28,0,28,1.361391,103.875419
548470,4,0,4,1.361391,103.875419
548471,9,6,15,1.358443,103.878396
548472,137,2,139,1.358349,103.878478
548473,55,1,56,1.358483,103.87843
548474,7,0,7,1.358378,103.878505
548476,3,0,3,1.361391,103.875419
548477,1,4,5,1.358552,103.878515
548478,1,1,2,1.361038,103.875925
548479,3,1,4,1.358594,103.878558
548480,3,1,4,1.358487,103.878625
548481,4,0,4,1.358633,103.878604
548482,145,4,149,1.358516,103.878664
548483,6,0,6,1.358668,103.87865
548484,14,0,14,1.35855,103.878704
548485,4,0,4,1.3586,103.87876
548502,2,24,26,1.382294,103.877812
548504,0,10,10,1.383001,103.87755
548505,2,70,72,1.383044,103.877513
548521,8,29,37,1.358578,103.873835
548522,0,3,3,1.358418,103.878539
548523,0,26,26,1.358645,103.873811
548526,11,5,16,1.35854,103.873778
548527,1,54,55,1.358498,103.873776
548540,71,5,76,1.36591,103.884702
548541,11,15,26,1.366002,103.884623
548542,104,0,104,1.366058,103.884771
548543,4,17,21,1.366219,103.884859
548544,4,11,15,1.366311,103.884752
548545,12,2,14,1.366263,103.884865
548546,2,0,2,1.358453,103.878579
548550,1,2,3,1.358614,103.873837
548551,0,2,2,1.366348,103.884751
548552,38,7,45,1.366481,103.884806
548553,2,1,3,1.366434,103.884887
548554,51,1,52,1.366552,103.884812
548555,0,2,2,1.366499,103.884897
548556,2,1,3,1.366554,103.884907
548557,1,1,2,1.366625,103.884926
548558,2,1,3,1.366719,103.884844
548559,0,1,1,1.361504,103.875314
548560,3,0,3,1.36669,103.884946
548561,2,0,2,1.366782,103.884858
548562,9,0,9,1.366917,103.884958
548564,3,10,13,1.367058,103.884932
548565,0,2,2,1.367129,103.884774
548566,44,0,44,1.367144,103.884888
548571,1,0,1,1.367017,103.884841
548572,0,8,8,1.367781,103.884649
548573,0,3,3,1.367099,103.884789
548574,2,0,2,1.367231,103.884731
548575,5,16,21,1.367823,103.884805
548576,6,12,18,1.367839,103.884868
548577,1,2,3,1.367804,103.884703
548578,10,882,892,1.367854,103.885095
548579,2,0,2,1.367813,103.884758
548580,1,0,1,1.367384,103.884671
548581,39,0,39,1.367268,103.884852
548582,0,3,3,1.367817,103.885003
548583,0,3,3,1.36733,103.884823
548584,1,0,1,1.367717,103.884521
548585,22,6,28,1.367535,103.884721
548588,9,36,45,1.366177,103.884725
548589,19,2,21,1.366257,103.88474
548590,4,8,12,1.299509,103.837
548593,349,909,1258,1.391528,103.901796
548595,458,394,852,1.391747,103.902461
548596,47,61,108,1.390784,103.903622
548597,11,196,207,1.390451,103.904086
548598,5,44,49,1.390509,103.904185
548599,6,81,87,1.39035,103.904488
548600,3,380,383,1.390605,103.904459
548601,24,510,534,1.390406,103.904514
548614,3,10,13,1.357494,103.880016
548615,4,3,7,1.357617,103.880015
548616,2,21,23,1.357566,103.880056
548617,4,1,5,1.357526,103.879969
548618,12,0,12,1.357655,103.87998
548619,1,0,1,1.367498,103.884746
548620,4,1,5,1.357701,103.879937
548621,1,0,1,1.357563,103.87993
548622,1,0,1,1.357598,103.879885
548624,2,0,2,1.367597,103.88457
548627,2,0,2,1.357789,103.879856
548628,7,0,7,1.357866,103.879772
548629,2,6,8,1.357798,103.879714
548630,5,0,5,1.357906,103.879738
548632,44,0,44,1.35796,103.879684
548633,28,0,28,1.357884,103.879623
548634,1,2,3,1.367383,103.884787
548635,97,0,97,1.35793,103.879577
548636,5,0,5,1.358058,103.879582
548637,1,0,1,1.357744,103.879898
548638,14,11,25,1.358014,103.879496
548651,17,6,23,1.391484,103.900367
548652,3,0,3,1.358011,103.879633
548653,0,1,1,1.35797,103.879537
548654,166,3,169,1.391484,103.900367
548655,0,1,1,1.391484,103.900367
548657,28,3,31,1.392073,103.900842
548659,7,3,10,1.39212,103.900652
548660,2,0,2,1.357829,103.879816
548661,0,15,15,1.391723,103.900316
548662,7,39,46,1.391723,103.900316
548663,1,0,1,1.391484,103.900364
548664,1,0,1,1.392332,103.900542
548665,6,0,6,1.392302,103.900763
548666,3,0,3,1.391484,103.900367
548667,1,1,2,1.392095,103.900619
548668,7,1,8,1.392757,103.900508
548669,32,33,65,1.392732,103.900387
548670,3,75,78,1.392969,103.900412
548671,3,0,3,1.392757,103.90072
548672,2,2,4,1.39297,103.900634
548673,19,0,19,1.39299,103.900734
548674,4,24,28,1.393449,103.900512
548675,36,101,137,1.393389,103.900424
548676,9,4,13,1.391726,103.900317
548677,1,6,7,1.391724,103.900316
548678,0,11,11,1.391726,103.900318
548688,4,265,269,1.36402,103.874455
548689,0,13,13,1.364133,103.874637
548690,0,55,55,1.364169,103.874529
548691,16,2,18,1.364211,103.874666
548692,1,18,19,1.36425,103.874569
548693,2,0,2,1.392756,103.900637
548694,0,6,6,1.364353,103.87462
548695,7,1,8,1.364394,103.874846
548696,1,4,5,1.364433,103.874654
548697,16,0,16,1.364336,103.874724
548698,1,9,10,1.364559,103.874734
548699,60,13,73,1.364464,103.87478
548700,0,5,5,1.364639,103.874768
548701,8,3,11,1.364658,103.874909
548702,2,9,11,1.36476,103.874825
548703,38,0,38,1.364711,103.874958
548704,0,14,14,1.36484,103.874865
548705,0,1,1,1.392328,103.900661
548706,3,10,13,1.364954,103.874922
548708,22,4,26,1.365023,103.874973
548709,6,0,6,1.364736,103.875203
548710,23,11,34,1.365143,103.875024
548711,3,0,3,1.392992,103.900526
548712,1,6,7,1.365218,103.875058
548713,4,0,4,1.364792,103.875341
548714,3,8,11,1.365338,103.875132
548715,0,1,1,1.364688,103.875038
548716,0,2,2,1.364327,103.874848
548717,1,0,1,1.364817,103.875409
548718,0,32,32,1.365499,103.875206
548720,89,2,91,1.365582,103.875213
548721,1,0,1,1.364841,103.875472
548722,2,290,292,1.365649,103.875246
548723,0,1,1,1.364886,103.875586
548724,0,2,2,1.365418,103.875172
548725,6,0,6,1.364963,103.875764
548726,1,9,10,1.365034,103.875757
548727,1,0,1,1.364913,103.875642
548728,20,6,26,1.364937,103.875523
548729,1,0,1,1.365002,103.875679
548730,0,8,8,1.364807,103.875211
548731,1,0,1,1.364872,103.875367
548732,0,2,2,1.364938,103.875701
548733,1,10,11,1.364867,103.875145
548734,15,1,16,1.364994,103.875139
548735,1,0,1,1.364732,103.875021
548736,14,1,15,1.365324,103.875322
548737,6,1,7,1.365317,103.875204
548738,22,2,24,1.365364,103.875244
548740,3,502,505,1.366278,103.875436
548741,2,1,3,1.36476,103.875275
548742,18,286,304,1.365657,103.875783
548744,7,2,9,1.366033,103.875518
548746,1,6,7,1.365541,103.875784
548747,0,7,7,1.365757,103.875729
548748,2,2,4,1.366338,103.87576
548749,16,5,21,1.365702,103.875754
548750,2,19,21,1.366141,103.875908
548763,2,35,37,1.360281,103.881422
548764,3,41,44,1.360222,103.881445
548765,7,0,7,1.360328,103.881479
548766,15,1,16,1.36027,103.881501
548767,11,0,11,1.360379,103.881534
548768,10,0,10,1.360304,103.881546
548770,1,1,2,1.364775,103.874893
548772,3,1,4,1.360491,103.881743
548773,8,0,8,1.360538,103.881785
548775,1,1,2,1.36038,103.881625
548776,0,1,1,1.365251,103.875265
548788,15,5,20,1.366254,103.883954
548790,5,0,5,1.366495,103.883979
548791,1,0,1,1.360436,103.881597
548792,1,0,1,1.366571,103.884011
548793,7,0,7,1.366456,103.884069
548794,0,8,8,1.366681,103.884056
548795,1,0,1,1.366407,103.884038
548797,2,0,2,1.360615,103.881771
548798,8,0,8,1.366721,103.884201
548799,13,2,15,1.366849,103.884118
548800,6,0,6,1.367036,103.884033
548802,18,5,23,1.366804,103.884223
548803,3,1,4,1.366892,103.884225
548804,1,1,2,1.366676,103.884193
548805,20,0,20,1.367313,103.883427
548806,4,1,5,1.367023,103.882738
548807,1,0,1,1.366507,103.884091
548808,25,0,25,1.367029,103.882662
548809,2,1,3,1.366124,103.87564
548810,1,1,2,1.367321,103.883515
548811,16,0,16,1.367359,103.88373
548813,0,1,1,1.366992,103.882683
548814,0,4,4,1.36731,103.883233
548815,4,0,4,1.367245,103.884068
548816,5,9,14,1.367294,103.884042
548818,47,0,47,1.367395,103.883989
548819,12,1,13,1.367486,103.88394
548820,2,0,2,1.367034,103.884172
548821,16,2,18,1.367361,103.883101
548822,17,1,18,1.36735,103.882886
548824,19,9,28,1.367443,103.883843
548825,1,5,6,1.367483,103.88383
548828,0,2,2,1.367368,103.883195
548829,1,0,1,1.36731,103.883347
548830,5,4,9,1.36739,103.883372
548831,1,2,3,1.366986,103.884199
548833,1,1,2,1.367398,103.883515
548834,4,2,6,1.367858,103.883785
548835,8,3,11,1.368149,103.88392
548836,0,1,1,1.367397,103.883452
548837,43,45,88,1.368128,103.883998
548838,1,0,1,1.367912,103.883785
548839,7,0,7,1.368113,103.884062
548840,14,1,15,1.368025,103.883817
548841,63,39,102,1.368099,103.884111
548842,5,58,63,1.368071,103.883825
548843,2,3,5,1.368091,103.884167
548844,6,39,45,1.368174,103.883353
548845,2,17,19,1.368072,103.884226
548846,2,2,4,1.358947,103.87443
548847,0,2,2,1.367656,103.883875
548848,43,3,46,1.359392,103.874612
548850,0,3,3,1.367378,103.883307
548851,0,1,1,1.367973,103.883797
548855,0,1,1,1.359067,103.874572
548857,3,0,3,1.359438,103.874567
548858,2,1,3,1.359194,103.87472
548859,0,1,1,1.359153,103.874674
548861,5,0,5,1.359273,103.874911
548862,1,2,3,1.359626,103.874419
548864,0,1,1,1.359222,103.874765
548865,5,1,6,1.359336,103.874848
548866,2,0,2,1.358993,103.874475
548868,5,0,5,1.359427,103.874755
548870,1,0,1,1.35974,103.874304
548871,1,0,1,1.359485,103.874683
548873,3,5,8,1.359577,103.874592
548875,0,1,1,1.359514,103.874649
548878,3,1,4,1.359829,103.874393
548879,4,0,4,1.359858,103.874358
548880,6,0,6,1.359884,103.874324
548881,6,0,6,1.359915,103.87429
548882,2,0,2,1.359365,103.87482
548884,1,136,137,1.299509,103.837
548896,0,4,4,1.357372,103.877672
548897,0,8,8,1.357384,103.877588
548898,6,7,13,1.35734,103.87763
548899,34,5,39,1.35735,103.877559
548900,0,2,2,1.359945,103.874257
548901,30,0,30,1.35731,103.877519
548902,6,0,6,1.357251,103.877558
548903,0,5,5,1.357275,103.877485
548904,23,0,23,1.357205,103.877518
548905,3,0,3,1.3597,103.874337
548906,18,1,19,1.357154,103.877473
548907,90,0,90,1.357195,103.8774
548920,20,215,235,1.355787,103.87957
548921,1,1,2,1.357297,103.877603
548922,11,147,158,1.356092,103.879189
548923,11,22,33,1.356037,103.879227
548925,1,74,75,1.356566,103.878846
548926,500,76,576,1.356718,103.878618
548927,3,37,40,1.356725,103.878716
548928,4,0,4,1.357126,103.879009
548929,2,2,4,1.357092,103.878974
548930,4,0,4,1.357058,103.878935
548931,23,6,29,1.357012,103.878895
548932,0,1,1,1.359737,103.874478
548933,6,0,6,1.356943,103.878821
548934,42,10,52,1.356909,103.878787
548935,0,1,1,1.356977,103.878861
548936,2,1,3,1.357235,103.87744
548937,2,24,26,1.356822,103.878705
548938,1,0,1,1.356874,103.878747
548939,2,1,3,1.356845,103.878722
548940,34,2,36,1.357554,103.877294
548941,21,57,78,1.357925,103.877302
548942,4,0,4,1.357626,103.877097
548943,70,9,79,1.35817,103.877011
548944,82,1,83,1.357678,103.877028
548945,76,1,77,1.358464,103.877311
548946,477,0,477,1.357906,103.87705
548947,62,0,62,1.358056,103.876923
548948,19,8,27,1.358121,103.876847
548949,0,4,4,1.358138,103.876821
548951,8,1,9,1.35822,103.876771
548952,124,4,128,1.358665,103.876609
548953,4,0,4,1.358716,103.876558
548954,8,6,14,1.358279,103.876771
548955,9,6,15,1.358765,103.876509
548956,10,0,10,1.358802,103.876464
548958,9,0,9,1.358894,103.876373
548959,1,10,11,1.3588,103.876243
548960,1,1,2,1.356044,103.87932
548962,4,5,9,1.358696,103.876121
548963,0,5,5,1.358656,103.87607
548964,2,3,5,1.35861,103.87603
548965,0,2,2,1.358771,103.876195
548966,0,1,1,1.357016,103.878388
548968,0,12,12,1.358871,103.87616
548969,9,4,13,1.358843,103.876114
548970,2,1,3,1.357047,103.87834
548971,3,7,10,1.358745,103.876035
548972,4,8,12,1.358699,103.875995
548973,27,9,36,1.358659,103.875944
548974,8,10,18,1.358619,103.875898
548975,11,4,15,1.359021,103.87625
548976,13,0,13,1.35905,103.876212
548977,0,7,7,1.359076,103.875945
548978,0,3,3,1.358802,103.876088
548983,24,10,34,1.359383,103.876537
548984,2,1,3,1.359103,103.876175
548985,7,23,30,1.359452,103.876458
548986,4,0,4,1.359492,103.876418
548987,1,2,3,1.359418,103.876498
548989,5,0,5,1.359315,103.875804
548992,11,0,11,1.359373,103.876204
548993,5,0,5,1.359482,103.876319
548994,3,0,3,1.359359,103.876292
548995,0,1,1,1.358943,103.876328
548996,103,5,108,1.359412,103.875713
548997,6,0,6,1.359578,103.875718
548998,19,0,19,1.359492,103.875611
549000,19,7,26,1.359925,103.875362
549001,17,0,17,1.359641,103.875468
549005,0,7,7,1.360051,103.875237
549006,20,0,20,1.359898,103.875242
549008,3,2,5,1.359978,103.875153
549009,7,13,20,1.360177,103.875111
549010,225,8,233,1.360121,103.875031
549011,16,69,85,1.360235,103.875054
549012,3,2,5,1.360224,103.874951
549014,41,9,50,1.360624,103.874693
549015,7,0,7,1.360339,103.874832
549018,10,0,10,1.360661,103.874663
549019,41,6,47,1.360522,103.874615
549026,2,3,5,1.357365,103.877834
549027,4,0,4,1.359026,103.875908
549028,1,0,1,1.359422,103.875872
549029,4,1,5,1.358927,103.875817
549030,1,0,1,1.358966,103.87586
549031,2,0,2,1.35857,103.875979
549032,4,1,5,1.359542,103.876427
549033,2,0,2,1.358838,103.875723
549034,2,1,3,1.359324,103.875956
549035,64,10,74,1.359443,103.876518
549036,0,1,1,1.358889,103.875763
549037,18,9,27,1.359978,103.875153
549038,4,12,16,1.358959,103.87977
549039,5,7,12,1.358975,103.879873
549041,1,3,4,1.359027,103.879822
549042,0,1,1,1.35929,103.876206
549043,11,2,13,1.359084,103.879777
549044,8,1,9,1.359119,103.879616
549045,2,8,10,1.359135,103.879737
549046,2,0,2,1.359508,103.876461
549047,28,2,30,1.359187,103.879691
549048,3,6,9,1.359239,103.879497
549049,3,1,4,1.359233,103.879646
549050,22,1,23,1.359337,103.879406
549051,3,5,8,1.359273,103.8796
549052,18,6,24,1.359371,103.87936
549053,1,2,3,1.359473,103.87649
549054,10,5,15,1.359445,103.879292
549055,3,0,3,1.359324,103.879554
549056,13,7,20,1.35948,103.879246
549057,3,4,7,1.35941,103.879463
549059,0,3,3,1.35937,103.879509
549060,8,0,8,1.359545,103.879351
549073,4,24,28,1.35871,103.879824
549074,2,8,10,1.358646,103.879779
549075,4,1,5,1.358671,103.879854
549077,19,0,19,1.358642,103.879884
549078,1,3,4,1.358572,103.879858
549079,26,6,32,1.358621,103.879921
549080,1,0,1,1.35909,103.879651
549081,142,1,143,1.358575,103.879956
549082,15,0,15,1.358492,103.879944
549083,91,0,91,1.358529,103.87999
549085,2,1,3,1.359502,103.879386
549086,2,4,6,1.35842,103.880012
549087,2,0,2,1.359216,103.879531
549088,2,0,2,1.358449,103.880069
549101,16,218,234,1.355937,103.876685
549102,164,72,236,1.355764,103.876655
549103,0,61,61,1.35597,103.876636
549104,0,45,45,1.35603,103.876562
549106,4,74,78,1.356078,103.876532
549107,4,19,23,1.356083,103.876492
549108,6,4,10,1.356157,103.876474
549109,33,363,396,1.35619,103.876425
549110,5,1,6,1.356443,103.876612
549111,1,0,1,1.358532,103.879898
549114,93,1,94,1.356117,103.876662
549115,402,4,406,1.35663,103.877538
549117,1,0,1,1.356254,103.876536
549118,2,104,106,1.355966,103.87679
549119,22,6,28,1.356883,103.877731
549120,0,2,2,1.35839,103.880045
549121,0,3,3,1.358489,103.88003
549122,2,1,3,1.356965,103.877821
549125,0,33,33,1.357275,103.878219
549126,6,4,10,1.357128,103.877993
549127,0,1,1,1.356025,103.876753
549128,2,1,3,1.357002,103.877868
549129,0,5,5,1.357401,103.878348
549130,0,1,1,1.357312,103.878271
549132,5,8,13,1.357481,103.878421
549133,13,0,13,1.357668,103.878529
549134,7,1,8,1.357819,103.878773
549135,39,0,39,1.357791,103.878802
549136,13,0,13,1.357762,103.878836
549137,5,1,6,1.357721,103.878566
549138,3,0,3,1.357363,103.878312
549140,1,1,2,1.35692,103.877776
549141,0,13,13,1.357618,103.878971
549142,16,1,17,1.357781,103.878618
549143,2,0,2,1.35775,103.878595
549144,2,0,2,1.357821,103.878663
549146,12,0,12,1.357861,103.878715
549147,4,1,5,1.357693,103.878996
549148,1,0,1,1.357441,103.878387
549149,0,7,7,1.357959,103.878802
549150,3,4,7,1.357949,103.878925
549151,0,2,2,1.357765,103.878935
549152,3,0,3,1.357733,103.87887
549153,1,0,1,1.357648,103.879034
549154,5,1,6,1.357984,103.878959
549155,3,4,7,1.358039,103.878904
549156,16,9,25,1.358029,103.879004
549158,3,2,5,1.35807,103.879056
549159,0,4,4,1.358137,103.879007
549160,0,10,10,1.358144,103.879135
549163,7,18,25,1.358211,103.879104
549164,5,0,5,1.35823,103.879226
549165,1,1,2,1.357809,103.878903
549166,2,0,2,1.358251,103.87915
549167,11,0,11,1.358322,103.879329
549168,2,1,3,1.357999,103.878853
549169,2,0,2,1.358271,103.879276
549170,16,0,16,1.359204,103.880163
549171,5,0,5,1.359242,103.880204
549172,149,0,149,1.359277,103.880239
549173,6,0,6,1.359321,103.880283
549175,1,0,1,1.357913,103.878876
549176,7,0,7,1.359365,103.880353
549177,34,0,34,1.359411,103.880384
549178,2,0,2,1.358408,103.879425
549179,63,0,63,1.35945,103.880422
549180,16,22,38,1.359196,103.880236
549181,4,76,80,1.359607,103.880588
549182,14,4,18,1.359656,103.880549
549183,3,0,3,1.358373,103.87938
549184,2,12,14,1.359756,103.880446
549186,1,4,5,1.359859,103.880349
549188,1,9,10,1.359968,103.880258
549189,7,3,10,1.360013,103.880212
549190,197,3,200,1.359357,103.88043
549191,7,3,10,1.359998,103.880925
549192,5,0,5,1.359588,103.880648
549193,2,2,4,1.360018,103.880968
549194,0,11,11,1.359623,103.880687
549195,4,0,4,1.359663,103.880739
549196,3,0,3,1.359704,103.880491
549197,4,2,6,1.359732,103.880835
549198,27,0,27,1.359772,103.880887
549199,56,3,59,1.359829,103.880966
549200,77,0,77,1.359952,103.881121
549201,4,3,7,1.357632,103.878479
549202,23,1,24,1.357588,103.878442
549203,1,0,1,1.359341,103.880323
549204,0,1,1,1.357524,103.878371
549205,62,4,66,1.357397,103.878247
549206,1,7,8,1.357451,103.878288
549207,0,2,2,1.359041,103.880083
549209,1,1,2,1.357326,103.878169
549211,10,1,11,1.357543,103.879053
549212,2,0,2,1.3576,103.878997
549213,82,6,88,1.358493,103.879393
549214,0,2,2,1.357514,103.879082
549215,1,3,4,1.358545,103.87933
549216,5,0,5,1.358642,103.879381
549217,0,1,1,1.357546,103.878398
549220,14,0,14,1.358757,103.879255
549221,5,0,5,1.358717,103.879165
549222,0,2,2,1.358585,103.879443
549223,5,0,5,1.358774,103.879103
549226,0,1,1,1.358602,103.879279
549227,9,2,11,1.3589,103.878977
549228,24,0,24,1.35898,103.879005
549229,1,1,2,1.358808,103.879193
549230,3,0,3,1.359697,103.880784
549231,8,6,14,1.359032,103.878852
549232,2,1,3,1.359032,103.878948
549233,2,0,2,1.358963,103.878915
549234,3,16,19,1.35914,103.878822
549235,4,2,6,1.359152,103.878727
549236,26,0,26,1.359203,103.878766
549237,7,0,7,1.359215,103.878664
549238,0,4,4,1.359261,103.878714
549239,1,3,4,1.359264,103.878622
549240,87,1,88,1.359232,103.878976
549241,1,1,2,1.359089,103.878789
549242,7,0,7,1.359291,103.878668
549243,1,1,2,1.358852,103.879024
549244,1,3,4,1.359341,103.878552
549245,19,13,32,1.299509,103.837
549257,1,16,17,1.359096,103.881813
549258,3,4,7,1.359065,103.881731
549259,0,10,10,1.359153,103.881756
549261,1,1,2,1.359303,103.878588
549263,2,0,2,1.359205,103.881711
549264,1,8,9,1.359162,103.881611
549265,2,4,6,1.359313,103.881591
549266,5,0,5,1.359202,103.881583
549267,0,11,11,1.359376,103.881534
549268,30,0,30,1.359231,103.881543
549269,138,9,147,1.359271,103.881515
549270,17,11,28,1.359431,103.881457
549271,2,1,3,1.359089,103.878879
549272,0,14,14,1.359479,103.881412
549273,2,0,2,1.359256,103.881654
549274,4,5,9,1.359535,103.881357
549275,1,1,2,1.359412,103.881376
549276,1,4,5,1.359574,103.881346
549289,15,8,23,1.36216,103.875986
549290,104,9,113,1.362093,103.87609
549291,4,10,14,1.362285,103.875658
549292,2,0,2,1.35946,103.881342
549293,7,5,12,1.362039,103.876152
549294,2,0,2,1.362119,103.876309
549296,3,16,19,1.362195,103.875792
549297,30,0,30,1.362169,103.875826
549298,4,4,8,1.362154,103.875862
549299,6,3,9,1.362054,103.876511
549300,16,5,21,1.361996,103.876236
549301,0,1,1,1.358923,103.879067
549302,1,1,2,1.362257,103.875706
549303,17,19,36,1.361709,103.876805
549304,1,5,6,1.36182,103.876823
549305,1,4,5,1.361664,103.87678
549306,1,1,2,1.361947,103.876184
549308,6,7,13,1.361927,103.876813
549309,229,6,235,1.361975,103.876845
549310,7,0,7,1.361694,103.876741
549312,9,0,9,1.361731,103.876529
549313,1,0,1,1.36199,103.876114
549315,6,0,6,1.361603,103.876713
549316,0,2,2,1.361828,103.876357
549317,2,0,2,1.362082,103.876826
549318,144,0,144,1.362044,103.876604
549319,2,0,2,1.36194,103.876593
549320,1,8,9,1.361448,103.876921
549321,20,0,20,1.360918,103.877258
549323,1,0,1,1.361693,103.876592
549324,1,1,2,1.361512,103.876841
549326,18,4,22,1.360971,103.877413
549327,0,3,3,1.359311,103.88148
549328,125,10,135,1.361132,103.877864
549329,48,0,48,1.36118,103.877907
549330,1,0,1,1.360804,103.877308
549331,7,0,7,1.361221,103.877994
549332,23,2,25,1.361291,103.878055
549333,25,0,25,1.361053,103.87793
549334,5,0,5,1.361079,103.877975
549335,5,0,5,1.36117,103.878125
549336,1,0,1,1.361034,103.877876
549337,3,3,6,1.361245,103.878241
549338,727,9,736,1.361596,103.878591
549339,6,0,6,1.361624,103.878624
549340,277,15,292,1.361335,103.878349
549341,79,15,94,1.361813,103.878828
549342,1,0,1,1.361199,103.878171
549344,4,5,9,1.361884,103.878961
549345,206,0,206,1.361387,103.878413
549346,47,1,48,1.362149,103.879236
549347,18,0,18,1.362182,103.879285
549349,0,11,11,1.362254,103.87934
549350,8,1,9,1.362777,103.879924
549351,3,2,5,1.362653,103.879775
549352,7,5,12,1.363208,103.88038
549353,13,4,17,1.363309,103.880478
549354,0,3,3,1.360938,103.87737
549355,2,0,2,1.360764,103.877347
549356,0,2,2,1.363528,103.880647
549357,5,0,5,1.36366,103.88082
549359,10,4,14,1.362932,103.88016
549360,231,0,231,1.361933,103.879017
549361,0,6,6,1.361327,103.877084
549362,3,6,9,1.361618,103.877018
549363,0,6,6,1.361617,103.877241
549364,0,3,3,1.363456,103.880637
549365,3,35,38,1.361538,103.877284
549366,5,2,7,1.362304,103.875629
549367,4,0,4,1.36232,103.875605
549368,1,0,1,1.36174,103.878777
549369,1,3,4,1.362381,103.875481
549370,4,2,6,1.362406,103.875448
549371,11,1,12,1.362365,103.875524
549373,1,52,53,1.358774,103.882726
549374,10,1,11,1.358688,103.882624
549375,0,1,1,1.362341,103.875566
549376,0,3,3,1.361525,103.877251
549377,0,5,5,1.358688,103.882624
549381,1,33,34,1.358988,103.882613
549383,1,2,3,1.358688,103.882624
549384,0,1,1,1.358688,103.882624
549385,10,2,12,1.358889,103.882305
549386,0,2,2,1.363563,103.880721
549392,2,38,40,1.359465,103.882085
549393,1,0,1,1.358923,103.882339
549394,4,11,15,1.359535,103.882023
549396,2,10,12,1.359648,103.881899
549397,2,0,2,1.358849,103.882276
549398,0,13,13,1.359734,103.881802
549399,0,1,1,1.359571,103.881981
549400,10,1,11,1.359879,103.881632
549402,2,6,8,1.359777,103.881611
549403,0,8,8,1.359913,103.881581
549404,5,17,22,1.359969,103.88173
549405,115,13,128,1.360299,103.881218
549406,6,0,6,1.360104,103.880703
549407,0,3,3,1.358957,103.882379
549409,1,0,1,1.359832,103.881683
549410,1,11,12,1.36053,103.880928
549412,2,0,2,1.359697,103.881839
549414,9,2,11,1.360343,103.879813
549415,0,2,2,1.360418,103.879983
549418,0,1,1,1.360431,103.881099
549419,1,10,11,1.3605,103.879981
549420,2,0,2,1.360297,103.87971
549421,8,0,8,1.360443,103.879902
549422,29,2,31,1.360442,103.881155
549423,2,2,4,1.360415,103.879851
549424,31,3,34,1.360385,103.879797
549425,14,3,17,1.36038,103.879754
549426,122,24,146,1.360812,103.879858
549427,5,4,9,1.360595,103.880688
549428,0,3,3,1.360354,103.881179
549429,1,1,2,1.360471,103.879942
549430,3,23,26,1.361589,103.879255
549431,1,4,5,1.360623,103.880438
549432,210,0,210,1.360634,103.880364
549434,1,0,1,1.360251,103.879477
549435,0,1,1,1.360718,103.880168
549436,7,7,14,1.360767,103.880087
549437,120,0,120,1.360849,103.879965
549438,2,0,2,1.360951,103.879692
549440,0,4,4,1.361184,103.879604
549441,23,4,27,1.361298,103.879525
549443,9,0,9,1.361326,103.8795
549444,1,0,1,1.361744,103.879081
549445,5,0,5,1.36156,103.879346
549447,1,2,3,1.360595,103.880583
549449,7,0,7,1.361691,103.879243
549453,3,9,12,1.360503,103.880753
549454,7,14,21,1.360494,103.880591
549455,0,2,2,1.360982,103.879786
549457,0,5,5,1.360531,103.88022
549458,109,0,109,1.360509,103.880171
549459,126,1,127,1.360446,103.880052
549460,1,0,1,1.361344,103.879482
549461,2,1,3,1.361677,103.879279
549463,3,2,5,1.36029,103.879428
549464,2,1,3,1.36038,103.879326
549465,6,11,17,1.362579,103.88699
549466,0,3,3,1.360431,103.879286
549467,1,0,1,1.360328,103.879377
549468,6,10,16,1.362637,103.886814
549469,4,0,4,1.362741,103.886819
549470,0,8,8,1.36272,103.88671
549471,20,11,31,1.362926,103.886631
549472,0,1,1,1.362696,103.886874
549473,1,0,1,1.362745,103.886641
549476,0,6,6,1.362771,103.886538
549477,2,1,3,1.362634,103.886937
549478,0,6,6,1.362782,103.886475
549479,6,1,7,1.363083,103.886777
549481,26,1,27,1.363153,103.886861
549482,3,0,3,1.363049,103.886754
549483,0,2,2,1.360515,103.880456
549484,0,1,1,1.362972,103.886684
549486,5,1,6,1.363057,103.886721
549487,0,1,1,1.363115,103.886791
549488,15,0,15,1.362941,103.886581
549490,5,20,25,1.362825,103.886441
549492,0,1,1,1.362999,103.886651
549493,1,0,1,1.363146,103.886105
549494,7,2,9,1.36339,103.885917
549495,0,1,1,1.363179,103.886078
549496,0,18,18,1.36355,103.885793
549497,8,8,16,1.363814,103.885729
549498,1,0,1,1.363358,103.885945
549499,26,1,27,1.363813,103.885728
549500,10,1,11,1.363813,103.885728
549501,4,0,4,1.363957,103.885904
549503,3,1,4,1.363956,103.885903
549506,2,0,2,1.363144,103.886826
549507,5,0,5,1.364136,103.885398
549508,3,1,4,1.364432,103.885011
549509,21,0,21,1.364296,103.885259
549510,0,1,1,1.363813,103.885728
549513,24,2,26,1.364421,103.885176
549514,3,1,4,1.36447,103.884969
549516,6,11,17,1.364601,103.884925
549517,73,7,80,1.36455,103.884937
549518,0,5,5,1.364569,103.884928
549519,3,0,3,1.362787,103.886439
549520,1,1,2,1.364048,103.88547
549521,4,0,4,1.364973,103.885152
549522,1,0,1,1.364265,103.885285
549523,5,0,5,1.365087,103.885176
549524,3,20,23,1.364929,103.884955
549525,29,1,30,1.364911,103.884946
549526,1,1,2,1.364903,103.88513
549527,2,16,18,1.364845,103.884931
549528,0,1,1,1.365014,103.885155
549529,6,5,11,1.364781,103.884913
549530,5,0,5,1.364824,103.884927
549531,281,0,281,1.364803,103.88492
549533,2,9,11,1.365065,103.885162
549534,1,12,13,1.365526,103.885303
549535,1,4,5,1.365569,103.885321
549536,0,1,1,1.364866,103.884936
549537,4,0,4,1.36568,103.885369
549538,6,27,33,1.3657,103.88571
549539,39,4,43,1.36563,103.885781
549540,7,2,9,1.366,103.885347
549541,0,1,1,1.365604,103.885355
549542,9,0,9,1.365999,103.885346
549543,5,9,14,1.365996,103.885787
549544,5,5,10,1.365942,103.885799
549545,74,2,76,1.365885,103.885745
549546,43,0,43,1.36583,103.885847
549547,15,3,18,1.36576,103.885919
549548,6,5,11,1.365708,103.885983
549549,1,0,1,1.365999,103.885346
549551,1,1,2,1.364893,103.884944
549552,11,0,11,1.366138,103.885367
549553,0,3,3,1.364524,103.884947
549554,9,2,11,1.366138,103.885367
549555,135,39,174,1.36639,103.885793
549556,1,3,4,1.393618,103.742559
549557,9,2,11,1.299509,103.837
549558,3,3,6,1.299509,103.837
549560,2,18,20,1.299509,103.837
549561,86,0,86,1.366243,103.885771
549562,46,5,51,1.299509,103.837
549563,6,10,16,1.299509,103.837
549564,2,3,5,1.299509,103.837
549567,2,6,8,1.299509,103.837
549568,64,7,71,1.366935,103.885592
549569,0,6,6,1.367007,103.885587
549570,16,21,37,1.367268,103.885564
549571,3,3,6,1.367344,103.885547
549572,2,8,10,1.367385,103.885535
549573,7,10,17,1.367422,103.885511
549574,109,38,147,1.367475,103.885493
549575,2,25,27,1.367509,103.885485
549576,142,0,142,1.363432,103.885934
549588,5,2,7,1.361871,103.886426
549589,1,29,30,1.36193,103.886533
549590,2,3,5,1.362005,103.886465
549591,6,1,7,1.36204,103.886429
549592,13,1,14,1.361911,103.886402
549593,8,1,9,1.362102,103.886298
549594,10,0,10,1.362101,103.886297
549595,0,12,12,1.361942,103.886369
549596,0,26,26,1.362142,103.886261
549598,2,4,6,1.362212,103.886204
549599,51,14,65,1.362032,103.886304
549600,1,6,7,1.362282,103.886146
549601,15,1,16,1.362059,103.886286
549602,3,2,5,1.362353,103.886089
549603,11,35,46,1.362423,103.886032
549604,0,1,1,1.365672,103.885988
549606,0,1,1,1.362102,103.886278
549608,1,2,3,1.366138,103.885367
549609,3,1,4,1.362392,103.886037
549610,14,79,93,1.362413,103.886022
549623,1,17,18,1.357676,103.877589
549624,1,0,1,1.362204,103.88619
549625,0,3,3,1.362329,103.886088
549626,2,0,2,1.366139,103.885368
549628,22,0,22,1.357855,103.877822
549629,25,0,25,1.357894,103.877842
549630,3,12,15,1.357946,103.877908
549631,1,0,1,1.357716,103.877635
549632,3,0,3,1.357757,103.877686
549633,5,0,5,1.358055,103.878038
549634,5,0,5,1.358089,103.878073
549635,4,3,7,1.358238,103.878052
549636,9,0,9,1.358056,103.878139
549637,5,1,6,1.358164,103.878152
549638,1,1,2,1.357797,103.877737
549639,2,1,3,1.35802,103.877999
549640,12,2,14,1.358119,103.878213
549641,3,2,5,1.358244,103.878243
549642,2,2,4,1.358154,103.878241
549643,1,5,6,1.358302,103.878281
549645,1,15,16,1.358199,103.87831
549646,10,3,13,1.357642,103.877685
549647,44,0,44,1.357676,103.877725
549648,0,2,2,1.358085,103.878179
549650,4,0,4,1.357773,103.877865
549651,11,0,11,1.357808,103.877879
549652,50,0,50,1.357837,103.877924
549653,5,0,5,1.357871,103.877964
549654,11,0,11,1.3579,103.878009
549655,0,2,2,1.357711,103.877765
549658,0,3,3,1.358209,103.878198
549659,1,0,1,1.357986,103.877953
549660,13,2,15,1.358519,103.877672
549661,11,0,11,1.358494,103.877694
549662,1,2,3,1.358815,103.877376
549664,19,4,23,1.358537,103.877718
549676,6,3,9,1.359865,103.875452
549677,2,7,9,1.359896,103.875505
549678,3,1,4,1.359906,103.875521
549679,4,0,4,1.359916,103.875505
549681,0,2,2,1.357934,103.878043
549682,0,1,1,1.358773,103.877408
549683,2,0,2,1.360007,103.875627
549684,3,0,3,1.358696,103.877491
549685,1,4,5,1.3604,103.876037
549686,3,0,3,1.360118,103.875718
549687,3,0,3,1.360218,103.875824
549688,1,0,1,1.360017,103.875612
549690,3,0,3,1.360602,103.87625
549691,2,1,3,1.360601,103.876249
549692,0,1,1,1.360601,103.876249
549693,24,6,30,1.360601,103.876249
549694,31,0,31,1.360319,103.875931
549695,4,13,17,1.36042,103.876037
549696,0,1,1,1.360601,103.876249
549697,16,0,16,1.360521,103.876144
549698,2,0,2,1.360198,103.875824
549699,4,13,17,1.360612,103.87624
549700,12,12,24,1.360611,103.876239
549701,1,11,12,1.360611,103.876239
549702,4,2,6,1.360802,103.87645
549703,131,1,132,1.360622,103.87625
549704,20,2,22,1.360621,103.876249
549705,2,0,2,1.360702,103.87635
549706,24,2,26,1.360621,103.876249
549707,6,0,6,1.360902,103.87655
549708,16,0,16,1.361022,103.87665
549709,9,0,9,1.361002,103.87665
549710,0,1,1,1.360652,103.8763
549711,122,0,122,1.361101,103.876749
549712,1,0,1,1.361411,103.877039
549713,3,1,4,1.361301,103.876949
549714,101,1,102,1.361401,103.877049
549727,3,3,6,1.363552,103.883963
549728,39,56,95,1.363354,103.883903
549729,1,0,1,1.361201,103.876849
549730,3,1,4,1.363642,103.883643
549731,2,0,2,1.360621,103.876249
549732,1,1,2,1.363726,103.883674
549733,9,0,9,1.363791,103.883627
549734,4,2,6,1.36385,103.883561
549735,19,0,19,1.363708,103.883367
549736,8,18,26,1.363663,103.883432
549739,1,0,1,1.363585,103.883789
549740,3,1,4,1.363537,103.883125
549741,22,0,22,1.363521,103.88309
549742,1,1,2,1.363678,103.883615
549743,1,0,1,1.363566,103.883187
549744,2,1,3,1.360601,103.876249
549745,7,1,8,1.363349,103.882788
549746,7,1,8,1.363949,103.883481
549748,0,6,6,1.364058,103.88337
549749,2,0,2,1.363478,103.883048
549750,12,0,12,1.36414,103.883288
549751,15,0,15,1.364149,103.883214
549752,0,23,23,1.364192,103.883252
549754,30,0,30,1.364217,103.883201
549755,1,3,4,1.364259,103.883129
549757,96,8,104,1.364301,103.883101
549758,51,0,51,1.36436,103.883091
549759,2,0,2,1.364108,103.883325
549760,1,1,2,1.364345,103.883083
549761,11,14,25,1.364423,103.883023
549762,4,0,4,1.364504,103.882981
549764,16,1,17,1.36457,103.88292
549765,0,7,7,1.36456,103.88291
549766,5,2,7,1.364595,103.882889
549767,8,6,14,1.364321,103.882372
549769,6,2,8,1.364511,103.882592
549770,5,1,6,1.364234,103.882434
549771,9,2,11,1.36455,103.882586
549772,7,0,7,1.364176,103.882476
549773,27,0,27,1.364627,103.882575
549774,1,2,3,1.363408,103.882918
549775,2,2,4,1.364705,103.882563
549777,32,0,32,1.364782,103.882552
549778,4,5,9,1.364003,103.882601
549779,1,3,4,1.36486,103.88254
549780,6,0,6,1.363945,103.882643
549782,13,6,19,1.363887,103.882685
549783,10,0,10,1.365015,103.882517
549785,1,2,3,1.364119,103.882518
549788,12,4,16,1.364774,103.882533
549789,1,0,1,1.363415,103.882958
549790,0,3,3,1.364955,103.882506
549791,0,5,5,1.364653,103.882551
549792,4,3,7,1.363748,103.882765
549793,3,0,3,1.363673,103.882819
549794,0,2,2,1.364432,103.883036
549795,2,0,2,1.363824,103.88271
549796,19,0,19,1.363899,103.882656
549797,5,4,9,1.3645,103.882574
549798,5,0,5,1.363974,103.882602
549799,5,1,6,1.364049,103.882548
549801,55,25,80,1.3642,103.882439
549803,5,3,8,1.36434,103.882341
549804,7,11,18,1.363856,103.883407
549805,2,1,3,1.364593,103.88256
549806,1,11,12,1.363977,103.883335
549807,1,0,1,1.364713,103.882542
549808,151,5,156,1.364068,103.883273
549809,10,0,10,1.363829,103.882726
549810,5,7,12,1.363772,103.882768
549811,2,0,2,1.364532,103.882569
549813,1,0,1,1.364015,103.883297
549815,9,3,12,1.363635,103.882845
549817,1,2,3,1.363917,103.883381
549818,1,0,1,1.363608,103.882883
549819,0,1,1,1.364657,103.874999
549820,16,0,16,1.36472,103.875181
549821,0,5,5,1.364754,103.875283
549822,3,0,3,1.364617,103.87486
549823,83,10,93,1.364876,103.875506
549824,4,0,4,1.364884,103.875609
549825,10,11,21,1.364239,103.875638
549826,9,0,9,1.364938,103.875684
549827,1,2,3,1.364789,103.875403
549828,11,0,11,1.364342,103.875972
549829,1,1,2,1.363714,103.88281
549830,8,0,8,1.364396,103.876096
549831,12,1,13,1.364456,103.87567
549832,2,2,4,1.364436,103.876211
549833,3,11,14,1.364497,103.87574
549834,4,0,4,1.364555,103.875872
549835,3,1,4,1.364921,103.877277
549836,32,8,40,1.364563,103.875925
549837,2,0,2,1.364446,103.875621
549839,7,0,7,1.364987,103.877383
549840,1,4,5,1.364631,103.876039
549841,5,0,5,1.365075,103.877346
549842,16,1,17,1.364644,103.876059
549844,6,0,6,1.364649,103.876127
549845,6,24,30,1.365153,103.877419
549846,121,0,121,1.365238,103.877547
549847,8,7,15,1.365193,103.877507
549848,9,17,26,1.365339,103.877729
549849,0,45,45,1.365384,103.877786
549850,10,1,11,1.365458,103.877815
549851,7,6,13,1.365477,103.877891
549852,10,16,26,1.365528,103.87796
549853,37,0,37,1.36495,103.875748
549854,17,0,17,1.36431,103.875837
549856,7,0,7,1.365208,103.877534
549857,57,0,57,1.365208,103.877534
549858,3,0,3,1.36416,103.875214
549859,8,0,8,1.365208,103.877534
549860,1,0,1,1.364685,103.875084
549861,3,0,3,1.365208,103.877534
549862,4,0,4,1.364891,103.878164
549863,2,0,2,1.36494,103.877341
549864,2,0,2,1.364925,103.878109
549865,2,0,2,1.365292,103.877594
549866,2,3,5,1.36051,103.875028
549868,1,1,2,1.365292,103.877594
549869,1,0,1,1.365292,103.877594
549870,2,1,3,1.364887,103.878222
549871,0,2,2,1.360895,103.875579
549872,22,1,23,1.360786,103.875466
549873,2,2,4,1.360721,103.875474
549874,3,1,4,1.360721,103.875474
549875,1,1,2,1.360767,103.875519
549876,1,0,1,1.360807,103.875565
549877,32,0,32,1.360625,103.875306
549878,2,1,3,1.360843,103.875522
549879,2,2,4,1.360568,103.875244
549881,1,3,4,1.360568,103.875244
549882,6,0,6,1.360474,103.875229
549883,0,1,1,1.360618,103.875377
549884,0,4,4,1.361027,103.875597
549885,3,6,9,1.360923,103.875613
549886,4,2,6,1.360799,103.875759
549887,2,1,3,1.360566,103.875326
549888,1,3,4,1.361027,103.875597
549954,171,203,374,1.353011,103.875827
549957,0,49,49,1.353501,103.875425
549959,0,3,3,1.360861,103.875783
549961,6,56,62,1.353656,103.875288
549962,25,0,25,1.35369,103.875254
549964,3,33,36,1.353759,103.875186
549965,0,109,109,1.353179,103.876
549966,1,39,40,1.353236,103.875943
549967,7,26,33,1.353388,103.876089
549968,6,0,6,1.353385,103.875829
549969,1,241,242,1.353477,103.875738
549970,0,2,2,1.360669,103.875423
549971,0,3,3,1.353638,103.875317
549972,7,56,63,1.353585,103.875647
549973,1,24,25,1.35365,103.875616
549974,0,30,30,1.353759,103.875523
549975,38,23,61,1.353824,103.875486
549976,28,46,74,1.353875,103.875418
549977,5,50,55,1.354383,103.874955
549978,7,1,8,1.353951,103.875351
549979,1,34,35,1.353994,103.875322
549980,3,1,4,1.354173,103.875155
549981,1,67,68,1.35414,103.875198
549982,20,0,20,1.354286,103.875039
549983,1,69,70,1.354326,103.875011
549985,3,53,56,1.354464,103.87489
549986,1,30,31,1.354609,103.874758
549988,1,27,28,1.35466,103.874925
549989,2,53,55,1.354654,103.874713
549990,6,543,549,1.354693,103.874685
549991,3,44,47,1.354565,103.874802
550101,1238,4577,5815,1.371037,103.870226
550102,73,2904,2977,1.370838,103.870949
550103,465,286,751,1.370734,103.8702
550104,179,5996,6175,1.370662,103.870918
550105,176,366,542,1.370238,103.870049
550106,198,2813,3011,1.370251,103.870907
550107,1313,2348,3661,1.36991,103.870069
550108,757,1370,2127,1.369918,103.87093
550109,1313,1892,3205,1.369419,103.870362
550110,380,1505,1885,1.369323,103.871251
550111,1301,267,1568,1.369117,103.870453
550112,47,152,199,1.369137,103.871433
550113,333,511,844,1.368714,103.870362
550114,1367,242,1609,1.368802,103.871291
550115,565,459,1024,1.368175,103.870544
550116,1125,344,1469,1.368474,103.871379
550117,1121,179,1300,1.367952,103.870696
550118,982,757,1739,1.367589,103.870767
550119,42,44,86,1.367589,103.87139
550120,345,618,963,1.367214,103.870854
550121,657,230,887,1.366908,103.871001
550122,244,102,346,1.366662,103.871242
550123,777,171,948,1.366832,103.872065
550124,420,174,594,1.366228,103.871376
550125,415,2822,3237,1.366521,103.872153
550126,776,881,1657,1.366023,103.871635
550127,276,756,1032,1.365631,103.871705
550128,470,2966,3436,1.365878,103.872784
550129,275,164,439,1.365817,103.873119
550130,251,1933,2184,1.366139,103.873163
550131,36,7,43,1.365949,103.873715
550132,98,49,147,1.365601,103.8741
550133,293,192,485,1.366143,103.874518
550134,485,48,533,1.366272,103.874022
550135,784,271,1055,1.367372,103.874966
550136,720,199,919,1.368069,103.87482
550137,631,191,822,1.367844,103.875199
550138,240,1232,1472,1.368246,103.875496
550139,718,339,1057,1.368761,103.87533
550140,1241,476,1717,1.368491,103.874971
550141,871,1613,2484,1.368579,103.874424
550142,211,618,829,1.367403,103.873946
550143,401,236,637,1.36739,103.872894
550144,460,146,606,1.36776,103.872912
550145,270,311,581,1.367853,103.872354
550146,406,302,708,1.368176,103.872737
550147,1026,593,1619,1.368492,103.872537
550148,191,2964,3155,1.368627,103.873619
550149,2,343,345,1.299509,103.837
550150,25,398,423,1.369416,103.874661
550151,561,5287,5848,1.36926,103.874318
550152,260,8529,8789,1.369405,103.872572
550153,711,415,1126,1.369972,103.872411
550154,379,349,728,1.370166,103.873553
550157,131,16,147,1.370835,103.868978
550201,653,2470,3123,1.351274,103.873794
550202,330,368,698,1.351527,103.873665
550203,350,2052,2402,1.352066,103.873216
550204,248,1031,1279,1.352512,103.873231
550205,369,101,470,1.352786,103.87334
550206,845,1583,2428,1.353471,103.873335
550207,453,1472,1925,1.353855,103.873433
550208,602,634,1236,1.354066,103.873707
550209,398,245,643,1.354506,103.874118
550210,549,1061,1610,1.354907,103.873555
550211,1184,1036,2220,1.35642,103.873213
550212,520,399,919,1.356775,103.872967
550213,790,219,1009,1.357238,103.873005
550214,661,3521,4182,1.357329,103.873558
550215,540,885,1425,1.357862,103.873303
550216,787,597,1384,1.357622,103.873038
550217,1784,662,2446,1.357621,103.871986
550218,556,502,1058,1.35799,103.872016
550219,823,175,998,1.358376,103.872054
550220,965,197,1162,1.358713,103.872093
550221,1108,468,1576,1.359209,103.871776
550222,874,711,1585,1.358512,103.871085
550223,1003,296,1299,1.357604,103.870322
550224,576,827,1403,1.357249,103.870668
550225,1113,388,1501,1.356956,103.870077
550226,991,4098,5089,1.356886,103.870712
550227,626,3310,3936,1.356224,103.870735
550228,994,383,1377,1.35642,103.870132
550229,604,1065,1669,1.356065,103.870147
550230,796,1278,2074,1.355971,103.869265
550231,277,1307,1584,1.355014,103.868311
550232,564,201,765,1.354803,103.868602
550233,735,1438,2173,1.355122,103.86902
550234,463,257,720,1.354856,103.869434
550235,648,2896,3544,1.355052,103.869881
550236,404,2243,2647,1.354446,103.869765
550237,381,1116,1497,1.354141,103.870085
550238,737,210,947,1.353549,103.868994
550239,455,1416,1871,1.353256,103.868674
550240,424,350,774,1.353276,103.869306
550241,635,1060,1695,1.352676,103.870037
550242,374,415,789,1.352638,103.869555
550243,230,269,499,1.352884,103.868717
550244,42,2212,2254,1.352552,103.868726
550245,327,900,1227,1.352465,103.869066
550246,278,4445,4723,1.352131,103.869721
550253,125,4660,4785,1.353708,103.870912
550254,362,760,1122,1.354041,103.871142
550255,576,3099,3675,1.355039,103.870771
550256,993,1827,2820,1.355083,103.871318
550257,739,1668,2407,1.355122,103.871894
550258,837,3525,4362,1.355148,103.87275
550261,444,15340,15784,1.354133,103.872449
550262,309,8175,8484,1.353266,103.872115
550263,142,100,242,1.354197,103.87199
550264,70,4358,4428,1.352222,103.872072
550265,53,151,204,1.352988,103.871459
550266,12,1,13,1.353432,103.871399
550267,690,8414,9104,1.353246,103.870925
550301,186,2665,2851,1.353173,103.867803
550302,468,147,615,1.353243,103.867054
550303,442,150,592,1.353548,103.866996
550304,363,11253,11616,1.353935,103.867628
550305,443,317,760,1.35392,103.866899
550306,486,234,720,1.354231,103.866852
550307,1034,1760,2794,1.354533,103.867206
550308,703,1675,2378,1.354172,103.865835
550309,693,763,1456,1.35378,103.865118
550310,943,270,1213,1.353676,103.865611
550311,78,256,334,1.353765,103.866232
550312,368,207,575,1.353308,103.865767
550313,84,142,226,1.353354,103.865156
550314,124,31,155,1.353038,103.865481
550315,637,122,759,1.353038,103.86594
550316,241,181,422,1.352988,103.866425
550317,538,88,626,1.35268,103.866083
550318,384,88,472,1.352886,103.86713
550319,302,217,519,1.352338,103.867832
550321,583,133,716,1.352183,103.868597
550322,466,1922,2388,1.351757,103.868627
550323,669,5631,6300,1.351125,103.869333
550324,422,355,777,1.35131,103.86876
550325,420,317,737,1.350907,103.868675
550326,403,5152,5555,1.350383,103.86899
550327,451,245,696,1.350592,103.868413
550328,617,370,987,1.350393,103.868216
550329,953,1368,2321,1.349769,103.868215
550330,547,327,874,1.349912,103.8697
550331,572,149,721,1.349982,103.8701
550332,719,6436,7155,1.350952,103.870219
550333,229,1709,1938,1.350571,103.870396
550334,703,3431,4134,1.350284,103.870769
550335,965,1187,2152,1.349491,103.870876
550401,811,115,926,1.346368,103.873225
550402,922,373,1295,1.346706,103.872732
550403,1065,106,1171,1.346375,103.872411
550404,1227,859,2086,1.347157,103.872457
550405,417,348,765,1.347717,103.872749
550406,92,78,170,1.347608,103.873123
550407,576,249,825,1.347244,103.872893
550408,367,614,981,1.34723,103.873391
550409,428,5897,6325,1.347921,103.874327
550410,239,157,396,1.347815,103.873793
550411,532,418,950,1.348528,103.873759
550412,510,1718,2228,1.348426,103.873192
550413,427,510,937,1.349186,103.873913
550414,194,4210,4404,1.349008,103.87429
550415,302,3212,3514,1.34968,103.874517
550416,593,692,1285,1.350193,103.87478
550417,486,138,624,1.349974,103.874939
550418,82,231,313,1.349662,103.8752
550419,483,160,643,1.34924,103.875816
550420,283,214,497,1.349203,103.875079
550421,373,1791,2164,1.348844,103.875143
550422,785,287,1072,1.348855,103.87596
550423,460,354,814,1.348531,103.875491
550424,305,361,666,1.34812,103.875501
550425,826,257,1083,1.348201,103.876532
550426,711,1011,1722,1.347833,103.875979
550427,399,1818,2217,1.347833,103.875159
550500,374,3900,4274,1.374651,103.875711
550501,456,78,534,1.374217,103.876158
550502,296,1353,1649,1.374645,103.876481
550503,22,115,137,1.374019,103.876488
550504,367,342,709,1.373728,103.876031
550505,602,183,785,1.373382,103.876433
550506,884,810,1694,1.37285,103.876257
550507,744,1817,2561,1.371945,103.875242
550508,748,329,1077,1.371657,103.87577
550509,610,80,690,1.371397,103.876092
550510,868,497,1365,1.370672,103.875794
550511,556,307,863,1.371239,103.875571
550512,573,236,809,1.37152,103.875109
550514,326,294,620,1.370972,103.874188
550515,245,1593,1838,1.371126,103.873574
550516,560,1388,1948,1.371393,103.87321
550517,668,177,845,1.371378,103.874083
550518,463,334,797,1.371697,103.874182
550519,296,4467,4763,1.371976,103.874581
550520,398,476,874,1.372017,103.873641
550521,959,2360,3319,1.373279,103.873296
550522,113,132,245,1.372552,103.873336
550523,302,686,988,1.373073,103.872802
550524,828,302,1130,1.372745,103.872755
550525,365,356,721,1.372206,103.87261
550526,610,164,774,1.371806,103.8728
550527,557,1721,2278,1.3715,103.872808
550528,408,1789,2197,1.371463,103.872163
550529,250,3400,3650,1.372749,103.872207
550530,645,8605,9250,1.373384,103.872405
550531,460,3453,3913,1.374815,103.874995
550532,410,5900,6310,1.374844,103.874264
550533,243,271,514,1.374527,103.874532
550534,640,534,1174,1.374201,103.874514
550535,617,308,925,1.373799,103.873959
550536,486,2412,2898,1.373699,103.875112
550537,437,661,1098,1.374097,103.873177
550538,338,3252,3590,1.374903,103.87312
550539,634,3819,4453,1.374957,103.871994
550540,452,123,575,1.374672,103.872498
550541,401,313,714,1.374285,103.872603
550542,1031,835,1866,1.373908,103.872121
550543,616,153,769,1.374414,103.871219
550544,358,41,399,1.374431,103.87064
550545,672,3657,4329,1.374994,103.8712
550546,735,250,985,1.374778,103.870133
550547,668,1172,1840,1.373793,103.870583
550548,908,504,1412,1.373165,103.870599
550549,697,185,882,1.37272,103.871014
550550,883,166,1049,1.372741,103.870339
550551,658,164,822,1.372332,103.870821
550552,689,2580,3269,1.37232,103.871296
550553,399,1175,1574,1.371766,103.871081
550554,649,1624,2273,1.371984,103.870336
551135,11,162,173,1.299509,103.837
551141,32,4104,4136,1.36785,103.87422
551149,3,183,186,1.299509,103.837
551151,87,5837,5924,1.369543,103.873505
551152,14,37,51,1.369638,103.872672
551153,104,17226,17330,1.369658,103.871798
551157,42,1902,1944,1.299509,103.837
551223,833,2886,3719,1.357139,103.870581
551232,842,7317,8159,1.35434,103.868404
551234,615,461,1076,1.354354,103.868919
551236,992,152,1144,1.353988,103.86923
551238,20,240,260,1.354029,103.868893
551254,16,11,27,1.354454,103.870966
551256,14,2704,2718,1.354866,103.871513
551257,44,1230,1274,1.355205,103.872359
551410,1,258,259,1.348233,103.873588
551506,301,2299,2600,1.373134,103.875708
551512,9,137,146,1.371432,103.875202
551535,141,105,246,1.373614,103.874401
551542,58,2206,2264,1.373651,103.871834
551546,7,114,121,1.374118,103.869932
551550,5,185,190,1.372984,103.870202
552152,9,23,32,1.369306,103.873048
552157,2,9,11,1.299509,103.837
552223,14,1436,1450,1.357139,103.870581
552506,177,1364,1541,1.372581,103.87563
552542,72,956,1028,1.37338,103.871295
553157,16,1343,1359,1.299509,103.837
554351,5,2,7,1.299509,103.837
554353,7,2,9,1.299509,103.837
554354,0,8,8,1.299509,103.837
554356,3,4,7,1.299509,103.837
554357,5,4,9,1.299509,103.837
554358,7,1,8,1.299509,103.837
554359,1,27,28,1.299509,103.837
554360,275,102,377,1.375963,103.870676
554361,18,42,60,1.299509,103.837
554362,10,30,40,1.366114,103.861603
554363,50,2,52,1.299509,103.837
554365,5,1,6,1.299509,103.837
554366,11,2,13,1.299509,103.837
554367,6,20,26,1.299509,103.837
554368,5,13,18,1.299509,103.837
554369,1548,755,2303,1.375499,103.873654
554370,15,8,23,1.299509,103.837
554371,5,1,6,1.299509,103.837
554372,2,14,16,1.299509,103.837
554373,2,19,21,1.299509,103.837
554374,5,7,12,1.299509,103.837
554375,0,3,3,1.353532,103.87569
554376,7,1,8,1.299509,103.837
554377,16,3,19,1.299509,103.837
554378,3,2,5,1.299509,103.837
554379,2,3,5,1.299509,103.837
554380,5,4,9,1.299509,103.837
554382,5,3,8,1.36267,103.873001
554383,5,2,7,1.299509,103.837
554384,6,43,49,1.299509,103.837
554385,0,6,6,1.299509,103.837
554386,90,11,101,1.299509,103.837
554387,59,2,61,1.299509,103.837
554388,3,13,16,1.299509,103.837
554389,15,1,16,1.299509,103.837
554390,2,3,5,1.299509,103.837
554391,3,1,4,1.354173,103.875155
554392,88,1,89,1.299509,103.837
554393,47,0,47,1.299509,103.837
554394,1,3,4,1.299509,103.837
554396,10,5,15,1.299509,103.837
554397,15,35,50,1.299509,103.837
554398,0,1,1,1.36047,103.875118
554399,0,1,1,1.299509,103.837
554400,15,0,15,1.299509,103.837
554402,0,1,1,1.299509,103.837
554403,0,5,5,1.299509,103.837
554404,3,44,47,1.299509,103.837
554405,70,1,71,1.299509,103.837
554406,14,0,14,1.299509,103.837
554407,1,0,1,1.299509,103.837
554409,5,1,6,1.299509,103.837
554410,1,0,1,1.299509,103.837
554411,5,1,6,1.299509,103.837
554412,3,0,3,1.299509,103.837
554413,6,0,6,1.299509,103.837
554415,0,31,31,1.299509,103.837
554416,2,2,4,1.299509,103.837
554417,0,1,1,1.299509,103.837
554418,1,0,1,1.299509,103.837
554419,7,1,8,1.299509,103.837
554420,3,1,4,1.299509,103.837
554421,3,3,6,1.299509,103.837
554422,14,2,16,1.299509,103.837
554423,48,1,49,1.299509,103.837
554424,13,1,14,1.299509,103.837
554425,8,0,8,1.299509,103.837
554426,0,27,27,1.299509,103.837
554427,33,7,40,1.299509,103.837
554428,7,9,16,1.299509,103.837
554429,11,1,12,1.299509,103.837
554430,2,0,2,1.353685,103.875581
554431,9,0,9,1.299509,103.837
554432,25,0,25,1.363879,103.860121
554433,52,0,52,1.299509,103.837
554434,13,28,41,1.299509,103.837
554435,30,0,30,1.299509,103.837
554436,8,14,22,1.299509,103.837
554437,22,6,28,1.299509,103.837
554438,5,0,5,1.299509,103.837
554439,5,0,5,1.299509,103.837
554440,5,2,7,1.299509,103.837
554441,0,1,1,1.299509,103.837
554443,15,26,41,1.299509,103.837
554444,1,0,1,1.299509,103.837
554445,1,0,1,1.299509,103.837
554447,12,1,13,1.299509,103.837
554448,0,2,2,1.299509,103.837
554449,2,1,3,1.299509,103.837
554450,9,0,9,1.299509,103.837
554451,1,0,1,1.299509,103.837
554455,9,1,10,1.299509,103.837
554456,52,1,53,1.299509,103.837
554457,3,0,3,1.299509,103.837
554458,13,44,57,1.299509,103.837
554459,0,1,1,1.299509,103.837
554460,18,0,18,1.299509,103.837
554461,8,1,9,1.299509,103.837
554462,3,0,3,1.299509,103.837
554463,11,1,12,1.299509,103.837
554464,4,3,7,1.299509,103.837
554465,1,2,3,1.299509,103.837
554466,17,2,19,1.299509,103.837
554467,0,3,3,1.299509,103.837
554468,83,46,129,1.299509,103.837
554470,1,0,1,1.299509,103.837
554471,4,0,4,1.299509,103.837
554472,0,6,6,1.299509,103.837
554473,75,0,75,1.299509,103.837
554474,120,2281,2401,1.299509,103.837
554475,926,1106,2032,1.350831,103.865342
554476,608,6,614,1.350831,103.865342
554477,631,24,655,1.350831,103.865342
554478,1644,336,1980,1.35114,103.865482
554479,1001,1224,2225,1.350471,103.8654
554480,7,31,38,1.358499,103.86869
554481,35,15,50,1.358549,103.86884
554482,4,6,10,1.358509,103.868877
554483,4,3,7,1.358509,103.868942
554484,5,1,6,1.358494,103.868995
554485,18,0,18,1.358139,103.869584
554486,4,1,5,1.358139,103.869584
554487,13,2,15,1.358139,103.869584
554488,4,1,5,1.358139,103.869584
554489,4,0,4,1.358139,103.869584
554490,8,1,9,1.358139,103.869584
554491,7,1,8,1.358139,103.869584
554492,6,1,7,1.358139,103.869584
554493,3,0,3,1.299509,103.837
554494,1,0,1,1.299509,103.837
554495,3,0,3,1.358139,103.869584
554496,107,9,116,1.358139,103.869584
554497,0,7,7,1.357978,103.87024
554499,31,0,31,1.358139,103.869584
554500,37,1498,1535,1.375587,103.869048
554501,2,6,8,1.362525,103.869868
554502,355,1136,1491,1.375873,103.871438
554503,18,0,18,1.358063,103.870086
554504,4,0,4,1.358103,103.870061
554505,1,0,1,1.358139,103.869584
554506,1,0,1,1.358117,103.870021
554507,33,0,33,1.358151,103.869925
554508,6,1,7,1.35819,103.869861
554509,41,1,42,1.358213,103.869806
554510,23,1,24,1.358267,103.86975
554511,1,0,1,1.358124,103.869952
554512,2,0,2,1.299509,103.837
554513,43,0,43,1.358353,103.869612
554514,58,0,58,1.358378,103.869564
554515,0,1,1,1.358291,103.869737
554516,33,0,33,1.358343,103.868916
554517,1,0,1,1.358343,103.868916
554518,43,0,43,1.358343,103.868916
554519,83,0,83,1.358343,103.868916
554520,101,1,102,1.358343,103.868916
554522,2,1,3,1.358139,103.869584
554523,93,2,95,1.358343,103.868916
554524,91,5,96,1.358343,103.868916
554525,16,3,19,1.358343,103.868916
554526,2,5,7,1.358343,103.868916
554527,9,2,11,1.358343,103.868916
554528,8,2,10,1.358343,103.868916
554529,4,0,4,1.358103,103.870061
554530,205,95,300,1.375562,103.873529
554531,175,21,196,1.375468,103.868599
554532,3061,3263,6324,1.3731,103.86924
554533,692,2552,3244,1.351766,103.86362
554535,1,0,1,1.358343,103.868916
554536,10,0,10,1.360433,103.871593
554537,6,0,6,1.360433,103.871593
554539,0,1,1,1.360433,103.871593
554540,1,0,1,1.360433,103.871593
554546,1,8,9,1.359484,103.873032
554547,3,0,3,1.358343,103.868916
554548,27,0,27,1.369317,103.862991
554549,117,219,336,1.369765,103.863895
554550,11,1,12,1.360688,103.86908
554551,17,0,17,1.358103,103.862633
554552,2,0,2,1.358331,103.86965
554553,15,4,19,1.373124,103.867345
554554,2,1,3,1.359927,103.873147
554555,1,0,1,1.360433,103.871593
554556,0,1,1,1.361158,103.869374
554557,28,3,31,1.361745,103.866284
554558,19,8,27,1.361696,103.866293
554559,17,3,20,1.361667,103.866293
554560,5,0,5,1.362347,103.866398
554561,5,5,10,1.362398,103.86639
554562,13,0,13,1.362131,103.866015
554563,13,1,14,1.361746,103.865739
554564,42,0,42,1.36205,103.865503
554566,1,0,1,1.361804,103.866303
554567,39,0,39,1.36169,103.865525
554568,6,2,8,1.361477,103.865539
554569,1,7,8,1.361566,103.865536
554570,0,5,5,1.362219,103.865699
554571,3,0,3,1.363655,103.860528
554572,9,0,9,1.362232,103.86594
554573,11,9,20,1.362255,103.86602
554574,769,9655,10424,1.374741,103.868265
554575,1,1,2,1.365421,103.861704
554576,26,0,26,1.361613,103.8662
554577,41,2,43,1.361703,103.866169
554578,11,2,13,1.361783,103.866183
554579,2,3,5,1.361852,103.866179
554580,0,1,1,1.361777,103.865541
554581,0,1,1,1.361938,103.866173
554583,0,4,4,1.362212,103.865603
554584,7,10,17,1.362147,103.866111
554585,3,3,6,1.362068,103.865881
554586,9,8,17,1.362082,103.866071
554587,2,0,2,1.36154,103.866236
554588,61,5,66,1.362124,103.865828
554589,3,0,3,1.362221,103.865753
554590,44,11,55,1.362142,103.865764
554591,13,0,13,1.362111,103.865633
554592,0,9,9,1.36212,103.865697
554593,1,3,4,1.362212,103.865603
554594,14,37,51,1.362259,103.866179
554595,14,15,29,1.361506,103.867046
554596,2,1,3,1.36212,103.865926
554597,9,4,13,1.361547,103.86701
554598,8,3,11,1.361492,103.867179
554599,16,0,16,1.361957,103.866815
554600,4,3,7,1.361971,103.866764
554601,1,2,3,1.361506,103.866974
554602,6,0,6,1.361835,103.866794
554603,1,8,9,1.360831,103.86692
554604,58,6,64,1.360823,103.866868
554605,0,10,10,1.360845,103.866765
554606,22,11,33,1.360808,103.866764
554607,51,2,53,1.360838,103.866818
554608,3,2,5,1.360827,103.866554
554609,9,0,9,1.360844,103.866496
554610,0,15,15,1.360845,103.866395
554611,2,6,8,1.361665,103.866465
554612,1,4,5,1.362103,103.866244
554613,17,4,21,1.361934,103.866281
554614,2,9,11,1.361984,103.86627
554615,25,1,26,1.361897,103.866275
554616,15,0,15,1.362044,103.866257
554617,8,0,8,1.361843,103.866313
554618,0,1,1,1.361992,103.86616
554619,0,2,2,1.362151,103.866072
554620,63,466,529,1.354761,103.861372
554621,1,1,2,1.360853,103.867454
554622,1,28,29,1.354761,103.861432
554623,13,0,13,1.354761,103.861466
554624,10,0,10,1.354753,103.8615
554625,0,2,2,1.354761,103.861398
554626,10,82,92,1.354713,103.86162
554627,0,2,2,1.354753,103.861535
554628,1,0,1,1.360853,103.86749
554629,50,5,55,1.354704,103.861725
554630,23,3,26,1.3547,103.861768
554631,14,6,20,1.354696,103.86181
554632,0,6,6,1.354692,103.861852
554633,1,0,1,1.354708,103.861683
554634,66,0,66,1.354685,103.861936
554635,1,0,1,1.354689,103.861894
554636,11,5,16,1.35512,103.861099
554637,22,0,22,1.355304,103.861205
554638,1,4,5,1.355165,103.861122
554639,1,1,2,1.354711,103.861641
554640,1,1,2,1.355309,103.861241
554641,26,5,31,1.355313,103.861292
554642,6,1,7,1.355235,103.861165
554644,2,1,3,1.361886,103.866807
554645,6,2,8,1.355312,103.861337
554646,21,2,23,1.355244,103.861272
554647,0,1,1,1.355286,103.861163
554648,13,5,18,1.355282,103.861584
554649,6,2,8,1.355308,103.861457
554650,191,2,193,1.355279,103.861614
554651,1,1,2,1.355209,103.86114
554652,3,2,5,1.355272,103.861675
554653,1,2,3,1.355248,103.861221
554654,11,3,14,1.355264,103.861736
554655,0,1,1,1.35531,103.861378
554656,3,4,7,1.355257,103.861797
554657,5,1,6,1.355284,103.861736
554658,16,0,16,1.35525,103.861858
554659,7,3,10,1.355277,103.861797
554660,7,2,9,1.355242,103.861919
554661,0,4,4,1.362263,103.866097
554662,1,3,4,1.35527,103.861858
554663,6,1,7,1.355262,103.861919
554664,1,0,1,1.355292,103.861675
554665,7,0,7,1.355255,103.86198
554666,3,3,6,1.355248,103.862041
554667,3,1,4,1.355235,103.86198
554669,9,2,11,1.355844,103.861141
554670,7,3,10,1.355843,103.861151
554671,0,1,1,1.355228,103.862041
554672,7,0,7,1.355855,103.861244
554673,1,4,5,1.355859,103.861256
554674,2,0,2,1.355302,103.861584
554675,1,3,4,1.355841,103.861113
554676,17,0,17,1.355879,103.86143
554677,12,1,13,1.355874,103.861371
554678,3,0,3,1.355299,103.861614
554679,10,6,16,1.355881,103.861428
554680,2,3,5,1.355877,103.861602
554681,80,20,100,1.355885,103.861457
554682,2,13,15,1.35587,103.861634
554683,0,2,2,1.355867,103.861337
554684,1,4,5,1.355862,103.861666
554685,0,4,4,1.355867,103.861314
554686,18,3,21,1.355848,103.861731
554687,2,4,6,1.355892,103.861625
554689,1,1,2,1.355888,103.861555
554690,9,0,9,1.355818,103.86186
554691,0,1,1,1.355852,103.861199
554692,1,1,2,1.355887,103.861647
554693,2,1,3,1.355888,103.861506
554694,0,2,2,1.355803,103.861924
554695,8,0,8,1.355856,103.861782
554696,2,1,3,1.355866,103.861737
554697,10,0,10,1.355846,103.861828
554698,0,2,2,1.355789,103.861989
554699,2,4,6,1.355825,103.861918
554700,16,4,20,1.355815,103.861963
554701,2,0,2,1.355835,103.861873
554702,3,0,3,1.355774,103.862053
554703,6,1,7,1.360905,103.867266
554704,6,0,6,1.360914,103.867325
554705,0,3,3,1.355794,103.862053
554706,1,0,1,1.355876,103.861692
554708,11,0,11,1.360905,103.867034
554709,3,31,34,1.360906,103.866959
554711,1,0,1,1.360935,103.867155
554712,0,3,3,1.360925,103.86723
554713,9,3,12,1.361494,103.866915
554715,2,8,10,1.361565,103.866973
554716,1,0,1,1.360917,103.866853
554717,18,5,23,1.361144,103.865994
554718,6,0,6,1.361157,103.866123
554719,13,16,29,1.361146,103.866198
554720,1,10,11,1.361001,103.869313
554722,27,12,39,1.360912,103.866761
554723,34,3,37,1.360926,103.866808
554724,31,11,42,1.360926,103.866713
554725,16,7,23,1.360903,103.866657
554726,2,3,5,1.360907,103.866552
554727,6,1,7,1.360897,103.866418
554728,118,7,125,1.360893,103.866366
554729,15,14,29,1.360889,103.866483
554730,41,8,49,1.361016,103.866208
554731,3,4,7,1.360995,103.866091
554732,19,0,19,1.360915,103.866159
554733,25,5,30,1.36099,103.865987
554734,7,0,7,1.360909,103.866
554735,21,1,22,1.360966,103.865918
554736,65,0,65,1.360887,103.865735
554737,2,3,5,1.361102,103.865786
554738,15,11,26,1.360989,103.865771
554739,3,3,6,1.361033,103.865905
554740,4,0,4,1.355897,103.861602
554741,9,7,16,1.361104,103.865929
554742,8,40,48,1.361475,103.867867
554743,24,1,25,1.361493,103.867795
554744,1,1,2,1.355804,103.862008
554745,1,0,1,1.361131,103.866065
554746,3,1,4,1.361099,103.865853
554747,0,4,4,1.361469,103.867505
554748,1,0,1,1.361483,103.86762
554749,4,12,16,1.361386,103.867307
554750,0,2,2,1.361502,103.867688
554751,15,13,28,1.361376,103.867272
554752,7,4,11,1.361492,103.86737
554753,0,2,2,1.361474,103.867451
554754,7,14,21,1.361492,103.867298
554755,5,0,5,1.361376,103.867136
554756,6,0,6,1.36151,103.867199
554757,1,0,1,1.361485,103.867569
554758,1,0,1,1.361377,103.867065
554759,10,6,16,1.361395,103.866957
554760,30,7,37,1.361404,103.866922
554761,6,6,12,1.361386,103.86685
554762,21,2,23,1.361413,103.866813
554763,9,3,12,1.361404,103.866767
554764,0,3,3,1.36149,103.867116
554765,0,3,3,1.361386,103.866685
554766,3,1,4,1.361384,103.867367
554767,33,4,37,1.361404,103.866514
554768,43,5,48,1.361395,103.866407
554770,1,1,2,1.361372,103.867185
554771,40,1,41,1.361595,103.866813
554772,5,24,29,1.361411,103.866445
554773,687,378,1065,1.349422,103.867009
554774,812,82,894,1.349155,103.866966
554775,725,95,820,1.349674,103.866444
554776,15,0,15,1.360643,103.86732
554777,2,0,2,1.361702,103.866798
554778,3,0,3,1.361413,103.866633
554779,6,0,6,1.360585,103.867367
554780,1,0,1,1.361413,103.867001
554781,3,0,3,1.360515,103.867342
554782,29,1,30,1.360824,103.866706
554783,13,0,13,1.360823,103.866959
554784,2,2,4,1.361385,103.866597
554785,18,2,20,1.363195,103.86045
554786,1,0,1,1.360841,103.86707
554787,139,1139,1278,1.37596,103.870147
554788,16,14,30,1.360299,103.86655
554789,55,5,60,1.36027,103.866667
554790,0,5,5,1.362265,103.859636
554791,3,7,10,1.360751,103.867481
554792,30,2,32,1.360809,103.867457
554793,3,68,71,1.359741,103.867586
554794,0,5,5,1.35976,103.867847
554795,1,5,6,1.359516,103.867837
554796,0,2,2,1.360564,103.867323
554797,44,1,45,1.359495,103.867807
554798,10,0,10,1.359571,103.867839
554799,0,12,12,1.359488,103.867744
554800,1,5,6,1.359426,103.867749
554801,9,5,14,1.35967,103.867746
554802,1,0,1,1.362752,103.859696
554803,1,1,2,1.359443,103.867813
554804,11,0,11,1.359788,103.8677
554805,10,1,11,1.35972,103.867656
554806,4,25,29,1.359678,103.86784
554807,0,1,1,1.359747,103.867525
554808,107,8,115,1.36032,103.867451
554809,209,2131,2340,1.375472,103.869624
554811,15,3,18,1.359713,103.86734
554812,48,1869,1917,1.37518,103.868281
554813,18,56,74,1.359623,103.867835
554814,3,0,3,1.360813,103.867027
554815,177,16,193,1.359868,103.867719
554816,7,15,22,1.359888,103.867601
554817,2,3,5,1.359892,103.867913
554818,72,1,73,1.359789,103.867623
554819,1,11,12,1.360031,103.867332
554820,3,9,12,1.360122,103.867428
554821,5,2,7,1.360071,103.86734
554822,74,0,74,1.360225,103.867446
554823,7,0,7,1.360106,103.867348
554824,1,0,1,1.360719,103.86746
554825,15,1,16,1.36016,103.867331
554826,2,0,2,1.359713,103.867714
554827,30,0,30,1.360237,103.867331
554828,4,6,10,1.359879,103.867665
554829,55,0,55,1.360192,103.867358
554830,29,10,39,1.359867,103.867856
554831,9,0,9,1.360331,103.86736
554832,5,23,28,1.361257,103.867493
554833,1,2,3,1.359879,103.867964
554834,13,0,13,1.361213,103.867455
554835,30,3,33,1.361262,103.867453
554836,5,19,24,1.360172,103.867429
554837,1,0,1,1.360077,103.867425
554839,52,33,85,1.360893,103.867447
554840,18,1,19,1.359952,103.866895
554841,2,0,2,1.360272,103.867442
554842,20,1,21,1.360016,103.866772
554844,7,2,9,1.359949,103.867053
554845,5,0,5,1.359999,103.866873
554846,57,0,57,1.3602,103.866471
554847,4,0,4,1.360819,103.866621
554848,43,0,43,1.360095,103.866682
554850,6,2,8,1.360031,103.866827
554852,2,0,2,1.359752,103.867126
554854,31,2,33,1.359974,103.866833
554856,1,0,1,1.360773,103.867443
554857,108,0,108,1.36022,103.866428
554858,6,2,8,1.360178,103.866245
554859,66,90,156,1.375537,103.872508
554860,26,1,27,1.360256,103.866612
554861,1,3,4,1.360144,103.866584
554862,7,0,7,1.360212,103.866676
554863,3,13,16,1.360186,103.866746
554864,97,91,188,1.375516,103.872845
554865,1,14,15,1.360172,103.866898
554866,8,1,9,1.359907,103.867132
554867,15,4,19,1.360141,103.866882
554868,8,6,14,1.360415,103.866873
554869,6,3,9,1.360359,103.866858
554870,12,7,19,1.360214,103.866879
554871,11,0,11,1.360289,103.866868
554872,12,3,15,1.359902,103.867562
554873,5,12,17,1.35977,103.867738
554874,6,10,16,1.360684,103.867444
554875,22,17,39,1.36069,103.867491
554876,66,338,404,1.349248,103.860872
554877,39,239,278,1.349229,103.860734
554878,2,2,4,1.360258,103.86668
554879,11,33,44,1.349213,103.860773
554880,1,4,5,1.349242,103.860983
554881,0,2,2,1.36017,103.866521
554882,40,5,45,1.349242,103.86104
554883,41,4,45,1.349207,103.860848
554884,1,5,6,1.349242,103.8611
554885,7,0,7,1.349206,103.860891
554886,2,33,35,1.349238,103.861168
554887,5,2,7,1.349204,103.860941
554888,26,80,106,1.349522,103.861213
554889,6,2,8,1.349206,103.860994
554890,124,1923,2047,1.349636,103.861211
554891,12,2,14,1.349203,103.861047
554892,6,1,7,1.349589,103.861231
554893,5,2,7,1.349204,103.861099
554894,0,7,7,1.349558,103.861243
554895,25,3,28,1.3492,103.861155
554896,2,8,10,1.349524,103.861255
554897,20,13,33,1.349198,103.861199
554898,11,1,12,1.349484,103.861266
554899,142,15,157,1.349196,103.861247
554900,19,0,19,1.349436,103.861276
554901,1,1,2,1.349206,103.860812
554902,33,2,35,1.349387,103.861293
554903,4,0,4,1.349244,103.860925
554904,0,1,1,1.360075,103.866728
554905,3,1,4,1.349197,103.861355
554906,0,19,19,1.349265,103.861339
554907,0,2,2,1.349194,103.861298
554908,25,0,25,1.349189,103.861514
554909,0,1,1,1.349332,103.861316
554910,2738,1902,4640,1.374484,103.869139
554911,743,586,1329,1.372391,103.869164
554912,5,101,106,1.37604,103.872084
554913,581,2083,2664,1.375346,103.871995
554914,665,681,1346,1.375229,103.874819
554915,1980,7423,9403,1.372507,103.868183
554916,527,4353,4880,1.374048,103.867586
554917,19,5,24,1.367766,103.865225
554918,2,6,8,1.367759,103.865286
554919,13,3,16,1.367887,103.865374
554920,0,1,1,1.349189,103.861583
554921,4,0,4,1.349191,103.861411
554923,0,2,2,1.349188,103.861464
554924,4,3,7,1.367849,103.865346
554936,2,24,26,1.366549,103.867853
554937,4,1,5,1.36662,103.867932
554938,9,0,9,1.36662,103.867853
554939,1,42,43,1.366605,103.868008
554941,0,3,3,1.361304,103.867454
554942,2,2,4,1.367791,103.865236
554943,105,5,110,1.366885,103.867934
554944,1,3,4,1.366774,103.86786
554945,29,17,46,1.367063,103.868045
554946,4,1,5,1.367144,103.867784
554947,22,1,23,1.36703,103.867936
554948,2,24,26,1.367099,103.86793
554949,12,1,13,1.367079,103.867864
554951,4,1,5,1.367154,103.867847
554952,5,0,5,1.367255,103.867946
554953,4,0,4,1.366982,103.867765
554954,1,4,5,1.367307,103.867936
554955,2,2,4,1.367232,103.867864
554956,11,2,13,1.367392,103.867949
554957,8,1,9,1.367405,103.867867
554958,7,0,7,1.367538,103.867945
554959,8,2,10,1.367479,103.86786
554960,17,1,18,1.367653,103.867962
554961,4,1,5,1.367578,103.867871
554962,15,0,15,1.367738,103.867972
554963,3,1,4,1.367311,103.867867
554964,27,1,28,1.367839,103.867966
554965,0,1,1,1.36781,103.865356
554966,0,1,1,1.367744,103.867878
554969,3,6,9,1.36838,103.867878
554970,24,14,38,1.368083,103.867963
554972,116,2,118,1.368553,103.867882
554973,1,0,1,1.367914,103.867966
554974,2,10,12,1.368305,103.867967
554975,3,2,5,1.368732,103.867882
554976,0,1,1,1.368641,103.867892
554977,2,0,2,1.367876,103.865346
554979,58,1,59,1.368928,103.867876
554980,0,11,11,1.368588,103.86799
554981,2,2,4,1.367659,103.867874
554982,1,3,4,1.369012,103.867886
554983,16,2,18,1.369107,103.867892
554984,15,1,16,1.368743,103.867971
554985,10,2,12,1.369198,103.867883
554986,61,12,73,1.368836,103.867974
554987,7,19,26,1.369293,103.867889
554989,52,0,52,1.369358,103.867896
554990,0,2,2,1.368817,103.867889
554991,2,5,7,1.369987,103.867903
554992,2,1,3,1.366793,103.868036
554993,18,0,18,1.370075,103.867913
554994,2,0,2,1.369022,103.867994
554995,4,4,8,1.370157,103.8679
554996,5,4,9,1.369397,103.867994
554997,61,0,61,1.370205,103.867907
554998,18,0,18,1.369465,103.867988
555000,2,1,3,1.369107,103.867997
555002,10,1,11,1.369286,103.868004
555004,68,8,76,1.36971,103.867978
555006,35,0,35,1.369782,103.867981
555008,41,0,41,1.369863,103.867985
555010,29,1,30,1.369948,103.867988
555012,3,0,3,1.36955,103.867978
555014,0,11,11,1.370117,103.868001
555026,5,0,5,1.364047,103.867029
555027,5,206,211,1.363847,103.867107
555028,2,2,4,1.368686,103.867977
555030,2,22,24,1.364327,103.866982
555031,2,15,17,1.364146,103.867147
555032,4,3,7,1.364484,103.867026
555033,36,0,36,1.364046,103.86714
555034,15,1,16,1.364498,103.867165
555035,1,5,6,1.364235,103.86719
555036,1,0,1,1.368435,103.867983
555037,1,3,4,1.364097,103.867031
555038,32,6,38,1.364382,103.867208
555039,6,5,11,1.364331,103.867188
555040,1,0,1,1.364686,103.867114
555042,6,0,6,1.3647,103.867271
555043,1,1,2,1.369172,103.867994
555044,12,10,22,1.365027,103.867365
555046,24,12,36,1.364891,103.867361
555047,4,7,11,1.364555,103.867281
555048,6,1,7,1.364946,103.867425
555049,5,0,5,1.364989,103.867584
555050,5,0,5,1.365351,103.867646
555051,0,2,2,1.364764,103.867411
555052,3,0,3,1.370029,103.867998
555054,2,0,2,1.365206,103.867856
555055,14,2,16,1.365199,103.867535
555056,33,12,45,1.365373,103.868023
555058,3,0,3,1.365546,103.867901
555059,1,2,3,1.365468,103.868036
555060,0,2,2,1.365294,103.867935
555061,1,0,1,1.364425,103.867109
555062,11,0,11,1.365417,103.868107
555063,99,0,99,1.365405,103.867703
555065,1,0,1,1.365463,103.867804
555066,26,0,26,1.365645,103.868166
555068,6,0,6,1.365635,103.868339
555069,3,0,3,1.365309,103.867683
555070,73,2,75,1.365513,103.868682
555071,5,0,5,1.365506,103.868656
555072,0,1,1,1.365513,103.868119
555073,13,1,14,1.365455,103.869011
555074,3,0,3,1.365552,103.868568
555075,6,2,8,1.365344,103.869311
555076,28,0,28,1.365398,103.869169
555077,34,4,38,1.36532,103.869407
555078,6,0,6,1.365231,103.869138
555079,10,0,10,1.365265,103.869536
555080,1,4,5,1.365155,103.869457
555082,1,2,3,1.365462,103.86888
555083,8,12,20,1.365325,103.869375
555084,29,0,29,1.365096,103.869663
555085,5,5,10,1.365274,103.869665
555086,2,17,19,1.365028,103.869782
555087,11,0,11,1.365166,103.869794
555088,1,0,1,1.36552,103.86871
555090,4,0,4,1.364595,103.867203
555091,71,0,71,1.365034,103.870255
555092,9,1,10,1.365092,103.870216
555093,2,12,14,1.365653,103.868133
555095,4,0,4,1.365157,103.869983
555104,26,113,139,1.366812,103.86222
555105,28,81,109,1.366693,103.862279
555106,44,21,65,1.366743,103.862164
555107,4,5,9,1.366816,103.862314
555108,179,72,251,1.367496,103.862429
555109,22,26,48,1.367383,103.862552
555110,19,11,30,1.367658,103.862494
555111,2,12,14,1.368267,103.8627
555112,1,3,4,1.365523,103.868181
555113,1,14,15,1.36836,103.86269
555114,38,4,42,1.368119,103.862555
555115,33,6,39,1.368498,103.862724
555116,20,0,20,1.36858,103.862732
555117,6,0,6,1.368263,103.862587
555118,0,7,7,1.368542,103.862781
555119,2,17,19,1.368349,103.862579
555120,9,1,10,1.36887,103.862759
555121,18,4,22,1.368682,103.862656
555122,1,3,4,1.368024,103.862563
555123,17,0,17,1.368596,103.862639
555124,4,0,4,1.368777,103.862748
555125,18,0,18,1.368925,103.862662
555126,5,1,6,1.368696,103.862739
555127,6,2,8,1.368788,103.862642
555128,1,1,2,1.365329,103.867881
555130,3,10,13,1.369284,103.862959
555131,0,96,96,1.369132,103.862713
555132,1,0,1,1.365216,103.869761
555133,19,507,526,1.369341,103.862817
555134,1,11,12,1.369353,103.863156
555135,1,103,104,1.369399,103.862937
555136,4,7,11,1.369324,103.863119
555137,11,12,23,1.369438,103.863132
555138,1,5,6,1.369503,103.863522
555139,2,70,72,1.369566,103.86348
555141,9,27,36,1.369639,103.863493
555142,4,158,162,1.369586,103.863401
555144,0,150,150,1.369691,103.863612
555145,1,8,9,1.369563,103.86374
555146,11,7,18,1.369653,103.863652
555147,1,6,7,1.369702,103.864076
555148,5,139,144,1.369753,103.86396
555149,21,1,22,1.36974,103.86421
555150,52,30,82,1.369727,103.863872
555151,8,3,11,1.369773,103.86429
555152,24,110,134,1.369714,103.863803
555153,38,13,51,1.3698,103.864334
555154,24,26,50,1.369914,103.86435
555155,82,24,106,1.369877,103.864581
555156,4,29,33,1.369891,103.86427
555157,15,71,86,1.369849,103.864183
555158,14,62,76,1.369962,103.864558
555159,22,25,47,1.370012,103.864682
555160,5,83,88,1.370036,103.864749
555161,16,6,22,1.370063,103.864817
555162,1,144,145,1.369615,103.863553
555163,20,3135,3155,1.370084,103.864864
555164,2,2,4,1.369025,103.862782
555165,1,3,4,1.367747,103.862512
555166,7,6,13,1.369054,103.862686
555167,197,99,296,1.369959,103.864466
555168,0,4,4,1.367848,103.862531
555169,0,472,472,1.369685,103.863721
555170,5,2,7,1.368957,103.862706
555171,8,0,8,1.36885,103.862684
555172,210,5,215,1.368661,103.862583
555173,0,109,109,1.358197,103.870187
555174,6,63,69,1.35873,103.869691
555175,0,6,6,1.358689,103.869651
555176,1,39,40,1.358784,103.8696
555177,3,0,3,1.365119,103.869549
555178,1,3,4,1.369545,103.863353
555179,21,5,26,1.358613,103.869768
555180,1,7,8,1.359117,103.869379
555181,1,1,2,1.369113,103.862801
555182,1,5,6,1.359209,103.869166
555183,62,9,71,1.358576,103.869643
555184,103,36,139,1.358993,103.869275
555185,1,94,95,1.359751,103.868969
555186,4,0,4,1.358901,103.869427
555187,5,3,8,1.359246,103.868879
555188,19,5,24,1.358837,103.869393
555189,15,1,16,1.359146,103.869116
555190,0,1,1,1.369321,103.863031
555191,6,8,14,1.359296,103.869221
555192,30,2,32,1.358982,103.869188
555193,25,6,31,1.359351,103.868739
555194,1,1,2,1.35887,103.869326
555195,3,10,13,1.359237,103.869184
555196,6,30,36,1.358949,103.86903
555197,14,0,14,1.359718,103.86893
555198,71,1,72,1.359267,103.869195
555199,3,0,3,1.358405,103.869907
555200,8,3,11,1.359144,103.868929
555201,25,4,29,1.359416,103.869276
555202,1,1,2,1.358903,103.869096
555203,0,36,36,1.35926,103.868747
555204,4,123,127,1.359613,103.868562
555205,0,1,1,1.359348,103.86926
555206,23,1,24,1.359811,103.868775
555207,0,2,2,1.359128,103.868718
555208,64,1,65,1.359993,103.868937
555209,1,0,1,1.359783,103.868999
555221,5,15,20,1.35657,103.861364
555222,1,0,1,1.359773,103.868919
555223,29,0,29,1.35649,103.861473
555224,56,2,58,1.356456,103.861522
555225,2,3,5,1.35652,103.861742
555226,5,1,6,1.356426,103.861581
555227,6,4,10,1.356365,103.861678
555228,20,2,22,1.356317,103.861741
555229,18,3,21,1.356284,103.861783
555230,0,2,2,1.35967,103.868885
555231,54,1,55,1.356223,103.861859
555243,2,0,2,1.356268,103.861799
555244,33,2,35,1.356514,103.860796
555245,5,0,5,1.35654,103.860762
555246,0,1,1,1.356529,103.861428
555247,5,2,7,1.3566,103.860694
555251,1,2,3,1.359322,103.869246
555252,27,1,28,1.356755,103.860523
555253,20,23,43,1.356781,103.860489
555254,1,15,16,1.356824,103.860446
555255,0,1,1,1.356575,103.860728
555256,20,2,22,1.356884,103.860369
555257,2,2,4,1.358765,103.869508
555258,1,0,1,1.356858,103.860412
555259,26,3,29,1.357087,103.859973
555260,17,0,17,1.357078,103.859699
555261,15,0,15,1.357121,103.859939
555262,4,0,4,1.356918,103.860327
555263,29,1,30,1.357155,103.859896
555265,3,1,4,1.357033,103.859843
555266,0,3,3,1.356721,103.860557
555267,25,2,27,1.357224,103.859836
555268,38,0,38,1.357148,103.859712
555269,1,0,1,1.356993,103.859895
555270,4,0,4,1.357198,103.859871
555271,1,3,4,1.357188,103.859655
555272,2,3,5,1.357228,103.859621
555284,1,0,1,1.357267,103.859811
555285,29,0,29,1.357563,103.861113
555286,40,7,47,1.357633,103.861312
555288,1,0,1,1.357676,103.861346
555289,10,0,10,1.357435,103.861028
555291,0,1,1,1.35759,103.861278
555292,4,3,7,1.357504,103.861209
555293,4,3,7,1.35734,103.860968
555294,1,0,1,1.357383,103.860994
555295,3,4,7,1.357297,103.860934
555296,15,0,15,1.357254,103.860892
555297,0,1,1,1.357461,103.861175
555298,29,5,34,1.357211,103.860857
555300,58,1,59,1.357159,103.860823
555301,8,0,8,1.357298,103.861064
555302,3,7,10,1.357357,103.860905
555303,3,1,4,1.357284,103.859768
555305,4,0,4,1.357263,103.861039
555306,81,26,107,1.357134,103.860936
555307,31,0,31,1.3571,103.860902
555319,6,4,10,1.356989,103.861825
555320,5,4,9,1.35678,103.86206
555321,135,1,136,1.356707,103.862237
555322,21,0,21,1.35695,103.861686
555323,0,1,1,1.357375,103.861124
555324,23,1,24,1.356934,103.861736
555325,1,18,19,1.356811,103.862078
555326,2,13,15,1.35692,103.861776
555327,49,23,72,1.3568,103.862144
555328,55,0,55,1.35682,103.861883
555329,0,9,9,1.356869,103.862022
555330,0,4,4,1.357177,103.86097
555331,0,3,3,1.357108,103.859764
555332,7,0,7,1.356757,103.862168
555333,3,0,3,1.356715,103.862067
555334,42,1,43,1.356632,103.862358
555335,4,3,7,1.356695,103.862093
555336,1,0,1,1.356929,103.86192
555337,12,1,13,1.356555,103.86221
555338,4,0,4,1.356631,103.862285
555339,1,1,2,1.356489,103.860831
555340,0,1,1,1.356737,103.862195
555341,5,2,7,1.356671,103.862146
555342,151,4,155,1.356634,103.862307
555343,1,0,1,1.35667,103.862274
555344,6,0,6,1.356606,103.862359
555345,10,0,10,1.356659,103.862081
555346,2,0,2,1.3566,103.862189
555347,23,0,23,1.356541,103.862278
555348,4,14,18,1.356545,103.862448
555349,15,0,15,1.356492,103.862497
555361,75,3,78,1.357525,103.860015
555362,1,4,5,1.35766,103.859875
555364,3,1,4,1.356706,103.862223
555366,39,0,39,1.357764,103.859969
555368,1,5,6,1.357841,103.860029
555369,8,0,8,1.357901,103.860088
555370,0,2,2,1.356584,103.862398
555371,1,1,2,1.357944,103.860123
555372,21,0,21,1.358021,103.860191
555375,0,1,1,1.356603,103.86221
555376,2,1,3,1.356764,103.861991
555377,9,6,15,1.358417,103.860551
555378,2,0,2,1.357979,103.860157
555380,0,2,2,1.358392,103.860619
555382,0,1,1,1.358116,103.860242
555383,2,0,2,1.358579,103.860721
555384,3,0,3,1.35815,103.860268
555386,3,0,3,1.358798,103.860823
555387,7,1,8,1.358228,103.860892
555388,1,4,5,1.358641,103.8609
555389,0,2,2,1.358306,103.860798
555390,6,2,8,1.358595,103.860847
555391,16,0,16,1.358135,103.861046
555392,5,14,19,1.358487,103.861003
555393,5,86,91,1.358109,103.861088
555394,0,4,4,1.357729,103.859935
555395,0,2,2,1.358185,103.860955
555396,1,0,1,1.358649,103.860766
555397,67,9,76,1.358041,103.861165
555398,3,2,5,1.358496,103.861373
555399,3,0,3,1.358745,103.860984
555400,6,0,6,1.358419,103.86146
555401,1,1,2,1.358075,103.861131
555402,4,0,4,1.358277,103.861227
555404,3,0,3,1.358015,103.861208
555405,5,3,8,1.357849,103.861485
555406,28,0,28,1.358309,103.861433
555407,4,1,5,1.357615,103.861814
555408,36,6,42,1.357976,103.861513
555410,2,4,6,1.357892,103.861624
555411,10,0,10,1.357636,103.861772
555412,2,4,6,1.358076,103.861711
555413,5,0,5,1.357542,103.861666
555414,6,0,6,1.358062,103.861825
555415,4,0,4,1.358086,103.861429
555416,12,2,14,1.358319,103.861878
555417,4,3,7,1.357683,103.861692
555418,42,0,42,1.358032,103.861939
555419,4,1,5,1.357443,103.86208
555420,12,1,13,1.357876,103.861875
555421,1,0,1,1.358415,103.861304
555422,3,0,3,1.357972,103.861754
555423,65,1,66,1.357232,103.862364
555424,36,4,40,1.357796,103.861773
555425,0,1,1,1.357348,103.862167
555426,15,7,22,1.35757,103.862204
555427,113,1,114,1.357103,103.862561
555429,5,1,6,1.357138,103.862437
555430,33,0,33,1.357649,103.86229
555431,1,0,1,1.357124,103.862484
555432,20,7,27,1.357719,103.862444
555433,1,1,2,1.357989,103.861251
555434,1,0,1,1.357305,103.86225
555435,2,1,3,1.357586,103.861849
555436,11,4,15,1.357719,103.862444
555437,1,0,1,1.357681,103.862443
555438,0,1,1,1.357138,103.862437
555439,6,1,7,1.357138,103.862437
555440,43,9,52,1.357403,103.862462
555441,8,0,8,1.357138,103.862437
555442,3,4,7,1.357195,103.862688
555443,78,11,89,1.356996,103.862701
555444,1,0,1,1.357591,103.862383
555445,0,2,2,1.357031,103.862618
555446,64,3,67,1.357228,103.862742
555447,3,0,3,1.357138,103.862437
555448,3,0,3,1.356913,103.86284
555449,2,0,2,1.357138,103.862437
555450,1,0,1,1.357319,103.862782
555451,22,0,22,1.35737,103.862976
555452,2,0,2,1.356949,103.862735
555453,9,12,21,1.357201,103.862874
555465,7,3,10,1.356902,103.859947
555466,5,1,6,1.356833,103.859913
555467,8,0,8,1.356773,103.859879
555468,0,2,2,1.35737,103.862976
555469,18,0,18,1.356684,103.859834
555470,4,3,7,1.356644,103.859817
555471,8,1,9,1.356609,103.8598
555472,43,6,49,1.35655,103.859706
555473,6,0,6,1.356593,103.859629
555474,2,0,2,1.356721,103.859854
555475,4,0,4,1.357658,103.86172
555477,1,1,2,1.356615,103.859577
555478,2,2,4,1.356637,103.859531
555479,11,1,12,1.35674,103.859254
555480,1,0,1,1.357435,103.862945
555481,1,2,3,1.357437,103.862862
555483,9,1,10,1.356709,103.859088
555486,14,1,15,1.356626,103.859279
555488,31,15,46,1.356295,103.859769
555490,5,2,7,1.35616,103.859739
555493,33,1,34,1.356107,103.859518
555494,5,8,13,1.356118,103.859461
555495,12,0,12,1.35613,103.859404
555496,12,0,12,1.356124,103.859353
555497,20,11,31,1.356113,103.859307
555498,1,0,1,1.356773,103.859159
555499,12,0,12,1.356104,103.859171
555511,0,2,2,1.35668,103.859399
555512,51,1,52,1.355537,103.860412
555513,1,0,1,1.356111,103.859241
555514,6,3,9,1.35559,103.86035
555515,1,3,4,1.356723,103.859322
555516,5,0,5,1.35561,103.860306
555518,0,7,7,1.355628,103.860231
555519,7,4,11,1.355479,103.860322
555520,35,0,35,1.35564,103.860178
555521,1,0,1,1.355461,103.860453
555522,4,11,15,1.355646,103.860133
555523,18,14,32,1.35549,103.860225
555524,13,0,13,1.355657,103.860087
555525,125,0,125,1.355496,103.860174
555526,0,13,13,1.355669,103.860047
555527,29,2,31,1.355507,103.860134
555529,3,0,3,1.356804,103.859088
555530,0,2,2,1.35545,103.860487
555531,2,2,4,1.355467,103.860407
555532,93,1,94,1.355704,103.859913
555534,1,4,5,1.355712,103.859871
555535,2,12,14,1.355547,103.859952
555536,8,0,8,1.355718,103.85982
555537,1,0,1,1.355484,103.860276
555538,5,1,6,1.355724,103.859768
555539,73,10,83,1.355567,103.859849
555540,6,0,6,1.355732,103.859731
555542,13,0,13,1.355782,103.859707
555543,18,1,19,1.35561,103.859678
555544,5,0,5,1.355792,103.859643
555545,3,0,3,1.355519,103.860094
555546,11,20,31,1.355797,103.859597
555547,12,1,13,1.355661,103.859516
555549,6,0,6,1.355653,103.859431
555551,0,2,2,1.355693,103.859953
555552,1,2,3,1.355627,103.85961
555564,8,1,9,1.355745,103.860642
555565,2,8,10,1.355254,103.861111
555566,2,0,2,1.355656,103.859337
555567,9,12,21,1.354918,103.860541
555568,4,0,4,1.355524,103.860048
555569,2,10,12,1.354927,103.860499
555570,3,0,3,1.35582,103.859421
555573,3,11,14,1.354944,103.860405
555574,9,1,10,1.355493,103.860693
555577,2,10,12,1.354961,103.860319
555578,1,1,2,1.355705,103.860653
555579,5,0,5,1.35497,103.860285
555580,4,4,8,1.355373,103.860716
555581,3,2,5,1.354978,103.860242
555582,1,3,4,1.355648,103.860664
555583,8,0,8,1.355007,103.860194
555584,10,0,10,1.355281,103.860722
555585,1,1,2,1.355413,103.860704
555586,7,0,7,1.355241,103.860727
555587,43,0,43,1.355035,103.860092
555588,12,4,16,1.355201,103.860739
555589,6,116,122,1.355041,103.860035
555590,2,10,12,1.355161,103.860744
555591,2,0,2,1.355012,103.860143
555592,0,2,2,1.355087,103.859978
555593,1,0,1,1.355553,103.859912
555594,12,11,23,1.355121,103.859807
555595,1,0,1,1.355104,103.859864
555596,8,14,22,1.355138,103.859653
555597,62,0,62,1.35515,103.859585
555598,1,4,5,1.355155,103.859534
555600,0,11,11,1.355198,103.859434
555601,52,64,116,1.3552,103.859237
555603,1,161,162,1.355269,103.859214
555605,6,1,7,1.355355,103.859202
555607,92,0,92,1.355429,103.859191
555609,0,1,1,1.355133,103.859727
555611,1,2,3,1.355591,103.860676
555613,5,2,7,1.35571,103.859157
555615,12,2,14,1.355807,103.859145
555617,2,0,2,1.355093,103.859921
555621,7,0,7,1.356025,103.859128
555622,0,3,3,1.355624,103.859163
555637,4,4,8,1.357366,103.86022
555638,0,1,1,1.355526,103.859174
555640,2,0,2,1.355887,103.859134
555641,0,2,2,1.35728,103.860349
555642,2,0,2,1.357426,103.860306
555643,12,0,12,1.35746,103.860348
555646,6,7,13,1.357461,103.860511
555648,23,0,23,1.357512,103.860562
555650,15,6,21,1.357624,103.860485
555651,0,1,1,1.357211,103.860297
555653,1,2,3,1.355942,103.859136
555654,2,1,3,1.357658,103.860664
555655,3,3,6,1.357701,103.860699
555656,21,0,21,1.357736,103.860562
555659,3,0,3,1.357701,103.860536
555660,19,0,19,1.357899,103.860664
555672,50,4,54,1.356352,103.861399
555674,10,0,10,1.356275,103.861331
555675,132,30,162,1.35708,103.861554
555676,1,7,8,1.356198,103.861271
555677,8,0,8,1.357329,103.861692
555678,2,0,2,1.357332,103.860408
555679,1,2,3,1.357856,103.860639
555681,6,1,7,1.356792,103.861332
555682,1,0,1,1.357615,103.86063
555683,0,1,1,1.356965,103.861448
555685,1,3,4,1.355327,103.860716
555686,1,0,1,1.357243,103.861636
555687,1,2,3,1.356681,103.861248
555689,31,0,31,1.356702,103.861268
555690,7,1,8,1.356069,103.861177
555701,11,124,135,1.35721,103.868386
555702,7,442,449,1.356816,103.868342
555703,3,0,3,1.356854,103.861385
555705,4,0,4,1.357032,103.861527
555706,8,4,12,1.356849,103.868432
555707,2,0,2,1.35612,103.861228
555708,0,1,1,1.356912,103.86143
555709,0,3,3,1.357194,103.868416
555710,1,3,4,1.357172,103.868496
555711,1,2,3,1.356992,103.869074
555712,2,0,2,1.35718,103.868528
555714,63,1,64,1.35698,103.868752
555716,0,2,2,1.356975,103.868882
555717,1,0,1,1.356846,103.868474
555718,2,3,5,1.356983,103.868475
555719,6,0,6,1.35698,103.868412
555720,13,5,18,1.356975,103.868357
555721,6,0,6,1.357218,103.868998
555723,1,0,1,1.356975,103.868541
555724,1,5,6,1.357079,103.869375
555725,5,0,5,1.357065,103.868838
555726,7,3,10,1.357057,103.869014
555728,118,0,118,1.356574,103.868598
555729,22,0,22,1.357049,103.869349
555730,5,1,6,1.357235,103.869301
555732,2,2,4,1.35698,103.869014
555733,44,9,53,1.357205,103.869495
555734,0,4,4,1.357201,103.86944
555735,37,0,37,1.357209,103.869571
555736,1,24,25,1.35723,103.869658
555737,10,14,24,1.356891,103.869393
555738,0,1,1,1.357222,103.869058
555739,1,4,5,1.356621,103.868958
555740,8,14,22,1.356791,103.869282
555741,1,0,1,1.356854,103.869355
555742,11,2,13,1.35706,103.868882
555743,1,0,1,1.357054,103.868797
555744,1,8,9,1.357087,103.869052
555745,1,0,1,1.357054,103.868965
555746,0,8,8,1.356483,103.869087
555747,19,2,21,1.356438,103.86901
555748,0,22,22,1.356359,103.86902
555760,1,0,1,1.357057,103.869292
555762,47,1,48,1.364224,103.864019
555763,32,0,32,1.364235,103.863865
555764,5,1,6,1.363948,103.86375
555765,3,0,3,1.356975,103.868951
555767,32,2,34,1.364123,103.863752
555768,266,0,266,1.36417,103.863918
555769,25,2,27,1.36406,103.86368
555770,0,8,8,1.364093,103.863868
555771,23,0,23,1.363991,103.863622
555772,5,3,8,1.363918,103.863567
555774,0,5,5,1.363725,103.863552
555786,8,0,8,1.360982,103.872958
555787,5,8,13,1.360969,103.872892
555788,19,1,20,1.360951,103.872834
555789,1,0,1,1.364129,103.863902
555790,0,8,8,1.360937,103.872725
555791,2,2,4,1.357211,103.869549
555792,4,4,8,1.361074,103.87295
555793,0,7,7,1.361042,103.872823
555795,3,6,9,1.361002,103.872725
555796,4,4,8,1.360986,103.872669
555797,53,0,53,1.360915,103.872513
555798,11,0,11,1.361185,103.872096
555799,126,6,132,1.361236,103.872005
555801,6,3,9,1.360984,103.872377
555802,0,7,7,1.361314,103.871829
555803,16,0,16,1.361018,103.872307
555805,4,6,10,1.36139,103.87167
555806,0,1,1,1.360955,103.87278
555807,38,3,41,1.361459,103.871532
555809,1,2,3,1.36418,103.863803
555810,3,0,3,1.361121,103.872048
555811,2,2,4,1.361051,103.87239
555812,32,0,32,1.361558,103.871404
555813,13,1,14,1.36159,103.871274
555814,0,1,1,1.361066,103.872201
555815,1,0,1,1.361648,103.871252
555816,34,15,49,1.361216,103.871872
555817,42,0,42,1.361247,103.871802
555818,30,4,34,1.36129,103.871711
555819,0,1,1,1.361687,103.871197
555821,6,0,6,1.361361,103.871597
555822,31,17,48,1.361715,103.871006
555823,3,2,5,1.361383,103.8715
555824,27,0,27,1.361431,103.871422
555825,9,0,9,1.361757,103.870909
555826,47,1,48,1.361498,103.870702
555828,5,1,6,1.3618,103.870822
555831,1,0,1,1.361671,103.871094
555832,10,11,21,1.361993,103.870584
555833,6,0,6,1.361712,103.870801
555834,0,1,1,1.361646,103.870985
555835,5,0,5,1.361794,103.8707
555836,0,1,1,1.362076,103.870497
555837,26,0,26,1.361963,103.870515
555838,111,15,126,1.362041,103.87043
555839,6,6,12,1.362239,103.870327
555840,10,0,10,1.3623,103.870276
555842,2,0,2,1.356983,103.868624
555850,192,5013,5205,1.37354,103.876018
555851,179,580,759,1.376863,103.875704
555852,273,250,523,1.376525,103.874938
555853,377,113,490,1.37611,103.875774
555854,681,1090,1771,1.376461,103.875702
555855,422,1350,1772,1.372862,103.874791
555856,455,705,1160,1.375532,103.875641
555857,8,995,1003,1.374635,103.87368
555858,952,156,1108,1.376119,103.875089
555859,385,208,593,1.376626,103.87512
555862,24,27,51,1.373296,103.870234
555863,0,234,234,1.372794,103.870194
555864,7,114,121,1.372798,103.870111
555876,399,806,1205,1.369102,103.875445
555877,185,608,793,1.369861,103.874489
555888,11,16,27,1.366675,103.870239
555889,406,1,407,1.36967,103.868983
555890,45,4177,4222,1.369042,103.872872
555891,19,1483,1502,1.368712,103.872374
555892,2,8,10,1.364666,103.872061
555893,0,79,79,1.364714,103.87197
555894,74,512,586,1.367695,103.870093
555897,1,0,1,1.361902,103.870591
555903,25,109,134,1.299509,103.837
555904,1,0,1,1.362289,103.873063
555905,3,6,9,1.362231,103.872982
555906,1,6,7,1.36232,103.872893
555907,1,141,142,1.362369,103.872986
555908,6,2,8,1.362444,103.872815
555909,1,9,10,1.362378,103.872977
555910,5,7,12,1.362587,103.872679
555911,0,11,11,1.362396,103.87296
555912,10,3,13,1.363336,103.872904
555913,0,5,5,1.363475,103.873023
555914,3,109,112,1.363072,103.872607
555915,23,2,25,1.363137,103.872657
555916,1,5,6,1.363232,103.872717
555917,26,0,26,1.363315,103.872771
555919,13,0,13,1.363457,103.872869
555920,142,2,144,1.363525,103.872922
555921,1,0,1,1.362289,103.873063
555922,0,23,23,1.362687,103.872583
555924,42,2,44,1.362764,103.872467
555925,4,14,18,1.362815,103.872405
555926,4,17,21,1.362847,103.872354
555927,3,0,3,1.361153,103.871972
555928,2,1,3,1.362892,103.872286
555929,1,3,4,1.361493,103.871458
555930,1,5,6,1.362957,103.872084
555931,22,0,22,1.362983,103.872007
555932,4,4,8,1.363007,103.871947
555933,1,0,1,1.363567,103.872967
555935,4,206,210,1.363225,103.871885
555936,0,62,62,1.299509,103.837
555938,21,23,44,1.363052,103.870957
555939,6,1,7,1.363076,103.870828
555940,228,20,248,1.363783,103.869553
555942,3,118,121,1.363875,103.867657
555943,0,81,81,1.363863,103.867559
555944,28,103,131,1.363314,103.867356
555945,134,51,185,1.363381,103.866835
555946,2,310,312,1.363834,103.866839
555947,57,309,366,1.363467,103.866451
555948,27,597,624,1.36388,103.866737
555949,274,264,538,1.36379,103.865848
555950,83,2847,2930,1.362789,103.872657
555951,225,172,397,1.363787,103.865813
555952,83,1232,1315,1.364491,103.865648
555953,41,40,81,1.36378,103.865744
555954,43,322,365,1.364419,103.865592
555955,14,0,14,1.363773,103.865675
555956,78,155,233,1.364363,103.865581
555957,72,3523,3595,1.363775,103.865604
555958,1764,173,1937,1.364294,103.865511
555959,18,0,18,1.363785,103.865556
555960,48,372,420,1.3642,103.865513
555961,27,2,29,1.363811,103.865488
555962,103,890,993,1.364169,103.865478
555963,475,44,519,1.363814,103.865464
555964,87,656,743,1.364101,103.865439
555965,305,813,1118,1.363835,103.865435
555966,191,5009,5200,1.364032,103.865113
555967,22,137,159,1.363846,103.865416
555968,43,481,524,1.36404,103.865095
555969,197,114,311,1.363868,103.865378
555970,95,34,129,1.364055,103.86506
555971,2,1,3,1.362915,103.872209
555972,61,249,310,1.364071,103.865025
555973,11,189,200,1.363913,103.865301
555974,50,31,81,1.364087,103.86499
555975,17,291,308,1.363935,103.865263
555976,22,45,67,1.364103,103.864956
555977,22,125,147,1.363957,103.865225
555978,18,188,206,1.364118,103.864921
555979,13,118,131,1.36398,103.865186
555980,66,6,72,1.364134,103.864886
555981,36,148,184,1.364002,103.865148
555982,260,142,402,1.36415,103.864851
555983,13,2,15,1.364014,103.86512
555984,11,107,118,1.36422,103.864713
555985,19,2,21,1.364224,103.864686
555986,3,1,4,1.36293,103.872146
555987,3,31,34,1.364242,103.864652
555988,1,0,1,1.363036,103.871879
555989,2,0,2,1.362398,103.870181
555990,14,70,84,1.364293,103.864577
555991,7,0,7,1.364314,103.864517
555993,1,0,1,1.364264,103.864632
555994,4,0,4,1.364235,103.864686
555995,0,10,10,1.364387,103.864381
555996,26,0,26,1.364379,103.864415
555998,20,0,20,1.364408,103.864361
556000,1,0,1,1.36435,103.864449
556001,0,1,1,1.364437,103.864306
556003,3,62,65,1.364466,103.864252
556004,2,0,2,1.364278,103.864584
556005,12,0,12,1.364495,103.864198
556007,21,4,25,1.364505,103.864188
556008,5,0,5,1.364704,103.863507
556009,0,2,2,1.364615,103.863672
556010,13,7,20,1.364783,103.863439
556011,1,3,4,1.36435,103.864469
556015,7,33,40,1.364767,103.863685
556016,1,7,8,1.364767,103.863685
556018,1,1,2,1.364632,103.863942
556019,50,0,50,1.364891,103.863298
556020,161,1,162,1.364798,103.863642
556021,3,2,5,1.364953,103.863185
556022,45,17,62,1.364828,103.863599
556023,0,2,2,1.364783,103.863664
556024,39,0,39,1.364858,103.863556
556025,5,0,5,1.365082,103.863033
556026,16,1,17,1.365485,103.863253
556027,27,0,27,1.365159,103.862985
556028,30,1,31,1.365557,103.863203
556029,7,0,7,1.365229,103.86294
556030,8,8,16,1.365613,103.863124
556031,1,18,19,1.365288,103.862868
556032,41,0,41,1.365679,103.863112
556033,2,0,2,1.365003,103.863113
556034,2,10,12,1.365761,103.862994
556035,16,8,24,1.365423,103.862733
556036,4,4,8,1.365814,103.862951
556037,12,3,15,1.365502,103.862656
556038,1,7,8,1.365911,103.862871
556039,42,1,43,1.365506,103.862557
556040,9,0,9,1.36599,103.862837
556041,4,2,6,1.365602,103.862493
556042,11,7,18,1.366062,103.862747
556043,78,0,78,1.365734,103.862486
556045,10,5,15,1.365806,103.862452
556046,61,6,67,1.366209,103.862628
556047,0,11,11,1.365876,103.862387
556048,1,8,9,1.36626,103.862614
556049,6,0,6,1.36596,103.862315
556050,28,1,29,1.36638,103.862534
556051,3,4,7,1.366043,103.862258
556052,56,0,56,1.366443,103.862464
556053,9,80,89,1.366156,103.86217
556054,253,0,253,1.366439,103.86191
556055,555,328,883,1.367391,103.861553
556056,187,165,352,1.36603,103.861261
556057,394,269,663,1.368436,103.861963
556058,1,0,1,1.364485,103.864188
556059,4,18,22,1.36322,103.870091
556060,2,85,87,1.363725,103.867287
556061,1,16,17,1.363081,103.87179
556062,8,0,8,1.363206,103.871972
556063,50,1,51,1.363212,103.871943
556064,5,0,5,1.363122,103.871641
556065,14,0,14,1.363155,103.871532
556066,6,10,16,1.364484,103.864187
556067,2,7,9,1.364484,103.864187
556068,1,7,8,1.364484,103.864187
556069,7,3,10,1.299509,103.837
556082,165,122,287,1.350695,103.872171
556083,2791,46,2837,1.350644,103.871806
556094,110,3,113,1.3587,103.870667
556095,707,11,718,1.359895,103.869558
556108,230,138,368,1.348506,103.868407
556109,35,870,905,1.349249,103.86751
556110,68,30,98,1.349335,103.867643
556111,818,528,1346,1.350297,103.866494
556112,1959,292,2251,1.350689,103.864707
556113,1816,184,2000,1.350689,103.864707
556114,2032,194,2226,1.350689,103.864707
556115,70,9,79,1.350689,103.864707
556117,5,227,232,1.34912,103.866193
556118,3,35,38,1.349179,103.866056
556119,1466,239,1705,1.350921,103.864187
556120,74,523,597,1.351329,103.863739
556121,1254,508,1762,1.351332,103.863578
556122,1820,8085,9905,1.350765,103.862546
556123,141,58,199,1.349457,103.869187
556124,447,202,649,1.349091,103.867434
556125,120,1,121,1.349054,103.86763
556126,556,522,1078,1.349478,103.865833
556127,177,958,1135,1.349133,103.866513
556129,89,1420,1509,1.352174,103.870326
556130,890,469,1359,1.348276,103.871682
556131,446,32,478,1.348321,103.871372
556132,383,29,412,1.348433,103.871094
556133,1338,22,1360,1.348292,103.870752
556134,1248,50,1298,1.348821,103.870671
556135,877,1485,2362,1.348904,103.871101
556136,131,264,395,1.348719,103.871327
556140,634,421,1055,1.346401,103.875825
556141,10,106,116,1.347444,103.876446
556142,6,0,6,1.347444,103.876446
556143,8,3,11,1.347444,103.876446
556144,9,3,12,1.347444,103.876446
556145,1,2,3,1.363891,103.865339
556146,41,0,41,1.347161,103.876779
556147,0,7,7,1.347528,103.877156
556148,0,3,3,1.347161,103.876779
556149,85,6,91,1.347527,103.877155
556150,3,34,37,1.347527,103.877155
556151,2,56,58,1.346487,103.877254
556152,4,21,25,1.346337,103.877273
556153,2,2,4,1.364768,103.863686
556166,56,1,57,1.36529,103.864776
556167,34,32,66,1.365433,103.86484
556179,42,64,106,1.363325,103.871255
556180,9,92,101,1.363332,103.871278
556181,2,0,2,1.365363,103.862796
556182,48,5,53,1.3634,103.871308
556183,10,1,11,1.363508,103.871336
556184,8,2,10,1.363536,103.871368
556185,4,2,6,1.363631,103.871391
556186,1,0,1,1.363158,103.870115
556187,0,1,1,1.363671,103.871429
556188,4,0,4,1.346233,103.877289
556189,51,2,53,1.363875,103.871499
556190,7,0,7,1.363943,103.871549
556191,0,1,1,1.363753,103.871445
556192,0,2,2,1.363386,103.871282
556193,3,3,6,1.364119,103.871607
556194,10,1,11,1.364214,103.87167
556195,16,0,16,1.364242,103.871662
556196,9,4,13,1.36435,103.87173
556197,3,0,3,1.347527,103.877155
556199,26,0,26,1.364486,103.87177
556200,2,0,2,1.364079,103.871609
556201,1,4,5,1.364536,103.871656
556202,0,4,4,1.363807,103.871489
556203,0,13,13,1.364587,103.871542
556204,2,1,3,1.364364,103.871716
556205,0,22,22,1.364688,103.871313
556206,1,18,19,1.364789,103.871105
556207,10,26,36,1.364779,103.871095
556208,4,19,23,1.364761,103.871077
556209,6,10,16,1.364713,103.871064
556210,47,0,47,1.364722,103.871059
556211,12,2,14,1.364646,103.871033
556212,6,0,6,1.364645,103.871023
556213,6,0,6,1.364514,103.870971
556214,28,0,28,1.364569,103.870987
556215,78,27,105,1.364381,103.870909
556216,11,0,11,1.364492,103.870951
556217,43,0,43,1.364248,103.870847
556218,6,14,20,1.364415,103.870915
556220,1,3,4,1.364587,103.871562
556221,5,1,6,1.363983,103.870722
556222,21,5,26,1.364261,103.870843
556224,2,2,4,1.364338,103.870879
556226,18,2,20,1.364108,103.870771
556227,9,0,9,1.363585,103.870536
556228,0,1,1,1.363997,103.871553
556229,8,2,10,1.363453,103.870474
556231,0,3,3,1.364688,103.871333
556233,2,9,11,1.363801,103.870628
556235,1,0,1,1.364031,103.870736
556236,1,0,1,1.363647,103.870556
556237,11,0,11,1.363494,103.870484
556238,2,115,117,1.363417,103.870448
556239,3,72,75,1.36334,103.870412
556240,1,7,8,1.364587,103.871562
556241,0,21,21,1.363385,103.870457
556250,1,1,2,1.364536,103.871676
556251,59,53,112,1.36385,103.868614
556252,1,0,1,1.36357,103.87052
556253,0,16,16,1.363988,103.868653
556254,8,0,8,1.364007,103.868579
556255,9,0,9,1.364109,103.868734
556256,44,1,45,1.36409,103.868651
556257,12,0,12,1.364203,103.868828
556258,22,0,22,1.364206,103.868706
556259,1,0,1,1.363914,103.868562
556260,5,5,10,1.364278,103.868773
556261,18,0,18,1.364413,103.869047
556262,8,0,8,1.36432,103.868834
556263,1,6,7,1.364482,103.869166
556264,8,0,8,1.364389,103.868898
556265,1,2,3,1.36333,103.870422
556266,5,0,5,1.364427,103.86897
556267,4,1,5,1.364548,103.869394
556268,15,0,15,1.364494,103.869047
556269,4,0,4,1.364185,103.870807
556270,4,0,4,1.364568,103.869518
556271,0,5,5,1.364565,103.869623
556272,19,0,19,1.364571,103.869222
556273,57,0,57,1.364593,103.869319
556274,16,1,17,1.364621,103.869421
556275,15,0,15,1.364632,103.869516
556276,7,9,16,1.364632,103.869629
556277,3,0,3,1.364516,103.869277
556279,13,34,47,1.363839,103.868537
556289,13,10,23,1.365664,103.865859
556290,6,16,22,1.365626,103.865925
556291,1,80,81,1.365494,103.865669
556292,0,9,9,1.365505,103.865579
556293,196,10,206,1.365462,103.86535
556294,5,10,15,1.365602,103.864923
556296,10,4,14,1.365731,103.864762
556297,3,0,3,1.364629,103.869723
556299,18,0,18,1.365665,103.864712
556300,21,5,26,1.36601,103.864598
556301,94,0,94,1.36581,103.864573
556302,8,1,9,1.36578,103.864716
556303,2,0,2,1.363762,103.86852
556304,2,1,3,1.365576,103.86479
556305,34,0,34,1.366075,103.864301
556306,49,0,49,1.366047,103.864543
556307,9,0,9,1.366146,103.864278
556308,12,0,12,1.36612,103.864413
556309,1,0,1,1.364302,103.86892
556310,46,1,47,1.366204,103.864369
556311,88,1,89,1.366285,103.864179
556312,3,2,5,1.366131,103.864462
556313,58,0,58,1.366362,103.864123
556316,2,0,2,1.366004,103.864382
556318,13,2,15,1.366285,103.864276
556319,1,0,1,1.366225,103.864145
556320,0,2,2,1.366342,103.864273
556321,67,0,67,1.366435,103.864033
556322,2,4,6,1.366541,103.864114
556323,73,1,74,1.366598,103.863929
556324,2,2,4,1.364546,103.869147
556325,140,2,142,1.366605,103.863834
556326,22,3,25,1.36656,103.864043
556327,12,0,12,1.36688,103.863617
556328,16,7,23,1.366765,103.863879
556330,44,9,53,1.366641,103.863982
556331,1,0,1,1.36651,103.86394
556332,1,0,1,1.36672,103.863766
556333,20,0,20,1.366769,103.863721
556334,1,0,1,1.366862,103.863787
556335,187,0,187,1.367308,103.863257
556336,3,5,8,1.366996,103.863703
556337,3,0,3,1.365971,103.864538
556338,28,0,28,1.36701,103.863655
556339,1,0,1,1.366915,103.863782
556341,93,0,93,1.367093,103.863497
556343,0,1,1,1.366995,103.863563
556344,4,9,13,1.367076,103.863597
556345,6,0,6,1.367043,103.86347
556347,1,0,1,1.367131,103.863374
556348,2,3,5,1.367331,103.863391
556349,5,0,5,1.367461,103.863092
556350,2,0,2,1.366394,103.864219
556351,14,0,14,1.367606,103.86299
556352,60,3,63,1.367297,103.863438
556354,9,3,12,1.3674,103.863341
556355,2,1,3,1.367221,103.863283
556356,9,7,16,1.367469,103.863313
556357,147,28,175,1.367887,103.862778
556358,9,1,10,1.367688,103.863076
556359,2,2,4,1.366443,103.86415
556360,33,1,34,1.367529,103.863249
556361,15,17,32,1.367733,103.863032
556362,7,0,7,1.367936,103.863083
556364,0,1,1,1.367375,103.863166
556366,10,1,11,1.367958,103.862852
556378,1,5,6,1.359206,103.873203
556379,10,6,16,1.359234,103.873323
556380,175,0,175,1.359261,103.873414
556381,25,0,25,1.359304,103.873593
556382,4,3,7,1.359336,103.873689
556383,4,55,59,1.359235,103.873662
556384,3,9,12,1.359035,103.87273
556385,0,2,2,1.367542,103.863193
556386,2,1,3,1.367697,103.862907
556387,0,2,2,1.359221,103.873615
556388,7,2,9,1.35908,103.872867
556391,2,0,2,1.35921,103.873568
556392,8,29,37,1.359121,103.872993
556393,0,3,3,1.359061,103.872804
556395,4,0,4,1.367611,103.863153
556396,3,4,7,1.359141,103.873257
556397,0,13,13,1.359123,103.873183
556398,37,0,37,1.358612,103.873212
556399,7,85,92,1.358591,103.873165
556400,0,3,3,1.359158,103.873388
556401,0,4,4,1.359152,103.873319
556402,1,12,13,1.358529,103.873185
556403,1,6,7,1.358792,103.873117
556404,1,19,20,1.358663,103.873137
556405,43,34,77,1.359005,103.873044
556406,1,1,2,1.359175,103.87345
556407,31,3,34,1.358771,103.873164
556417,10,46,56,1.36278,103.865494
556418,3,47,50,1.362841,103.865508
556419,6,0,6,1.36282,103.865439
556421,1,8,9,1.362874,103.865363
556422,32,1,33,1.362911,103.865409
556423,1,3,4,1.35856,103.873173
556424,79,5,84,1.362936,103.86538
556426,2,0,2,1.358705,103.873181
556427,4,1,5,1.363034,103.865146
556428,20,0,20,1.363036,103.86523
556430,0,1,1,1.367858,103.862933
556431,6,0,6,1.363192,103.865005
556432,1,0,1,1.363127,103.865017
556433,0,11,11,1.363248,103.864922
556434,5,0,5,1.363223,103.864879
556435,1,1,2,1.362984,103.865311
556436,12,0,12,1.363321,103.864811
556437,10,0,10,1.363272,103.864818
556438,4,0,4,1.362921,103.865296
556439,6,2,8,1.363305,103.864771
556442,0,1,1,1.36318,103.864946
556443,4,31,35,1.363358,103.86469
556444,0,1,1,1.363434,103.864648
556446,37,4,41,1.363509,103.864542
556447,20,0,20,1.363448,103.864566
556448,1,4,5,1.363584,103.864443
556451,5,0,5,1.363525,103.864443
556453,5,0,5,1.363559,103.864385
556454,4,0,4,1.363359,103.864764
556455,1,0,1,1.363469,103.864597
556456,4,3,7,1.363716,103.864221
556457,2,0,2,1.363296,103.864844
556458,25,0,25,1.363731,103.864562
556459,1,0,1,1.363593,103.864341
556460,0,1,1,1.363651,103.864245
556461,3,0,3,1.35862,103.873157
556464,10,1,11,1.363764,103.864073
556466,12,3,15,1.363272,103.864818
556467,8,0,8,1.299509,103.837
556476,33,14,47,1.361717,103.865215
556477,0,16,16,1.361914,103.865211
556478,3,1,4,1.363803,103.86461
556479,11,0,11,1.361639,103.86523
556480,32,1,33,1.361775,103.865217
556481,0,2,2,1.363624,103.864297
556482,1,19,20,1.361863,103.865241
556483,0,3,3,1.363683,103.864198
556484,0,1,1,1.363778,103.864109
556485,2,1,3,1.361577,103.865229
556497,1,0,1,1.361591,103.865194
556498,3,17,20,1.362437,103.865205
556499,0,1,1,1.362048,103.865026
556500,1,0,1,1.36179,103.864607
556501,13,0,13,1.36234,103.864781
556502,13,0,13,1.362428,103.864882
556503,77,0,77,1.36227,103.864954
556504,13,4,17,1.36247,103.86482
556505,4,0,4,1.361833,103.865205
556508,2,3,5,1.362524,103.864764
556509,15,2,17,1.362639,103.86461
556510,1,0,1,1.362378,103.864955
556512,1,0,1,1.362569,103.864429
556513,3,2,5,1.362724,103.864506
556514,5,0,5,1.362688,103.864304
556515,5,0,5,1.362811,103.864363
556516,2,0,2,1.361688,103.865251
556517,1,0,1,1.362502,103.864499
556518,10,0,10,1.362748,103.864272
556519,0,29,29,1.362775,103.864404
556520,8,4,12,1.362787,103.864214
556521,11,1,12,1.362939,103.864214
556522,10,0,10,1.362934,103.864059
556524,5,7,12,1.363095,103.863898
556525,14,0,14,1.362991,103.864151
556527,18,25,43,1.363038,103.864076
556529,2,0,2,1.362858,103.864106
556530,12,0,12,1.363008,103.863917
556531,13,1,14,1.363183,103.863657
556532,18,0,18,1.363041,103.864129
556533,1,1,2,1.363106,103.864009
556534,48,6,54,1.363176,103.863907
556536,9,12,21,1.363243,103.863849
556537,40,0,40,1.363419,103.863508
556538,12,2,14,1.363301,103.863792
556539,12,0,12,1.363713,103.863287
556540,1,0,1,1.36285,103.864305
556541,44,6,50,1.363266,103.86366
556542,5,0,5,1.363402,103.863689
556543,2,5,7,1.363519,103.863692
556544,2,3,5,1.363539,103.863645
556546,1,0,1,1.363352,103.86374
556547,15,0,15,1.363335,103.863586
556548,61,8,69,1.36346,103.863639
556550,4,8,12,1.363488,103.863597
556551,3,0,3,1.361635,103.865138
556552,2,0,2,1.363174,103.863746
556553,2,0,2,1.364099,103.863106
556556,20,0,20,1.364322,103.863254
556557,2,0,2,1.363889,103.863082
556558,3,1,4,1.362424,103.864731
556559,1,0,1,1.363402,103.863689
556560,17,1,18,1.364249,103.862939
556561,80,6,86,1.364693,103.862661
556562,1,0,1,1.364055,103.862891
556563,10,0,10,1.364356,103.862672
556564,49,0,49,1.364531,103.862749
556565,5,0,5,1.364274,103.862602
556566,1,1,2,1.364161,103.862851
556567,0,2,2,1.364565,103.862674
556568,10,0,10,1.36463,103.862641
556569,1,0,1,1.364144,103.863043
556570,13,2,15,1.364812,103.862504
556571,5,43,48,1.364474,103.862792
556572,6,0,6,1.364887,103.862711
556573,24,0,24,1.364645,103.862394
556574,2,1,3,1.363778,103.863165
556575,19,4,23,1.364633,103.86229
556576,0,2,2,1.364335,103.86256
556577,2,16,18,1.364738,103.86222
556578,1,2,3,1.364723,103.86259
556580,2,0,2,1.364839,103.862437
556581,16,6,22,1.364896,103.862251
556582,0,2,2,1.365178,103.862443
556583,0,1,1,1.364396,103.862829
556584,120,4,124,1.365133,103.862233
556585,32,1,33,1.364989,103.862148
556586,9,0,9,1.365007,103.862312
556588,9,1,10,1.365466,103.862201
556589,0,11,11,1.365234,103.861845
556590,8,0,8,1.365355,103.862026
556591,40,2,42,1.364047,103.863309
556602,12,0,12,1.360107,103.872243
556603,93,0,93,1.359883,103.872741
556604,7,0,7,1.360016,103.872435
556605,94,0,94,1.359977,103.872533
556606,1,86,87,1.359952,103.872575
556608,0,20,20,1.360009,103.872465
556609,3,13,16,1.360228,103.872185
556610,1,11,12,1.360268,103.872114
556611,2,0,2,1.365224,103.862382
556613,4,0,4,1.364625,103.862696
556615,4,10,14,1.360186,103.872103
556617,5,1,6,1.360294,103.872028
556618,1,0,1,1.364921,103.862051
556619,0,1,1,1.360323,103.871974
556621,6,4,10,1.36033,103.871804
556622,19,2,21,1.360343,103.871927
556623,14,32,46,1.360365,103.871728
556624,5,0,5,1.360386,103.871698
556626,4,0,4,1.360182,103.872262
556627,17,0,17,1.360427,103.871749
556629,1,0,1,1.360297,103.871862
556630,5,0,5,1.360539,103.871538
556632,1,0,1,1.360501,103.871647
556633,16,0,16,1.360603,103.87141
556634,2,4,6,1.360667,103.871275
556635,5,0,5,1.360604,103.871224
556637,3,8,11,1.36065,103.871148
556639,5,0,5,1.360676,103.871076
556640,7,0,7,1.360718,103.871198
556641,2,2,4,1.360412,103.871793
556642,1,0,1,1.360644,103.871325
556645,29,1,30,1.360895,103.8708
556646,0,2,2,1.359913,103.872655
556647,11,0,11,1.360825,103.870794
556648,1,0,1,1.360746,103.870922
556649,0,2,2,1.360929,103.870732
556650,3,0,3,1.364911,103.862395
556651,19,0,19,1.360943,103.870535
556652,159,0,159,1.360993,103.870594
556653,1,0,1,1.360861,103.870664
556654,236,3,239,1.361117,103.870319
556659,150,0,150,1.361074,103.870252
556660,53,0,53,1.36123,103.870052
556661,2,0,2,1.360956,103.870692
556662,0,10,10,1.361193,103.870081
556663,12,12,24,1.361147,103.870272
556664,8,0,8,1.361306,103.869965
556665,0,1,1,1.361041,103.87033
556666,19,6,25,1.361374,103.869896
556667,15,6,21,1.361383,103.869982
556668,5,2,7,1.359893,103.872704
556669,2,11,13,1.361042,103.870507
556670,4,0,4,1.360873,103.870874
556673,13,0,13,1.360433,103.871593
556679,2427,0,2427,1.365217,103.865262
556680,49,618,667,1.364727,103.865499
556681,94,590,684,1.3651,103.865475
556682,44,1141,1185,1.364819,103.865508
556683,28,137,165,1.365152,103.865479
556684,62,235,297,1.364909,103.865516
556685,160,110,270,1.365239,103.865488
556686,56,363,419,1.365008,103.865527
556687,7,231,238,1.365336,103.865493
556688,7,143,150,1.365057,103.865537
556689,61,151,212,1.365406,103.8655
556690,19,116,135,1.365096,103.865553
556691,15,37,52,1.364946,103.86546
556692,41,79,120,1.365142,103.865553
556693,20,76,96,1.365187,103.865568
556694,34,13,47,1.365234,103.865569
556695,53,36,89,1.365271,103.865576
556696,25,15,40,1.36533,103.865583
556697,10,29,39,1.365374,103.865589
556698,12,83,95,1.365415,103.865576
556710,66,29,95,1.365019,103.86377
556711,5,0,5,1.365117,103.863789
556713,2,4,6,1.365279,103.863904
556714,1,0,1,1.361206,103.870176
556741,13863,2076,15939,1.352087,103.861482
556742,367,2,369,1.349363,103.862358
556743,475,828,1303,1.351972,103.863659
556744,546,193,739,1.352973,103.863909
556745,1330,220,1550,1.353151,103.86458
556746,33,121,154,1.352689,103.864592
556747,839,2863,3702,1.352119,103.864646
556748,1521,148,1669,1.352326,103.865329
556749,7,79,86,1.356598,103.86826
556750,5,7,12,1.356585,103.868326
556751,0,5,5,1.356302,103.868646
556752,0,6,6,1.356196,103.86855
556753,1,0,1,1.364947,103.863737
556754,1,0,1,1.356259,103.86862
556755,1,27,28,1.35622,103.868593
556757,2,1,3,1.360902,103.870601
556758,3,2,5,1.356113,103.868584
556759,4,1,5,1.35607,103.868546
556760,3,0,3,1.356179,103.868636
556761,3,0,3,1.356042,103.868569
556762,1,121,122,1.356022,103.868478
556763,0,60,60,1.357852,103.86821
556764,0,23,23,1.357852,103.86821
556765,0,22,22,1.35695,103.868041
556766,4,12,16,1.357104,103.868024
556767,1,55,56,1.357852,103.86821
556768,5,121,126,1.357852,103.86821
556769,4,5,9,1.357124,103.867928
556770,6,2,8,1.357124,103.867928
556771,38,99,137,1.357808,103.86791
556772,39,8,47,1.358171,103.86815
556774,2,3,5,1.35832,103.868181
556775,6,11,17,1.358367,103.868191
556776,1,8,9,1.358433,103.868212
556777,1,17,18,1.358656,103.868235
556778,10,12,22,1.358514,103.868209
556779,3,13,16,1.358582,103.868216
556780,13,18,31,1.35874,103.868216
556781,0,175,175,1.358165,103.867907
556782,0,20,20,1.372154,103.900344
556784,4,40,44,1.359939,103.868274
556785,3,39,42,1.359992,103.868264
556786,1,48,49,1.36054,103.86844
556787,4,9,13,1.360459,103.868558
556788,0,5,5,1.360353,103.868632
556789,2,3,5,1.3603,103.868673
556790,6,1,7,1.36023,103.868746
556791,3,0,3,1.356022,103.868526
556792,0,3,3,1.360679,103.868304
556793,0,1,1,1.356155,103.86852
556794,0,5,5,1.36057,103.868601
556795,1,3,4,1.360433,103.871593
556796,0,4,4,1.360508,103.868666
556797,17,0,17,1.360337,103.868783
556798,24,2,26,1.360318,103.868883
556799,13,17,30,1.360773,103.868167
556800,22,498,520,1.361657,103.868085
556801,0,12,12,1.361677,103.868126
556802,1,2,3,1.360699,103.868454
556803,39,0,39,1.361711,103.868174
556804,3,2,5,1.361726,103.868198
556805,2,0,2,1.36117,103.870216
556806,2,0,2,1.361751,103.868223
556807,0,6,6,1.361809,103.868292
556808,1,19,20,1.361853,103.868257
556809,4,188,192,1.361832,103.868234
556810,21,126,147,1.362466,103.867847
556811,10,14,24,1.35912,103.86825
556812,7,89,96,1.359246,103.868225
556813,2,0,2,1.361775,103.868258
556815,6,4,10,1.360979,103.868134
556816,0,4,4,1.360419,103.868753
556817,9,47,56,1.361134,103.868098
556818,13347,1203,14550,1.35103,103.858437
556820,2438,1027,3465,1.34996,103.860887
556821,22,593,615,1.35106,103.858476
556822,0,54,54,1.363739,103.86979
556823,2,5,7,1.364091,103.869811
556824,13,11,24,1.363835,103.869858
556825,21,5,26,1.364222,103.869901
556826,6,4,10,1.363883,103.86985
556827,13,8,21,1.364198,103.869934
556828,6,0,6,1.363968,103.869893
556829,5,0,5,1.364193,103.869882
556830,4,8,12,1.364145,103.870059
556831,40,8,48,1.364271,103.870065
556832,3,3,6,1.364113,103.869967
556833,4,3,7,1.364352,103.870009
556835,0,19,19,1.364744,103.870027
556836,1,0,1,1.36064,103.868547
556837,4,1,5,1.364625,103.870103
556838,0,1,1,1.364185,103.870001
556839,5,4,9,1.364806,103.870224
556840,0,1,1,1.364335,103.870089
556841,5,2,7,1.364658,103.870126
556842,42,11,53,1.364488,103.870193
556843,0,2,2,1.36083,103.868162
556844,0,2,2,1.364677,103.870066
556845,1,1,2,1.364425,103.870154
556846,5,0,5,1.364615,103.870241
556847,225,30,255,1.364565,103.87019
556848,5,5,10,1.36478,103.870323
556849,11,2,13,1.364869,103.870332
556850,24,0,24,1.364952,103.870398
556851,18,0,18,1.364701,103.870267
556852,14,0,14,1.365095,103.87046
556854,1,1,2,1.36485,103.870053
556855,4,130,134,1.363739,103.86979
556865,22,13,35,1.356395,103.864698
556866,2,23,25,1.356624,103.864657
556867,11,2,13,1.356428,103.864711
556868,0,2,2,1.365156,103.870371
556869,6,0,6,1.35637,103.864667
556870,0,1,1,1.364386,103.870101
556871,29,5,34,1.35659,103.864843
556872,24,3,27,1.356436,103.864627
556873,1,2,3,1.361697,103.86816
556874,4,0,4,1.361054,103.868113
556875,2,0,2,1.356498,103.864689
556876,2,1,3,1.356338,103.864848
556878,31,4,35,1.35652,103.864785
556880,18,0,18,1.35645,103.864735
556892,2,13,15,1.35485,103.865149
556893,1,2,3,1.356166,103.864419
556894,0,125,125,1.354764,103.864498
556895,0,1,1,1.35658,103.864601
556896,6,34,40,1.354653,103.865034
556897,0,1,1,1.354812,103.864902
556898,137,17,154,1.354575,103.864982
556899,2,2,4,1.356495,103.864495
556900,0,19,19,1.354423,103.864902
556901,1,3,4,1.354734,103.864789
556902,2,114,116,1.354644,103.864728
556903,4,0,4,1.3547,103.864769
556904,17,1,18,1.354631,103.864709
556905,44,5,49,1.35432,103.864688
556906,22,1,23,1.354629,103.864246
556907,2,55,57,1.354472,103.864584
556908,18,16,34,1.354596,103.864044
556909,1,33,34,1.354433,103.86437
556910,9,0,9,1.354585,103.86406
556911,1,90,91,1.354447,103.864486
556912,24,6,30,1.354564,103.863758
556913,6,9,15,1.354369,103.864103
556914,6,14,20,1.354392,103.864212
556915,1,38,39,1.354668,103.864179
556916,1,46,47,1.354383,103.864151
556917,12,32,44,1.35419,103.86387
556918,10,3,13,1.354583,103.864188
556930,54,14,68,1.356256,103.865284
556931,0,9,9,1.356364,103.865183
556932,8,0,8,1.356141,103.865394
556933,2,2,4,1.354685,103.864749
556935,89,0,89,1.355985,103.865014
556936,7,1,8,1.356014,103.865128
556937,11,3,14,1.356231,103.86507
556938,8,1,9,1.355945,103.865093
556939,0,1,1,1.354761,103.864808
556940,12,0,12,1.355947,103.86528
556941,0,1,1,1.356226,103.865034
556942,9,0,9,1.355943,103.864992
556943,7,0,7,1.356142,103.865218
556944,29,1,30,1.356054,103.864964
556945,5,1,6,1.355883,103.865182
556946,1,2,3,1.354917,103.864917
556947,9,5,14,1.355807,103.865178
556948,27,3,30,1.355905,103.864964
556949,1,1,2,1.356491,103.864772
556950,1,4,5,1.355874,103.864931
556951,2,4,6,1.355645,103.86481
556952,5,0,5,1.355564,103.864652
556953,32,0,32,1.355612,103.864786
556954,22,3,25,1.355801,103.86477
556955,2,2,4,1.356038,103.865071
556956,8,2,10,1.355738,103.864748
556957,20,2,22,1.355583,103.864769
556959,32,0,32,1.355507,103.864919
556960,0,1,1,1.356141,103.86503
556961,4,3,7,1.355535,103.864739
556963,17,0,17,1.355416,103.864879
556964,20,0,20,1.355418,103.864561
556965,10,1,11,1.355373,103.864821
556966,1,22,23,1.355318,103.864501
556969,2,0,2,1.35575,103.865107
556970,2,0,2,1.355258,103.864528
556971,15,0,15,1.355375,103.864712
556972,6,1,7,1.355188,103.864385
556975,20,0,20,1.355285,103.864794
556976,9,0,9,1.354902,103.864209
556977,1,0,1,1.355693,103.864634
556978,40,5,45,1.355126,103.864345
556980,162,1,163,1.355008,103.864255
556981,11,0,11,1.355115,103.865314
556982,7,0,7,1.355039,103.86428
556983,14,1,15,1.355064,103.865352
556984,9,0,9,1.354642,103.864139
556985,8,10,18,1.355029,103.865415
556986,24,3,27,1.354717,103.864187
556987,1,0,1,1.355171,103.865223
556988,9,1,10,1.355123,103.864651
556989,0,28,28,1.355212,103.864684
557001,4,13,17,1.355773,103.865656
557002,7,8,15,1.35581,103.865605
557003,0,1,1,1.355219,103.864488
557005,4,5,9,1.355717,103.865604
557006,9,1,10,1.355749,103.865631
557008,2,0,2,1.355427,103.864397
557009,0,42,42,1.355684,103.865581
557010,1,1,2,1.355888,103.865496
557011,0,46,46,1.355398,103.865484
557012,11,0,11,1.355656,103.865487
557013,0,2,2,1.355761,103.865568
557014,3,0,3,1.356009,103.865045
557015,16,0,16,1.355518,103.865317
557016,0,1,1,1.355643,103.865772
557017,16,0,16,1.355363,103.865519
557018,21,0,21,1.355554,103.865275
557019,0,4,4,1.355465,103.864697
557020,2,3,5,1.355447,103.865427
557024,67,54,121,1.355198,103.865563
557036,20,25,45,1.356758,103.864444
557037,164,21,185,1.356608,103.864014
557038,13,16,29,1.356642,103.864355
557039,8,2,10,1.356821,103.863983
557040,0,2,2,1.355615,103.865463
557041,9,5,14,1.356755,103.863984
557042,4,6,10,1.356703,103.864176
557044,10,3,13,1.356697,103.864142
557045,1,4,5,1.356442,103.863828
557046,0,1,1,1.355474,103.865379
557048,4,0,4,1.355377,103.86534
557050,2,0,2,1.356646,103.864088
557051,26,0,26,1.356357,103.864163
557052,1,0,1,1.356444,103.863946
557053,53,18,71,1.356285,103.864134
557054,6,0,6,1.356465,103.863714
557055,9,0,9,1.356271,103.864088
557056,1,18,19,1.356317,103.863777
557058,14,1,15,1.356249,103.863587
557059,37,17,54,1.356395,103.863901
557060,4,62,66,1.355959,103.863476
557061,2,1,3,1.355582,103.865442
557062,14,0,14,1.355907,103.863431
557063,1,1,2,1.356551,103.863788
557065,2,8,10,1.355795,103.86351
557066,0,1,1,1.356471,103.863793
557067,1,24,25,1.355804,103.863474
557068,0,4,4,1.356479,103.863878
557069,13,4,17,1.355562,103.863573
557070,4,3,7,1.355989,103.863374
557071,1,17,18,1.355472,103.863466
557072,33,9,42,1.355611,103.863217
557073,1,6,7,1.355345,103.863418
557074,159,3,162,1.355983,103.863584
557076,0,12,12,1.355658,103.863248
557077,1,19,20,1.355057,103.862955
557078,31,0,31,1.355764,103.863198
557079,0,1,1,1.355552,103.86314
557080,15,3,18,1.355729,103.863186
557081,3,6,9,1.354928,103.863128
557082,2,3,5,1.355497,103.86309
557083,3,10,13,1.354861,103.863058
557084,0,5,5,1.355361,103.86301
557085,32,12,44,1.354542,103.862806
557087,32,11,43,1.354678,103.86282
557088,2,1,3,1.355973,103.863644
557089,2,34,36,1.354444,103.862994
557090,46,2,48,1.355479,103.863016
557091,19,124,143,1.354397,103.862755
557092,1,6,7,1.355435,103.862996
557093,6,0,6,1.35515,103.862861
557094,0,1,1,1.355071,103.863188
557095,2,7,9,1.355028,103.86283
557096,0,6,6,1.355084,103.862844
557097,18,1,19,1.355268,103.862948
557098,14,1,15,1.355111,103.862747
557099,27,12,39,1.355058,103.862762
557101,50,2,52,1.354916,103.862788
557102,4,18,22,1.35474,103.862724
557103,14,10,24,1.35474,103.862637
557104,7,0,7,1.354792,103.862592
557105,28,9,37,1.354793,103.862768
557106,0,1,1,1.355206,103.862902
557108,2,6,8,1.354469,103.862357
557109,19,54,73,1.354412,103.862418
557110,69,21,90,1.354434,103.86245
557111,47,15,62,1.354455,103.862541
557112,2,77,79,1.354434,103.862571
557113,1,51,52,1.354386,103.862513
557125,6,0,6,1.3561,103.864653
557126,11,0,11,1.356305,103.864388
557127,28,8,36,1.356072,103.864421
557128,4,6,10,1.35607,103.864333
557129,0,7,7,1.355802,103.864205
557131,33,2,35,1.355974,103.864324
557132,1,3,4,1.355584,103.863187
557133,0,1,1,1.354854,103.862778
557134,6,0,6,1.356131,103.864243
557135,1,3,4,1.356138,103.864286
557136,1,1,2,1.355844,103.863502
557137,46,8,54,1.356028,103.864181
557138,5,0,5,1.355653,103.864113
557139,8,2,10,1.355712,103.864048
557140,2,3,5,1.355812,103.8644
557141,21,1,22,1.355742,103.863981
557142,1,0,1,1.355828,103.864244
557143,17,0,17,1.355493,103.863881
557144,4,1,5,1.355618,103.864099
557145,1,0,1,1.35572,103.864383
557146,145,1,146,1.355681,103.864145
557147,0,1,1,1.355276,103.863714
557148,0,1,1,1.354941,103.864036
557149,3,0,3,1.35543,103.863056
557150,2,0,2,1.356052,103.864264
557151,4,0,4,1.355898,103.864284
557152,1,3,4,1.354976,103.863482
557153,2,0,2,1.355435,103.863919
557154,84,1,85,1.355343,103.863881
557155,0,1,1,1.355016,103.864028
557156,12,2,14,1.35537,103.863887
557157,0,3,3,1.355387,103.863695
557158,0,1,1,1.355022,103.863535
557159,13,2,15,1.35465,103.863343
557160,76,0,76,1.354685,103.864215
557161,0,1,1,1.355226,103.863762
557163,25,2,27,1.354624,103.863237
557164,0,2,2,1.354898,103.863436
557165,3,5,8,1.354533,103.863209
557166,3,1,4,1.354765,103.864039
557167,2,4,6,1.354416,103.863235
557168,9,6,15,1.354611,103.863738
557169,17,84,101,1.354278,103.863176
557170,6,2,8,1.354409,103.863614
557171,11,66,77,1.35422,103.863519
557183,14,11,25,1.366696,103.866412
557184,20,59,79,1.367296,103.866308
557185,5,0,5,1.367072,103.866358
557187,2,0,2,1.354505,103.86369
557188,0,1,1,1.354784,103.863359
557189,0,1,1,1.367488,103.866088
557190,12,2,14,1.367429,103.866176
557192,165,2,167,1.36744,103.866132
557193,2,0,2,1.367256,103.866166
557195,17,1,18,1.367606,103.865981
557196,3,2,5,1.367436,103.866012
557197,0,2,2,1.367539,103.865937
557198,37,2,39,1.367335,103.866098
557199,2,0,2,1.36788,103.86575
557200,0,1,1,1.367195,103.866247
557201,4,1,5,1.368148,103.865574
557202,8,2,10,1.367524,103.865834
557203,1,0,1,1.3676,103.865891
557205,31,2,33,1.367995,103.865681
557206,17,1,18,1.367775,103.865718
557207,12,3,15,1.368043,103.865612
557208,0,1,1,1.368093,103.865649
557209,4,0,4,1.355039,103.863626
557211,3,0,3,1.354646,103.863871
557212,20,0,20,1.368585,103.865156
557213,2,0,2,1.36772,103.865915
557214,0,5,5,1.36829,103.865333
557215,0,1,1,1.367673,103.86582
557216,13,0,13,1.368312,103.865293
557217,30,2,32,1.368168,103.865537
557218,9,2,11,1.368643,103.865105
557220,0,1,1,1.368388,103.865347
557221,94,4,98,1.368336,103.865401
557222,14,1,15,1.368561,103.865072
557223,4,3,7,1.368272,103.865422
557224,93,0,93,1.368536,103.865101
557225,6,0,6,1.368481,103.865227
557227,0,4,4,1.367983,103.865706
557228,1,0,1,1.36849,103.865137
557229,2,0,2,1.368093,103.86558
557230,13,0,13,1.368975,103.86489
557232,3,4,7,1.368947,103.864748
557233,1,0,1,1.368708,103.864949
557234,35,0,35,1.368936,103.864915
557235,1,0,1,1.368963,103.864966
557236,30,0,30,1.369171,103.864899
557237,3,3,6,1.369198,103.864988
557238,3,1,4,1.368746,103.86521
557239,1,0,1,1.36868,103.865077
557240,1,1,2,1.368539,103.865203
557241,185,0,185,1.369271,103.864905
557242,33,16,49,1.299509,103.837
557243,11,1,12,1.299509,103.837
557253,179,9513,9692,1.364471,103.866077
557254,23,733,756,1.364526,103.86609
557255,30,1013,1043,1.364673,103.866042
557256,39,470,509,1.364629,103.866095
557257,25,463,488,1.364591,103.866105
557258,11,191,202,1.364697,103.866113
557259,22,224,246,1.36498,103.866119
557260,15,119,134,1.364903,103.866103
557261,40,284,324,1.364823,103.866127
557262,14,146,160,1.364941,103.866113
557263,14,280,294,1.364905,103.866141
557264,21,78,99,1.365051,103.86613
557265,117,781,898,1.365112,103.866158
557266,7,827,834,1.365481,103.866312
557267,4,2,6,1.365553,103.86631
557268,40,436,476,1.365597,103.866333
557269,560,7504,8064,1.364548,103.866374
557271,1352,52,1404,1.365696,103.86649
557273,1,120,121,1.36576,103.866355
557274,2,134,136,1.365809,103.866371
557275,6,170,176,1.36586,103.866377
557276,7,46,53,1.365916,103.866378
557277,14,85,99,1.366016,103.8664
557278,7,156,163,1.366871,103.866413
557279,25,96,121,1.366505,103.86643
557280,8,22,30,1.366801,103.866407
557281,1,20,21,1.36765,103.866411
557283,24,0,24,1.368261,103.866587
557285,2,0,2,1.368789,103.864997
557286,44,8,52,1.368121,103.866769
557287,18,19,37,1.368207,103.866834
557288,1,0,1,1.369067,103.864897
557289,54,2,56,1.368206,103.866907
557290,8,27,35,1.368113,103.866919
557291,1,1,2,1.368203,103.866726
557292,39,0,39,1.368116,103.866998
557293,3,0,3,1.368238,103.865454
557294,131,4,135,1.368112,103.867081
557295,12,3,15,1.368205,103.867114
557297,34,1,35,1.368375,103.8672
557298,3,0,3,1.368208,103.867042
557299,6,15,21,1.368213,103.867214
557300,5,3,8,1.368117,103.867278
557301,27,9,36,1.3684,103.867449
557302,22,5,27,1.368114,103.867468
557303,1,2,3,1.368115,103.867202
557304,9,3,12,1.368111,103.867533
557305,1,0,1,1.368117,103.866824
557306,2,0,2,1.368203,103.866979
557307,3,31,34,1.368345,103.867813
557308,2,11,13,1.368117,103.867714
557309,57,111,168,1.367154,103.86729
557320,1014,44,1058,1.366796,103.868687
557321,343,6,349,1.367812,103.868373
557322,603,32,635,1.368655,103.868384
557323,1918,558,2476,1.368581,103.86959
557324,2074,394,2468,1.367786,103.869599
557325,1269,164,1433,1.367245,103.869628
557337,0,3,3,1.36819,103.867644
557340,7,0,7,1.355114,103.862109
557342,9,1,10,1.355417,103.862249
557344,1,0,1,1.36826,103.867845
557346,29,0,29,1.355508,103.862341
557349,6,4,10,1.355322,103.862266
557350,0,2,2,1.368111,103.867612
557351,13,0,13,1.355367,103.862301
557353,15,5,20,1.355665,103.862456
557354,1,0,1,1.355468,103.862288
557355,0,1,1,1.355439,103.862375
557357,0,2,2,1.355609,103.86241
557358,3,0,3,1.355288,103.862137
557359,1,2,3,1.355524,103.86244
557360,1,0,1,1.35571,103.862494
557361,0,2,2,1.355756,103.862523
557362,6,3,9,1.355668,103.862526
557363,9,0,9,1.355891,103.862638
557364,6,1,7,1.355938,103.862674
557365,6,2,8,1.35571,103.862566
557366,15,0,15,1.356008,103.862699
557367,2,1,3,1.3558,103.862554
557368,0,6,6,1.356057,103.862726
557369,0,1,1,1.355616,103.862493
557370,3,7,10,1.356147,103.86282
557371,65,0,65,1.355834,103.862678
557372,1,0,1,1.355792,103.862638
557373,1,0,1,1.356209,103.862862
557374,27,5,32,1.356301,103.862927
557375,1,0,1,1.355879,103.862713
557376,81,2,83,1.356359,103.862975
557377,12,0,12,1.355964,103.862778
557379,4,0,4,1.369133,103.864775
557380,1,1,2,1.355853,103.862602
557381,3,2,5,1.3561,103.862873
557382,1,5,6,1.356508,103.863091
557384,0,3,3,1.355752,103.862598
557385,1,3,4,1.356011,103.86281
557386,0,2,2,1.356455,103.863053
557387,2,1,3,1.356554,103.863126
557388,1,3,4,1.356186,103.862942
557389,0,2,2,1.356658,103.863241
557391,1,0,1,1.355921,103.86274
557393,21,1,22,1.35636,103.863091
557394,5,0,5,1.356881,103.863419
557395,0,1,1,1.356318,103.863057
557396,1,0,1,1.356401,103.863126
557397,2,2,4,1.35669,103.863267
557398,7,14,21,1.357008,103.863521
557399,5,0,5,1.356496,103.863202
557400,3,0,3,1.356218,103.862986
557401,2,7,9,1.356658,103.863261
557402,7,1,8,1.357135,103.863622
557403,0,2,2,1.356272,103.863026
557404,36,47,83,1.357199,103.863673
557405,0,3,3,1.357072,103.863571
557406,28,3,31,1.356817,103.863388
557407,1,0,1,1.356944,103.86347
557410,3,0,3,1.356753,103.863338
557411,16,0,16,1.357135,103.863642
557412,3,19,22,1.357189,103.863683
557413,6,0,6,1.355938,103.862674
557425,19,285,304,1.36357,103.873371
557426,23,4,27,1.363606,103.873341
557427,2,44,46,1.363839,103.873166
557428,0,37,37,1.363744,103.873247
557429,1,56,57,1.36378,103.873215
557433,1,0,1,1.356881,103.863439
557434,2,0,2,1.35669,103.863287
557435,7,1,8,1.363641,103.873307
557445,16,7,23,1.366288,103.868273
557446,0,3,3,1.357072,103.863591
557447,0,4,4,1.356445,103.863159
557448,0,2,2,1.363641,103.873307
557449,3,3,6,1.366282,103.868214
557450,1,1,2,1.366212,103.868188
557452,2,0,2,1.366216,103.868145
557453,1,7,8,1.366289,103.86813
557454,4,1,5,1.366217,103.868037
557455,2,0,2,1.366216,103.868093
557456,104,0,104,1.366217,103.867905
557457,44,7,51,1.366423,103.867814
557458,78,0,78,1.366423,103.867751
557459,7,2,9,1.366419,103.867696
557460,30,0,30,1.366415,103.867649
557463,106,1,107,1.366411,103.867516
557464,3,0,3,1.366209,103.868233
557465,51,0,51,1.366406,103.867396
557466,18,0,18,1.366404,103.867344
557467,17,0,17,1.366397,103.867286
557468,1,0,1,1.363641,103.873307
557469,3,0,3,1.366403,103.867451
557470,1,208,209,1.366397,103.8671
557471,10,33,43,1.3664,103.867024
557483,3,1,4,1.366286,103.868242
557484,14,8,22,1.36662,103.867387
557485,20,2,22,1.366625,103.8673
557486,0,3,3,1.366399,103.867167
557488,1,0,1,1.366399,103.867211
557490,0,2,2,1.366219,103.867977
557493,0,1,1,1.366815,103.867399
557494,1,1,2,1.366868,103.867406
557495,1,6,7,1.367088,103.867389
557496,1,1,2,1.367008,103.867399
557497,21,0,21,1.367186,103.867399
557498,0,2,2,1.367106,103.867318
557499,2,20,22,1.367272,103.867412
557500,2,0,2,1.367174,103.867306
557501,6,0,6,1.367338,103.867405
557502,19,11,30,1.36729,103.86731
557503,11,0,11,1.367424,103.867408
557504,29,3,32,1.367361,103.867326
557505,2,4,6,1.367499,103.867417
557506,27,1,28,1.367489,103.86731
557507,5,1,6,1.367598,103.867405
557508,1,0,1,1.367041,103.867316
557511,24,0,24,1.367802,103.867404
557512,0,1,1,1.367733,103.867293
557513,7,5,12,1.367963,103.867404
557514,13,2,15,1.367943,103.867327
557515,11,4,15,1.368331,103.867422
557516,36,0,36,1.368506,103.867319
557517,4,3,7,1.368478,103.867427
557518,7,1,8,1.368588,103.867328
557519,17,4,21,1.368572,103.86742
557520,1,0,1,1.367657,103.867305
557521,31,2,33,1.368661,103.867435
557522,21,1,22,1.368782,103.867338
557523,9,2,11,1.368738,103.867441
557524,5,0,5,1.368876,103.867345
557525,0,5,5,1.368823,103.86744
557526,5,8,13,1.368929,103.867353
557527,4,2,6,1.368895,103.867435
557528,3,2,5,1.36897,103.86734
557529,1,0,1,1.368683,103.867341
557530,45,0,45,1.369066,103.867345
557531,5,2,7,1.3691,103.867466
557532,33,14,47,1.369143,103.86735
557533,1,43,44,1.369328,103.867458
557534,253,0,253,1.369204,103.867352
557535,2,1,3,1.3667,103.867395
557536,2,0,2,1.36722,103.8673
557537,6,3,9,1.369491,103.867442
557538,5,1,6,1.369377,103.867356
557539,3,0,3,1.369239,103.867431
557540,6,3,9,1.369466,103.867365
557541,2,1,3,1.36978,103.867447
557542,28,0,28,1.36954,103.867361
557544,2,0,2,1.36928,103.867351
557545,3,0,3,1.369866,103.867443
557546,5,0,5,1.369692,103.867368
557547,6,2,8,1.370083,103.867446
557548,10,0,10,1.36975,103.867355
557549,1,3,4,1.366549,103.867304
557551,1,0,1,1.368997,103.867431
557552,45,2,47,1.369867,103.867352
557553,13,1,14,1.36995,103.867364
557554,2,0,2,1.369612,103.86736
557555,10,0,10,1.370146,103.867368
557557,5,0,5,1.370231,103.867368
557558,3,3,6,1.370309,103.867366
557559,4,9,13,1.370359,103.867357
557560,8,1,9,1.370448,103.867339
557561,68,21,89,1.370299,103.867465
557562,24,41,65,1.370359,103.867457
557572,69,1,70,1.366383,103.866227
557573,0,5,5,1.366651,103.866126
557576,0,3,3,1.37002,103.867451
557577,38,0,38,1.366845,103.865946
557578,0,5,5,1.366641,103.86601
557579,85,2,87,1.367114,103.866295
557581,13,2,15,1.366907,103.865918
557582,63,6,69,1.366705,103.865969
557583,18,1,19,1.367386,103.865546
557584,1,0,1,1.37023,103.867461
557585,27,26,53,1.366756,103.865926
557586,9,2,11,1.367351,103.865592
557588,1,0,1,1.367268,103.865643
557589,0,4,4,1.370152,103.867454
557590,0,4,4,1.366841,103.865849
557591,1,0,1,1.367258,103.865802
557592,23,0,23,1.367565,103.865369
557593,9,1,10,1.366954,103.865754
557594,1,15,16,1.367657,103.865307
557595,4,2,6,1.367012,103.865707
557596,2,0,2,1.37004,103.867367
557597,1,3,4,1.367485,103.865423
557598,18,0,18,1.367571,103.865524
557599,23,0,23,1.367275,103.865463
557600,0,2,2,1.367612,103.865346
557601,11,1,12,1.367169,103.86557
557602,21,1,22,1.368276,103.864704
557603,1,2,3,1.366531,103.866093
557604,0,5,5,1.368125,103.864848
557606,3,3,6,1.368164,103.864798
557607,3,1,4,1.367071,103.865644
557608,61,0,61,1.368615,103.864476
557609,3,0,3,1.367202,103.865361
557610,1,5,6,1.368217,103.864789
557611,0,1,1,1.366896,103.865802
557612,33,1,34,1.368247,103.864731
557614,6,0,6,1.36819,103.864778
557615,43,0,43,1.367546,103.865239
557616,35,16,51,1.368396,103.864609
557617,34,1,35,1.367691,103.865109
557618,1,0,1,1.367383,103.865341
557619,1,1,2,1.368049,103.865115
557620,9,0,9,1.368464,103.864562
557621,10,1,11,1.367776,103.865056
557622,0,3,3,1.367475,103.865284
557623,1,0,1,1.368488,103.864533
557624,0,2,2,1.367734,103.865086
557625,1,0,1,1.367827,103.865011
557626,219,0,219,1.368642,103.864457
557627,0,1,1,1.367898,103.864829
557629,2,5,7,1.368232,103.864765
557630,8,0,8,1.36909,103.864588
557631,8,1,9,1.368101,103.864782
557632,2,1,3,1.36859,103.864491
557633,2,3,5,1.368048,103.864817
557634,0,1,1,1.367916,103.864939
557635,0,1,1,1.369229,103.864471
557636,4,8,12,1.369164,103.864456
557637,2,5,7,1.368229,103.864667
557638,1,7,8,1.369575,103.86453
557640,0,3,3,1.368859,103.864397
557641,6,0,6,1.36833,103.864586
557642,0,1,1,1.368147,103.864739
557643,26,4,30,1.368385,103.864553
557644,5,0,5,1.368475,103.864457
557645,3,0,3,1.369369,103.864504
557647,36,2,38,1.368683,103.864336
557648,10,0,10,1.368769,103.864328
557649,57,4,61,1.368829,103.864343
557650,5,0,5,1.3689,103.864338
557651,103,3,106,1.368996,103.864354
557652,1,0,1,1.369503,103.864534
557653,46,3,49,1.369154,103.864348
557654,0,24,24,1.369209,103.864382
557655,2,8,10,1.369285,103.864398
557656,3,6,9,1.369481,103.864408
557657,8,3,11,1.36843,103.864507
557658,8,4,12,1.366383,103.866227
557668,3,5,8,1.367841,103.866394
557669,110,49,159,1.368082,103.866285
557670,120,13,133,1.367975,103.866279
557671,1,0,1,1.369054,103.864373
557672,270,0,270,1.368051,103.86622
557673,0,5,5,1.368351,103.866057
557674,20,98,118,1.368,103.86614
557675,7,4,11,1.368411,103.866245
557676,9,4,13,1.368145,103.866109
557677,7,2,9,1.368489,103.865935
557678,0,3,3,1.368518,103.864433
557679,1,3,4,1.367341,103.865424
557680,23,5,28,1.368609,103.865838
557681,6,0,6,1.368215,103.866069
557682,6,0,6,1.368642,103.865812
557683,35,0,35,1.368355,103.865932
557684,0,1,1,1.368248,103.866145
557685,2,0,2,1.368912,103.864412
557686,5,3,8,1.36869,103.865772
557687,52,1,53,1.368421,103.86588
557688,103,3,106,1.368829,103.865645
557689,5,0,5,1.368765,103.865708
557690,1,0,1,1.368924,103.865582
557691,44,2,46,1.36851,103.865819
557692,11,2,13,1.36888,103.865607
557694,4,2,6,1.368999,103.865504
557695,2,1,3,1.368121,103.866158
557696,3,2,5,1.369136,103.865405
557697,6,1,7,1.368742,103.865616
557698,1,2,3,1.368634,103.865706
557699,110,3,113,1.368883,103.865509
557700,19,1,20,1.369398,103.865155
557701,3,0,3,1.369023,103.865483
557704,0,1,1,1.368968,103.865529
557705,2,1,3,1.369181,103.86538
557706,20,0,20,1.369344,103.865191
557707,2,0,2,1.368801,103.865685
557709,0,2,2,1.369003,103.865408
557710,23,1,24,1.369278,103.865253
557711,1,0,1,1.369203,103.865341
557713,19,1,20,1.369629,103.864861
557714,2,0,2,1.369758,103.864744
557716,0,5,5,1.369773,103.864873
557717,25,31,56,1.36987,103.864797
557718,4,19,23,1.36815,103.866222
557729,9,107,116,1.358384,103.868522
557730,4,6,10,1.35837,103.868591
557731,1,0,1,1.369569,103.864794
557732,12,17,29,1.358318,103.868725
557733,2,3,5,1.358292,103.868818
557734,18,2,20,1.358263,103.868892
557735,0,1,1,1.358345,103.868665
557736,55,4,59,1.358197,103.86907
557737,4,0,4,1.368534,103.865906
557739,3,1,4,1.358175,103.869136
557740,5,4,9,1.35811,103.86938
557741,39,0,39,1.358092,103.869442
557742,5,2,7,1.358055,103.869512
557743,6,3,9,1.358035,103.869564
557744,0,1,1,1.358239,103.868995
557745,5,1,6,1.357983,103.869708
557746,79,0,79,1.357962,103.869784
557748,4,3,7,1.357912,103.869924
557749,2,0,2,1.369488,103.865101
557750,3,7,10,1.358556,103.868759
557751,65,5,70,1.358597,103.868688
557752,28,78,106,1.358584,103.868588
557753,35,12,47,1.358715,103.868634
557754,0,7,7,1.358746,103.86864
557755,3,37,40,1.35898,103.868629
557756,2,0,2,1.357907,103.869968
557757,1,1,2,1.358367,103.868775
557758,3,3,6,1.358455,103.868393
557759,0,2,2,1.358399,103.868683
557760,0,1,1,1.358004,103.869644
557761,3,102,105,1.35779,103.868365
557762,4,0,4,1.358117,103.869321
557763,0,1,1,1.358343,103.868916
557764,5,0,5,1.357736,103.868577
557765,0,1,1,1.357762,103.868504
557766,1,1,2,1.35883,103.86881
557767,1,3,4,1.35778,103.868418
557768,5,0,5,1.357667,103.868844
557769,4,3,7,1.357651,103.868902
557770,0,6,6,1.35764,103.868966
557771,4,1,5,1.357624,103.869033
557772,1,0,1,1.357716,103.868644
557773,0,1,1,1.357608,103.86909
557774,1,1,2,1.357701,103.868711
557775,0,3,3,1.368798,103.86557
557776,22,2,24,1.357543,103.86936
557777,45,3,48,1.357527,103.86941
557778,52,9,61,1.357514,103.869465
557779,2,3,5,1.357491,103.869514
557780,1,0,1,1.357579,103.869209
557781,1,10,11,1.357456,103.869638
557782,15,2,17,1.357445,103.869694
557783,8,37,45,1.357428,103.869747
557784,0,14,14,1.357414,103.869809
557785,4,6,10,1.357591,103.869158
557796,5,86,91,1.364527,103.865476
557797,41,219,260,1.364578,103.865365
557798,1,0,1,1.357476,103.869585
557799,38,143,181,1.364661,103.865221
557800,24,0,24,1.364694,103.865163
557801,9,23,32,1.364777,103.865032
557803,2,32,34,1.364827,103.864934
557804,1,0,1,1.364641,103.86527
557805,59,13,72,1.364833,103.864873
557806,2,9,11,1.364734,103.865072
557807,5,0,5,1.364883,103.864795
557808,7,5,12,1.364993,103.864631
557809,1,3,4,1.357683,103.868782
557810,43,0,43,1.365029,103.864566
557811,0,1,1,1.364947,103.864728
557813,8,0,8,1.365088,103.864491
557814,2,0,2,1.357565,103.869264
557815,2,1,3,1.357553,103.869318
557816,0,5,5,1.365347,103.864278
557817,7,0,7,1.365114,103.864453
557818,2,3,5,1.365381,103.864215
557820,37,0,37,1.365553,103.863965
557821,8,0,8,1.365191,103.864331
557822,84,0,84,1.365426,103.864144
557823,6,4,10,1.365231,103.864156
557824,1,0,1,1.365045,103.864543
557825,14,14,28,1.365313,103.864071
557826,12,1,13,1.365746,103.863786
557827,1,0,1,1.365468,103.864078
557828,37,3,40,1.365779,103.863707
557829,11,3,14,1.365562,103.863726
557830,5,0,5,1.365855,103.863643
557831,1,0,1,1.365826,103.863741
557832,4,0,4,1.365013,103.864593
557833,19,12,31,1.365598,103.863914
557834,25,6,31,1.365692,103.863794
557835,3,4,7,1.365778,103.863593
557837,3,2,5,1.36583,103.863547
557838,2,0,2,1.36531,103.864344
557839,0,4,4,1.366114,103.863466
557841,12,1,13,1.366005,103.863381
557842,1,2,3,1.365215,103.864226
557843,10,4,14,1.366084,103.863299
557844,6,0,6,1.366473,103.863427
557845,11,6,17,1.366151,103.863233
557846,17,0,17,1.36644,103.863211
557847,7,0,7,1.366203,103.8632
557848,25,5,30,1.366471,103.863148
557849,2,5,7,1.366375,103.86305
557850,26,0,26,1.366611,103.863059
557851,4,27,31,1.366419,103.863013
557852,4,0,4,1.365849,103.863526
557853,9,0,9,1.366466,103.862976
557854,54,8,62,1.366787,103.863127
557855,1,0,1,1.365503,103.864028
557856,5,2,7,1.366911,103.863068
557857,2,5,7,1.36662,103.862868
557858,7,0,7,1.366787,103.862851
557859,2,3,5,1.366624,103.86266
557860,153,34,187,1.367037,103.862929
557861,9,2,11,1.366674,103.862625
557862,105,6,111,1.366873,103.862812
557863,62,10,72,1.366732,103.862737
557864,1,0,1,1.36652,103.862922
557865,23,20,43,1.36681,103.862511
557866,10,0,10,1.366921,103.862742
557867,11,11,22,1.366954,103.862581
557868,1,8,9,1.367341,103.862697
557869,24,48,72,1.366829,103.862678
557870,65,37,102,1.365234,103.86454
557871,6,47,53,1.365249,103.864461
557872,15,4,19,1.365278,103.864403
557880,41,0,41,1.361688,103.864649
557882,3,3,6,1.361656,103.864543
557883,163,1,164,1.361613,103.864615
557884,0,2,2,1.366028,103.863516
557885,24,8,32,1.361777,103.864518
557886,12,0,12,1.361774,103.864352
557887,0,7,7,1.361897,103.864354
557888,2,4,6,1.361828,103.864299
557890,1,0,1,1.367009,103.862659
557891,15,0,15,1.36201,103.864201
557893,51,0,51,1.362079,103.864118
557894,13,1,14,1.361993,103.864076
557895,140,5,145,1.361952,103.864276
557897,12,10,22,1.362173,103.863953
557898,8,0,8,1.362085,103.863965
557899,17,0,17,1.362257,103.863833
557900,1,0,1,1.361883,103.864223
557901,57,2,59,1.362122,103.864052
557902,18,18,36,1.3622,103.863829
557904,11,0,11,1.362227,103.863786
557905,3,2,5,1.362584,103.863748
557907,15,1,16,1.36251,103.863488
557908,2,2,4,1.36655,103.86311
557909,21,0,21,1.362555,103.863397
557910,3,0,3,1.366306,103.863282
557911,34,0,34,1.362381,103.863555
557912,5,0,5,1.362457,103.863442
557913,86,0,86,1.362709,103.863237
557914,15,20,35,1.362516,103.86334
557916,29,0,29,1.362588,103.863259
557917,96,8,104,1.362842,103.863116
557918,2,4,6,1.362667,103.863164
557919,1,0,1,1.362134,103.86391
557920,2,0,2,1.361671,103.864214
557921,0,1,1,1.362925,103.863043
557922,37,9,46,1.363015,103.862985
557923,0,1,1,1.363238,103.863092
557924,3,1,4,1.36233,103.863632
557925,25,2,27,1.363152,103.862846
557927,77,0,77,1.363223,103.862795
557928,1,2,3,1.362165,103.863853
557929,5,0,5,1.363492,103.86284
557930,16,0,16,1.363375,103.862687
557931,4,16,20,1.363308,103.862738
557932,24,1,25,1.363141,103.862789
557933,4,0,4,1.362926,103.86295
557934,56,0,56,1.363195,103.862725
557935,11,1,12,1.363531,103.862552
557936,20,0,20,1.36327,103.862637
557937,51,0,51,1.36383,103.862313
557938,34,1,35,1.363355,103.862596
557939,1,0,1,1.363088,103.862911
557940,2,0,2,1.362749,103.863093
557941,43,2,45,1.363749,103.862369
557942,6,3,9,1.363421,103.862555
557943,1,0,1,1.363667,103.862443
557944,11,0,11,1.363586,103.862522
557945,1,5,6,1.363908,103.862243
557946,4,2,6,1.363724,103.862271
557947,10,0,10,1.363975,103.862173
557948,27,1,28,1.363807,103.862216
557949,2,2,4,1.363449,103.862616
557950,273,2,275,1.363856,103.862163
557951,40,0,40,1.364119,103.862058
557952,6,2,8,1.363937,103.862101
557953,1,6,7,1.364197,103.861996
557955,2,0,2,1.363481,103.862482
557956,25,3,28,1.364089,103.861979
557958,17,9,26,1.364103,103.861795
557959,20,1,21,1.3644,103.861815
557960,9,0,9,1.364238,103.861845
557961,1,0,1,1.363568,103.862421
557962,0,3,3,1.363056,103.862842
557963,4,0,4,1.364048,103.862099
557964,7,2,9,1.364305,103.861786
557966,0,1,1,1.364703,103.861852
557968,7,8,15,1.364362,103.861729
557980,14,2,16,1.357637,103.864861
557981,12,2,14,1.357718,103.864884
557982,1,6,7,1.357742,103.864801
557983,6,6,12,1.357653,103.864722
557984,1,2,3,1.364471,103.861753
557985,44,0,44,1.357671,103.864638
557986,3,0,3,1.357746,103.864682
557987,1,0,1,1.364444,103.861661
557988,5,2,7,1.357299,103.86434
557989,40,5,45,1.357346,103.864307
557990,7,3,10,1.357395,103.864311
557991,10,1,11,1.357464,103.864301
557992,3,0,3,1.357758,103.864519
557993,7,5,12,1.35773,103.864749
558003,9,4,13,1.365803,103.865874
558004,29,8,37,1.365721,103.865876
558005,12,2,14,1.365672,103.8658
558006,2,0,2,1.364269,103.861936
558008,1,15,16,1.365887,103.865886
558009,0,2,2,1.366009,103.865894
558011,5,0,5,1.365934,103.86584
558013,0,1,1,1.357655,103.864576
558014,6,0,6,1.366264,103.86594
558015,18,2,20,1.36622,103.865773
558016,1,1,2,1.36586,103.865825
558018,15,0,15,1.366171,103.86574
558019,0,1,1,1.36601,103.865836
558020,10,2,12,1.366242,103.865672
558021,1,0,1,1.366085,103.865867
558023,0,1,1,1.366445,103.86558
558025,4,3,7,1.366547,103.86539
558026,1,0,1,1.366524,103.865507
558027,1,5,6,1.366579,103.865465
558028,1,1,2,1.366096,103.865795
558029,5,0,5,1.36665,103.865414
558030,1,0,1,1.366433,103.865498
558031,26,2,28,1.366765,103.865296
558032,1,0,1,1.36649,103.865446
558033,1,0,1,1.36661,103.865348
558034,0,1,1,1.366865,103.86543
558035,21,1,22,1.366865,103.865212
558036,1,1,2,1.366917,103.865167
558037,3,0,3,1.357753,103.864612
558039,2,1,3,1.36681,103.865264
558040,47,2,49,1.366835,103.865147
558041,0,3,3,1.366968,103.865124
558042,6,1,7,1.366893,103.865105
558043,0,1,1,1.366658,103.865287
558044,21,4,25,1.366964,103.865047
558045,2,2,4,1.364546,103.861696
558046,7,3,10,1.367033,103.864992
558047,11,2,13,1.367152,103.864969
558048,8,0,8,1.36709,103.864948
558049,53,1,54,1.367232,103.864903
558050,22,0,22,1.367147,103.86489
558052,0,1,1,1.367058,103.865051
558054,8,0,8,1.36726,103.864797
558055,11,0,11,1.367519,103.86467
558056,184,0,184,1.367719,103.864485
558057,52,3,55,1.367568,103.864623
558058,0,4,4,1.367103,103.865013
558059,75,2,77,1.367425,103.864762
558060,7,3,10,1.367446,103.864632
558061,38,4,42,1.367631,103.864587
558062,1,0,1,1.367201,103.864847
558063,0,3,3,1.367025,103.865078
558064,8,0,8,1.367562,103.864531
558065,6,2,8,1.367812,103.864609
558066,5,0,5,1.36763,103.864482
558067,1,0,1,1.367505,103.864586
558068,8,0,8,1.367704,103.864415
558070,46,8,54,1.367767,103.864366
558071,5,2,7,1.367927,103.864316
558072,12,0,12,1.368138,103.864031
558073,15,1,16,1.368004,103.86428
558074,2,3,5,1.368227,103.863961
558075,12,4,16,1.36805,103.864218
558076,1,1,2,1.366715,103.865254
558077,1,5,6,1.368115,103.864187
558078,11,1,12,1.368356,103.863864
558079,5,0,5,1.368214,103.864112
558080,1,0,1,1.367786,103.864426
558081,3,0,3,1.367661,103.864535
558082,8,2,10,1.368484,103.863778
558083,5,2,7,1.368262,103.864054
558084,7,1,8,1.368573,103.863759
558085,11,1,12,1.368462,103.863887
558086,4,0,4,1.367378,103.864683
558087,18,0,18,1.368376,103.864017
558088,59,0,59,1.368705,103.863769
558089,3,1,4,1.368661,103.863763
558090,1,0,1,1.368419,103.863822
558091,3,4,7,1.368598,103.863877
558092,38,1,39,1.368838,103.863793
558093,3,1,4,1.368394,103.863962
558094,1,2,3,1.36832,103.864028
558095,10,0,10,1.368672,103.863859
558096,3,1,4,1.368541,103.86385
558097,4,1,5,1.368791,103.863874
558098,1,0,1,1.368768,103.863785
558099,1,0,1,1.369044,103.86382
558100,0,1,1,1.368594,103.86388
558101,7,4,11,1.368834,103.863901
558102,5,0,5,1.369216,103.863838
558103,54,0,54,1.36896,103.863897
558104,6,6,12,1.36912,103.863923
558105,30,4,34,1.369026,103.863923
558106,92,6,98,1.3692,103.863916
558107,42,0,42,1.369452,103.863954
558110,5,0,5,1.369294,103.863848
558111,2,15,17,1.369365,103.863865
558120,7,23,30,1.369696,103.867485
558121,92,17,109,1.369641,103.867502
558122,2,0,2,1.368305,103.863904
558123,82,2,84,1.369641,103.867604
558124,18,6,24,1.369694,103.867713
558125,24,2,26,1.36963,103.867736
558126,7,22,29,1.369695,103.867759
558127,0,21,21,1.369636,103.867834
558128,8,1,9,1.369695,103.867546
558139,26,12,38,1.360006,103.860603
558140,0,1,1,1.369123,103.863831
558142,9,2,11,1.360118,103.86074
558143,0,2,2,1.36969,103.867612
558144,63,11,74,1.360307,103.861133
558145,104,21,125,1.360391,103.861047
558146,10,2,12,1.360372,103.861195
558148,7,1,8,1.36046,103.861141
558149,0,4,4,1.36899,103.863821
558161,3,3,6,1.359278,103.863474
558162,10,4,14,1.359207,103.863623
558163,2,1,3,1.368909,103.8638
558164,75,7,82,1.359093,103.863783
558165,1,1,2,1.360357,103.861013
558166,0,4,4,1.360494,103.861184
558167,5,20,25,1.358845,103.864146
558168,7,15,22,1.358856,103.864101
558170,11,1,12,1.358479,103.864319
558171,6,0,6,1.358687,103.864218
558172,43,8,51,1.359007,103.864058
558173,18,2,20,1.358876,103.86435
558174,7,5,12,1.359002,103.864413
558175,2,0,2,1.3589,103.864052
558176,7,32,39,1.358745,103.864491
558186,17,1,18,1.359415,103.865391
558187,34,3,37,1.359632,103.865445
558188,7,6,13,1.359531,103.865428
558190,3,0,3,1.358947,103.863967
558192,1,0,1,1.360041,103.860654
558194,8,0,8,1.359257,103.86538
558195,33,0,33,1.359062,103.865284
558196,4,0,4,1.358995,103.863929
558197,0,2,2,1.358564,103.864128
558198,2,0,2,1.35898,103.865342
558200,0,1,1,1.359167,103.865393
558201,106,0,106,1.359466,103.865426
558202,4,0,4,1.358859,103.865263
558203,6,2,8,1.358809,103.865342
558204,0,1,1,1.358764,103.865244
558205,0,4,4,1.35856,103.86523
558206,5,1,6,1.358492,103.86521
558207,1,0,1,1.358667,103.865247
558208,32,1,33,1.358079,103.865154
558209,34,2,36,1.358565,103.865302
558210,22,1,23,1.357961,103.865128
558212,30,0,30,1.357839,103.865135
558214,2,3,5,1.35777,103.865113
558215,32,0,32,1.358496,103.865285
558216,1,0,1,1.35889,103.865332
558217,2,3,5,1.357925,103.865227
558218,0,2,2,1.359376,103.865302
558220,11,13,24,1.357021,103.865023
558221,26,1,27,1.357787,103.865208
558222,3,0,3,1.359339,103.865394
558223,11,0,11,1.357737,103.865201
558224,0,2,2,1.357246,103.865056
558225,17,3,20,1.357644,103.865189
558226,5,0,5,1.357578,103.865182
558228,0,2,2,1.357691,103.865188
558229,1,1,2,1.357717,103.865106
558230,0,3,3,1.35692,103.864982
558231,24,3,27,1.357222,103.865137
558232,6,14,20,1.357142,103.865119
558233,43,0,43,1.357055,103.865113
558234,0,1,1,1.357394,103.865077
558235,9,0,9,1.35714,103.865036
558236,2,0,2,1.357352,103.865157
558237,8,2,10,1.357733,103.86504
558238,2,1,3,1.357288,103.865148
558239,13,1,14,1.356791,103.865081
558240,42,3,45,1.35838,103.86521
558241,5,8,13,1.358492,103.86521
558246,51,3,54,1.359427,103.865321
558247,1,6,7,1.359743,103.865289
558248,403,0,403,1.359378,103.865104
558249,8,1,9,1.359797,103.865188
558250,28,0,28,1.359564,103.865038
558251,47,2,49,1.360183,103.865188
558252,11,3,14,1.359562,103.864874
558253,21,0,21,1.360002,103.865163
558254,10,0,10,1.359636,103.864914
558255,2,5,7,1.359941,103.865038
558256,12,1,13,1.359631,103.864827
558257,88,4,92,1.360152,103.864914
558258,5,2,7,1.359725,103.864855
558260,29,2,31,1.359936,103.864717
558261,4,4,8,1.360439,103.865088
558262,0,2,2,1.357886,103.865122
558263,14,7,21,1.360492,103.865153
558264,5,2,7,1.359806,103.86483
558265,6,19,25,1.360507,103.865271
558266,1,0,1,1.356972,103.865099
558267,2,5,7,1.360158,103.865335
558268,1,5,6,1.360208,103.865033
558269,18,12,30,1.360049,103.865143
558270,68,1,69,1.360138,103.864477
558271,9,21,30,1.360262,103.865181
558272,5,0,5,1.360196,103.864454
558273,1,2,3,1.356901,103.86509
558274,4,6,10,1.360278,103.864597
558275,7,3,10,1.360422,103.864611
558276,5,0,5,1.360392,103.865144
558277,4,1,5,1.360599,103.864839
558278,15,2,17,1.3605,103.864754
558279,14,0,14,1.360434,103.865168
558280,34,5,39,1.360702,103.86495
558282,31,0,31,1.36114,103.86508
558283,48,0,48,1.361113,103.865176
558284,20,0,20,1.360649,103.865165
558285,3,2,5,1.361144,103.865384
558286,12,0,12,1.360075,103.864743
558287,22,3,25,1.35943,103.865188
558288,87,0,87,1.299509,103.837
558297,0,1,1,1.3599,103.864626
558298,4,0,4,1.359035,103.865373
558299,8,0,8,1.359234,103.867014
558300,35,1,36,1.359446,103.866951
558301,83,1,84,1.359161,103.867
558302,3,3,6,1.359373,103.86695
558303,1,0,1,1.35932,103.867023
558305,1,0,1,1.359113,103.866986
558306,21,0,21,1.359258,103.866916
558307,1,3,4,1.359522,103.866965
558308,0,2,2,1.359882,103.864764
558309,30,13,43,1.359051,103.866911
558310,0,1,1,1.35906,103.866988
558311,0,5,5,1.358982,103.866893
558313,1,1,2,1.359126,103.866909
558314,22,2,24,1.358699,103.866947
558315,0,1,1,1.358826,103.866965
558316,24,0,24,1.358627,103.866966
558317,9,0,9,1.358755,103.866866
558318,2,0,2,1.358916,103.866886
558319,5,0,5,1.358708,103.866856
558320,20,6,26,1.358519,103.866939
558321,2,1,3,1.360964,103.865664
558322,3,1,4,1.358978,103.866984
558323,2,4,6,1.358564,103.866868
558324,5,0,5,1.358391,103.86692
558325,17,0,17,1.358496,103.866836
558326,14,11,25,1.358345,103.866916
558327,5,0,5,1.358415,103.866819
558328,4,2,6,1.358275,103.866913
558330,11,2,13,1.359546,103.866973
558331,5,1,6,1.359581,103.866958
558341,0,2,2,1.358581,103.866937
558342,2,0,2,1.359267,103.867543
558343,0,9,9,1.359056,103.867513
558344,17,0,17,1.35921,103.867462
558345,5,0,5,1.358906,103.867502
558346,0,1,1,1.358828,103.866874
558348,1,0,1,1.359145,103.867459
558349,0,4,4,1.358461,103.866927
558350,1,2,3,1.358646,103.866847
558351,0,3,3,1.358994,103.867443
558354,3,1,4,1.35878,103.86749
558355,3,1,4,1.358515,103.867479
558356,11,4,15,1.358438,103.867469
558357,0,1,1,1.359061,103.867448
558358,1,2,3,1.358699,103.867488
558359,2,0,2,1.359202,103.867534
558360,1,0,1,1.358723,103.867411
558361,0,1,1,1.358255,103.867441
558362,1,3,4,1.358792,103.867419
558364,45,3,48,1.358125,103.867441
558365,18,6,24,1.358476,103.867387
558366,39,3,42,1.358076,103.86742
558367,2,0,2,1.358668,103.867408
558368,2,2,4,1.358175,103.867435
558369,0,1,1,1.35861,103.867399
558370,3,1,4,1.358041,103.867415
558372,3,2,5,1.357917,103.867395
558373,0,3,3,1.35837,103.867453
558374,1,1,2,1.3584,103.867384
558375,0,3,3,1.358214,103.867349
558376,7,6,13,1.357999,103.867523
558378,0,3,3,1.357393,103.867246
558379,1,1,2,1.358057,103.867538
558380,0,2,2,1.357829,103.867275
558381,2,0,2,1.35781,103.867527
558382,0,6,6,1.35775,103.867494
558383,5,0,5,1.357271,103.867193
558384,21,1,22,1.35723,103.867168
558386,0,1,1,1.358353,103.867346
558387,5,3,8,1.357101,103.867065
558388,1,0,1,1.357143,103.867113
558389,2,0,2,1.357319,103.86722
558390,14,0,14,1.356992,103.866997
558391,6,0,6,1.356961,103.866956
558392,7,10,17,1.356918,103.866916
558393,1,0,1,1.357058,103.867034
558394,3,1,4,1.357991,103.867408
558395,1,4,5,1.35676,103.866751
558396,3,0,3,1.357907,103.867513
558407,0,10,10,1.356793,103.867594
558408,26,2,28,1.356917,103.867578
558409,0,4,4,1.356815,103.866813
558410,0,8,8,1.356863,103.867549
558411,13,16,29,1.356666,103.867529
558412,1,0,1,1.356871,103.866869
558413,6,7,13,1.356626,103.867505
558414,0,7,7,1.356709,103.867422
558415,10,2,12,1.356579,103.867462
558416,1,1,2,1.357023,103.867015
558417,0,3,3,1.359287,103.867541
558418,1,6,7,1.356558,103.867339
558419,2,3,5,1.356473,103.867383
558420,2,4,6,1.35649,103.867301
558421,6,7,13,1.356435,103.867361
558422,7,14,21,1.356423,103.867266
558423,28,9,37,1.356346,103.86729
558424,11,6,17,1.356359,103.867223
558425,6,3,9,1.356303,103.86726
558426,0,2,2,1.356643,103.867385
558427,6,7,13,1.356232,103.867219
558429,6,11,17,1.356196,103.867193
558430,0,2,2,1.356322,103.8672
558431,1,0,1,1.356786,103.867479
558432,9,0,9,1.356194,103.867119
558433,7,22,29,1.35609,103.86713
558434,9,0,9,1.356156,103.867098
558435,2,3,5,1.356055,103.867104
558437,5,20,25,1.356027,103.867077
558438,0,2,2,1.356238,103.867156
558439,9,3,12,1.35553,103.866764
558441,148,0,148,1.355773,103.866862
558442,5,0,5,1.356023,103.867023
558443,1,84,85,1.355888,103.86698
558444,11,0,11,1.355975,103.866979
558445,8,8,16,1.355829,103.866952
558446,7,4,11,1.355892,103.866915
558447,8,51,59,1.355776,103.866917
558449,9,10,19,1.355734,103.866887
558450,4,0,4,1.356729,103.867573
558451,0,39,39,1.355672,103.866853
558452,9,0,9,1.355741,103.866821
558453,0,2,2,1.356085,103.867053
558454,2,1,3,1.356541,103.867439
558455,8,101,109,1.355581,103.866796
558456,1,0,1,1.356134,103.86716
558457,59,12,71,1.355586,103.866714
558469,2,49,51,1.362485,103.867596
558470,2,32,34,1.362863,103.867533
558471,1,1,2,1.355633,103.86683
558473,2,0,2,1.36275,103.867687
558474,0,8,8,1.362851,103.867459
558475,0,2,2,1.362776,103.866932
558476,0,11,11,1.362867,103.867328
558477,3,0,3,1.355699,103.866787
558478,22,1,23,1.362847,103.867173
558479,6,3,9,1.362846,103.867108
558480,0,9,9,1.362863,103.867018
558481,3,0,3,1.36283,103.867267
558483,0,13,13,1.362696,103.867683
558484,0,3,3,1.362834,103.867071
558486,4,70,74,1.362773,103.867447
558487,8,0,8,1.362781,103.867381
558488,2,39,41,1.362814,103.867316
558489,59,4,63,1.362806,103.867206
558490,20,32,52,1.362798,103.867145
558491,45,3,48,1.36281,103.86701
558492,1,3,4,1.35584,103.866889
558493,78,3,81,1.362768,103.867092
558494,3,3,6,1.362793,103.86703
558495,48,0,48,1.362257,103.867165
558496,4,2,6,1.362433,103.866677
558497,4,8,12,1.362712,103.867537
558498,9,0,9,1.362353,103.866657
558499,6,0,6,1.362725,103.867402
558500,12,0,12,1.362286,103.86669
558501,0,3,3,1.362794,103.867561
558502,2,0,2,1.362843,103.86741
558503,2,0,2,1.362265,103.8667
558504,3,0,3,1.362757,103.867263
558505,5,2,7,1.362219,103.867429
558506,19,0,19,1.362147,103.866698
558507,2,0,2,1.362733,103.867161
558508,13,0,13,1.362231,103.867546
558509,4,121,125,1.362252,103.86764
558510,10,0,10,1.362063,103.866933
558511,0,1,1,1.355632,103.866758
558512,1,1,2,1.362232,103.867487
558514,0,1,1,1.362061,103.866994
558515,2,0,2,1.362057,103.867116
558516,4,0,4,1.362749,103.866973
558517,1,4,5,1.362035,103.867727
558518,20,20,40,1.362031,103.867849
558521,22,9,31,1.363414,103.869649
558522,11,3,14,1.363373,103.869627
558523,2,245,247,1.363456,103.86965
558524,5,0,5,1.363289,103.869584
558525,28,5,33,1.363359,103.8696
558526,8,0,8,1.363206,103.869541
558527,11,11,22,1.363119,103.869466
558528,7,0,7,1.363119,103.869486
558529,11,19,30,1.363062,103.869378
558530,12,0,12,1.36308,103.869434
558531,0,1,1,1.362048,103.86736
558532,3,0,3,1.362175,103.866707
558533,1,3,4,1.36204,103.867605
558534,0,2,2,1.362044,103.867483
558535,2,0,2,1.362894,103.869138
558538,3,0,3,1.363023,103.86935
558540,8,7,15,1.36272,103.86891
558541,1,0,1,1.362929,103.869183
558542,17,2,19,1.36265,103.868819
558543,4,2,6,1.3627,103.86891
558544,2,0,2,1.362919,103.869193
558545,2,0,2,1.362581,103.868728
558546,0,5,5,1.362511,103.868637
558547,25,2,27,1.362561,103.868728
558549,109,0,109,1.362491,103.868637
558550,1,5,6,1.362372,103.868455
558551,65,0,65,1.362421,103.868546
558552,16,36,52,1.362302,103.868364
558553,84,0,84,1.362352,103.868455
558554,55,1,56,1.36294,103.868511
558555,0,1,1,1.36277,103.869001
558556,19,0,19,1.363035,103.868285
558557,15,0,15,1.362282,103.868364
558558,2,5,7,1.36333,103.868921
558560,1,0,1,1.362292,103.868374
558561,23,9,32,1.363444,103.86885
558563,0,14,14,1.363447,103.868753
558564,4,7,11,1.363418,103.868604
558565,0,8,8,1.363425,103.868515
558566,33,4,37,1.363475,103.868327
558567,0,1,1,1.362099,103.868051
558568,20,8,28,1.363331,103.868136
558569,74,13,87,1.363242,103.868135
558570,0,11,11,1.363098,103.868106
558571,9,7,16,1.36301,103.868103
558572,7,64,71,1.36289,103.868114
558573,12,34,46,1.362821,103.868071
558585,18,0,18,1.359808,103.865995
558587,2,0,2,1.36263,103.868819
558588,10,0,10,1.359886,103.865908
558589,5,3,8,1.359629,103.865968
558591,2,0,2,1.35971,103.865971
558592,14,12,26,1.35973,103.865905
558593,2,0,2,1.359546,103.865966
558594,0,1,1,1.36344,103.868267
558596,28,1,29,1.359557,103.86589
558597,0,6,6,1.359476,103.865881
558598,0,5,5,1.359334,103.86593
558599,66,1,67,1.359396,103.865867
558601,5,1,6,1.359304,103.865862
558602,1,7,8,1.359172,103.865898
558603,1,0,1,1.35963,103.8659
558604,37,0,37,1.359097,103.865886
558605,33,0,33,1.359175,103.865829
558608,9,0,9,1.358931,103.865892
558609,1,0,1,1.359238,103.86584
558610,20,4,24,1.358862,103.86588
558611,22,0,22,1.358913,103.865804
558612,3,0,3,1.36279,103.869001
558613,3,0,3,1.358796,103.86587
558614,1,0,1,1.358997,103.865818
558617,0,2,2,1.359477,103.86597
558621,0,1,1,1.358704,103.865859
558622,10,0,10,1.3584,103.865809
558623,4,0,4,1.362966,103.869267
558624,126,4,130,1.357969,103.865773
558625,15,0,15,1.358207,103.865337
558626,0,4,4,1.358456,103.865739
558627,1,0,1,1.358526,103.86575
558628,2,2,4,1.357869,103.865777
558629,6,1,7,1.357798,103.865643
558630,11,0,11,1.357574,103.865747
558631,13,0,13,1.357742,103.865646
558632,2,2,4,1.357735,103.865754
558635,3,0,3,1.358825,103.86579
558636,5,19,24,1.357219,103.865701
558637,0,1,1,1.35787,103.865653
558638,40,0,40,1.357306,103.865713
558639,3,12,15,1.35744,103.865619
558640,1,3,4,1.357658,103.865738
558641,17,67,84,1.357369,103.865613
558644,2,8,10,1.357123,103.865687
558645,32,3,35,1.357249,103.86559
558646,83,20,103,1.357178,103.865694
558647,0,22,22,1.357168,103.865582
558648,2,3,5,1.357019,103.865687
558649,4,0,4,1.357441,103.865722
558652,3,0,3,1.357581,103.865634
558653,1,1,2,1.358696,103.865773
558654,40,6,46,1.356824,103.865639
558655,1,3,4,1.357096,103.865565
558656,15,3,18,1.356739,103.865641
558657,7,1,8,1.35677,103.865522
558658,30,3,33,1.356684,103.865661
558659,3,3,6,1.35668,103.865504
558660,7,2,9,1.356639,103.865635
558661,14,6,20,1.356572,103.865489
558662,0,1,1,1.35752,103.865616
558663,21,5,26,1.356501,103.865606
558675,12,2,14,1.363388,103.872065
558676,20,131,151,1.363334,103.872114
558677,10,12,22,1.363478,103.872097
558678,24,5,29,1.363403,103.872155
558679,20,0,20,1.363555,103.872137
558680,2,1,3,1.35712,103.865735
558681,2,0,2,1.356928,103.865539
558683,3,1,4,1.356837,103.865536
558684,1,0,1,1.356571,103.865612
558685,0,4,4,1.363676,103.872201
558686,0,1,1,1.363558,103.872224
558687,8,1,9,1.363811,103.872271
558688,4,5,9,1.363873,103.872385
558689,11,0,11,1.363843,103.8723
558690,21,0,21,1.363723,103.872321
558692,5,53,58,1.363785,103.872359
558694,3,40,43,1.364235,103.872636
558695,0,7,7,1.36384,103.872357
558696,10,89,99,1.363354,103.872038
558697,7,0,7,1.364206,103.872493
558698,3,0,3,1.363456,103.872187
558699,7,600,607,1.364028,103.872389
558700,12,188,200,1.364067,103.872411
558702,4,0,4,1.363737,103.872224
558703,0,13,13,1.36417,103.872466
558707,20,623,643,1.36318,103.865921
558708,3,0,3,1.363986,103.872369
558709,12,9,21,1.363037,103.86609
558710,14,0,14,1.362958,103.865783
558711,1,15,16,1.362884,103.865712
558712,0,1,1,1.363631,103.872277
558713,2,1,3,1.363101,103.86587
558714,0,4,4,1.364143,103.872447
558715,0,1,1,1.362836,103.865681
558716,5,35,40,1.361984,103.864979
558717,16,20,36,1.362401,103.86538
558718,0,2,2,1.363617,103.87217
558719,1,17,18,1.36185,103.865024
558720,6,1,7,1.361489,103.864643
558721,87,4,91,1.361782,103.864963
558722,1,29,30,1.361662,103.864765
558723,2,0,2,1.361879,103.864917
558724,2,6,8,1.361236,103.86447
558725,0,4,4,1.362716,103.86562
558726,50,15,65,1.36134,103.864512
558727,38,0,38,1.361195,103.86452
558728,1,0,1,1.362574,103.865503
558730,13,10,23,1.361236,103.864323
558731,3,0,3,1.362763,103.865655
558732,0,9,9,1.361064,103.864201
558733,27,1,28,1.361378,103.864669
558734,6,4,10,1.360872,103.864222
558736,15,7,22,1.360788,103.864153
558737,4,2,6,1.360979,103.864406
558738,0,13,13,1.360711,103.864104
558739,16,0,16,1.361113,103.864458
558740,2,6,8,1.360558,103.864076
558741,0,1,1,1.360978,103.864293
558742,89,1,90,1.360541,103.863969
558744,97,2,99,1.360362,103.863852
558745,3,1,4,1.361597,103.864836
558746,15,4,19,1.360441,103.86391
558747,1,0,1,1.360904,103.864331
558748,4,9,13,1.360097,103.863673
558749,17,1,18,1.360516,103.864354
558750,1,3,4,1.360824,103.864283
558751,12,5,17,1.360519,103.864025
558752,14,7,21,1.360042,103.86363
558753,8,0,8,1.360469,103.864026
558754,51,33,84,1.359883,103.863529
558755,28,20,48,1.359329,103.863196
558756,9,6,15,1.359816,103.863475
558757,37,30,67,1.359187,103.863122
558758,244,38,282,1.358203,103.863703
558760,3,5,8,1.359573,103.863311
558761,0,26,26,1.358675,103.862809
558762,0,4,4,1.360118,103.863526
558763,0,8,8,1.358896,103.862914
558764,1,7,8,1.359676,103.863378
558765,14,0,14,1.35817,103.863012
558766,62,24,86,1.359033,103.862888
558767,38,37,75,1.358728,103.862803
558768,12,22,34,1.359083,103.862929
558769,63,65,128,1.358676,103.862762
558770,14,4,18,1.35913,103.862993
558771,1,33,34,1.358614,103.862705
558772,5,7,12,1.358988,103.86286
558773,1,3,4,1.359387,103.863172
558774,222,10,232,1.358674,103.862672
558775,9,9,18,1.358564,103.862567
558776,7,7,14,1.358612,103.862626
558777,3,5,8,1.361932,103.865055
558788,3,8,11,1.360166,103.863843
558789,0,15,15,1.360184,103.86408
558790,1,0,1,1.360602,103.864124
558791,32,3,35,1.360053,103.863982
558793,1,0,1,1.360109,103.863937
558794,2,0,2,1.361512,103.864779
558795,0,3,3,1.361266,103.86463
558798,21,1,22,1.359631,103.86429
558799,1,0,1,1.359944,103.864058
558800,8,1,9,1.359497,103.864378
558801,0,1,1,1.359567,103.864328
558802,8,0,8,1.359451,103.8644
558803,7,3,10,1.359402,103.864454
558804,5,0,5,1.359348,103.86449
558805,25,0,25,1.35929,103.864518
558806,59,0,59,1.358625,103.864853
558807,25,5,30,1.359202,103.864586
558808,1,2,3,1.359797,103.864179
558809,51,1,52,1.359135,103.864629
558810,71,0,71,1.358354,103.864691
558811,15,2,17,1.35906,103.864672
558812,8,2,10,1.358425,103.864883
558813,23,0,23,1.358999,103.864726
558814,2,0,2,1.359851,103.864131
558816,8,3,11,1.358373,103.864834
558817,4,1,5,1.358883,103.86481
558818,1,25,26,1.358173,103.86517
558819,10,14,24,1.358263,103.865339
558820,0,5,5,1.358193,103.865398
558821,0,1,1,1.358687,103.864814
558822,16,0,16,1.358173,103.865501
558823,1,4,5,1.358228,103.865546
558824,54,16,70,1.358161,103.865556
558825,5,8,13,1.358217,103.865615
558826,0,6,6,1.358112,103.86586
558827,13,7,20,1.358203,103.865862
558828,8,5,13,1.358098,103.86597
558829,4,1,5,1.358189,103.865958
558830,1,0,1,1.358241,103.865431
558831,0,4,4,1.358952,103.862566
558832,55,11,66,1.358077,103.866168
558833,0,17,17,1.358167,103.866166
558834,11,11,22,1.35805,103.866366
558835,15,24,39,1.358156,103.866349
558836,0,3,3,1.358423,103.864733
558837,201,0,201,1.358141,103.86645
558838,2,10,12,1.358033,103.866522
558839,1,1,2,1.35831,103.864782
558841,4,1,5,1.358118,103.866646
558842,11,17,28,1.358013,103.866705
558843,4,0,4,1.358173,103.866054
558844,3,0,3,1.358043,103.866447
558846,0,1,1,1.358086,103.866067
558847,5,9,14,1.357663,103.867238
558848,4,0,4,1.358075,103.866926
558849,5,0,5,1.3579,103.867302
558850,4,0,4,1.358052,103.867105
558851,0,1,1,1.358061,103.867014
558853,9,0,9,1.3576,103.867258
558854,0,4,4,1.358044,103.867192
558855,15,0,15,1.357697,103.867251
558856,0,2,2,1.358138,103.866529
558857,6,14,20,1.358331,103.864978
558858,4,0,4,1.358017,103.86731
558868,1,2,3,1.357993,103.866849
558869,12,1,13,1.359607,103.866441
558871,3,1,4,1.299509,103.837
558872,2,1,3,1.359683,103.866526
558874,5,0,5,1.359462,103.866509
558875,0,1,1,1.357548,103.867245
558876,45,2,47,1.359397,103.866504
558877,18,3,21,1.359358,103.866364
558878,7,4,11,1.359328,103.866492
558879,8,0,8,1.359381,103.86642
558880,0,6,6,1.359303,103.866385
558881,1,2,3,1.359521,103.866525
558882,6,0,6,1.359536,103.866422
558883,108,5,113,1.359205,103.866468
558884,30,12,42,1.35914,103.866375
558885,7,12,19,1.359129,103.866465
558886,5,13,18,1.359075,103.866353
558887,3,6,9,1.359058,103.866462
558888,0,1,1,1.359446,103.866385
558889,3,0,3,1.359274,103.866479
558890,0,2,2,1.357765,103.867275
558891,3,1,4,1.359463,103.866436
558892,5,1,6,1.359022,103.866341
558893,25,8,33,1.358792,103.866427
558894,3,1,4,1.358892,103.866448
558895,18,21,39,1.358717,103.866434
558896,10,2,12,1.358796,103.86633
558897,1,0,1,1.358952,103.866366
558898,8,1,9,1.358706,103.866329
558899,31,7,38,1.358624,103.866552
558900,0,1,1,1.358631,103.866412
558901,62,13,75,1.358463,103.866396
558902,0,3,3,1.358988,103.866454
558903,308,6,314,1.358394,103.866384
558904,15,4,19,1.358308,103.866256
558905,3,1,4,1.358852,103.866358
558906,70,5,75,1.35838,103.866279
558909,1,1,2,1.359214,103.866374
558912,3,0,3,1.358481,103.866293
558913,7,1,8,1.357572,103.866292
558914,26,1,27,1.357467,103.86618
558915,2,0,2,1.35771,103.866296
558916,124,1,125,1.357382,103.866177
558917,11,1,12,1.357397,103.866276
558918,2,1,3,1.357547,103.866189
558919,2,1,3,1.35732,103.866169
558920,5,0,5,1.357255,103.86616
558921,1,7,8,1.357269,103.866263
558922,13,3,16,1.357203,103.866142
558923,29,0,29,1.357198,103.866266
558924,2,0,2,1.357511,103.866296
558927,1,0,1,1.358571,103.86632
558928,4,0,4,1.358295,103.866364
558930,0,2,2,1.35713,103.866134
558931,0,2,2,1.3569,103.86612
558932,1,0,1,1.357069,103.866258
558933,3,1,4,1.356971,103.866125
558934,0,2,2,1.35693,103.866242
558935,1,0,1,1.35683,103.86611
558937,82,1,83,1.356755,103.866217
558938,89,2,91,1.356596,103.866083
558939,1,0,1,1.356818,103.866213
558940,6,29,35,1.356536,103.866068
558941,18,0,18,1.356634,103.866203
558942,7,17,24,1.356492,103.866057
558943,12,0,12,1.35655,103.86619
558944,4,3,7,1.356432,103.866057
558945,1,7,8,1.356508,103.866178
558946,2,2,4,1.35687,103.866219
558947,1,1,2,1.356747,103.866104
558948,0,3,3,1.35735,103.866269
558949,7,8,15,1.356364,103.866168
558950,13,5,18,1.35623,103.86603
558951,28,0,28,1.356283,103.866148
558952,2,4,6,1.356151,103.866027
558953,0,1,1,1.3567,103.866209
558954,5,3,8,1.356067,103.866021
558955,21,0,21,1.356145,103.866128
558956,7,35,42,1.356031,103.865964
558958,8,1,9,1.355866,103.866113
558959,12,0,12,1.355951,103.866115
558960,4,44,48,1.355752,103.866102
558961,336,804,1140,1.355263,103.865821
558962,953,660,1613,1.355013,103.865628
558974,17,19,36,1.35785,103.86314
558975,40,0,40,1.35732,103.862946
558977,90,3,93,1.356837,103.864579
558978,2,4,6,1.356876,103.864532
558979,466,95,561,1.35732,103.863998
558980,21,0,21,1.357884,103.863074
558981,81,1,82,1.35786,103.863043
558982,61,2,63,1.358156,103.862927
558984,0,3,3,1.3563,103.866039
558985,2,5,7,1.358242,103.862793
558986,19,0,19,1.35814,103.862737
558987,15,2,17,1.358322,103.862653
558988,5,1,6,1.358242,103.86258
558990,4,0,4,1.356381,103.866054
558992,11,2,13,1.35877,103.862041
558993,58,0,58,1.358294,103.86252
558994,171,2,173,1.358714,103.862156
558995,11,0,11,1.358335,103.862359
558996,14,5,19,1.358745,103.862095
558997,4,0,4,1.358193,103.862636
558998,2,1,3,1.358009,103.862897
558999,1,0,1,1.356211,103.866142
559000,2,1,3,1.358948,103.861815
559001,52,0,52,1.358523,103.862214
559002,0,1,1,1.358458,103.862275
559003,8,3,11,1.358623,103.861804
559004,3,2,5,1.359024,103.861707
559005,6,2,8,1.358595,103.862078
559006,1,0,1,1.358891,103.861854
559007,4,0,4,1.358417,103.862348
559008,3,4,7,1.35909,103.8616
559009,1,0,1,1.358987,103.861769
559011,2,0,2,1.356432,103.866171
559012,6,0,6,1.359141,103.861514
559013,4,0,4,1.358699,103.861968
559014,1,0,1,1.358753,103.861877
559016,0,1,1,1.359397,103.86136
559017,11,0,11,1.359021,103.861511
559018,2,1,3,1.358837,103.861912
559020,129,15,144,1.359481,103.860468
559021,0,1,1,1.35944,103.861093
559022,840,105,945,1.359255,103.859632
559023,2,0,2,1.358803,103.861819
559024,0,1,1,1.359614,103.86109
559025,1,3,4,1.358877,103.8617
559026,4,3,7,1.360034,103.860463
559027,1,6,7,1.360111,103.860395
559028,2,3,5,1.360206,103.860318
559029,4,0,4,1.359611,103.86078
559030,2,0,2,1.359304,103.861254
559031,2,1,3,1.359538,103.861208
559032,3,3,6,1.360549,103.860027
559033,13,16,29,1.360635,103.859951
559034,137,28,165,1.36073,103.859882
559035,4,32,36,1.360824,103.859822
559036,0,10,10,1.36091,103.859754
559037,0,13,13,1.360979,103.859703
559038,14,41,55,1.361065,103.85966
559039,9,0,9,1.359119,103.861386
559040,32,5,37,1.358456,103.862284
559041,0,2,2,1.360369,103.860173
559042,6,10,16,1.35673,103.864105
559043,6,7,13,1.356794,103.864171
559044,18,1,19,1.358701,103.861973
559045,4,0,4,1.360292,103.86025
559046,0,5,5,1.356467,103.865343
559047,5,4,9,1.358089,103.862807
559048,2,22,24,1.358038,103.863099
559049,3,4,7,1.35814,103.862737
559050,16,0,16,1.359274,103.862867
559051,12,0,12,1.359425,103.862994
559052,1,0,1,1.359359,103.861155
559053,28,0,28,1.35949,103.862895
559054,3,0,3,1.360438,103.860104
559055,1,2,3,1.359563,103.862606
559056,1,2,3,1.359546,103.862825
559057,2,2,4,1.358089,103.862807
559058,1,5,6,1.35968,103.862658
559059,3,0,3,1.359621,103.862525
559060,4,2,6,1.359733,103.862535
559061,2,1,3,1.359745,103.862373
559063,1,0,1,1.359442,103.862783
559064,5,0,5,1.359801,103.862286
559065,1,1,2,1.358589,103.862079
559066,8,0,8,1.359896,103.862316
559067,7,1,8,1.360095,103.862028
559068,6,0,6,1.359854,103.862214
559069,7,3,10,1.359966,103.862216
559070,11,4,15,1.359887,103.862153
559071,18,1,19,1.360036,103.86209
559072,6,0,6,1.359925,103.862101
559074,91,6,97,1.360246,103.862077
559075,0,2,2,1.359791,103.862483
559076,1,2,3,1.359765,103.862324
559077,5,0,5,1.360058,103.86191
559078,24,1,25,1.360334,103.8617
559079,1,2,3,1.360195,103.861902
559080,2,2,4,1.359755,103.862786
559082,2,0,2,1.360243,103.86184
559083,0,1,1,1.359853,103.862399
559084,10,1,11,1.360368,103.861599
559086,74,5,79,1.360429,103.86154
559087,3,8,11,1.360311,103.861547
559088,8,1,9,1.360506,103.861471
559089,14,1,15,1.36064,103.861107
559090,1,0,1,1.360218,103.861694
559091,2,0,2,1.360494,103.861759
559092,2,0,2,1.360718,103.861047
559096,5,1,6,1.360872,103.861183
559097,28,3,31,1.36095,103.860876
559098,5,0,5,1.36094,103.861132
559099,1,2,3,1.3601,103.861839
559100,1,0,1,1.360575,103.86142
559101,4,0,4,1.360299,103.861765
559102,7,0,7,1.361043,103.861021
559103,7,2,9,1.361156,103.860714
559104,193,3,196,1.361095,103.860961
559106,0,2,2,1.360652,103.861352
559107,0,1,1,1.360992,103.861072
559108,1,2,3,1.361035,103.860833
559110,10,2,12,1.361275,103.860773
559112,2,1,3,1.361207,103.860824
559114,7,0,7,1.361387,103.860696
559115,1,0,1,1.361267,103.860611
559116,7,0,7,1.361496,103.860594
559117,4,0,4,1.361087,103.860782
559120,11,3,14,1.361617,103.860499
559122,14,0,14,1.361669,103.860464
559123,34,9,43,1.361697,103.860201
559124,53,0,53,1.361723,103.860431
559125,1,3,4,1.361551,103.860347
559126,0,7,7,1.361774,103.860363
559127,4,4,8,1.361842,103.86032
559128,2,2,4,1.361766,103.860159
559129,8,0,8,1.361954,103.860243
559130,4,3,7,1.362006,103.860192
559131,0,1,1,1.361491,103.860398
559133,12,18,30,1.360377,103.861469
559143,3,8,11,1.363166,103.870471
559145,3,10,13,1.363149,103.870353
559146,15,1,16,1.363065,103.870363
559147,35,1,36,1.362791,103.870033
559149,18,4,22,1.362823,103.870062
559150,2,3,5,1.362729,103.870054
559151,32,0,32,1.362586,103.869845
559152,0,3,3,1.361336,103.860739
559153,2,0,2,1.361147,103.860884
559154,10,0,10,1.36227,103.869608
559156,2,0,2,1.362368,103.869606
559158,4,0,4,1.361902,103.860286
559159,0,4,4,1.362125,103.869369
559160,2,0,2,1.362254,103.869507
559161,3,3,6,1.361804,103.869059
559162,23,4,27,1.361824,103.869161
559163,41,5,46,1.361764,103.869108
559164,0,1,1,1.362057,103.860141
559165,0,1,1,1.361925,103.869176
559166,10,0,10,1.36162,103.868948
559168,14,2,16,1.361325,103.868791
559169,8,1,9,1.361499,103.868752
559170,1,2,3,1.362474,103.869808
559171,1,0,1,1.361617,103.868868
559172,14,1,15,1.361199,103.868824
559173,6,0,6,1.36113,103.868892
559174,14,0,14,1.361078,103.868947
559175,2,0,2,1.361855,103.869114
559176,6,0,6,1.361049,103.868972
559177,14,11,25,1.360899,103.869192
559178,3,0,3,1.361449,103.868702
559179,0,6,6,1.36115,103.868943
559180,35,0,35,1.361039,103.869068
559182,0,2,2,1.360972,103.869035
559183,15,4,19,1.361063,103.86938
559184,1,3,4,1.361915,103.869251
559185,11,0,11,1.361287,103.869507
559186,64,0,64,1.361361,103.869574
559187,3,2,5,1.36091,103.869679
559189,1,0,1,1.361558,103.868793
559190,3,1,4,1.361034,103.869348
559191,6,5,11,1.360972,103.869614
559192,17,0,17,1.361659,103.869858
559193,6,0,6,1.361746,103.870017
559194,7,1,8,1.361964,103.870163
559195,5,1,6,1.362041,103.870228
559197,9,0,9,1.362415,103.870599
559198,4,0,4,1.361373,103.869662
559199,3,4,7,1.362576,103.870757
559200,1,1,2,1.361214,103.869434
559201,0,5,5,1.362758,103.870901
559202,3,0,3,1.360967,103.869273
559203,39,0,39,1.362299,103.870551
559204,9,23,32,1.362966,103.871028
559205,1,3,4,1.362204,103.870462
559206,2,0,2,1.362486,103.870662
559207,1,15,16,1.362398,103.870663
559209,1,17,18,1.362362,103.870623
559210,42,30,72,1.362462,103.870729
559211,4,14,18,1.362769,103.870985
559212,0,3,3,1.362721,103.870886
559213,30,5,35,1.362926,103.871126
559214,26,0,26,1.362823,103.871002
559215,1,6,7,1.362885,103.871044
559216,19,11,30,1.36303,103.871132
559217,2,2,4,1.362267,103.870519
559218,58,25,83,1.363174,103.87123
559219,16,8,24,1.363141,103.871202
559220,9,5,14,1.362942,103.87017
559221,0,3,3,1.362855,103.87108
559222,5,0,5,1.361798,103.869985
559223,38,0,38,1.361868,103.870042
559224,27,4,31,1.36124,103.868874
559225,28,2,30,1.361107,103.868988
559226,16,0,16,1.362867,103.870181
559227,9,0,9,1.360997,103.869014
559228,129,0,129,1.360945,103.869065
559229,14,0,14,1.360894,103.869115
559231,13,0,13,1.362473,103.871189
559232,44,3,47,1.362555,103.871182
559233,14,2,16,1.362421,103.871315
559234,1,4,5,1.362437,103.871272
559235,3,0,3,1.361738,103.869935
559236,3,0,3,1.36241,103.871522
559237,9,0,9,1.362265,103.871638
559238,3,0,3,1.362387,103.871363
559239,0,1,1,1.361528,103.869743
559240,1,0,1,1.36203,103.872158
559241,35,0,35,1.362047,103.871561
559242,1,3,4,1.362989,103.871111
559243,3,0,3,1.362295,103.871751
559244,0,1,1,1.362222,103.871918
559245,2,0,2,1.362235,103.870491
559246,10,1,11,1.362212,103.872445
559247,3,0,3,1.362194,103.871804
559248,4,0,4,1.362146,103.872073
559249,15,7,22,1.362047,103.872608
559250,74,4,78,1.361994,103.872233
559251,6,1,7,1.361657,103.872474
559252,6,0,6,1.361513,103.872513
559253,3,0,3,1.361872,103.872426
559255,3,0,3,1.36188,103.872336
559256,1,0,1,1.362004,103.872353
559257,7,3,10,1.361679,103.872389
559258,15,1,16,1.360522,103.872769
559259,4,7,11,1.361229,103.872514
559261,24,0,24,1.360845,103.872601
559262,1,0,1,1.361593,103.872429
559263,18,3,21,1.360702,103.872645
559264,6,0,6,1.360617,103.87267
559265,17,371,388,1.360598,103.872757
559266,3,9,12,1.360437,103.872703
559267,0,11,11,1.360387,103.872716
559268,5,0,5,1.360306,103.872728
559269,5,3,8,1.36022,103.873097
559270,1,0,1,1.360781,103.872619
559272,11,25,36,1.360227,103.872742
559273,8,14,22,1.36016,103.87275
559274,2,34,36,1.360094,103.872777
559275,30,16,46,1.359436,103.873093
559276,6,0,6,1.35946,103.872932
559277,3,0,3,1.361291,103.872576
559278,5,2,7,1.359575,103.872919
559279,15,1,16,1.359305,103.873065
559280,9,1,10,1.35921,103.873086
559281,7,3,10,1.359691,103.872887
559282,11,2,13,1.359635,103.872888
559283,2,25,27,1.359527,103.872929
559284,4,19,23,1.362387,103.871575
559285,0,1,1,1.359733,103.872972
559287,7,1,8,1.36173,103.872466
559288,7,1,8,1.359484,103.873032
559289,16,0,16,1.359484,103.873032
559290,4,0,4,1.362103,103.871994
559291,5,0,5,1.359484,103.873032
559292,13,17,30,1.365608,103.865306
559293,4,10,14,1.365872,103.865207
559294,1,0,1,1.362293,103.871563
559295,1,69,70,1.365683,103.865306
559296,0,5,5,1.365904,103.865312
559298,4,0,4,1.359484,103.873032
559299,54,1,55,1.365965,103.865287
559300,1,0,1,1.365833,103.865213
559301,86,2,88,1.366115,103.864999
559302,0,1,1,1.366053,103.865044
559303,53,1,54,1.366026,103.865246
559305,3,1,4,1.365991,103.865125
559306,5,1,6,1.366172,103.865104
559307,1,0,1,1.366094,103.865172
559309,5,0,5,1.366309,103.865007
559310,2,1,3,1.359396,103.873057
559311,45,2,47,1.366346,103.864791
559313,140,3,143,1.366478,103.864681
559314,2,1,3,1.366416,103.86492
559315,13,1,14,1.366416,103.864741
559316,7,1,8,1.366738,103.864651
559317,6,5,11,1.366444,103.864666
559319,2,3,5,1.366514,103.864569
559320,1,1,2,1.36217,103.871857
559321,3,0,3,1.366527,103.864839
559322,43,5,48,1.366631,103.864737
559323,0,12,12,1.366691,103.864493
559324,1,3,4,1.366174,103.864941
559326,3,7,10,1.366681,103.86468
559327,1,0,1,1.366278,103.864853
559328,29,0,29,1.366799,103.864583
559329,2,2,4,1.366871,103.864389
559330,0,1,1,1.366803,103.864439
559331,3,1,4,1.366886,103.864525
559332,3,0,3,1.366567,103.864561
559333,28,0,28,1.367207,103.864114
559334,0,3,3,1.367,103.864595
559335,0,28,28,1.367064,103.864222
559339,1,3,4,1.366952,103.864313
559340,1,1,2,1.36657,103.8648
559342,18,0,18,1.367249,103.864223
559343,27,9,36,1.367274,103.86402
559344,12,1,13,1.367398,103.864089
559345,6,1,7,1.367386,103.863965
559346,4,0,4,1.367319,103.863978
559348,34,1,35,1.367199,103.864278
559349,3,4,7,1.367435,103.863913
559350,0,2,2,1.367032,103.864412
559354,7,0,7,1.367567,103.863997
559355,23,0,23,1.367641,103.863672
559357,72,0,72,1.367752,103.863614
559358,2,9,11,1.367599,103.863926
559359,36,1,37,1.367826,103.863542
559360,1,0,1,1.366834,103.864565
559361,0,2,2,1.367333,103.864149
559362,4,0,4,1.367451,103.864068
559363,2,0,2,1.367877,103.863495
559364,44,1,45,1.36804,103.863528
559365,22,16,38,1.368043,103.863363
559366,17,8,25,1.368201,103.863381
559367,36,8,44,1.367911,103.863412
559368,1,0,1,1.368114,103.863476
559369,34,2,36,1.368046,103.863295
559370,2,6,8,1.368271,103.863333
559371,25,1,26,1.368087,103.86325
559372,1,0,1,1.368328,103.863307
559375,47,1,48,1.368234,103.863173
559376,3,0,3,1.366937,103.864476
559377,3,2,5,1.368434,103.863149
559379,1,1,2,1.367984,103.863371
559380,10,2,12,1.368988,103.86336
559382,4,0,4,1.368161,103.863415
559383,1,0,1,1.368392,103.86331
559384,11,3,14,1.368681,103.863287
559385,14,0,14,1.368813,103.863182
559386,16,4,20,1.369169,103.863398
559387,8,0,8,1.368492,103.863121
559388,34,1,35,1.369075,103.863358
559389,0,1,1,1.368571,103.863191
559390,2,0,2,1.368491,103.863173
559391,0,1,1,1.369097,103.863233
559392,7,2,9,1.368897,103.863226
559393,2,0,2,1.369277,103.863382
559394,6,0,6,1.365911,103.865171
559405,11,1,12,1.359845,103.863334
559406,6,2,8,1.359882,103.863287
559407,8,3,11,1.359856,103.863169
559408,2,2,4,1.368933,103.863326
559409,2,0,2,1.368979,103.863227
559410,0,8,8,1.360092,103.863
559411,6,3,9,1.359971,103.862995
559413,8,9,17,1.360005,103.862795
559414,3,14,17,1.360165,103.862846
559415,2,1,3,1.368521,103.863289
559417,0,1,1,1.368695,103.863203
559418,25,1,26,1.360091,103.862793
559419,0,2,2,1.359903,103.863101
559420,0,2,2,1.360393,103.862579
559421,10,0,10,1.360264,103.862735
559422,115,2,117,1.360202,103.862601
559423,2,1,3,1.360003,103.862933
559424,3,0,3,1.360344,103.862628
559425,2,0,2,1.360198,103.862796
559426,1,1,2,1.36044,103.862508
559427,3,0,3,1.360332,103.862436
559428,114,0,114,1.360363,103.862339
559429,18,0,18,1.360566,103.862317
559431,17,0,17,1.360539,103.862364
559432,0,1,1,1.360135,103.862884
559433,66,2,68,1.360784,103.862219
559435,13,0,13,1.360657,103.862166
559436,1,0,1,1.360482,103.862129
559437,5,0,5,1.360709,103.8621
559438,8,0,8,1.360897,103.861657
559439,2,0,2,1.360353,103.862349
559441,0,3,3,1.360506,103.862407
559442,2,0,2,1.360837,103.861974
559443,1,1,2,1.360984,103.861534
559444,0,5,5,1.361053,103.861465
559445,21,1,22,1.361235,103.861737
559446,13,3,16,1.361139,103.861397
559447,5,0,5,1.361683,103.861189
559448,3,1,4,1.360026,103.863095
559449,9,7,16,1.361751,103.861121
559450,2,3,5,1.361302,103.861286
559451,1,0,1,1.36067,103.86199
559452,2,0,2,1.361562,103.8613
559454,2,5,7,1.361431,103.861175
559455,1,0,1,1.361811,103.861061
559456,16,1,17,1.3615,103.861124
559457,17,0,17,1.361992,103.860907
559458,7,0,7,1.361568,103.861072
559459,16,1,17,1.362026,103.860865
559460,26,0,26,1.361628,103.861012
559461,37,3,40,1.362069,103.860822
559462,2,0,2,1.361362,103.861226
559463,42,3,45,1.362129,103.860762
559464,6,0,6,1.361749,103.860901
559465,8,2,10,1.362189,103.860719
559466,4,6,10,1.361792,103.860842
559467,9,0,9,1.362241,103.860685
559468,44,3,47,1.361852,103.860807
559469,6,2,8,1.362301,103.860634
559470,3,3,6,1.36192,103.860756
559471,0,1,1,1.361915,103.860967
559472,45,3,48,1.361989,103.860705
559474,3,2,5,1.362041,103.860662
559475,4,3,7,1.362404,103.860566
559478,3,0,3,1.361016,103.861883
559480,4,0,4,1.361208,103.861346
559482,0,1,1,1.362335,103.8606
559483,15,1,16,1.362556,103.860454
559484,0,1,1,1.3623,103.860353
559485,3,0,3,1.362161,103.860577
559486,8,0,8,1.362286,103.860426
559487,1,7,8,1.362676,103.860341
559488,0,2,2,1.361689,103.860961
559489,5,4,9,1.362745,103.860284
559490,3,1,4,1.36223,103.860508
559491,0,5,5,1.362528,103.860201
559492,4,1,5,1.362602,103.860127
559493,0,2,2,1.362401,103.860309
559494,0,1,1,1.362194,103.860542
559495,40,24,64,1.362822,103.859987
559505,1,0,1,1.361388,103.861417
559506,23,1,24,1.360311,103.863566
559508,5,2,7,1.360439,103.863418
559509,0,1,1,1.360379,103.863495
559510,1,0,1,1.360332,103.863348
559511,129,2,131,1.360503,103.863316
559512,5,2,7,1.360551,103.863253
559513,2,11,13,1.360452,103.863128
559514,27,2,29,1.360729,103.863325
559515,1,0,1,1.360397,103.86329
559516,1,1,2,1.362688,103.860064
559517,6,7,13,1.360589,103.863178
559518,4,0,4,1.362465,103.860252
559519,40,0,40,1.360637,103.863125
559520,15,0,15,1.360487,103.863198
559521,12,1,13,1.360679,103.863068
559522,1,2,3,1.362613,103.860397
559523,5,2,7,1.36072,103.862993
559524,16,5,21,1.36091,103.862566
559525,4,2,6,1.360768,103.862936
559526,1,0,1,1.360461,103.863023
559527,1,0,1,1.360842,103.862683
559528,3,3,6,1.360826,103.862587
559529,1,0,1,1.360819,103.862859
559530,3,0,3,1.360653,103.862968
559531,2,4,6,1.360921,103.862719
559532,3,0,3,1.360892,103.862492
559533,39,1,40,1.360966,103.862645
559534,3,5,8,1.360968,103.862298
559536,5,0,5,1.360966,103.862481
559537,1,1,2,1.360565,103.863214
559538,1,0,1,1.36086,103.862802
559539,21,0,21,1.361311,103.862238
559541,26,1,27,1.361466,103.862003
559542,3,4,7,1.361449,103.861916
559543,9,0,9,1.361669,103.861919
559544,5,0,5,1.361608,103.861773
559545,10,3,13,1.361712,103.861859
559546,0,2,2,1.361087,103.862515
559547,13,7,20,1.361763,103.8618
559548,25,4,29,1.361758,103.86161
559549,130,4,134,1.361806,103.861757
559550,219,7,226,1.361801,103.861559
559551,140,0,140,1.361858,103.861714
559552,3,3,6,1.361852,103.861516
559553,6,1,7,1.361901,103.861672
559554,1,5,6,1.361895,103.861473
559555,11,1,12,1.361935,103.861629
559556,9,4,13,1.361938,103.861431
559557,19,1,20,1.361978,103.861595
559560,5,4,9,1.362032,103.861362
559561,2,0,2,1.361697,103.861661
559562,0,1,1,1.361219,103.862196
559563,16,2,18,1.362115,103.861501
559564,4,0,4,1.360576,103.863031
559566,10,4,14,1.362161,103.86126
559567,14,1,15,1.362218,103.861441
559568,0,4,4,1.362127,103.861294
559570,10,0,10,1.362256,103.861174
559572,6,1,7,1.362299,103.86114
559575,24,0,24,1.362793,103.860921
559577,88,3,91,1.362655,103.861029
559579,5,1,6,1.362703,103.860986
559580,2,1,3,1.360859,103.862624
559581,1,0,1,1.362084,103.861328
559583,9,1,10,1.362831,103.860902
559584,1,0,1,1.362882,103.860826
559585,4,0,4,1.362204,103.861226
559586,0,1,1,1.362843,103.86073
559587,3,1,4,1.363025,103.860721
559590,5,1,6,1.363107,103.860652
559601,2,2,4,1.363231,103.860771
559602,119,1,120,1.360767,103.863759
559603,1,2,3,1.362489,103.861002
559604,0,2,2,1.362072,103.861535
559605,2,1,3,1.360861,103.863605
559606,0,8,8,1.360876,103.863739
559607,3,1,4,1.3607,103.863847
559608,20,0,20,1.360914,103.863534
559609,9,0,9,1.360946,103.863635
559610,33,3,36,1.360975,103.863427
559611,3,0,3,1.360927,103.863664
559613,64,1,65,1.361039,103.863504
559614,25,1,26,1.361148,103.863339
559615,4,10,14,1.361097,103.863423
559616,1,4,5,1.361251,103.863063
559617,1,0,1,1.362789,103.860771
559618,1,3,4,1.360815,103.863687
559619,8,1,9,1.361386,103.863027
559621,3,0,3,1.361092,103.863277
559622,10,0,10,1.361283,103.863003
559623,0,1,1,1.361199,103.863129
559625,0,1,1,1.361316,103.863117
559628,5,1,6,1.361423,103.862824
559629,2,6,8,1.361554,103.86275
559630,5,0,5,1.361466,103.862762
559631,36,3,39,1.361592,103.862697
559632,4,5,9,1.361484,103.862716
559633,28,6,34,1.361632,103.862648
559634,0,6,6,1.36153,103.862655
559635,8,0,8,1.361667,103.862596
559636,1,2,3,1.361262,103.863194
559637,6,1,7,1.362019,103.862125
559638,1,0,1,1.36143,103.862962
559639,6,0,6,1.361854,103.862407
559640,2,3,5,1.361784,103.862227
559642,0,1,1,1.361883,103.862224
559644,1,1,2,1.360838,103.863793
559645,52,2,54,1.361959,103.862321
559646,1,1,2,1.362093,103.862077
559647,21,2,23,1.362004,103.862271
559648,1,2,3,1.361642,103.86251
559649,41,0,41,1.362581,103.861762
559650,15,7,22,1.362271,103.86192
559652,9,6,15,1.362129,103.862049
559653,2,2,4,1.36114,103.863218
559654,1,1,2,1.362182,103.862005
559655,1,0,1,1.36196,103.862183
559656,0,1,1,1.362657,103.861687
559657,5,0,5,1.362535,103.861662
559658,18,2,20,1.362386,103.861858
559659,29,21,50,1.362902,103.861506
559660,0,3,3,1.361836,103.862291
559661,1,0,1,1.362316,103.861893
559662,0,5,5,1.362666,103.861521
559663,1,1,2,1.362063,103.862106
559664,4,2,6,1.362734,103.861453
559665,8,3,11,1.363091,103.861346
559666,6,0,6,1.362792,103.861396
559667,10,4,14,1.363159,103.861289
559668,18,1,19,1.362855,103.861345
559670,2,0,2,1.363039,103.861392
559671,146,3,149,1.363291,103.861181
559672,1,0,1,1.362976,103.861449
559673,0,4,4,1.362232,103.861963
559674,1,1,2,1.362912,103.861288
559675,1,0,1,1.362975,103.861231
559676,1,0,1,1.363406,103.861079
559677,99,3,102,1.363457,103.861028
559678,4,0,4,1.363348,103.86113
559679,1,1,2,1.363038,103.861185
559680,6,0,6,1.363261,103.861014
559681,0,1,1,1.363107,103.861128
559682,0,3,3,1.362591,103.861578
559683,1,0,1,1.363572,103.860931
559684,13,0,13,1.363393,103.860889
559685,3,6,9,1.363442,103.860841
559686,20,7,27,1.361679,103.862681
559687,4,4,8,1.299509,103.837
559688,52,23,75,1.299509,103.837
559697,4,0,4,1.363187,103.861077
559698,11,1,12,1.361215,103.864194
559699,117,5,122,1.36126,103.863965
559700,2,15,17,1.361395,103.863957
559701,1,3,4,1.361146,103.864112
559702,2,0,2,1.363431,103.861048
559703,7,2,9,1.361369,103.863778
559704,0,1,1,1.363629,103.860877
559705,3,2,5,1.361437,103.863722
559706,0,1,1,1.361509,103.8638
559707,35,1,36,1.361486,103.863679
559709,53,2,55,1.361572,103.863538
559710,1,3,4,1.361317,103.863863
559711,117,2,119,1.361595,103.863678
559712,2,0,2,1.36133,103.864056
559713,13,1,14,1.36165,103.8636
559714,12,1,13,1.361622,103.863455
559715,6,0,6,1.361814,103.86321
559717,1,1,2,1.36172,103.863514
559718,53,0,53,1.362055,103.862872
559719,48,1,49,1.361836,103.8634
559720,25,3,28,1.361775,103.863277
559721,1,2,3,1.363324,103.860952
559722,5,1,6,1.361908,103.863255
559723,0,3,3,1.36185,103.863343
559724,5,0,5,1.361867,103.863155
559725,4,3,7,1.362,103.863111
559726,1,0,1,1.36149,103.863877
559727,4,0,4,1.361515,103.863616
559728,27,2,29,1.362014,103.862942
559730,4,1,5,1.362113,103.862781
559731,1,2,3,1.362211,103.86269
559732,1,2,3,1.36228,103.862793
559733,35,1,36,1.362426,103.862662
559734,0,1,1,1.361862,103.862942
559735,2,0,2,1.361928,103.863453
559736,1,2,3,1.362076,103.862843
559737,1,0,1,1.362164,103.862742
559738,6,0,6,1.36237,103.862545
559739,1,3,4,1.362113,103.862971
559740,1,0,1,1.362594,103.862552
559741,5,2,7,1.362332,103.862574
559742,3,0,3,1.362227,103.862571
559743,14,2,16,1.362769,103.86237
559744,1,1,2,1.362509,103.862608
559745,9,0,9,1.362801,103.862194
559746,4,0,4,1.362499,103.862451
559747,11,14,25,1.362915,103.862281
559748,1,0,1,1.362431,103.862499
559749,36,1,37,1.36304,103.862153
559750,8,0,8,1.363151,103.86188
559751,7,0,7,1.362969,103.862211
559752,1,0,1,1.362975,103.862061
559754,0,1,1,1.36297,103.862033
559755,1,0,1,1.363064,103.861956
559756,89,0,89,1.362935,103.861968
559757,7,0,7,1.363195,103.861888
559759,35,1,36,1.363447,103.861821
559761,0,1,1,1.363143,103.862054
559762,8,0,8,1.362939,103.862076
559763,3,0,3,1.36241,103.862515
559764,2,0,2,1.362601,103.862367
559765,2,0,2,1.363328,103.861738
559767,7,1,8,1.363674,103.861621
559768,24,0,24,1.363448,103.86163
559769,2,0,2,1.363642,103.861664
559770,2,0,2,1.363758,103.861561
559771,1,0,1,1.363571,103.861728
559772,7,1,8,1.363568,103.861521
559773,6,0,6,1.363877,103.86149
559774,8,0,8,1.363625,103.861465
559775,2,0,2,1.363511,103.861573
559776,13,0,13,1.363683,103.861408
559777,1,0,1,1.363795,103.861539
559779,5,1,6,1.364019,103.861356
559780,1,1,2,1.363904,103.861452
559781,40,8,48,1.364141,103.861237
559782,11,1,12,1.363877,103.861265
559783,28,23,51,1.363963,103.861191
559795,0,1,1,1.363942,103.86141
559796,0,2,2,1.363803,103.861322
559797,14,3,17,1.358905,103.862612
559798,203,2,205,1.359058,103.862563
559799,19,0,19,1.359056,103.862394
559800,2,0,2,1.359087,103.862489
559801,1,2,3,1.363358,103.861901
559802,10,2,12,1.359155,103.862449
559803,5,1,6,1.359101,103.862324
559804,2,0,2,1.359231,103.862378
559805,1,0,1,1.358871,103.862649
559806,10,0,10,1.359184,103.862418
559808,0,1,1,1.358971,103.86251
559809,23,1,24,1.359381,103.862129
559810,41,3,44,1.359412,103.861905
559811,2,5,7,1.359494,103.861962
559812,0,3,3,1.359008,103.862477
559813,2,1,3,1.299509,103.837
559814,3,0,3,1.359448,103.862024
559815,2,0,2,1.359266,103.862305
559817,3,1,4,1.362548,103.862417
559818,3,0,3,1.359543,103.861723
559819,8,2,10,1.359572,103.861837
559820,0,3,3,1.359376,103.861973
559821,14,0,14,1.359848,103.861678
559822,7,1,8,1.359724,103.861433
559823,0,9,9,1.359835,103.861612
559824,186,0,186,1.359776,103.861356
559825,5,6,11,1.359532,103.861891
559826,28,2,30,1.359836,103.861305
559827,1,0,1,1.359338,103.862015
559828,28,10,38,1.359879,103.861237
559829,52,0,52,1.359898,103.861397
559830,17,4,21,1.359922,103.861168
559831,24,0,24,1.360422,103.860807
559832,58,0,58,1.360061,103.861014
559833,12,0,12,1.360525,103.860713
559834,10,4,14,1.360016,103.861057
559835,25,11,36,1.360611,103.860644
559836,11,0,11,1.360462,103.860615
559838,1,1,2,1.359577,103.861671
559839,0,1,1,1.35968,103.861661
559840,5,0,5,1.360548,103.860538
559841,67,0,67,1.360878,103.860414
559842,15,2,17,1.360591,103.860487
559843,0,3,3,1.359658,103.861515
559844,1,1,2,1.360505,103.860581
559845,95,6,101,1.361024,103.860277
559846,0,1,1,1.360783,103.86049
559847,3,1,4,1.359627,103.861782
559848,29,7,36,1.360737,103.86035
559849,10,0,10,1.361187,103.860149
559850,5,3,8,1.360806,103.860308
559851,3,3,6,1.361255,103.860097
559852,31,1,32,1.360866,103.860265
559853,3,0,3,1.360955,103.860354
559854,6,0,6,1.360935,103.860214
559855,0,2,2,1.360626,103.860444
559856,2,5,7,1.360986,103.860171
559857,1,0,1,1.360686,103.860402
559858,4,1,5,1.361038,103.86012
559859,19,0,19,1.36153,103.85985
559860,1,1,2,1.361393,103.859969
559861,13,0,13,1.361599,103.859798
559862,0,1,1,1.36147,103.859901
559864,0,8,8,1.361261,103.859915
559865,15,0,15,1.359956,103.861117
559866,12,0,12,1.361689,103.859909
559867,6,0,6,1.36174,103.859661
559868,2,3,5,1.361638,103.859756
559876,66,10,76,1.367922,103.86364
559877,125,1,126,1.367942,103.863601
559878,1,0,1,1.361158,103.860026
559879,4,3,7,1.368074,103.863926
559891,8,0,8,1.365837,103.861989
559892,13,0,13,1.365815,103.861774
559893,1,75,76,1.365581,103.86172
559894,2,0,2,1.361107,103.860077
559895,93,0,93,1.365389,103.861681
559896,131,0,131,1.364931,103.861772
559897,115,1,116,1.365525,103.861713
559898,31,2,33,1.365293,103.861763
559899,5,0,5,1.365487,103.861473
559900,1,2,3,1.361333,103.860029
559901,3,2,5,1.365295,103.861598
559902,2,0,2,1.3656,103.86202
559903,1,10,11,1.365137,103.86154
559904,54,0,54,1.365024,103.861428
559905,1,1,2,1.363115,103.86031
559907,5,7,12,1.364796,103.861342
559908,30,7,37,1.363046,103.860182
559909,18,3,21,1.364552,103.861219
559911,1,3,4,1.361101,103.860226
559912,1,1,2,1.363072,103.860225
559913,1,12,13,1.362014,103.859718
559914,149,1,150,1.364148,103.861001
559915,0,7,7,1.361869,103.859665
559916,10,1,11,1.364059,103.860917
559917,59,5,64,1.363925,103.860836
559918,9,0,9,1.363818,103.860772
559919,1,0,1,1.367847,103.863691
559920,3,2,5,1.363581,103.860608
559921,10,0,10,1.363524,103.86058
559922,4,1,5,1.363344,103.860432
559923,8,3,11,1.363295,103.860331
559924,7,0,7,1.363174,103.860121
559926,1,0,1,1.363745,103.860703
559927,1,0,1,1.363072,103.859918
559928,3,1,4,1.362192,103.859736
559929,31,8,39,1.362889,103.859738
559930,5,95,100,1.362819,103.859681
559931,3,0,3,1.363141,103.860361
559933,0,20,20,1.362369,103.85966
559934,8,4,12,1.362212,103.859627
559935,0,67,67,1.362075,103.859624
559936,9,0,9,1.361958,103.859595
559937,12,5,17,1.361829,103.859587
559938,2,5,7,1.361732,103.859567
559939,4,16,20,1.361625,103.859554
559940,12,1,13,1.3615,103.859528
559941,12,8,20,1.361344,103.859512
559942,13,3,16,1.361193,103.85951
559943,4,55,59,1.361047,103.859485
559944,9,50,59,1.363982,103.860882
559945,0,1,1,1.363013,103.859861
559946,2,0,2,1.364544,103.861103
559947,3,3,6,1.363637,103.860652
559948,6,1,7,1.363423,103.860475
559949,16,5,21,1.364214,103.861064
559950,6,4,10,1.363137,103.860053
559951,5,8,13,1.361356,103.85958
559952,12,20,32,1.361425,103.859513
559954,0,5,5,1.362429,103.859656
559955,9,0,9,1.36388,103.867793
559956,0,65,65,1.36392,103.867859
559957,3,0,3,1.362673,103.859699
559958,0,58,58,1.363997,103.86789
559959,0,8,8,1.364064,103.867847
559960,41,0,41,1.364089,103.867919
559961,0,21,21,1.364167,103.867879
559962,0,13,13,1.364155,103.867957
559963,1,0,1,1.362591,103.859684
559964,13,1,14,1.36424,103.867969
559965,3,2,5,1.364369,103.867982
559966,0,1,1,1.364273,103.867931
559967,10,0,10,1.364321,103.868018
559968,36,9,45,1.364419,103.868078
559969,2,0,2,1.36322,103.860222
559970,2,6,8,1.364519,103.868146
559971,1,1,2,1.364544,103.868097
559972,13,1,14,1.364633,103.868228
559973,10,3,13,1.36473,103.868246
559974,7,1,8,1.364707,103.868281
559975,6,0,6,1.364815,103.868305
559977,0,1,1,1.364464,103.86804
559978,0,3,3,1.363963,103.867806
559980,0,2,2,1.364639,103.868173
559981,2,0,2,1.364882,103.86845
559983,3,1,4,1.362975,103.859793
559984,23,10,33,1.3651,103.868784
559985,0,1,1,1.364896,103.86837
559986,13,0,13,1.365157,103.868867
559987,15,5,20,1.365165,103.86881
559988,125,2,127,1.365206,103.868948
559989,1,1,2,1.365025,103.868505
559990,7,0,7,1.299509,103.837
560101,670,6592,7262,1.370292,103.839264
560102,644,246,890,1.370583,103.839309
560103,155,791,946,1.371001,103.839156
560104,452,64,516,1.371759,103.838983
560105,107,50,157,1.372332,103.837397
560106,1161,1122,2283,1.371994,103.837256
560107,1682,3233,4915,1.371452,103.837222
560108,727,2486,3213,1.371119,103.838173
560109,319,3287,3606,1.370202,103.837762
560110,1004,278,1282,1.370527,103.83728
560111,640,3692,4332,1.370889,103.837108
560112,385,694,1079,1.371316,103.835594
560113,752,510,1262,1.371855,103.835847
560114,1277,635,1912,1.372704,103.835855
560115,89,442,531,1.373035,103.836116
560116,956,556,1512,1.37341,103.836186
560117,1084,210,1294,1.373685,103.83548
560118,2412,581,2993,1.37325,103.835339
560119,369,6320,6689,1.369612,103.844349
560120,281,655,936,1.370092,103.844264
560121,583,10597,11180,1.369835,103.843763
560122,408,2299,2707,1.370211,103.843297
560123,419,1775,2194,1.370481,103.844796
560124,532,477,1009,1.370906,103.844763
560125,356,1862,2218,1.371506,103.844839
560126,852,895,1747,1.371609,103.843547
560127,756,355,1111,1.371244,103.843497
560128,634,432,1066,1.370836,103.843567
560129,547,3479,4026,1.369981,103.842368
560130,535,254,789,1.370334,103.842153
560131,819,37,856,1.370991,103.84186
560132,387,29,416,1.371417,103.841917
560133,117,3770,3887,1.371135,103.842662
560134,938,227,1165,1.372035,103.842133
560150,229,1648,1877,1.376759,103.841859
560151,572,3353,3925,1.376687,103.84105
560152,257,3657,3914,1.376656,103.840063
560153,328,94,422,1.376353,103.841774
560154,414,184,598,1.37628,103.841054
560155,564,3534,4098,1.375919,103.839952
560156,119,333,452,1.37552,103.839844
560157,278,7873,8151,1.37526,103.839382
560158,157,5949,6106,1.374781,103.839019
560159,154,683,837,1.374582,103.839739
560160,8,3,11,1.374481,103.839239
560161,68,21,89,1.374125,103.839812
560162,31,159,190,1.37426,103.838842
560163,480,2158,2638,1.373542,103.838189
560170,277,1320,1597,1.374059,103.836383
560171,802,600,1402,1.37481,103.835413
560172,308,175,483,1.37459,103.836432
560173,624,129,753,1.375423,103.836331
560174,604,8329,8933,1.375244,103.837729
560175,1110,297,1407,1.375768,103.83693
560176,401,165,566,1.375902,103.836097
560177,521,391,912,1.375895,103.838023
560178,937,253,1190,1.376304,103.83687
560179,764,190,954,1.377027,103.836082
560180,569,915,1484,1.376465,103.838001
560181,417,3587,4004,1.376781,103.837008
560182,364,5894,6258,1.377331,103.836343
560201,339,1303,1642,1.368819,103.844489
560202,429,981,1410,1.368466,103.84435
560203,337,1587,1924,1.367693,103.844121
560204,172,1830,2002,1.367385,103.843791
560205,186,903,1089,1.366946,103.843416
560206,349,758,1107,1.366658,103.843197
560207,603,201,804,1.365886,103.842705
560208,48,1806,1854,1.365483,103.842539
560209,269,2293,2562,1.368934,103.843151
560210,469,127,596,1.368659,103.843146
560211,412,2778,3190,1.369208,103.841395
560212,1050,683,1733,1.368832,103.841421
560213,859,343,1202,1.367847,103.841097
560214,564,2117,2681,1.367506,103.840976
560215,727,2447,3174,1.366631,103.841498
560216,59,69,128,1.366209,103.841368
560217,404,213,617,1.365589,103.84149
560218,553,2516,3069,1.365265,103.841373
560219,462,314,776,1.366032,103.840513
560220,238,523,761,1.365686,103.840259
560221,705,0,705,1.36632,103.839616
560222,472,129,601,1.365992,103.839517
560223,474,9215,9689,1.366256,103.837673
560224,274,481,755,1.366674,103.837897
560225,1340,1934,3274,1.367448,103.837981
560226,494,1768,2262,1.367837,103.838163
560229,471,537,1008,1.369014,103.838243
560230,714,276,990,1.368731,103.837828
560231,142,2057,2199,1.368456,103.837452
560232,1042,5898,6940,1.36823,103.837143
560233,1031,3914,4945,1.367618,103.83664
560234,251,1197,1448,1.367161,103.836625
560235,349,4239,4588,1.36682,103.836493
560244,180,3233,3413,1.367332,103.834399
560245,604,538,1142,1.367767,103.834615
560246,62,708,770,1.367649,103.833507
560247,29,39,68,1.368093,103.83368
560248,23,375,398,1.368397,103.832356
560249,13,44,57,1.368591,103.833818
560251,1,2,3,1.364919,103.868584
560252,9,101,110,1.369286,103.834231
560253,538,376,914,1.369464,103.834662
560254,942,784,1726,1.370297,103.834554
560255,401,194,595,1.370676,103.834502
560256,359,491,850,1.37063,103.83558
560257,749,316,1065,1.370193,103.835595
560258,232,7211,7443,1.370107,103.836305
560259,1096,1072,2168,1.368676,103.831274
560260,32,153,185,1.299509,103.837
560301,845,167,1012,1.367422,103.845774
560302,376,1735,2111,1.367182,103.845533
560303,346,5119,5465,1.366618,103.845133
560304,354,1061,1415,1.366246,103.844905
560305,549,5499,6048,1.366082,103.845861
560306,177,95,272,1.365781,103.845544
560311,311,316,627,1.36671,103.848716
560312,798,8768,9566,1.36624,103.848753
560313,679,1785,2464,1.366719,103.850066
560314,580,6157,6737,1.366237,103.850049
560317,265,3262,3527,1.365519,103.846726
560318,103,4455,4558,1.365594,103.847536
560319,444,193,637,1.365133,103.847326
560320,377,6550,6927,1.365625,103.848332
560321,479,624,1103,1.365142,103.8483
560322,358,28819,29177,1.368384,103.847635
560323,288,370,658,1.367917,103.847636
560324,443,1616,2059,1.368378,103.846828
560325,941,83,1024,1.367913,103.846764
560326,452,178,630,1.367065,103.847708
560327,783,197,980,1.367065,103.846874
560328,243,117,360,1.366677,103.847775
560329,202,743,945,1.366656,103.846819
560330,1607,744,2351,1.362468,103.85096
560331,559,5137,5696,1.362118,103.850621
560332,1342,796,2138,1.361755,103.851834
560333,391,2950,3341,1.361378,103.851544
560334,31,17,48,1.36374,103.850875
560335,454,473,927,1.363253,103.850563
560336,34,134,168,1.363639,103.851698
560337,1488,792,2280,1.363213,103.851456
560338,457,4172,4629,1.363639,103.848762
560339,127,700,827,1.364786,103.849209
560340,197,5403,5600,1.364445,103.849482
560341,57,62,119,1.364171,103.848065
560342,26,199,225,1.3647,103.848396
560343,420,1573,1993,1.368423,103.849062
560344,850,552,1402,1.367985,103.849085
560345,537,1061,1598,1.367476,103.849501
560346,441,269,710,1.367172,103.849509
560347,140,627,767,1.367346,103.848598
560348,557,2398,2955,1.366198,103.847824
560350,1492,332,1824,1.363789,103.849848
560351,971,1498,2469,1.364387,103.850135
560352,901,362,1263,1.364551,103.850762
560353,1264,168,1432,1.364188,103.851531
560354,1153,4148,5301,1.364095,103.851824
560401,691,12877,13568,1.361011,103.855172
560402,75,639,714,1.36152,103.855074
560403,458,566,1024,1.361281,103.854503
560404,18,0,18,1.361759,103.85444
560405,1323,340,1663,1.361599,103.853662
560406,292,219,511,1.362096,103.853687
560407,224,755,979,1.361909,103.855275
560408,81,209,290,1.362079,103.854612
560409,129,292,421,1.363019,103.855294
560410,75,918,993,1.36282,103.854492
560411,170,7310,7480,1.363437,103.855128
560412,400,3890,4290,1.36395,103.855117
560413,88,435,523,1.363497,103.85364
560414,904,165,1069,1.364074,103.85359
560415,851,240,1091,1.364413,103.853659
560416,351,282,633,1.36458,103.854932
560417,314,1093,1407,1.365021,103.855077
560418,856,272,1128,1.364935,103.853958
560419,580,2322,2902,1.365438,103.854045
560420,601,626,1227,1.365016,103.853055
560421,773,1138,1911,1.36539,103.852877
560422,2196,626,2822,1.367993,103.851481
560423,1036,642,1678,1.368727,103.851495
560424,245,4430,4675,1.368377,103.850758
560425,320,4484,4804,1.369111,103.851473
560426,190,1861,2051,1.369462,103.853166
560427,207,2941,3148,1.369293,103.854499
560428,580,262,842,1.36894,103.854351
560429,901,261,1162,1.369086,103.853292
560430,957,1167,2124,1.368989,103.85261
560431,384,734,1118,1.368317,103.852727
560432,464,406,870,1.36831,103.853729
560433,307,1108,1415,1.368119,103.854137
560434,282,9,291,1.367973,103.853466
560435,453,465,918,1.367842,103.85407
560436,757,207,964,1.367334,103.853903
560437,756,91,847,1.367284,103.85314
560438,954,87,1041,1.367065,103.853798
560439,275,1499,1774,1.36637,103.853391
560440,894,1266,2160,1.366447,103.85415
560441,438,2474,2912,1.366132,103.854053
560442,623,2510,3133,1.365756,103.854888
560443,915,658,1573,1.366129,103.855221
560444,783,935,1718,1.366643,103.855438
560445,1099,578,1677,1.366989,103.85559
560446,228,3611,3839,1.367823,103.85528
560447,61,1166,1227,1.367554,103.855892
560448,259,17730,17989,1.367516,103.856308
560449,202,254,456,1.367823,103.855993
560450,144,1508,1652,1.368487,103.855409
560451,143,3783,3926,1.368948,103.855577
560452,343,4004,4347,1.368902,103.85612
560453,23,67,90,1.368595,103.855861
560454,5,196,201,1.299509,103.837
560455,8,1140,1148,1.299509,103.837
560456,737,732,1469,1.367224,103.858465
560457,979,155,1134,1.365753,103.858861
560458,648,317,965,1.366606,103.859399
560459,651,254,905,1.367071,103.859143
560460,388,406,794,1.366337,103.858917
560461,243,546,789,1.367525,103.857333
560462,645,1777,2422,1.36698,103.857901
560463,813,204,1017,1.366913,103.85752
560464,108,12888,12996,1.366846,103.856853
560465,929,440,1369,1.366321,103.856778
560466,746,908,1654,1.365868,103.856877
560467,773,3902,4675,1.36538,103.856725
560468,146,8148,8294,1.364992,103.856273
560469,566,425,991,1.364574,103.856711
560470,184,519,703,1.364078,103.856647
560471,631,772,1403,1.363466,103.857038
560472,796,1,797,1.363302,103.857612
560473,481,516,997,1.363074,103.857041
560474,1342,138,1480,1.362884,103.857599
560475,792,934,1726,1.362678,103.856327
560476,638,446,1084,1.36245,103.857625
560501,100,477,577,1.375967,103.84881
560502,354,4231,4585,1.375694,103.849892
560503,434,242,676,1.375437,103.848907
560504,796,379,1175,1.374825,103.84888
560505,555,1503,2058,1.374855,103.849951
560506,415,323,738,1.37438,103.84888
560507,376,1173,1549,1.374471,103.849946
560508,489,294,783,1.373775,103.848939
560509,315,1065,1380,1.373946,103.850075
560510,1102,320,1422,1.373372,103.848988
560511,326,160,486,1.373608,103.85007
560512,202,284,486,1.372616,103.849015
560513,430,826,1256,1.372718,103.849876
560520,281,6587,6868,1.373385,103.851224
560521,385,245,630,1.373532,103.851676
560522,416,2507,2923,1.373138,103.851947
560523,374,2499,2873,1.372972,103.852844
560524,517,678,1195,1.373409,103.853042
560525,110,5540,5650,1.372623,103.854009
560526,12,469,481,1.373009,103.854069
560527,72,431,503,1.372761,103.854306
560528,61,3122,3183,1.372565,103.854993
560529,101,2400,2501,1.372526,103.855671
560530,39,913,952,1.372766,103.85535
560531,59,384,443,1.373356,103.854322
560532,649,5559,6208,1.373784,103.854658
560533,495,583,1078,1.37414,103.852875
560534,554,386,940,1.374038,103.854042
560535,725,391,1116,1.37461,103.852967
560536,405,2728,3133,1.374504,103.854003
560537,622,766,1388,1.375172,103.852964
560538,395,2952,3347,1.375574,103.852989
560539,115,4535,4650,1.375366,103.85418
560540,605,4510,5115,1.375255,103.855386
560541,519,12313,12832,1.374013,103.855623
560542,403,520,923,1.374729,103.855835
560543,435,196,631,1.374278,103.856246
560544,262,170,432,1.373805,103.85637
560545,568,7834,8402,1.373227,103.856281
560546,365,768,1133,1.37348,103.856788
560547,792,292,1084,1.374162,103.85819
560548,21,1104,1125,1.372952,103.856987
560549,353,3225,3578,1.373143,103.857381
560550,754,802,1556,1.373639,103.858157
560551,487,317,804,1.374001,103.858562
560552,651,8791,9442,1.37236,103.856827
560553,691,229,920,1.372491,103.857264
560554,136,612,748,1.372784,103.857763
560555,287,8395,8682,1.3712,103.857102
560556,623,471,1094,1.372089,103.857733
560557,663,745,1408,1.371586,103.857711
560558,520,1428,1948,1.371173,103.859145
560559,311,1038,1349,1.370969,103.857794
560560,526,1585,2111,1.370852,103.859127
560561,892,3108,4000,1.370589,103.857754
560562,544,2123,2667,1.370203,103.858773
560563,1084,1173,2257,1.369882,103.857961
560564,284,1201,1485,1.370207,103.859546
560565,1472,1504,2976,1.369882,103.858475
560570,239,3267,3506,1.369808,103.855853
560571,1114,1808,2922,1.370103,103.854642
560572,804,398,1202,1.370272,103.855694
560573,500,790,1290,1.370546,103.854725
560574,107,7613,7720,1.371097,103.856309
560575,1239,351,1590,1.371366,103.855892
560576,1786,529,2315,1.371406,103.854702
560577,67,399,466,1.371812,103.855832
560578,171,3423,3594,1.371872,103.854777
560584,748,611,1359,1.37064,103.853431
560585,486,200,686,1.370536,103.852328
560586,485,1847,2332,1.370343,103.853453
560587,540,1661,2201,1.370236,103.852422
560588,154,1646,1800,1.372154,103.853414
560589,50,1717,1767,1.371353,103.854091
560590,4,2,6,1.299509,103.837
560591,2,1,3,1.369453,103.833558
560596,18,493,511,1.372388,103.85146
560601,137,986,1123,1.380965,103.834765
560602,520,485,1005,1.380634,103.835088
560603,418,883,1301,1.380128,103.835397
560604,359,336,695,1.379907,103.835824
560605,283,211,494,1.379677,103.836207
560606,309,319,628,1.379201,103.8363
560607,793,676,1469,1.380428,103.838706
560608,457,466,923,1.378777,103.836717
560609,648,408,1056,1.379275,103.837334
560610,304,2529,2833,1.379335,103.838932
560611,435,16,451,1.378346,103.837073
560612,433,56,489,1.378915,103.838014
560613,408,317,725,1.378466,103.839134
560614,493,194,687,1.378147,103.839161
560615,334,948,1282,1.377525,103.8386
560616,232,859,1091,1.377505,103.838968
560617,243,3942,4185,1.377595,103.838024
560618,500,243,743,1.378096,103.838254
560619,423,144,567,1.378639,103.838502
560620,151,1735,1886,1.382467,103.839421
560621,111,8833,8944,1.383045,103.8406
560622,226,313,539,1.382048,103.839658
560623,366,1947,2313,1.382653,103.840837
560624,454,428,882,1.381588,103.839876
560625,395,2747,3142,1.382273,103.841187
560626,91,3271,3362,1.381182,103.840116
560627,217,1122,1339,1.381903,103.841327
560628,186,5791,5977,1.380977,103.840658
560629,588,10895,11483,1.380134,103.839797
560630,56,1211,1267,1.380585,103.840906
560631,730,1146,1876,1.379578,103.840731
560632,73,5682,5755,1.379999,103.841406
560633,1753,464,2217,1.381147,103.842282
560634,430,3035,3465,1.381497,103.843225
560635,469,245,714,1.380811,103.842315
560636,359,1500,1859,1.381187,103.843264
560637,304,166,470,1.38037,103.842256
560638,296,1115,1411,1.380483,103.843467
560639,356,3905,4261,1.379877,103.842309
560640,363,4029,4392,1.380001,103.843571
560641,420,6414,6834,1.378985,103.839949
560642,280,697,977,1.377949,103.840714
560643,371,3313,3684,1.377515,103.840568
560644,670,346,1016,1.379137,103.840956
560645,441,2852,3293,1.379222,103.842271
560646,372,3390,3762,1.379296,103.843786
560647,272,552,824,1.378904,103.843395
560648,445,1990,2435,1.378252,103.843631
560649,382,4398,4780,1.377772,103.843635
560650,832,1186,2018,1.377706,103.842809
560700,18,325,343,1.370145,103.846452
560702,6,182,188,1.370073,103.847542
560703,14,143,157,1.369998,103.847311
560704,128,284,412,1.370127,103.847291
560705,40,194,234,1.370157,103.847513
560709,94,74,168,1.371124,103.847654
560710,179,15556,15735,1.371042,103.84818
560711,48,6962,7010,1.371438,103.847915
560712,22,40,62,1.371428,103.847103
560713,225,190,415,1.371464,103.846517
560714,506,228,734,1.371121,103.846223
560715,164,4714,4878,1.371011,103.845942
560716,120,8338,8458,1.371466,103.845862
560718,7,0,7,1.37736,103.84283
560720,61,74,135,1.371796,103.84701
560721,107,7408,7515,1.372561,103.847542
560722,26,111,137,1.372236,103.847521
560723,1276,5306,6582,1.372402,103.847305
560724,20,0,20,1.372185,103.846562
560725,325,1977,2302,1.372811,103.84691
560726,264,1342,1606,1.372778,103.846465
560727,81,156,237,1.373029,103.845959
560728,163,5143,5306,1.372648,103.845701
560729,121,584,705,1.373866,103.84593
560730,194,3806,4000,1.373221,103.845823
561104,319,1154,1473,1.372031,103.8386
561130,165,193,358,1.370685,103.842227
561132,125,188,313,1.371793,103.842074
561206,6,3353,3359,1.299509,103.837
561207,73,549,622,1.366059,103.842083
561220,9,353,362,1.299509,103.837
561226,121,2040,2161,1.367489,103.839307
561253,594,97,691,1.370103,103.83416
561255,211,90,301,1.370455,103.834654
561256,31,86,117,1.370384,103.835926
561260,208,7,215,1.3687,103.834632
561306,1,140,141,1.365355,103.846099
561307,390,5373,5763,1.365971,103.844469
561308,614,2235,2849,1.365497,103.844098
561309,3,11,14,1.365025,103.846094
561310,887,2902,3789,1.364814,103.843865
561315,17,93,110,1.364395,103.847124
561323,7,207,214,1.367701,103.847752
561325,50,173,223,1.367538,103.84691
561347,7,198,205,1.36734,103.848914
561352,25,32,57,1.364103,103.85093
561354,78,3940,4018,1.364379,103.851749
561409,62,26606,26668,1.362475,103.85546
561415,117,1537,1654,1.364331,103.854453
561424,24,432,456,1.368173,103.85115
561453,91,30,121,1.367925,103.856773
561455,35,101,136,1.299509,103.837
561456,21,844,865,1.368055,103.85691
561460,28,979,1007,1.36663,103.859
561552,7,164,171,1.299509,103.837
561588,767,148,915,1.371353,103.854091
561590,5,501,506,1.299509,103.837
561591,2,0,2,1.363818,103.867855
561596,817,2862,3679,1.37258,103.850842
561602,5,214,219,1.299509,103.837
561613,2,401,403,1.377962,103.838977
561628,12,1511,1523,1.380678,103.840285
561632,13,2762,2775,1.37948,103.841483
561700,536,2174,2710,1.370008,103.84608
561710,32,261,293,1.370649,103.848021
561712,81,118,199,1.370354,103.846854
562104,13,158,171,1.371933,103.838351
562130,13,19,32,1.370785,103.84135
562226,50,1198,1248,1.367338,103.839576
562260,54,6,60,1.299509,103.837
562307,485,281,766,1.365781,103.844731
562308,483,181,664,1.365242,103.844454
562309,1500,163,1663,1.365018,103.845287
562310,697,2282,2979,1.364567,103.844142
562315,588,2042,2630,1.364259,103.846876
562316,1028,410,1438,1.364785,103.84693
562455,18,75,93,1.299509,103.837
562588,537,118,655,1.371353,103.854091
562590,5,42,47,1.299509,103.837
562591,2,5,7,1.299509,103.837
562596,780,287,1067,1.372127,103.850482
562700,859,2899,3758,1.369435,103.846052
563226,40,106,146,1.367159,103.839302
563260,2,8,10,1.299509,103.837
563307,725,266,991,1.365584,103.845157
563308,16,250,266,1.365113,103.844586
563309,7,391,398,1.364915,103.846179
563310,409,1998,2407,1.364626,103.844869
563315,952,1876,2828,1.364145,103.847474
563316,39,219,258,1.364831,103.847772
563455,26,191,217,1.299509,103.837
563588,465,115,580,1.371353,103.854091
563590,2,3,5,1.299509,103.837
563596,667,298,965,1.372111,103.850064
563700,567,733,1300,1.369426,103.846429
564226,17,76,93,1.366795,103.839176
564260,0,27,27,1.299509,103.837
564307,34,153,187,1.365207,103.846264
564310,22,2550,2572,1.364571,103.84517
564455,3,467,470,1.299509,103.837
564588,1041,882,1923,1.371353,103.854091
564596,658,178,836,1.371972,103.850869
564700,14,199,213,1.369779,103.847
565226,15,406,421,1.36627,103.839982
566226,15,3,18,1.366629,103.840074
567226,51,96,147,1.366851,103.839876
567695,25,47,72,1.375487,103.834083
567696,42,103,145,1.299509,103.837
567697,7,3,10,1.299509,103.837
567698,2,1,3,1.299509,103.837
567699,3,8,11,1.299509,103.837
567700,0,17,17,1.390351,103.847208
567701,1,2,3,1.299509,103.837
567705,0,4,4,1.36507,103.868589
567706,0,343,343,1.299509,103.837
567710,2158,1058,3216,1.389846,103.847698
567711,346,199,545,1.391198,103.849259
567712,6,2921,2927,1.299509,103.837
567713,38,1601,1639,1.299509,103.837
567720,2744,221,2965,1.377704,103.855486
567725,55,3592,3647,1.299509,103.837
567726,23,96,119,1.299509,103.837
567727,19,2646,2665,1.299509,103.837
567730,43,15,58,1.359256,103.859785
567736,325,2964,3289,1.37965,103.846179
567737,91,11,102,1.299509,103.837
567738,158,383,541,1.299509,103.837
567739,169,249,418,1.377523,103.848837
567740,128,1377,1505,1.372429,103.844726
567741,1016,47,1063,1.375516,103.846776
567742,145,2812,2957,1.375388,103.847227
567743,896,592,1488,1.375445,103.846995
567744,334,511,845,1.375455,103.847336
567745,824,740,1564,1.375622,103.847471
567746,754,559,1313,1.37622,103.847378
567747,453,296,749,1.376455,103.847187
567748,343,457,800,1.376487,103.846949
567749,365,1052,1417,1.376517,103.846662
567750,14,788,802,1.381865,103.846706
567752,3269,2792,6061,1.370436,103.848739
567753,29,4093,4122,1.374801,103.847785
567754,117,0,117,1.386153,103.852981
567757,7,0,7,1.386147,103.853007
567759,620,1,621,1.386127,103.852978
567760,587,4416,5003,1.378008,103.870243
567761,359,792,1151,1.377348,103.870786
567762,245,101,346,1.37604,103.833674
567763,70,7,77,1.375959,103.833652
567764,2,6,8,1.375959,103.833652
567765,0,3,3,1.299509,103.837
567766,7,5,12,1.375856,103.833512
567767,15,4,19,1.375841,103.833498
567768,0,3,3,1.375894,103.833556
567769,0,2,2,1.371294,103.852351
567770,17,2,19,1.375702,103.833383
567771,7,2,9,1.375641,103.833332
567772,2,5,7,1.375617,103.833306
567773,1,2,3,1.375787,103.833447
567774,3,0,3,1.37556,103.833281
567775,3,2,5,1.375484,103.833217
567776,7,7,14,1.375456,103.833189
567777,0,5,5,1.375408,103.833157
567778,106,4,110,1.375364,103.833111
567779,0,7,7,1.375286,103.833121
567780,5,50,55,1.375213,103.833091
567781,16,35,51,1.375183,103.833048
567782,65,7,72,1.375172,103.832941
567783,4,2,6,1.375205,103.832876
567784,2,3,5,1.375202,103.832831
567785,4,0,4,1.299509,103.837
567786,23,2,25,1.375189,103.83272
567787,5,5,10,1.376028,103.833645
567788,62,1,63,1.375902,103.833504
567789,2,1,3,1.375527,103.833263
567790,23,0,23,1.375875,103.833459
567791,116,0,116,1.375829,103.833365
567792,12,0,12,1.375871,103.833249
567793,10,0,10,1.375803,103.833231
567794,15,1,16,1.375762,103.833185
567796,30,0,30,1.375695,103.833148
567797,4,0,4,1.375204,103.832795
567799,4,1,5,1.375535,103.833053
567800,159,1,160,1.375506,103.833027
567801,40,0,40,1.375434,103.833002
567803,8,3,11,1.375367,103.832953
567804,20,1,21,1.375538,103.832876
567805,2,0,2,1.375755,103.833413
567806,14,1,15,1.375672,103.83275
567807,18,0,18,1.375688,103.83275
567808,6,1,7,1.375758,103.832957
567809,2,2,4,1.375651,103.833117
567811,1,0,1,1.365116,103.868703
567812,49,0,49,1.376028,103.833157
567813,5,0,5,1.376091,103.8332
567814,4,0,4,1.375875,103.833048
567817,4,1,5,1.376041,103.833533
567818,1,0,1,1.376005,103.8331
567819,1,0,1,1.376076,103.833601
567820,2,0,2,1.375571,103.832839
567821,65,1,66,1.376152,103.833716
567822,6,1,7,1.376167,103.833738
567823,0,1,1,1.376101,103.833645
567826,2,7,9,1.376494,103.834068
567827,19,7,26,1.376464,103.834031
567828,46,49,95,1.376284,103.83393
567829,0,1,1,1.376217,103.83382
567830,4,0,4,1.375922,103.833327
567831,1,0,1,1.376357,103.833872
567832,7,0,7,1.376475,103.83376
567833,1,1,2,1.376135,103.833689
567834,7,0,7,1.376536,103.833696
567835,6,0,6,1.376574,103.833656
567836,0,1,1,1.376437,103.833807
567837,1,0,1,1.376664,103.833661
567838,0,2,2,1.376511,103.833726
567839,3,0,3,1.375887,103.833486
567841,0,1,1,1.376691,103.833626
567842,13,1,14,1.376964,103.83361
567843,0,1,1,1.376898,103.833582
567844,4,1,5,1.377097,103.833566
567845,0,4,4,1.376398,103.833859
567846,86,2,88,1.377197,103.833541
567847,2,2,4,1.377148,103.833545
567848,7,1,8,1.377304,103.833522
567849,13,1,14,1.377329,103.833511
567850,2,0,2,1.376747,103.833618
567851,2,1,3,1.376827,103.833624
567853,16,7,23,1.377549,103.83351
567854,21,6,27,1.377335,103.833702
567855,64,0,64,1.377247,103.833716
567856,2,1,3,1.377435,103.833531
567857,13,4,17,1.377138,103.833725
567858,0,1,1,1.377034,103.833568
567859,0,2,2,1.377391,103.833508
567860,1,0,1,1.377117,103.833703
567861,192,1,193,1.376957,103.833738
567862,6,2,8,1.376875,103.83375
567863,1,0,1,1.376988,103.833731
567864,6,0,6,1.376762,103.833791
567865,2,2,4,1.377254,103.833538
567866,3,0,3,1.377192,103.833687
567867,5,0,5,1.376594,103.833961
567868,20,3,23,1.376605,103.834006
567869,18,0,18,1.376641,103.834047
567870,4,2,6,1.376678,103.83409
567871,8,0,8,1.376738,103.834105
567872,2,4,6,1.376736,103.83418
567873,0,2,2,1.377064,103.83374
567874,23,0,23,1.376813,103.834237
567876,0,3,3,1.376502,103.833942
567877,2,1,3,1.376796,103.834374
567878,7,3,10,1.37688,103.834488
567879,12,0,12,1.376902,103.834506
567880,26,1,27,1.376946,103.834539
567881,19,0,19,1.377007,103.834586
567882,11,1,12,1.377035,103.834634
567883,7,5,12,1.377054,103.83466
567884,1,1,2,1.376805,103.834219
567885,0,4,4,1.37674,103.833799
567886,8,5,13,1.376547,103.834032
567887,23,2,25,1.376937,103.833916
567888,141,1,142,1.37698,103.833897
567889,5,2,7,1.377043,103.833873
567890,4,2,6,1.377086,103.833865
567891,5,3,8,1.377177,103.833879
567892,9,5,14,1.377259,103.83387
567893,39,2,41,1.377287,103.833822
567894,4,8,12,1.376646,103.834282
567895,10,2,12,1.37756,103.833631
567896,1,5,6,1.377539,103.833692
567897,4,5,9,1.37752,103.83373
567898,7,5,12,1.377527,103.833813
567899,47,4,51,1.377503,103.833839
567900,0,2,2,1.376529,103.833993
567901,100,5,105,1.377448,103.83396
567902,53,2,55,1.377403,103.833976
567903,13,2,15,1.377382,103.834062
567904,31,5,36,1.377356,103.834101
567905,3,1,4,1.37656,103.834072
567906,0,1,1,1.376824,103.833781
567907,41,5,46,1.377331,103.834227
567908,0,3,3,1.376847,103.834457
567909,30,1,31,1.377258,103.834369
567910,1,2,3,1.377284,103.834308
567911,1,2,3,1.377295,103.834407
567912,17,3,20,1.377291,103.834548
567913,14,3,17,1.3773,103.834602
567914,0,2,2,1.377451,103.833884
567916,2,2,4,1.377337,103.83413
567917,3,0,3,1.377278,103.834464
567918,1,2,3,1.377357,103.834779
567919,1,1,2,1.377331,103.834624
567920,1,1,2,1.377375,103.834899
567921,2,2,4,1.377317,103.834755
567922,21,69,90,1.377376,103.835078
567923,6,6,12,1.377452,103.835437
567924,1,3,4,1.377357,103.835027
567925,9,0,9,1.377504,103.83537
567927,42,0,42,1.377563,103.835424
567928,6,1,7,1.377588,103.835447
567929,34,1,35,1.377615,103.835471
567930,67,5,72,1.377646,103.835502
567931,0,2,2,1.377381,103.834946
567932,4,3,7,1.377688,103.835551
567933,4,0,4,1.377481,103.835353
567934,67,0,67,1.378108,103.835564
567935,15,0,15,1.378098,103.835606
567936,3,0,3,1.377338,103.834837
567937,2,0,2,1.377689,103.835544
567939,2,0,2,1.378158,103.835715
567940,1,1,2,1.378202,103.835788
567941,5,1605,1610,1.378207,103.835915
567942,46,1,47,1.378011,103.835742
567943,11,0,11,1.377984,103.835727
567944,7,1,8,1.377718,103.835591
567945,3,4,7,1.377752,103.835617
567946,85,2,87,1.377769,103.83564
567947,9,1,10,1.377817,103.83569
567948,4,2,6,1.377811,103.835494
567949,8,4,12,1.377559,103.835545
567950,24,1,25,1.377582,103.835559
567951,51,86,137,1.377601,103.83559
567952,0,24,24,1.377622,103.835619
567953,1,16,17,1.377645,103.83564
567954,6,20,26,1.377674,103.835677
567955,7,33,40,1.377702,103.835711
567956,7,19,26,1.377719,103.835733
567957,2,9,11,1.377744,103.835772
567958,8,15,23,1.377792,103.835826
567959,68,9,77,1.377836,103.835876
567960,0,5,5,1.377886,103.835951
567961,2,20,22,1.377939,103.835944
567962,1,16,17,1.378,103.835966
567963,1,1922,1923,1.377999,103.835998
567964,0,3,3,1.378113,103.835668
567965,12,125,137,1.371939,103.832759
567966,0,4,4,1.378056,103.835481
567967,5,0,5,1.371965,103.832731
567968,0,1,1,1.377346,103.83421
567970,13,3,16,1.371954,103.832507
567971,3,0,3,1.37184,103.832676
567972,9,1,10,1.371991,103.832469
567973,1,0,1,1.371884,103.832589
567974,84,9,93,1.372034,103.832423
567975,10,0,10,1.372082,103.832578
567976,12,0,12,1.37207,103.832385
567977,3,4,7,1.372115,103.832543
567978,3,9,12,1.372107,103.832342
567979,0,12,12,1.372597,103.832517
567980,2,2,4,1.371857,103.832631
567981,1,0,1,1.372049,103.832615
567982,14,0,14,1.372177,103.832258
567983,4,1,5,1.37255,103.832665
567984,25,0,25,1.372207,103.832245
567986,3,0,3,1.372015,103.832663
567987,4,3,7,1.372518,103.832793
567988,2,0,2,1.378222,103.835867
567989,1,0,1,1.372573,103.832591
567990,10,0,10,1.372352,103.832264
567991,25,41,66,1.372489,103.832894
567992,5,0,5,1.372396,103.832283
567993,30,51,81,1.372628,103.832779
567994,6,2,8,1.372445,103.832298
567995,8,0,8,1.372653,103.832724
567996,40,0,40,1.372502,103.832321
567997,2,2,4,1.372143,103.832296
567998,2,2,4,1.372683,103.832669
567999,1,0,1,1.372499,103.832846
568000,22,0,22,1.372596,103.832363
568001,21,8,29,1.372717,103.832557
568002,9,26,35,1.372656,103.832391
568003,5,15,20,1.37294,103.832619
568004,14,0,14,1.372703,103.832458
568005,2,20,22,1.373007,103.832642
568006,2,2,4,1.372546,103.83234
568007,7,17,24,1.37305,103.832665
568008,23,0,23,1.372777,103.832482
568009,0,1,1,1.372696,103.832619
568011,70,19,89,1.373161,103.832701
568013,2,18,20,1.373212,103.832722
568014,1,3,4,1.372727,103.832466
568015,18,54,72,1.37329,103.832728
568016,2,1,3,1.372257,103.832235
568017,1,2,3,1.372974,103.832547
568018,4,3,7,1.373073,103.83258
568021,3,0,3,1.373024,103.832564
568022,8,0,8,1.373344,103.832653
568024,3,0,3,1.373221,103.832629
568025,0,3,3,1.373473,103.832706
568026,8,4,12,1.373563,103.83273
568027,2,3,5,1.373644,103.832747
568028,8,3,11,1.373682,103.832744
568029,5,4,9,1.373783,103.832754
568030,1,2,3,1.37353,103.832728
568031,0,2,2,1.372306,103.832243
568032,1,2,3,1.373852,103.832747
568033,1,2,3,1.373962,103.832749
568034,0,3,3,1.37401,103.832747
568035,1,0,1,1.3731,103.832682
568036,2,5,7,1.374205,103.832753
568037,8,4,12,1.374291,103.83276
568038,1,6,7,1.374428,103.832753
568039,1,1,2,1.3739,103.832739
568040,2,1,3,1.374084,103.832737
568041,4,0,4,1.372925,103.832531
568042,1,8,9,1.374689,103.832749
568043,3,3,6,1.37474,103.83277
568044,26,2,28,1.374708,103.832778
568045,7,5,12,1.374784,103.83278
568046,1234,2051,3285,1.380399,103.84615
568047,692,565,1257,1.377379,103.868828
568049,243,1720,1963,1.377913,103.868356
568050,177,1659,1836,1.377589,103.868802
568051,11,7,18,1.380943,103.836562
568052,6,9,15,1.380956,103.836808
568053,1,0,1,1.374131,103.832745
568054,0,2,2,1.37447,103.83276
568056,1,0,1,1.380985,103.836594
568057,6,0,6,1.381061,103.836688
568058,3,0,3,1.374525,103.832758
568059,13,23,36,1.381102,103.836716
568060,6,0,6,1.380753,103.836961
568061,0,1,1,1.380856,103.836874
568062,4,3,7,1.380703,103.836995
568064,6,2,8,1.381187,103.83683
568066,1,2,3,1.380804,103.836917
568067,3,4,7,1.381056,103.836866
568068,1,0,1,1.381133,103.836765
568069,29,3,32,1.3811,103.836937
568070,10,1,11,1.381443,103.837138
568071,1,0,1,1.381323,103.836985
568073,43,4,47,1.381199,103.837055
568076,3,0,3,1.381271,103.836944
568077,5,1,6,1.381297,103.837162
568078,0,2,2,1.380906,103.836841
568079,4,0,4,1.374599,103.832761
568081,25,0,25,1.38141,103.837314
568082,5,28,33,1.3817,103.837502
568084,5,1,6,1.381732,103.837549
568085,3,1,4,1.381349,103.837221
568087,3,1,4,1.381498,103.837422
568088,75,1,76,1.381838,103.837676
568091,1,0,1,1.381151,103.836992
568092,4,1,5,1.381938,103.837803
568094,31,2,33,1.381981,103.83786
568095,8,1,9,1.381747,103.837738
568096,2,0,2,1.381647,103.837429
568097,2,2,4,1.381542,103.837485
568098,2,1,3,1.381589,103.837359
568099,6,0,6,1.381853,103.837876
568100,1,0,1,1.381648,103.837608
568101,2,0,2,1.382022,103.837923
568103,0,1,1,1.382095,103.838047
568104,2,0,2,1.381885,103.837919
568105,3,11,14,1.38194,103.837986
568106,1,0,1,1.381916,103.837955
568107,0,252,252,1.382236,103.838276
568108,3,3,6,1.381568,103.838271
568109,6,15,21,1.382011,103.838057
568110,1,0,1,1.382201,103.838245
568113,26,2,28,1.381884,103.83815
568114,1,0,1,1.381542,103.838235
568115,6,0,6,1.381824,103.838188
568116,24,0,24,1.381439,103.838124
568118,5,7,12,1.381396,103.838069
568119,0,479,479,1.381702,103.83827
568121,1,3,4,1.381806,103.837817
568122,0,3,3,1.382057,103.837982
568123,1,0,1,1.38148,103.838174
568124,2,0,2,1.382171,103.838177
568125,2,34,36,1.381491,103.838435
568126,4,1,5,1.381512,103.837461
568127,0,62,62,1.381437,103.838467
568128,8,0,8,1.38109,103.837706
568129,2,44,46,1.381364,103.838516
568131,0,2,2,1.381269,103.837913
568132,1,0,1,1.381568,103.838377
568133,0,905,905,1.381206,103.838627
568134,15,0,15,1.381036,103.837771
568135,20,3089,3109,1.381144,103.838682
568136,1,0,1,1.380979,103.837709
568137,10,0,10,1.381155,103.837895
568138,1,0,1,1.381102,103.837838
568139,8,0,8,1.381242,103.83799
568140,1,1,2,1.381277,103.838581
568141,29,0,29,1.381345,103.838097
568142,7,1,8,1.381392,103.838156
568145,3,4,7,1.381518,103.83831
568146,1,10,11,1.381033,103.838637
568147,95,0,95,1.380982,103.838578
568149,0,9,9,1.38086,103.838416
568150,2,0,2,1.381293,103.838053
568151,0,16,16,1.38071,103.838243
568152,4,1,5,1.380666,103.83818
568153,1,2,3,1.381312,103.837956
568155,6,8,14,1.380578,103.838039
568156,0,5,5,1.380538,103.837993
568157,3,17,20,1.380489,103.837932
568158,4,0,4,1.381637,103.838318
568159,3,1,4,1.38056,103.837103
568160,12,16,28,1.380143,103.837551
568161,0,10,10,1.380071,103.837443
568162,0,31,31,1.380021,103.837178
568163,2,1,3,1.380651,103.83813
568164,6,2,8,1.380277,103.837012
568165,0,2,2,1.380793,103.838329
568166,3,0,3,1.380147,103.837075
568178,9,53,62,1.370039,103.832272
568179,7,33,40,1.369731,103.832377
568180,36,31,67,1.369655,103.832362
568182,14,6,20,1.369946,103.832448
568183,19,1,20,1.36961,103.832359
568184,7,1,8,1.36986,103.832611
568185,3,11,14,1.369531,103.832381
568186,11,1,12,1.369864,103.832757
568187,9,12,21,1.369421,103.832417
568189,4,8,12,1.369192,103.832383
568190,22,2,24,1.370364,103.832886
568191,6,1,7,1.369201,103.832509
568192,2,0,2,1.380381,103.836954
568193,12,38,50,1.369348,103.832436
568194,1,0,1,1.381195,103.837931
568195,82,8,90,1.369781,103.832783
568196,102,2,104,1.370392,103.832594
568197,1,20,21,1.369418,103.832536
568198,11,100,111,1.37041,103.832514
568199,7,2,9,1.369668,103.8325
568200,19,44,63,1.370499,103.832707
568201,1,0,1,1.370365,103.83269
568202,0,4,4,1.380533,103.837197
568203,3,0,3,1.38081,103.836789
568204,4,0,4,1.370473,103.832815
568205,0,2,2,1.370358,103.832789
568206,20,0,20,1.370482,103.833009
568207,0,1,1,1.369598,103.832466
568208,113,1,114,1.370477,103.833106
568209,1,0,1,1.36975,103.833118
568210,20,0,20,1.370465,103.833299
568211,124,8,132,1.370454,103.833396
568212,33,0,33,1.370442,103.833504
568213,3,1,4,1.370488,103.832907
568214,96,2,98,1.370425,103.833709
568215,93,1,94,1.370408,103.833758
568216,6,6,12,1.370414,103.833801
568217,7,2,9,1.370322,103.833537
568218,9,0,9,1.370348,103.833402
568219,1,0,1,1.370465,103.833208
568220,4,1,5,1.370318,103.833242
568221,1,3,4,1.370437,103.833601
568222,1,1,2,1.369599,103.832949
568223,6,0,6,1.36987,103.83315
568224,14,0,14,1.369847,103.833266
568226,75,2980,3055,1.367211,103.840017
568245,0,76,76,1.371055,103.832928
568246,0,29,29,1.370923,103.832749
568247,0,8,8,1.371049,103.833019
568248,4,0,4,1.370321,103.833169
568249,3,2,5,1.371038,103.833138
568250,40,11,51,1.3709,103.832948
568251,3,6,9,1.371032,103.833229
568252,1,8,9,1.370895,103.833045
568253,32,9,41,1.37102,103.833366
568254,0,3,3,1.369623,103.832844
568255,1,0,1,1.370318,103.833319
568256,4,0,4,1.370917,103.832828
568257,1,7,8,1.371009,103.833599
568258,9,0,9,1.370878,103.833341
568259,10,10,20,1.370998,103.833707
568260,25,1,26,1.370872,103.833432
568262,1,0,1,1.371015,103.833463
568263,4,0,4,1.370877,103.833255
568264,0,2,2,1.369866,103.833073
568312,5,20,25,1.354543,103.859001
568313,5,144,149,1.354552,103.858872
568314,0,3,3,1.370883,103.833153
568315,0,16,16,1.354581,103.858666
568316,24,465,489,1.354604,103.858598
568317,9,745,754,1.354543,103.858544
568318,0,3,3,1.354569,103.858753
568319,3,1,4,1.370849,103.833739
568320,0,14,14,1.354529,103.858611
568321,36,0,36,1.354503,103.858739
568323,3,11,14,1.354469,103.859012
568344,80,7,87,1.35404,103.859468
568346,54,99,153,1.354327,103.85931
568347,2,4,6,1.353933,103.859743
568348,1,3,4,1.354507,103.858683
568349,150,8,158,1.353667,103.859683
568350,32,32,64,1.354523,103.859443
568351,5,14,19,1.353696,103.859797
568353,40,3,43,1.353824,103.859823
568354,51,0,51,1.354344,103.859395
568355,1,15,16,1.353836,103.86016
568356,2,1,3,1.354611,103.858551
568357,73,1,74,1.353773,103.860339
568358,38,8,46,1.354124,103.859452
568359,2,28,30,1.353718,103.860533
568360,1,0,1,1.370855,103.833637
568361,7,0,7,1.35371,103.860627
568362,9,0,9,1.354111,103.859523
568363,36,1,37,1.353684,103.860713
568364,2,0,2,1.370843,103.833836
568365,14,0,14,1.353676,103.860832
568366,15,0,15,1.354085,103.859574
568367,5,1,6,1.353641,103.860943
568368,9,7,16,1.354077,103.859608
568369,1,1,2,1.354094,103.859548
568370,0,2,2,1.353607,103.861054
568371,0,2,2,1.354075,103.85979
568372,3,1,4,1.353796,103.859717
568373,1,0,1,1.354098,103.859478
568374,0,1,1,1.353573,103.861233
568375,0,2,2,1.35359,103.861139
568376,9,27,36,1.35443,103.85994
568377,10,6,16,1.353538,103.861396
568378,3,26,29,1.354378,103.859939
568379,3,1,4,1.35423,103.859807
568380,1,0,1,1.354367,103.859866
568381,5,4,9,1.35404,103.859867
568382,0,1,1,1.354169,103.859918
568383,1,6,7,1.353953,103.860102
568384,4,0,4,1.354297,103.859935
568385,6,3,9,1.353953,103.860166
568386,0,1,1,1.353987,103.859954
568387,43,4,47,1.353935,103.860276
568388,44,1,45,1.353851,103.860578
568389,1,1,2,1.353547,103.86131
568390,2,0,2,1.353843,103.860612
568391,1,2,3,1.354189,103.859353
568392,1,0,1,1.353961,103.860217
568393,0,15,15,1.353826,103.860766
568395,1,4,5,1.353933,103.86094
568396,26,2,28,1.354053,103.861
568397,0,71,71,1.354127,103.86112
568398,0,206,206,1.354075,103.8611
568399,16,0,16,1.353914,103.861047
568401,2,1,3,1.353834,103.860681
568402,14,2,16,1.353711,103.861141
568404,2,0,2,1.353843,103.860647
568406,2,0,2,1.353674,103.861266
568407,1,2,3,1.353775,103.861027
568408,0,2,2,1.353632,103.8614
568409,1,3,4,1.353973,103.860042
568410,5,1,6,1.354021,103.861088
568411,4,279,283,1.353981,103.861073
568412,3,134,137,1.353564,103.861764
568413,3,3,6,1.353542,103.861811
568414,0,4,4,1.353732,103.861532
568415,3,3,6,1.353582,103.861702
568416,0,4,4,1.353516,103.861862
568417,0,1,1,1.353834,103.860723
568418,1,1,2,1.353658,103.861507
568420,1,19,20,1.353874,103.862241
568421,20,54,74,1.353953,103.862266
568422,2,6,8,1.353558,103.861886
568423,43,26,69,1.353548,103.862002
568424,1,1,2,1.353498,103.861992
568425,41,486,527,1.353613,103.861736
568426,1132,496,1628,1.353125,103.862753
568427,1272,349,1621,1.352741,103.863052
568428,53,3,56,1.352795,103.86251
568429,1487,5169,6656,1.35199,103.862287
568430,1898,113,2011,1.352429,103.862172
568431,1191,297,1488,1.352872,103.862313
568446,10,96,106,1.354344,103.860554
568447,6,136,142,1.354409,103.860482
568448,2,3,5,1.354198,103.860529
568449,0,1,1,1.353514,103.862053
568450,0,4,4,1.353618,103.861612
568451,36,2,38,1.354117,103.860405
568452,37,1,38,1.353923,103.860435
568453,1,2,3,1.353635,103.861487
568454,2,17,19,1.353272,103.860382
568455,30,7,37,1.353666,103.860282
568456,1,0,1,1.354255,103.860441
568457,3,0,3,1.353995,103.860387
568459,13,2,15,1.353476,103.860265
568461,1,20,21,1.353394,103.860211
568462,5,1,6,1.353178,103.860715
568463,90,13,103,1.353177,103.860373
568464,0,1,1,1.353246,103.860467
568465,54,79,133,1.353126,103.860501
568466,9,2,11,1.353135,103.860885
568467,2,45,47,1.353092,103.860655
568468,3,1,4,1.354043,103.860494
568469,115,20,135,1.353075,103.8608
568470,3,3,6,1.353092,103.861056
568471,7,5,12,1.353049,103.860945
568472,26,3,29,1.353075,103.861133
568473,2,5,7,1.352989,103.861116
568474,38,7,45,1.353058,103.861219
568475,0,7,7,1.352963,103.86127
568476,6,25,31,1.352932,103.861323
568477,1,5,6,1.352794,103.861314
568478,1,5,6,1.352666,103.861289
568479,7,90,97,1.352537,103.861272
568500,6,0,6,1.371742,103.839373
568501,3,2,5,1.372063,103.839612
568502,2,0,2,1.353598,103.861824
568503,9,0,9,1.372073,103.83967
568506,0,1,1,1.353152,103.8608
568508,48,1,49,1.372226,103.839895
568509,14,0,14,1.372092,103.839804
568510,0,2,2,1.372209,103.839744
568511,3,1,4,1.353109,103.860971
568513,4,2,6,1.372097,103.84005
568514,1,0,1,1.372217,103.839819
568516,0,3,3,1.35358,103.860273
568517,16,2,18,1.372145,103.840339
568518,0,4,4,1.372095,103.839916
568520,9,0,9,1.372174,103.840422
568521,2,0,2,1.372098,103.839843
568522,3,0,3,1.372133,103.840267
568523,1,1,2,1.372194,103.840484
568524,2,1,3,1.372193,103.840574
568525,0,2,2,1.372219,103.840639
568526,1,0,1,1.372121,103.840159
568528,2,1,3,1.372225,103.840685
568550,11,0,11,1.371591,103.839789
568551,13,0,13,1.371598,103.839868
568552,0,1,1,1.37223,103.840816
568553,0,2,2,1.372225,103.840753
568555,1,0,1,1.371594,103.839939
568557,1,0,1,1.371515,103.839939
568558,6,2,8,1.371642,103.840078
568560,108,0,108,1.371646,103.84018
568561,1,0,1,1.371522,103.83998
568562,13,5,18,1.37166,103.840249
568563,7,5,12,1.37153,103.840191
568564,16,0,16,1.371646,103.840303
568565,8,0,8,1.371529,103.840252
568567,3,0,3,1.372248,103.840947
568569,2,0,2,1.371522,103.839843
568571,5,0,5,1.371573,103.840429
568573,0,5,5,1.37158,103.840506
568574,4,0,4,1.372158,103.840383
568575,2,0,2,1.371575,103.84037
568577,3,0,3,1.371547,103.84025
568578,2,0,2,1.371593,103.840548
568579,3,0,3,1.371593,103.840618
568583,3,0,3,1.37161,103.840685
568584,8,0,8,1.371721,103.840933
568585,4,0,4,1.371665,103.840562
568586,0,5,5,1.371719,103.840995
568587,2,2,4,1.371629,103.840907
568608,0,55,55,1.37041,103.840318
568609,1,3,4,1.371628,103.840969
568610,0,3,3,1.37163,103.840837
568613,31,1,32,1.370373,103.840547
568614,2,0,2,1.371721,103.840774
568616,33,6,39,1.370451,103.840528
568617,0,4,4,1.370252,103.840424
568618,0,2,2,1.370442,103.840489
568620,25,0,25,1.370461,103.840724
568621,3,0,3,1.370434,103.840414
568623,2,1,3,1.370404,103.84078
568624,0,13,13,1.370488,103.840809
568625,30,0,30,1.370424,103.840898
568627,9,0,9,1.370442,103.840917
568628,4,5,9,1.370504,103.840949
568650,77,0,77,1.371993,103.838988
568651,1,5,6,1.372061,103.838874
568652,0,3,3,1.37042,103.840845
568653,2,3,5,1.372141,103.838715
568654,1,12,13,1.372311,103.838672
568655,0,3,3,1.372104,103.838776
568656,1,2,3,1.372229,103.838483
568657,2,11,13,1.372328,103.838287
568658,6,21,27,1.372521,103.83814
568659,1,0,1,1.371526,103.84007
568660,8,1,9,1.372826,103.838143
568661,0,27,27,1.372928,103.838269
568682,0,5,5,1.373674,103.83931
568683,9,0,9,1.373543,103.839254
568684,2,0,2,1.37045,103.840673
568686,3,2,5,1.373661,103.839372
568687,7,0,7,1.373523,103.839444
568689,2,1,3,1.372302,103.838345
568690,14,32,46,1.373598,103.839759
568691,1,0,1,1.372467,103.838153
568693,45,5,50,1.373477,103.839751
568695,6,0,6,1.373454,103.839859
568696,22,3,25,1.37357,103.839902
568697,13,0,13,1.37342,103.839956
568698,1,3,4,1.370379,103.840656
568699,11,0,11,1.373385,103.840087
568700,0,3,3,1.373511,103.839546
568701,12,0,12,1.373345,103.840161
568702,0,29,29,1.373444,103.840259
568703,3,1,4,1.373524,103.840027
568704,32,0,32,1.373381,103.840334
568705,35,1,36,1.373151,103.840354
568706,2,0,2,1.373678,103.839253
568707,3,1,4,1.373236,103.840292
568708,9,1,10,1.373146,103.840488
568710,1,2,3,1.373489,103.840124
568711,6,3,9,1.372818,103.840525
568713,36,4,40,1.372721,103.840577
568714,27,0,27,1.372865,103.840647
568715,57,2,59,1.372624,103.840611
568716,1,1,2,1.373238,103.840431
568717,1,4,5,1.372532,103.840662
568718,16,1,17,1.372705,103.840739
568719,4,0,4,1.373047,103.840406
568720,3,0,3,1.373043,103.840539
568721,3,1,4,1.372625,103.840767
568722,1,6,7,1.372344,103.840898
568743,1,1,2,1.372791,103.840687
568745,0,2,2,1.371018,103.840038
568746,1,28,29,1.370962,103.840088
568747,22,0,22,1.371029,103.840125
568748,16,0,16,1.370969,103.840141
568749,0,2,2,1.371014,103.840083
568750,2,0,2,1.371041,103.840209
568751,3,0,3,1.37255,103.840807
568752,2,5,7,1.370987,103.840223
568753,7,0,7,1.371046,103.840315
568754,4,0,4,1.372419,103.840853
568755,2,5,7,1.371062,103.840371
568756,13,0,13,1.371001,103.840352
568757,3,0,3,1.371046,103.840284
568759,1,8,9,1.371093,103.840557
568762,1,0,1,1.373494,103.839666
568763,2,23,25,1.371111,103.840635
568764,63,0,63,1.371043,103.840674
568766,4,6,10,1.371042,103.840755
568767,0,16,16,1.37112,103.840756
568768,27,0,27,1.371052,103.840817
568769,6,0,6,1.371129,103.840845
568770,3,2,5,1.371131,103.84091
568792,0,4,4,1.370991,103.840271
568793,3,0,3,1.371074,103.84049
568794,1,0,1,1.371031,103.8406
568795,0,4,4,1.373122,103.838658
568797,23,2,25,1.373617,103.838865
568798,0,2,2,1.370983,103.84018
568799,6,0,6,1.373473,103.838956
568800,1,3,4,1.373531,103.83878
568821,0,2,2,1.373344,103.838882
568822,5,0,5,1.372896,103.839033
568825,27,8,35,1.373052,103.839251
568826,3,0,3,1.373333,103.838649
568828,0,2,2,1.372816,103.838999
568829,13,0,13,1.373029,103.839634
568830,48,20,68,1.373012,103.839731
568831,1,0,1,1.373179,103.838724
568832,0,2,2,1.373057,103.83952
568833,4,1,5,1.372903,103.839989
568834,52,10,62,1.372747,103.840083
568835,1,5,6,1.372661,103.840128
568836,3,0,3,1.373053,103.839327
568837,4,2,6,1.372457,103.84021
568839,2,24,26,1.372289,103.840301
568840,13,3,16,1.372554,103.840058
568841,11,3,14,1.372496,103.840082
568842,5,1,6,1.372403,103.840111
568843,1,9,10,1.372345,103.840135
568860,33,22,55,1.373257,103.838277
568861,3,0,3,1.372562,103.840181
568862,13,2,15,1.373263,103.838445
568863,1,0,1,1.373001,103.8398
568867,29,3,32,1.372748,103.838787
568868,66,8,74,1.372677,103.838907
568869,0,1,1,1.372861,103.838582
568870,2,1,3,1.372872,103.838535
568872,3,2,5,1.372163,103.839217
568873,1,3,4,1.373556,103.839011
568874,4,1,5,1.372635,103.839007
568879,2,950,952,1.369933,103.840459
568880,0,47,47,1.369934,103.840516
568881,0,239,239,1.369934,103.840573
568882,10,12,22,1.370006,103.840695
568883,4,174,178,1.37001,103.840748
568884,0,48,48,1.370024,103.840804
568885,0,158,158,1.37003,103.840859
568886,0,14,14,1.370033,103.840913
568887,2,126,128,1.370047,103.840977
568888,0,69,69,1.370048,103.841036
568889,1,1122,1123,1.370058,103.841091
568892,165,0,165,1.372419,103.839383
568893,2,12,14,1.372339,103.839409
568894,5,0,5,1.37225,103.839456
568895,0,5,5,1.37221,103.839465
568912,21,40,61,1.371644,103.833524
568913,9,7,16,1.372005,103.833897
568915,8,5,13,1.372074,103.833931
568916,1,31,32,1.371741,103.833586
568917,0,1,1,1.372569,103.839017
568918,4,0,4,1.372087,103.839259
568919,0,1,1,1.372177,103.834005
568920,3,1,4,1.371799,103.833621
568921,4,1,5,1.372309,103.834096
568922,17,1,18,1.371873,103.833683
568923,5,2,7,1.372372,103.834136
568925,7,0,7,1.372469,103.834204
568927,8,5,13,1.372527,103.834238
568928,13,5,18,1.372034,103.833774
568929,21,2,23,1.372689,103.834489
568931,4,0,4,1.371839,103.833655
568932,7,2,9,1.372154,103.833859
568933,11,0,11,1.372597,103.834642
568936,1,4,5,1.372251,103.833939
568937,2,0,2,1.372955,103.839907
568939,120,0,120,1.372374,103.834956
568940,0,1,1,1.372234,103.834039
568941,6,0,6,1.372323,103.835047
568942,5,0,5,1.372389,103.834036
568943,39,16,55,1.372277,103.835104
568944,9,0,9,1.372435,103.834064
568945,1,0,1,1.372343,103.834007
568946,2,0,2,1.372403,103.834899
568947,7,1,8,1.371985,103.834924
568948,1,2,3,1.372468,103.839113
568949,1,0,1,1.372026,103.83497
568950,15,0,15,1.372572,103.834161
568951,2,0,2,1.372475,103.834093
568952,1,0,1,1.371888,103.834862
568955,1,3,4,1.37266,103.834546
568958,8,5,13,1.372842,103.834354
568959,4,0,4,1.371676,103.834702
568961,3,0,3,1.372515,103.834127
568962,4,0,4,1.372887,103.834383
568963,2,48,50,1.373048,103.834514
568964,26,2,28,1.372743,103.834532
568965,40,5,45,1.37272,103.834566
568966,1,6,7,1.372692,103.834623
568967,6,4,10,1.372663,103.834663
568968,0,13,13,1.372634,103.834708
568969,3,0,3,1.372956,103.834451
568970,7,4,11,1.372566,103.834805
568971,18,1,19,1.372537,103.834845
568972,0,1,1,1.372647,103.834218
568973,2,1,3,1.372606,103.834759
568974,5,8,13,1.372411,103.835033
568975,1,1,2,1.371825,103.834805
568976,0,5,5,1.372337,103.835129
568977,150,3,153,1.372308,103.835175
568978,9,50,59,1.372268,103.835232
568979,8,2,10,1.372234,103.835266
568980,16,29,45,1.372205,103.835317
568981,4,4,8,1.372182,103.835346
568982,2,29,31,1.372148,103.83538
568983,6,70,76,1.372131,103.835437
568984,2,3,5,1.372173,103.835162
568985,9,0,9,1.372139,103.835128
568987,1,0,1,1.372497,103.834907
568988,3,6,9,1.371984,103.835037
568989,139,3,142,1.371944,103.835003
568990,1,0,1,1.372036,103.835077
568992,2,0,2,1.372377,103.835067
568994,3,0,3,1.372463,103.834947
568995,6,0,6,1.371629,103.834798
568996,1,0,1,1.371892,103.834969
568997,7,6,13,1.371537,103.834724
568998,0,2,2,1.371801,103.834906
568999,2,0,2,1.371497,103.834702
569001,16,448,464,1.371348,103.834582
569002,0,30,30,1.371457,103.834508
569003,4,1,5,1.371479,103.834459
569004,0,1,1,1.371577,103.834764
569005,0,1,1,1.371488,103.834426
569006,14,3,17,1.371526,103.834343
569007,0,4,4,1.373002,103.834479
569008,51,0,51,1.371594,103.834229
569009,28,4,32,1.371617,103.834121
569010,81,0,81,1.371646,103.834053
569011,16,0,16,1.371674,103.833996
569012,19,1,20,1.371697,103.833922
569013,1,0,1,1.371503,103.834394
569014,10,3,13,1.371737,103.833825
569015,1,9,10,1.371766,103.833768
569058,93,3644,3737,1.38823,103.849103
569059,3567,2328,5895,1.38922,103.848734
569060,203,11522,11725,1.390359,103.849375
569061,855,7798,8653,1.391612,103.849258
569062,61,8173,8234,1.39079,103.848148
569083,494,665,1159,1.387244,103.849181
569084,855,561,1416,1.388197,103.849641
569085,18,2513,2531,1.387305,103.848432
569086,1006,2691,3697,1.388692,103.84481
569087,221,1372,1593,1.389758,103.845624
569088,2798,409,3207,1.389953,103.845514
569110,159,2060,2219,1.384952,103.848106
569111,24,93,117,1.384281,103.848637
569113,7,905,912,1.385588,103.848675
569115,36,693,729,1.385939,103.848301
569116,46,3550,3596,1.38628,103.848953
569117,291,839,1130,1.385913,103.847609
569118,10,3281,3291,1.386743,103.848057
569138,99,2181,2280,1.384603,103.846228
569139,1608,4047,5655,1.385486,103.845825
569140,144,16989,17133,1.387422,103.845642
569141,2936,8773,11709,1.387928,103.844052
569161,56,7357,7413,1.38058,103.841409
569162,21,1520,1541,1.380754,103.841345
569163,111,3105,3216,1.381193,103.841213
569184,1,881,882,1.373283,103.858513
569185,148,746,894,1.371969,103.85865
569205,313,255,568,1.372205,103.849472
569206,295,9497,9792,1.374262,103.851456
569208,20,98,118,1.37223,103.849031
569228,161,1476,1637,1.371479,103.851863
569249,3,1061,1064,1.363635,103.857618
569250,155,498,653,1.363994,103.858355
569251,2,376,378,1.364139,103.85761
569253,323,14,337,1.365,103.859119
569254,18,508,526,1.365626,103.858291
569256,2,1482,1484,1.365632,103.857939
569277,641,549,1190,1.365893,103.852329
569278,10,385,395,1.367447,103.851694
569299,414,637,1051,1.365396,103.850524
569341,4,453,457,1.36826,103.840503
569362,366,2300,2666,1.367353,103.8426
569383,378,1145,1523,1.367176,103.835464
569384,430,549,979,1.368331,103.835438
569385,24,265,289,1.299509,103.837
569405,1392,27,1419,1.373744,103.834301
569406,105,49,154,1.374704,103.833694
569458,10,0,10,1.389243,103.846093
569478,4,0,4,1.37156,103.834286
569479,0,138,138,1.299509,103.837
569498,309,3,312,1.372555,103.86656
569499,72,728,800,1.371694,103.863831
569500,344,270,614,1.371691,103.864672
569501,2050,857,2907,1.371792,103.865018
569502,32,385,417,1.372668,103.863556
569503,75,97,172,1.372749,103.863706
569504,20,1,21,1.373115,103.864813
569505,1323,62,1385,1.373279,103.865704
569506,1065,8,1073,1.373343,103.863855
569507,815,298,1113,1.376287,103.866998
569508,897,258,1155,1.3754,103.865508
569510,525,524,1049,1.375835,103.864835
569511,291,137,428,1.376133,103.866013
569525,187,600,787,1.370639,103.862914
569526,103,576,679,1.370856,103.863446
569527,14,37,51,1.370686,103.862959
569528,19,137,156,1.370394,103.86206
569529,5,8,13,1.371182,103.862775
569530,67,19,86,1.370897,103.861914
569531,23,4,27,1.371278,103.862913
569532,10,43,53,1.370944,103.86195
569533,43,19,62,1.371768,103.862772
569534,15,38,53,1.371412,103.861682
569535,132,19,151,1.371818,103.862763
569536,70,19,89,1.371445,103.861675
569537,26,7,33,1.372265,103.862598
569538,63,16,79,1.371866,103.861416
569539,45,55,100,1.37205,103.861795
569540,22,59,81,1.371887,103.861364
569541,145,21,166,1.37231,103.862587
569542,10,7,17,1.372323,103.861074
569543,19,48,67,1.372794,103.862428
569544,185,38,223,1.372379,103.86105
569545,23,8,31,1.372576,103.861653
569546,140,176,316,1.372848,103.862422
569547,5,20,25,1.372957,103.860823
569548,11,16,27,1.373144,103.861387
569549,64,209,273,1.373406,103.86219
569550,23,34,57,1.373414,103.860715
569551,66,19,85,1.37376,103.861745
569552,181,811,992,1.373866,103.862058
569553,19,40,59,1.373815,103.861726
569554,20,39,59,1.373466,103.860705
569555,51,56,107,1.37427,103.861565
569556,42,31,73,1.373914,103.860468
569557,55,55,110,1.37432,103.861547
569558,26,11,37,1.373962,103.860462
569559,67,71,138,1.374952,103.861324
569560,139,21,160,1.374604,103.860206
569561,184,37,221,1.3747,103.860377
569562,22,15,37,1.374614,103.860097
569563,20,111,131,1.374996,103.861307
569564,30,36,66,1.375089,103.859976
569565,73,62,135,1.375476,103.861155
569566,17,4,21,1.37522,103.860215
569567,36,43,79,1.375528,103.861144
569568,25,20,45,1.375693,103.860052
569569,46,33,79,1.375991,103.860963
569570,192,33,225,1.375743,103.860084
569571,81,32,113,1.376038,103.860954
569572,15,748,763,1.376035,103.859796
569573,45,179,224,1.376351,103.860714
569574,9,1251,1260,1.373867,103.862057
569619,44,2972,3016,1.359454,103.855833
569620,78,50,128,1.358869,103.855597
569621,612,785,1397,1.357331,103.855599
569622,36,780,816,1.362004,103.85634
569623,14,554,568,1.361849,103.856641
569624,16,256,272,1.361416,103.856276
569625,289,270,559,1.35987,103.856386
569626,962,440,1402,1.360145,103.857475
569627,62,532,594,1.360571,103.856729
569628,550,123,673,1.360963,103.856748
569629,74,3574,3648,1.35857,103.854812
569630,35,190,225,1.35799,103.855213
569631,27,40,67,1.357901,103.855329
569632,21,1197,1218,1.37783,103.868649
569633,9,372,381,1.299509,103.837
569634,36,31,67,1.357903,103.856217
569635,8,13,21,1.358235,103.856439
569636,22,51,73,1.358371,103.856505
569637,28,24,52,1.358932,103.856425
569638,6,59,65,1.359082,103.856564
569639,6,20,26,1.359415,103.856787
569640,20,23,43,1.361296,103.85723
569641,2,3,5,1.361545,103.857799
569642,15,161,176,1.361754,103.857574
569643,4,8,12,1.35763,103.855727
569663,213,4065,4278,1.372882,103.847666
569664,7,458,465,1.374436,103.845937
569707,261,442,703,1.372183,103.866294
569708,222,66,288,1.373536,103.866366
569709,907,163,1070,1.374665,103.866
569729,5,123,128,1.3602,103.854984
569730,478,131,609,1.359123,103.854452
569731,9,9392,9401,1.364274,103.855767
569732,24,2426,2450,1.368184,103.857102
569733,0,141,141,1.36839,103.856972
569734,16,261,277,1.363096,103.853577
569738,178,7,185,1.359801,103.856856
569739,945,1563,2508,1.359282,103.854654
569758,310,339,649,1.383108,103.838563
569759,3,34,37,1.383569,103.838267
569760,131,152,283,1.383681,103.83807
569761,695,120,815,1.384469,103.838355
569762,118,52,170,1.38432,103.838874
569763,398,43,441,1.383861,103.838753
569764,163,98,261,1.383663,103.839201
569765,459,811,1270,1.383238,103.839636
569766,2963,1099,4062,1.38371,103.839954
569767,121,635,756,1.383652,103.841742
569768,3,9,12,1.383701,103.842076
569770,98,39,137,1.382232,103.845925
569771,265,116,381,1.381524,103.846743
569773,5,20,25,1.381532,103.846763
569774,0,33,33,1.382264,103.845863
569777,170,33,203,1.383111,103.846582
569780,48,676,724,1.383762,103.845894
569783,22,505,527,1.384617,103.845795
569784,226,3646,3872,1.384535,103.845353
569785,236,1011,1247,1.384692,103.841225
569786,715,2384,3099,1.384062,103.842747
569787,1162,206,1368,1.384831,103.842172
569788,935,1145,2080,1.385326,103.842089
569809,280,3652,3932,1.361812,103.852295
569810,139,4634,4773,1.362559,103.852619
569811,3123,55023,58146,1.369922,103.849614
569813,1794,23485,25279,1.381747,103.844984
569814,265,7339,7604,1.371839,103.8477
569815,733,138,871,1.382519,103.849246
569816,4,0,4,1.299509,103.837
569818,166,2,168,1.383602,103.849613
569820,27,0,27,1.378602,103.849821
569821,32,0,32,1.378632,103.849827
569822,1,43,44,1.378396,103.850939
569823,167,1,168,1.378394,103.850934
569824,215,59,274,1.377519,103.850827
569825,27,73,100,1.377553,103.850829
569827,1,0,1,1.37172,103.83387
569828,1,0,1,1.378607,103.849828
569829,85,679,764,1.378632,103.849825
569830,1987,2062,4049,1.378461,103.848988
569839,13,3767,3780,1.367885,103.844725
569841,77,394,471,1.372198,103.845583
569842,66,1301,1367,1.374684,103.845664
569843,414,177,591,1.378043,103.845762
569844,157,1997,2154,1.370464,103.845756
569845,451,1494,1945,1.382254,103.8431
569866,93,3517,3610,1.378994,103.836168
569868,247,59,306,1.377635,103.842103
569869,209,6023,6232,1.375583,103.856212
569870,430,824,1254,1.377196,103.86438
569871,271,2338,2609,1.37809,103.864746
569872,351,2362,2713,1.37824,103.865896
569873,706,2236,2942,1.37749,103.866561
569874,499,123,622,1.377494,103.865599
569875,13,51,64,1.377447,103.865314
569876,535,15,550,1.377057,103.86546
569877,3858,5229,9087,1.377684,103.872842
569878,371,823,1194,1.376395,103.843181
569880,2963,4575,7538,1.377918,103.875414
569881,351,68,419,1.376825,103.864391
569882,47,1391,1438,1.299509,103.837
569897,13,2262,2275,1.373053,103.837219
569898,115,4742,4857,1.374963,103.837203
569920,164,1920,2084,1.368803,103.839266
569922,24,1635,1659,1.369149,103.847207
569923,1,892,893,1.367877,103.839617
569925,71,14648,14719,1.368989,103.84774
569927,64,885,949,1.370763,103.864159
569928,4346,2013,6359,1.371408,103.867694
569929,28,1273,1301,1.369982,103.85166
569930,220,47,267,1.36257,103.847097
569931,736,8386,9122,1.362481,103.847569
569932,18,3,21,1.362081,103.847562
569933,6029,90230,96259,1.369017,103.848122
569934,124,24138,24262,1.369831,103.848812
569935,2528,4936,7464,1.299509,103.837
569948,3,89,92,1.37619,103.835797
569949,4,211,215,1.377116,103.834957
569950,14,27,41,1.377093,103.834919
569951,34,31,65,1.377066,103.83488
569952,5,36,41,1.377043,103.834846
569953,2,27,29,1.376993,103.834792
569954,3,37,40,1.376976,103.834762
569955,6,8,14,1.376963,103.834672
569956,1,7,8,1.376931,103.834625
569957,13,5,18,1.376901,103.83456
569958,6,6,12,1.376875,103.834516
569959,1,3,4,1.383596,103.849614
569960,0,4,4,1.37683,103.834474
569961,1,11,12,1.376745,103.83438
569962,7,7,14,1.376739,103.834342
569963,4,10,14,1.376702,103.834307
569964,2,32,34,1.376667,103.834262
569965,7,36,43,1.376607,103.834212
569966,12,45,57,1.37658,103.834169
569967,34,15,49,1.37654,103.834153
569968,4,17,21,1.376513,103.834094
569969,43,326,369,1.368232,103.829965
569971,3,1060,1063,1.366604,103.844939
569974,10,213,223,1.36633,103.838723
569975,138,4971,5109,1.365291,103.839612
569976,38,277,315,1.366953,103.84042
569977,28,998,1026,1.36436,103.84588
569978,63,950,1013,1.362648,103.84951
569979,560,12,572,1.355488,103.858872
569980,18,39,57,1.377209,103.875398
569981,31,13,44,1.360872,103.846416
569982,5,398,403,1.299509,103.837
569983,62,16,78,1.364959,103.835859
569984,154,333,487,1.299509,103.837
570022,1162,1196,2358,1.357278,103.838552
570023,375,225,600,1.354562,103.835851
570024,530,212,742,1.355125,103.836184
570025,1439,243,1682,1.355092,103.836889
570026,521,386,907,1.355796,103.840544
570101,1272,400,1672,1.344941,103.848309
570102,598,148,746,1.345176,103.848022
570103,856,198,1054,1.345527,103.848334
570104,343,127,470,1.345674,103.848026
570105,618,820,1438,1.345833,103.847487
570106,734,297,1031,1.346084,103.847786
570107,1208,405,1613,1.346401,103.847937
570108,311,2913,3224,1.346676,103.847368
570109,354,460,814,1.346714,103.848028
570110,653,727,1380,1.347457,103.847744
570111,535,308,843,1.347022,103.848149
570112,712,827,1539,1.346821,103.848853
570113,647,550,1197,1.347252,103.848592
570114,860,283,1143,1.347551,103.848782
570115,519,4090,4609,1.347943,103.848478
570116,951,3769,4720,1.347754,103.849325
570117,506,1527,2033,1.347102,103.849915
570118,32,1488,1520,1.346648,103.849912
570119,436,130,566,1.347191,103.850536
570120,140,4548,4688,1.347119,103.850756
570121,201,1724,1925,1.347181,103.851076
570122,667,192,859,1.346804,103.850573
570123,1514,352,1866,1.346481,103.850389
570124,508,277,785,1.346528,103.851239
570125,269,4612,4881,1.34709,103.851481
570126,943,1663,2606,1.346162,103.852067
570127,304,235,539,1.346096,103.851492
570128,586,389,975,1.346116,103.850317
570129,5,151,156,1.345701,103.85039
570130,1559,365,1924,1.345935,103.850961
570131,608,842,1450,1.345621,103.8508
570132,465,582,1047,1.345633,103.851475
570133,129,93,222,1.345592,103.851772
570134,336,778,1114,1.345474,103.852087
570135,1350,250,1600,1.344648,103.851236
570136,498,135,633,1.344152,103.851754
570137,718,536,1254,1.34448,103.851784
570138,766,142,908,1.344342,103.852443
570139,232,545,777,1.345334,103.852778
570140,586,82,668,1.344884,103.852862
570141,738,115,853,1.345143,103.853005
570142,1067,274,1341,1.345606,103.853152
570143,27,1105,1132,1.345546,103.852824
570144,952,3135,4087,1.345907,103.853105
570145,1176,126,1302,1.344874,103.854356
570146,545,855,1400,1.344064,103.854124
570147,984,441,1425,1.343902,103.85511
570148,378,393,771,1.344223,103.854891
570149,2051,1713,3764,1.344275,103.855411
570150,442,457,899,1.344518,103.855269
570151,321,2481,2802,1.345012,103.855759
570152,374,5015,5389,1.345631,103.854692
570153,963,3564,4527,1.346153,103.854839
570154,952,373,1325,1.346652,103.85493
570155,799,216,1015,1.346233,103.855829
570156,1033,3043,4076,1.345382,103.856613
570157,1114,262,1376,1.345896,103.856719
570158,994,197,1191,1.34664,103.856237
570159,181,338,519,1.34699,103.855881
570160,106,66,172,1.347033,103.856381
570161,964,301,1265,1.347597,103.856235
570162,155,320,475,1.347651,103.8559
570163,2352,269,2621,1.348068,103.856015
570164,927,500,1427,1.348442,103.856034
570165,1922,223,2145,1.349146,103.85614
570166,880,89,969,1.348598,103.855538
570167,740,339,1079,1.347992,103.855214
570168,1325,1618,2943,1.347334,103.854089
570169,139,3021,3160,1.346984,103.854143
570170,857,4931,5788,1.346476,103.85345
570171,387,195,582,1.346767,103.853614
570172,463,489,952,1.347432,103.853603
570173,557,1569,2126,1.347746,103.854181
570174,106,3409,3515,1.348377,103.854189
570175,581,803,1384,1.348845,103.853586
570176,1011,296,1307,1.348121,103.853782
570177,977,390,1367,1.34786,103.853326
570178,1610,436,2046,1.348109,103.852257
570179,360,6,366,1.348557,103.851795
570180,1310,118,1428,1.348488,103.852217
570181,636,203,839,1.34872,103.853042
570182,1320,2073,3393,1.350147,103.852972
570183,269,539,808,1.350415,103.852491
570184,754,105,859,1.35008,103.852579
570185,965,123,1088,1.349726,103.852424
570186,1047,87,1134,1.349444,103.852755
570187,599,148,747,1.349699,103.851297
570188,491,130,621,1.349927,103.851583
570189,373,50,423,1.350256,103.851661
570190,259,1028,1287,1.350533,103.851942
570191,1101,1447,2548,1.35051,103.851208
570192,603,225,828,1.348991,103.851182
570193,297,112,409,1.34873,103.850908
570194,107,29,136,1.348316,103.851264
570195,534,93,627,1.348339,103.850776
570196,282,1919,2201,1.348091,103.850626
570197,934,444,1378,1.349109,103.850622
570201,403,1494,1897,1.355469,103.847122
570202,35,817,852,1.355099,103.847145
570203,189,893,1082,1.354722,103.847213
570204,352,136,488,1.354937,103.847422
570205,433,199,632,1.35547,103.847483
570206,348,633,981,1.355708,103.847661
570207,536,277,813,1.35475,103.848012
570208,99,337,436,1.354992,103.848425
570209,688,674,1362,1.355484,103.848472
570210,1077,846,1923,1.355861,103.848661
570211,297,116,413,1.356265,103.848808
570212,703,913,1616,1.356341,103.848045
570213,917,1139,2056,1.35731,103.847964
570214,506,254,760,1.357521,103.848208
570215,602,109,711,1.357158,103.848623
570216,295,783,1078,1.356452,103.848985
570217,321,53,374,1.356826,103.849094
570218,125,1600,1725,1.356852,103.849737
570219,859,140,999,1.357352,103.849363
570220,978,170,1148,1.35757,103.848732
570221,923,188,1111,1.357815,103.848816
570222,1104,461,1565,1.358071,103.848068
570223,831,162,993,1.358559,103.848038
570224,1258,31,1289,1.35884,103.847688
570225,831,277,1108,1.358614,103.847573
570226,1212,102,1314,1.358375,103.847201
570227,366,360,726,1.358112,103.847044
570228,910,98,1008,1.357979,103.846572
570229,480,272,752,1.357598,103.845974
570230,248,11179,11427,1.357937,103.845357
570231,599,7042,7641,1.357349,103.84573
570232,638,134,772,1.358286,103.845226
570233,695,6383,7078,1.358639,103.845253
570234,353,17,370,1.35839,103.845955
570235,622,89,711,1.358719,103.846477
570236,1460,158,1618,1.359041,103.846849
570237,1140,112,1252,1.359335,103.847097
570238,320,4493,4813,1.35988,103.844496
570239,562,324,886,1.360481,103.844678
570240,33,368,401,1.360773,103.845006
570241,760,160,920,1.360768,103.845452
570242,507,64,571,1.361363,103.844743
570243,720,249,969,1.361088,103.844539
570244,67,332,399,1.360458,103.84425
570245,589,6621,7210,1.360302,103.843984
570246,256,4897,5153,1.360755,103.843208
570247,177,538,715,1.361078,103.842996
570248,326,334,660,1.361375,103.843189
570249,215,65,280,1.361342,103.843341
570250,769,199,968,1.361656,103.843685
570251,777,100,877,1.361835,103.844131
570252,464,323,787,1.362015,103.843689
570253,360,1226,1586,1.36222,103.84304
570254,796,330,1126,1.361944,103.842985
570255,528,1484,2012,1.361652,103.842747
570256,456,158,614,1.361339,103.842648
570257,645,263,908,1.359734,103.842962
570258,199,258,457,1.359779,103.842669
570259,692,495,1187,1.359987,103.842162
570260,285,541,826,1.359655,103.842059
570261,399,69,468,1.35897,103.843393
570262,455,106,561,1.35929,103.842391
570263,771,317,1088,1.358947,103.842283
570264,997,227,1224,1.358749,103.842021
570265,665,426,1091,1.35838,103.842172
570266,720,404,1124,1.358021,103.842181
570267,491,237,728,1.357646,103.842568
570268,293,96,389,1.357625,103.84197
570269,327,347,674,1.35689,103.842498
570270,612,439,1051,1.356979,103.842072
570271,1318,817,2135,1.356702,103.842247
570272,1032,195,1227,1.356551,103.842798
570273,43,36,79,1.356224,103.844137
570274,55,760,815,1.356224,103.844137
570275,48,100,148,1.356224,103.844137
570278,599,431,1030,1.357082,103.843752
570279,526,488,1014,1.357491,103.843971
570280,133,268,401,1.357408,103.844263
570281,111,2927,3038,1.357334,103.84403
570282,411,8197,8608,1.358271,103.844651
570283,95,4273,4368,1.358924,103.844074
570284,197,336,533,1.359077,103.843716
570285,664,325,989,1.358864,103.843842
570286,139,178,317,1.358454,103.843912
570287,120,148,268,1.357753,103.84378
570288,1170,1160,2330,1.357031,103.844977
570289,705,642,1347,1.356681,103.844702
570290,1380,409,1789,1.356077,103.844669
570291,1412,442,1854,1.355842,103.84496
570292,992,544,1536,1.355914,103.845588
570293,1147,2186,3333,1.356245,103.845879
570301,580,43,623,1.349526,103.838468
570302,189,15073,15262,1.349606,103.839084
570303,419,118,537,1.349903,103.838141
570304,602,755,1357,1.350264,103.837961
570305,409,115,524,1.350209,103.838481
570306,20,1573,1593,1.35031,103.839147
570307,302,145,447,1.350569,103.83856
570308,1155,268,1423,1.350657,103.837584
570309,803,459,1262,1.35103,103.837454
570310,298,131,429,1.350905,103.838443
570311,22,470,492,1.350988,103.839223
570312,331,1116,1447,1.351236,103.838523
570313,1248,1423,2671,1.351541,103.837387
570314,326,1546,1872,1.351843,103.838313
570315,647,385,1032,1.351998,103.838552
570316,523,1031,1554,1.351902,103.839457
570317,250,13,263,1.352798,103.838904
570318,397,724,1121,1.352622,103.839642
570319,599,391,990,1.353234,103.839658
570320,262,984,1246,1.352105,103.836643
570401,126,222,348,1.362604,103.833082
570402,912,470,1382,1.362765,103.832646
570403,690,346,1036,1.362925,103.833429
570404,417,20,437,1.362625,103.833902
570405,1204,239,1443,1.363014,103.834571
570406,807,166,973,1.363086,103.833881
570407,838,4882,5720,1.363462,103.834051
570408,1056,840,1896,1.363344,103.834647
570409,36,44,80,1.362492,103.834677
570410,50,287,337,1.299509,103.837
570441,764,2374,3138,1.35908,103.83142
570442,993,902,1895,1.359256,103.83209
570443,650,295,945,1.35883,103.832577
570444,720,279,999,1.358667,103.832153
570445,700,158,858,1.358793,103.8314
570446,661,148,809,1.357735,103.832117
570447,922,123,1045,1.358198,103.83175
570448,447,469,916,1.358185,103.831117
570449,473,183,656,1.358193,103.83068
570450,555,38,593,1.358333,103.830104
570451,334,92,426,1.35852,103.82995
570452,806,103,909,1.358537,103.829697
570453,312,1008,1320,1.359033,103.829664
570454,789,5403,6192,1.35915,103.830647
570455,598,409,1007,1.358817,103.83058
570501,792,4228,5020,1.348388,103.849097
570502,252,2666,2918,1.3486,103.848342
570503,75,710,785,1.349031,103.848046
570504,45,43,88,1.349288,103.84848
570505,41,48,89,1.349394,103.848538
570506,97,5,102,1.348918,103.84866
570507,87,83,170,1.348793,103.849261
570508,41,76,117,1.348643,103.849313
570509,33,1072,1105,1.348695,103.849064
570510,73,4288,4361,1.348631,103.849885
570511,35,5607,5642,1.349051,103.849902
570512,54,4478,4532,1.349908,103.849457
570513,58,60,118,1.349631,103.849562
570514,343,47357,47700,1.350139,103.849757
571022,318,6498,6816,1.357782,103.839096
571023,11,667,678,1.354778,103.836024
571024,65,3794,3859,1.35518,103.836411
571135,35,356,391,1.344868,103.851214
571150,504,4900,5404,1.344551,103.855794
571151,46,3318,3364,1.345485,103.855194
571152,21,228,249,1.345152,103.854419
571167,7,76,83,1.347277,103.855492
571207,9,128,137,1.355203,103.848295
571212,16,335,351,1.356666,103.848595
571231,24,478,502,1.357508,103.846709
571237,39,349,388,1.359197,103.846657
571246,13,114,127,1.360947,103.843708
571263,10,944,954,1.359176,103.841896
571268,36,93,129,1.35732,103.842725
571273,2270,665,2935,1.356224,103.844137
571275,779,37,816,1.356224,103.844137
571290,98,547,645,1.355661,103.84467
571410,35,2632,2667,1.299509,103.837
571448,14,187,201,1.357846,103.831613
571505,4,22,26,1.34914,103.848639
571514,87,2611,2698,1.350582,103.850677
572152,227,106,333,1.345302,103.854054
572273,1185,112,1297,1.35603,103.843488
572275,10,215,225,1.356224,103.844137
572505,4,30,34,1.348272,103.84881
572514,19,227,246,1.350467,103.850519
573505,9,511,520,1.348272,103.84881
573514,10,925,935,1.350436,103.85048
573858,245,370,615,1.360128,103.825659
573868,5,4,9,1.358146,103.833392
573869,0,4,4,1.376805,103.834454
573870,8,407,415,1.299509,103.837
573883,119,132,251,1.299509,103.837
573884,264,286,550,1.299509,103.837
573885,31,80,111,1.299509,103.837
573886,7,14,21,1.299509,103.837
573887,4,3,7,1.299509,103.837
573888,3,11,14,1.299509,103.837
573889,6,8,14,1.299509,103.837
573890,9,8,17,1.299509,103.837
573891,11,3,14,1.299509,103.837
573893,597,139,736,1.35694,103.831688
573894,671,123,794,1.35694,103.831688
573895,1074,483,1557,1.35694,103.831688
573898,35,663,698,1.299509,103.837
573899,10,7,17,1.299509,103.837
573903,30,0,30,1.299509,103.837
573904,5,0,5,1.299509,103.837
573905,18,0,18,1.299509,103.837
573906,8,0,8,1.299509,103.837
573908,1836,631,2467,1.352392,103.851583
573909,2669,1398,4067,1.352312,103.851687
573910,2190,1735,3925,1.35281,103.851211
573911,1270,147,1417,1.299509,103.837
573913,435,20,455,1.365174,103.830023
573914,331,60,391,1.299509,103.837
573915,657,78,735,1.365691,103.829788
573916,527,26,553,1.35898,103.833904
573917,611,141,752,1.299509,103.837
573918,861,141,1002,1.365885,103.828615
573919,168,120,288,1.299509,103.837
573920,1,5,6,1.299509,103.837
573921,1,4,5,1.299509,103.837
573922,6,9,15,1.299509,103.837
573923,13,20,33,1.299509,103.837
573924,10,8,18,1.299509,103.837
573925,0,11,11,1.299509,103.837
573926,7,5,12,1.299509,103.837
573927,28,333,361,1.299509,103.837
573928,5,2,7,1.299509,103.837
573929,8,44,52,1.299509,103.837
573930,2,8,10,1.299509,103.837
573931,0,14,14,1.299509,103.837
573932,20,55,75,1.299509,103.837
573933,3,48,51,1.299509,103.837
573934,0,3,3,1.371663,103.834833
573935,27,27,54,1.299509,103.837
573936,23,66,89,1.299509,103.837
573937,52,5,57,1.299509,103.837
573938,6,40,46,1.299509,103.837
573939,14,17,31,1.299509,103.837
573940,5,4,9,1.299509,103.837
573941,46,190,236,1.299509,103.837
573943,3260,4335,7595,1.347508,103.841087
573950,0,13,13,1.351768,103.84699
573951,2,6,8,1.351888,103.846966
573952,0,1,1,1.378636,103.849846
573953,294,8,302,1.360179,103.833715
573954,52,63,115,1.360214,103.833739
573955,37,38,75,1.360167,103.833736
573956,198,190,388,1.360058,103.833659
573957,39,798,837,1.359973,103.833626
573958,32,210,242,1.35995,103.833623
573960,943,166,1109,1.358681,103.834139
573963,1295,17,1312,1.351138,103.840395
573964,824,152,976,1.35108,103.840378
573968,1346,1689,3035,1.358146,103.833392
573969,1150,1560,2710,1.358606,103.833566
573970,1999,2396,4395,1.358586,103.83358
573971,1855,619,2474,1.359509,103.833969
573972,1548,570,2118,1.36001,103.834167
573973,2005,981,2986,1.35926,103.845371
573974,264,905,1169,1.359527,103.84583
573975,3227,225,3452,1.35995,103.846299
573978,1,0,1,1.299509,103.837
573979,1,0,1,1.376515,103.832086
573982,0,20,20,1.299509,103.837
573983,4,1,5,1.355376,103.833436
573984,7,0,7,1.355498,103.833263
573985,12,3,15,1.355498,103.833263
573986,7,5,12,1.355498,103.833263
573987,93,2,95,1.355498,103.833263
573988,4,1,5,1.355498,103.833263
573989,23,17,40,1.355498,103.833263
573990,29,32,61,1.356126,103.832429
573991,21,4,25,1.299509,103.837
573992,2,0,2,1.371457,103.834673
573993,829,1578,2407,1.348581,103.839588
573994,5,0,5,1.356126,103.832429
573996,1,0,1,1.376585,103.832116
573997,4,0,4,1.299509,103.837
573998,20,1,21,1.356564,103.832593
573999,20,1,21,1.356126,103.832429
574000,11,0,11,1.356126,103.832429
574001,65,0,65,1.356126,103.832429
574002,29,0,29,1.356126,103.832429
574003,2,0,2,1.299509,103.837
574006,13,52,65,1.355986,103.832047
574007,2,105,107,1.356815,103.833869
574008,61,0,61,1.356802,103.833901
574009,4,0,4,1.356126,103.832429
574011,1,2,3,1.299509,103.837
574012,4,0,4,1.356798,103.83394
574013,561,700,1261,1.346326,103.842422
574015,3,4,7,1.352262,103.846905
574016,11,0,11,1.355456,103.832912
574017,4,6,10,1.355509,103.83286
574018,2,9,11,1.352136,103.846543
574019,4,5,9,1.355786,103.832529
574020,7,0,7,1.355441,103.833096
574021,5,20,25,1.355647,103.832585
574022,55,0,55,1.355617,103.832663
574023,0,2,2,1.356126,103.832429
574024,2,3,5,1.352411,103.847548
574025,55,4,59,1.352428,103.847598
574026,23,197,220,1.352455,103.84765
574027,1,9,10,1.355679,103.832773
574028,5,0,5,1.355835,103.832641
574029,24,530,554,1.348262,103.83859
574030,6,0,6,1.352079,103.844359
574031,1,2,3,1.351874,103.845803
574032,5,5,10,1.35209,103.844695
574033,17,3,20,1.357049,103.833268
574034,4,6,10,1.356997,103.833421
574035,117,677,794,1.35702,103.833351
574036,1509,513,2022,1.351679,103.841388
574037,16,12,28,1.3519,103.844787
574038,3,4,7,1.356875,103.833716
574039,6,0,6,1.356909,103.833671
574040,3,109,112,1.356862,103.83377
574044,1063,876,1939,1.348869,103.846462
574045,1534,908,2442,1.349501,103.847028
574046,0,3,3,1.352085,103.844524
574047,3,3,6,1.377056,103.827134
574048,63,2,65,1.375923,103.82637
574049,2,0,2,1.352385,103.847475
574050,8,0,8,1.376074,103.826349
574051,76,1,77,1.376195,103.826344
574052,4,0,4,1.352053,103.845876
574053,2,0,2,1.376002,103.826354
574054,7,5,12,1.376508,103.826416
574055,2,0,2,1.376414,103.826382
574056,3,0,3,1.37702,103.82704
574057,8,0,8,1.376746,103.826635
574058,22,4,26,1.376799,103.826679
574059,1,3,4,1.376282,103.826363
574061,2,0,2,1.376592,103.826438
574062,11,0,11,1.376677,103.826914
574064,176,9,185,1.376467,103.826833
574065,3,1,4,1.376945,103.826869
574066,1,4,5,1.376361,103.826833
574067,21,3,24,1.376515,103.826984
574068,1,1,2,1.376728,103.826855
574069,3,3,6,1.376452,103.826984
574070,1,1,2,1.376406,103.826859
574071,7,2,9,1.376395,103.826984
574072,2,1,3,1.376672,103.826532
574073,67,3,70,1.376326,103.826984
574074,9,2,11,1.376125,103.826865
574075,3,0,3,1.376222,103.826859
574076,1,2,3,1.376257,103.826984
574077,113,2,115,1.376195,103.82699
574078,35,6,41,1.375907,103.826876
574079,2,0,2,1.376308,103.826859
574080,5,0,5,1.375798,103.826882
574081,1,2,3,1.376022,103.82687
574082,1,0,1,1.356126,103.832429
574085,12,0,12,1.375948,103.82699
574086,13,14,27,1.37542,103.826893
574087,4,0,4,1.376566,103.826964
574089,5,0,5,1.375828,103.827007
574090,2,0,2,1.376131,103.82699
574091,3,0,3,1.376074,103.82699
574092,139,5,144,1.375616,103.827007
574093,278,2,280,1.375536,103.827018
574094,5,3,8,1.375444,103.827024
574095,1,0,1,1.375701,103.826882
574096,1,0,1,1.375401,103.826988
574097,22,0,22,1.375275,103.82698
574098,0,30,30,1.349376,103.840093
574099,2,122,124,1.349318,103.840097
574113,3,0,3,1.375685,103.827007
574114,5,0,5,1.356559,103.833162
574116,18,344,362,1.362226,103.836077
574117,897,5943,6840,1.361516,103.835812
574118,102,220,322,1.358341,103.828416
574119,2,37,39,1.358196,103.828281
574120,10,44,54,1.358022,103.827604
574121,8,0,8,1.358005,103.827535
574122,6,0,6,1.357999,103.82749
574123,2,0,2,1.375753,103.827007
574124,2,0,2,1.357976,103.827456
574126,3,4,7,1.357953,103.827342
574128,8,12,20,1.357936,103.827268
574129,2,26,28,1.357872,103.827354
574130,1,1,2,1.35797,103.82741
574131,5,0,5,1.357792,103.82716
574132,78,9,87,1.357912,103.827026
574133,2,0,2,1.358012,103.827067
574135,33,0,33,1.357666,103.826779
574136,32,6,38,1.357892,103.826901
574137,10,2,12,1.35762,103.826551
574138,2,16,18,1.35787,103.826874
574141,23,6,29,1.357568,103.826329
574142,11,2,13,1.357887,103.826738
574143,19,3,22,1.357271,103.825972
574144,25,7,32,1.357855,103.826694
574145,9,0,9,1.357636,103.826022
574146,1,5,6,1.357647,103.826068
574147,27,1,28,1.357023,103.825507
574149,7,3,10,1.356155,103.825765
574150,1,9,10,1.357664,103.826187
574151,4,7,11,1.357664,103.826256
574152,188,0,188,1.35616,103.825839
574153,3,0,3,1.356435,103.832966
574154,0,4,4,1.375885,103.82699
574157,4,2,6,1.357693,103.826449
574158,113,0,113,1.357705,103.826506
574159,21,9,30,1.357733,103.826569
574160,190,6,196,1.356362,103.824034
574161,0,4,4,1.356975,103.824667
574162,54,0,54,1.356632,103.823983
574163,73,8,81,1.355895,103.824201
574164,20,3,23,1.357651,103.825955
574165,50,1,51,1.355969,103.82469
574166,2,2,4,1.35764,103.826035
574168,47,3,50,1.35759,103.825856
574169,153,3,156,1.356317,103.825128
574171,0,1,1,1.375345,103.826988
574172,6,2,8,1.357212,103.825073
574173,141,1,142,1.357182,103.823946
574174,16,17,33,1.35675,103.823958
574175,9,0,9,1.356672,103.823599
574177,106,2,108,1.355906,103.823434
574178,73,1,74,1.355274,103.823154
574179,42,3,45,1.355267,103.823429
574180,2,1,3,1.357676,103.826318
574181,17,0,17,1.355778,103.824282
574182,2,0,2,1.35774,103.826978
574183,8,5,13,1.355824,103.824635
574184,9,2,11,1.355899,103.825016
574185,16,1,17,1.355926,103.825243
574186,14,6,20,1.355995,103.825607
574187,42,0,42,1.356054,103.825877
574188,4,3,7,1.35738,103.825754
574189,20,0,20,1.374274,103.946081
574196,87,14,101,1.357344,103.82449
574197,3,0,3,1.355673,103.823994
574198,13,0,13,1.357412,103.824495
574199,24,2,26,1.357469,103.824435
574200,109,4,113,1.35738,103.824364
574201,7,6,13,1.357445,103.824348
574210,1,0,1,1.3576,103.825771
574211,63,1,64,1.345479,103.836879
574212,5,2,7,1.34555,103.836971
574213,1,0,1,1.345546,103.836872
574214,1,0,1,1.345476,103.836953
574215,1,0,1,1.345564,103.837073
574216,16,3,19,1.345574,103.837161
574217,9,0,9,1.345493,103.837147
574218,0,6,6,1.345581,103.837253
574219,8,10,18,1.345504,103.837288
574220,2,0,2,1.355752,103.823998
574221,13,2,15,1.34552,103.837395
574222,134,29,163,1.345028,103.837418
574223,11,0,11,1.345599,103.837418
574224,2,0,2,1.345592,103.837323
574225,3,13,16,1.345602,103.837493
574226,2,5,7,1.345009,103.837202
574227,6,0,6,1.345685,103.837584
574228,25,129,154,1.3456,103.837573
574229,0,8,8,1.345531,103.837578
574230,2,80,82,1.345468,103.837598
574231,9,0,9,1.345006,103.837108
574232,2,23,25,1.345372,103.837578
574233,0,2,2,1.345018,103.837345
574234,4,55,59,1.344806,103.837611
574235,33,0,33,1.344986,103.836949
574236,1,24,25,1.344488,103.837674
574237,2,0,2,1.344993,103.83703
574238,2,23,25,1.344295,103.837674
574239,1,9,10,1.344935,103.837115
574240,3,88,91,1.343848,103.83775
574241,104,0,104,1.344945,103.837213
574242,4,94,98,1.343663,103.83777
574243,24,4,28,1.344955,103.837338
574244,8,358,366,1.343424,103.837712
574245,96,3,99,1.344962,103.837424
574246,18,673,691,1.343234,103.837584
574247,36,4,40,1.344447,103.837538
574248,12,507,519,1.34304,103.837193
574249,5,0,5,1.344442,103.837442
574250,0,389,389,1.342966,103.837013
574251,1,1,2,1.344931,103.836974
574252,8,88,96,1.342902,103.836851
574253,2,11,13,1.344424,103.837244
574254,7,47,54,1.342818,103.836671
574256,1,1,2,1.344431,103.837343
574257,3,2,5,1.344372,103.837185
574258,2,0,2,1.344364,103.837108
574259,0,2,2,1.34438,103.837269
574260,91,1,92,1.344388,103.837447
574261,2,5,7,1.343908,103.837603
574262,44,0,44,1.343897,103.837499
574263,40,0,40,1.343894,103.837377
574264,0,4,4,1.357642,103.825927
574265,28,1,29,1.343882,103.837153
574266,82,3,85,1.343862,103.837605
574267,2,1,3,1.357482,103.824504
574268,31,1,32,1.34385,103.837409
574269,5,7,12,1.343845,103.837291
574271,3,8,11,1.343257,103.837306
574272,76,2,78,1.343288,103.837131
574273,4,3,7,1.34308,103.837108
574274,107,2,109,1.343042,103.837004
574275,9,1,10,1.343009,103.836907
574277,3,0,3,1.343854,103.837529
574279,9,2,11,1.342869,103.836611
574280,46,0,46,1.342828,103.836534
574281,2,3,5,1.342789,103.836465
574282,1,0,1,1.345483,103.837073
574284,1,1,2,1.344382,103.837376
574285,68,412,480,1.342564,103.83616
574286,4,106,110,1.342709,103.836475
574287,15,1327,1342,1.342585,103.836298
574288,11,3,14,1.345295,103.837583
574289,3,69,72,1.345182,103.837586
574290,8,68,76,1.345089,103.837588
574291,171,5,176,1.344201,103.837698
574292,3,35,38,1.344099,103.837708
574293,144,1,145,1.344345,103.837156
574294,1,39,40,1.358184,103.827746
574295,18,0,18,1.358237,103.827743
574296,1,0,1,1.342726,103.836377
574297,4,5,9,1.358346,103.827706
574298,3,0,3,1.34293,103.836736
574299,4,7,11,1.358342,103.827617
574300,19,7,26,1.35846,103.827774
574302,97,15,112,1.358237,103.827649
574303,1,1,2,1.342619,103.836224
574304,29,9,38,1.358165,103.827689
574306,2,1,3,1.358426,103.827717
574307,39,0,39,1.358592,103.82803
574309,3,0,3,1.35862,103.827962
574310,6,0,6,1.358653,103.828049
574311,8,61,69,1.358682,103.82819
574312,1,0,1,1.3583,103.827712
574313,0,2,2,1.358523,103.827905
574314,1,0,1,1.358676,103.828089
574315,9,5,14,1.358762,103.828203
574316,35,309,344,1.358791,103.828243
574317,6,9,15,1.358564,103.827812
574318,1,0,1,1.358722,103.828158
574325,558,63,621,1.346324,103.837277
574326,50,486,536,1.348069,103.838213
574327,889,45,934,1.348052,103.835451
574328,1779,348,2127,1.348568,103.834962
574329,1059,59,1118,1.349308,103.83436
574330,14,601,615,1.348829,103.837778
574331,375,311,686,1.350672,103.835777
574332,36,197,233,1.351037,103.83567
574333,121,460,581,1.351488,103.835332
574334,2,20,22,1.35057,103.835876
574335,21,213,234,1.351551,103.835315
574336,15,387,402,1.351602,103.835292
574337,18,216,234,1.351654,103.835275
574338,21,0,21,1.351717,103.835258
574339,206,2087,2293,1.350971,103.836222
574340,28,533,561,1.351768,103.835241
574341,20,9,29,1.35182,103.835218
574342,32,295,327,1.351871,103.835195
574343,17,197,214,1.351914,103.835181
574344,5,13,18,1.351957,103.835164
574345,33,166,199,1.351998,103.83515
574346,15,0,15,1.352043,103.835132
574347,25,209,234,1.352095,103.835115
574348,26,36,62,1.352187,103.835047
574349,215,1165,1380,1.352244,103.835001
574350,19,20,39,1.352284,103.834956
574351,65,324,389,1.35233,103.834905
574352,53,1293,1346,1.352945,103.835411
574353,30,1,31,1.35237,103.834859
574354,22,592,614,1.352815,103.835165
574355,72,849,921,1.352421,103.834814
574356,13,2,15,1.352865,103.835119
574357,19,1,20,1.352467,103.834768
574358,3,221,224,1.352902,103.835053
574359,24,106,130,1.352513,103.834728
574360,15,1,16,1.352951,103.835041
574361,16,0,16,1.352564,103.834688
574362,22,1025,1047,1.352616,103.83466
574363,17,1,18,1.35302,103.834955
574364,5,3,8,1.352656,103.83462
574365,18,470,488,1.353066,103.83491
574366,15,298,313,1.352702,103.834597
574367,20,362,382,1.353111,103.834853
574368,30,1371,1401,1.352742,103.834574
574369,89,5853,5942,1.353319,103.834655
574370,448,8006,8454,1.353649,103.834316
574371,235,24,259,1.354788,103.833974
574373,0,3,3,1.358627,103.828106
574374,5,0,5,1.354513,103.83328
574375,2,0,2,1.358699,103.828118
574376,493,343,836,1.353342,103.8337
574377,0,13,13,1.35455,103.833138
574378,0,301,301,1.354512,103.833209
574380,34,5,39,1.353445,103.833589
574381,0,53,53,1.354694,103.833024
574382,12,53,65,1.353507,103.833543
574383,0,92,92,1.354624,103.833042
574384,15,29,44,1.353537,103.83351
574386,29,54,83,1.353566,103.833476
574387,38,0,38,1.354757,103.832892
574388,10,0,10,1.353414,103.833624
574389,2,73,75,1.354797,103.832818
574390,4,11,15,1.353635,103.833412
574391,0,11,11,1.354825,103.832761
574392,12,1,13,1.353597,103.833449
574393,9,47,56,1.354854,103.83271
574394,36,0,36,1.353654,103.833259
574396,1,49,50,1.354931,103.832616
574397,1,143,144,1.354953,103.832565
574398,1,0,1,1.358586,103.827879
574399,1,51,52,1.354994,103.832463
574400,6,47,53,1.355016,103.832411
574401,0,64,64,1.355045,103.832354
574402,32,65,97,1.355068,103.832298
574403,1,52,53,1.355097,103.832246
574404,3,125,128,1.355125,103.832195
574405,5,483,488,1.35516,103.832144
574406,13,1322,1335,1.35515,103.83207
574408,6072,46777,52849,1.354637,103.830935
574409,503,391,894,1.3568,103.829014
574410,91,473,564,1.357921,103.828577
574414,2,1,3,1.3546,103.833198
574415,64,10,74,1.369994,103.828249
574416,30,125,155,1.370357,103.828354
574417,11,76,87,1.370908,103.828269
574418,486,349,835,1.371376,103.828299
574419,148,1399,1547,1.372311,103.828766
574420,106,784,890,1.373071,103.828947
574421,272,1,273,1.375054,103.82865
574422,35,449,484,1.354031,103.833811
574423,21,359,380,1.352985,103.835001
574424,359,4729,5088,1.352012,103.835801
574425,4,61,65,1.370107,103.828312
574426,23,440,463,1.350593,103.835864
574427,16,3,19,1.374001,103.828696
574428,56,1119,1175,1.299509,103.837
574430,16,7,23,1.357056,103.826172
574431,5,0,5,1.357299,103.825992
574432,362,4,366,1.356789,103.826278
574434,2,0,2,1.35463,103.833139
574435,3,0,3,1.369638,103.828293
574436,4,0,4,1.343894,103.837272
574437,45,1,46,1.356379,103.826285
574438,1,0,1,1.354971,103.832514
574440,6,2,8,1.355856,103.826782
574449,0,3,3,1.356826,103.826136
574450,3,4,7,1.375962,103.831483
574451,22,3,25,1.376071,103.832123
574452,3,3,6,1.375933,103.83158
574453,17,1,18,1.37621,103.832262
574454,21,0,21,1.375899,103.831682
574455,3,0,3,1.376001,103.832078
574456,113,4,117,1.37587,103.831779
574457,2,3,5,1.376906,103.833028
574458,15,30,45,1.375836,103.831876
574460,197,1,198,1.375808,103.831961
574461,42,0,42,1.37579,103.832064
574462,0,2,2,1.357015,103.826068
574463,2,1,3,1.376297,103.832355
574464,0,1,1,1.356138,103.826397
574466,61,5,66,1.377192,103.832972
574467,5,0,5,1.375705,103.832348
574468,5,6,11,1.377256,103.832968
574469,26,6,32,1.375647,103.832445
574470,3,2,5,1.377322,103.832948
574472,1,5,6,1.377429,103.833128
574473,0,2,2,1.377062,103.832998
574475,2,8,10,1.377239,103.833168
574476,10,0,10,1.377176,103.833178
574477,1,2,3,1.375756,103.83216
574478,5,0,5,1.377053,103.833198
574479,5,2,7,1.376979,103.833218
574480,7,0,7,1.376893,103.833225
574482,0,2,2,1.377369,103.833138
574483,27,0,27,1.376649,103.833255
574484,20,0,20,1.376563,103.833271
574485,0,3,3,1.377106,103.833184
574486,1,0,1,1.377129,103.832985
574487,1,2,3,1.376506,103.833275
574488,16,1,17,1.376713,103.833141
574489,2,0,2,1.376716,103.833248
574491,4,1,5,1.376463,103.833181
574492,5,0,5,1.376378,103.832844
574493,31,6,37,1.376399,103.832808
574494,12,4,16,1.37622,103.832631
574495,1,0,1,1.376651,103.833011
574496,0,1,1,1.376219,103.832669
574497,69,0,69,1.375765,103.832339
574498,1,0,1,1.376171,103.83268
574499,22,0,22,1.375743,103.832414
574500,3,5,8,1.376137,103.831228
574501,15,8,23,1.376249,103.831197
574502,0,1,1,1.375747,103.832371
574503,0,3,3,1.376548,103.83307
574504,14,0,14,1.376208,103.831123
574505,7,52,59,1.349094,103.848998
574506,1,3,4,1.356603,103.826216
574507,9,0,9,1.376283,103.831043
574508,4,1,5,1.376483,103.83094
574509,3,0,3,1.376335,103.831111
574510,12,5,17,1.376552,103.830866
574511,50,6,56,1.376415,103.830895
574512,4,0,4,1.376403,103.831031
574513,17,9,26,1.376695,103.830707
574514,19,0,19,1.376529,103.830741
574515,17,1,18,1.376753,103.830644
574516,3,4,7,1.376575,103.830667
574517,6,0,6,1.376798,103.83057
574518,8,1,9,1.376643,103.830582
574519,3,1,4,1.376627,103.830798
574520,21,0,21,1.376695,103.830497
574521,0,1,1,1.376151,103.831203
574522,23,0,23,1.376758,103.830422
574523,4,0,4,1.376873,103.830502
574524,1,6,7,1.376821,103.830343
574525,12,2,14,1.37705,103.830274
574527,5,5,10,1.377113,103.8302
574528,7,1,8,1.376958,103.830195
574530,11,1,12,1.37709,103.830035
574531,9,0,9,1.377157,103.829984
574532,0,1,1,1.37693,103.830416
574541,2,2,4,1.376993,103.830342
574542,2,0,2,1.376633,103.833171
574543,9,86,95,1.37966,103.831455
574544,76,0,76,1.37881,103.831129
574545,1,8,9,1.378836,103.831132
574547,0,1,1,1.377196,103.829944
574548,31,1,32,1.378622,103.831202
574549,10,1,11,1.378541,103.831245
574551,3,12,15,1.379017,103.830968
574553,67,0,67,1.378926,103.831025
574554,0,3,3,1.376346,103.830975
574555,2,3,5,1.378892,103.831027
574556,0,1,1,1.378781,103.831132
574557,21,0,21,1.378816,103.831052
574558,7,1,8,1.378031,103.831375
574560,1,3,4,1.379027,103.831122
574561,0,4,4,1.378001,103.831378
574562,44,1,45,1.377896,103.831412
574563,0,1,1,1.378205,103.831494
574565,10,0,10,1.378549,103.831129
574566,26,2,28,1.377754,103.831554
574568,89,0,89,1.37771,103.831572
574570,11,0,11,1.37769,103.831592
574571,7,1,8,1.378334,103.831189
574572,0,1,1,1.378617,103.831111
574574,5,2,7,1.377602,103.831672
574576,0,8,8,1.376976,103.832255
574577,45,3,48,1.3782,103.831197
574578,0,4,4,1.378718,103.831044
574579,4,0,4,1.376916,103.832285
574580,1,0,1,1.377644,103.831636
574582,1,0,1,1.376879,103.832349
574583,18,3,21,1.377992,103.831235
574584,42,0,42,1.376797,103.832394
574585,28,0,28,1.377936,103.831254
574586,6,0,6,1.376774,103.832428
574587,2,1,3,1.378272,103.831477
574588,1,0,1,1.376833,103.832382
574589,1,0,1,1.376722,103.832468
574590,40,2,42,1.376677,103.832508
574593,27,0,27,1.377653,103.831483
574594,0,1,1,1.377837,103.831346
574595,1,0,1,1.377638,103.831506
574596,2,0,2,1.378898,103.831118
574597,5,3,8,1.377498,103.831622
574599,3,0,3,1.37786,103.831316
574600,8,0,8,1.377447,103.831673
574602,10,0,10,1.377251,103.831846
574605,4,1,5,1.3771,103.831989
574606,0,3,3,1.377347,103.831748
574607,0,1,1,1.377586,103.83152
574608,1,0,1,1.376938,103.832162
574609,117,3,120,1.376835,103.832276
574610,5,1,6,1.376778,103.832322
574611,4,0,4,1.378165,103.831242
574612,2,0,2,1.377553,103.831545
574613,2,1,3,1.37705,103.832038
574614,2,10,12,1.376618,103.832487
574623,2241,8971,11212,1.341499,103.837625
574624,4,661,665,1.342528,103.838567
574626,2,25236,25238,1.299509,103.837
574627,79,1258,1337,1.342494,103.838569
574633,54,896,950,1.3529,103.834062
574634,2,9,11,1.352944,103.834029
574635,12,20,32,1.352975,103.833989
574636,6,12,18,1.352941,103.833872
574637,11,48,59,1.352681,103.834044
574638,1,0,1,1.376892,103.832231
574639,3,0,3,1.376658,103.832441
574640,1,0,1,1.352715,103.834148
574641,2,1,3,1.352595,103.834144
574642,10,0,10,1.352538,103.833979
574643,1,0,1,1.352656,103.833986
574644,0,2,2,1.376703,103.832402
574645,0,2,2,1.352639,103.833895
574646,2,0,2,1.352475,103.833803
574647,5,0,5,1.352435,103.833712
574648,7,0,7,1.352587,103.833719
574650,1,1,2,1.352589,103.833845
574652,7,0,7,1.35249,103.833491
574653,0,2,2,1.352547,103.833611
574654,0,6,6,1.352438,103.83336
574655,1,4,5,1.352274,103.83333
574656,14,7,21,1.352381,103.833241
574657,24,14,38,1.352234,103.833228
574658,1,2,3,1.352566,103.834064
574659,14,2,16,1.352199,103.833125
574660,9,4,13,1.352278,103.833019
574661,0,2,2,1.352308,103.833427
574662,32,3,35,1.352226,103.832911
574663,0,3,3,1.352354,103.833195
574664,0,8,8,1.352169,103.832797
574665,20,2,22,1.352062,103.832835
574666,2,1,3,1.352096,103.832932
574667,3,0,3,1.352129,103.832689
574668,147,2,149,1.352094,103.832592
574669,37,3,40,1.351947,103.832613
574670,0,1,1,1.352515,103.833888
574671,1,1,2,1.352153,103.833034
574672,0,2,2,1.351901,103.832511
574673,1,1,2,1.352008,103.832393
574674,17,1,18,1.351957,103.832296
574675,7,0,7,1.351792,103.8323
574676,1,1,2,1.351844,103.832397
574677,6,1,7,1.351746,103.832209
574678,6,3,9,1.35187,103.832091
574679,0,1,1,1.352054,103.832495
574680,32,1,33,1.351813,103.831977
574681,8,0,8,1.351655,103.831915
574682,26,2,28,1.351773,103.831869
574683,3,6,9,1.352214,103.83454
574684,11,1,12,1.352296,103.834488
574685,11,0,11,1.35217,103.834475
574687,12,0,12,1.352131,103.834385
574688,1,2,3,1.351999,103.832716
574690,0,1,1,1.351712,103.832107
574691,25,0,25,1.352052,103.834223
574692,99,0,99,1.352121,103.834109
574693,0,1,1,1.352169,103.834188
574694,2,0,2,1.351911,103.832199
574695,2,1,3,1.352202,103.834292
574696,2,0,2,1.352075,103.834013
574697,34,0,34,1.351958,103.834001
574698,6,2,8,1.352,103.833814
574699,52,1,53,1.351902,103.833951
574701,3,1,4,1.376744,103.832362
574702,4,0,4,1.351868,103.833882
574703,14,0,14,1.351839,103.833814
574704,31,3,34,1.351862,103.833501
574705,1,1,2,1.352035,103.833916
574706,4,0,4,1.351908,103.833603
574707,4,1,5,1.351787,103.833672
574708,11,0,11,1.351782,103.833318
574709,1,0,1,1.352025,103.834169
574710,1,2,3,1.351995,103.834075
574711,3,1,4,1.351822,103.833409
574712,7,0,7,1.351708,103.833131
574713,3,0,3,1.351753,103.833222
574714,4,2,6,1.351662,103.833034
574715,2,4,6,1.351673,103.833393
574718,19,6,25,1.351559,103.832846
574719,0,3,3,1.351701,103.833461
574720,46,0,46,1.351513,103.832744
574721,18,5,23,1.351598,103.833194
574722,1,3,4,1.351736,103.833535
574723,6,1,7,1.351092,103.832435
574724,120,6,126,1.351415,103.832527
574725,2,0,2,1.351816,103.83374
574726,0,5,5,1.351375,103.832436
574727,9,0,9,1.351045,103.83203
574728,0,1,1,1.351764,103.833603
574730,1,0,1,1.351318,103.83234
574731,55,0,55,1.351298,103.831811
574732,5,0,5,1.351386,103.831715
574733,5,0,5,1.351423,103.831645
574737,2,2,4,1.351455,103.832624
574738,65,4,69,1.351214,103.83272
574739,21,10,31,1.351169,103.83263
574740,10,6,16,1.351174,103.8326
574741,11,4,15,1.351684,103.832009
574742,12,4,16,1.351266,103.832226
574746,4,6,10,1.378861,103.83203
574747,18,9,27,1.379241,103.831526
574748,0,3,3,1.351621,103.833256
574749,15,1,16,1.379192,103.831531
574750,1,2,3,1.378761,103.832079
574751,33,2,35,1.379115,103.83156
574752,6,8,14,1.378562,103.832059
574753,4,2,6,1.379054,103.831556
574754,52,0,52,1.378474,103.832079
574755,30,10,40,1.37898,103.831577
574756,4,5,9,1.378387,103.832132
574757,8,0,8,1.378933,103.831706
574758,0,3,3,1.37864,103.832014
574759,24,4,28,1.378291,103.832193
574760,3,2,5,1.378772,103.831742
574761,0,2,2,1.350998,103.832209
574762,0,4,4,1.351723,103.831404
574763,3,7,10,1.378164,103.832335
574764,4,0,4,1.378661,103.831736
574765,1,0,1,1.35121,103.831871
574766,1,2,3,1.378833,103.831639
574767,2,0,2,1.378239,103.832268
574769,11,0,11,1.378279,103.831916
574770,1,2,3,1.378505,103.831791
574771,0,3,3,1.378212,103.831946
574772,2,0,2,1.378481,103.831808
574773,4,0,4,1.378548,103.831782
574774,0,5,5,1.377952,103.832013
574775,0,1,1,1.378526,103.831827
574776,1,16,17,1.378972,103.832064
574787,7,3,10,1.376135,103.831805
574788,2,2,4,1.378092,103.832062
574789,1,2,3,1.378168,103.831964
574790,6,15,21,1.377229,103.832059
574791,4,0,4,1.376231,103.831891
574792,5,0,5,1.377391,103.832287
574793,9,7,16,1.377125,103.832657
574794,1,2,3,1.377265,103.832172
574795,6,10,16,1.377197,103.832707
574796,1,0,1,1.377895,103.832051
574797,18,0,18,1.377395,103.832367
574798,8,10,18,1.377586,103.832425
574799,3,0,3,1.377461,103.832326
574800,12,9,21,1.377668,103.832948
574801,5,0,5,1.377735,103.833112
574802,3,4,7,1.377766,103.833208
574803,2,0,2,1.37813,103.831997
574804,0,4,4,1.377363,103.832255
574805,7,1,8,1.37791,103.833627
574806,0,5,5,1.37774,103.834122
574807,5,1,6,1.377956,103.833732
574808,5,2,7,1.377691,103.834214
574809,0,2,2,1.377843,103.833437
574810,42,8,50,1.377774,103.834458
574811,19,1,20,1.378024,103.833897
574812,100,1,101,1.377785,103.834527
574813,2,1,3,1.377631,103.832848
574814,4,0,4,1.377996,103.833507
574815,1,0,1,1.377494,103.832349
574816,1,1,2,1.378488,103.833683
574817,2,1,3,1.378031,103.833987
574818,16,10,26,1.378227,103.834463
574819,32,3,35,1.378263,103.834544
574820,0,7,7,1.378274,103.834689
574821,1,0,1,1.378159,103.834236
574822,5,3,8,1.377944,103.833417
574823,5,2,7,1.376162,103.831862
574824,6,1,7,1.376245,103.8319
574825,3,1,4,1.377807,103.834697
574826,0,2,2,1.37781,103.834744
574827,6,1,7,1.376386,103.832026
574828,4,0,4,1.3763,103.831957
574829,8,0,8,1.376503,103.832081
574830,22,4,26,1.376613,103.831595
574831,9,7,16,1.376694,103.83167
574832,10,3,13,1.376678,103.831519
574833,31,0,31,1.376739,103.831633
574834,5,0,5,1.376755,103.831419
574835,1,1,2,1.376362,103.831983
574836,1,1,2,1.376842,103.831518
574837,4,0,4,1.376459,103.832057
574839,2,4,6,1.377015,103.831288
574840,22,2,24,1.376943,103.831228
574841,1,0,1,1.378321,103.834754
574842,28,0,28,1.377052,103.831263
574843,2,0,2,1.376828,103.831337
574844,18,1,19,1.37716,103.8312
574845,2,0,2,1.377042,103.831129
574846,2,2,4,1.376888,103.831475
574847,10,0,10,1.377147,103.83103
574848,2,0,2,1.377113,103.831066
574849,8,1,9,1.37712,103.830932
574850,5,4,9,1.37742,103.830965
574851,7,0,7,1.377176,103.830826
574852,9,0,9,1.377451,103.830914
574854,0,2,2,1.37728,103.831059
574855,4,0,4,1.377196,103.831145
574856,17,1,18,1.377805,103.830937
574857,13,2,15,1.377361,103.83061
574858,3,2,5,1.377905,103.830917
574859,1,12,13,1.377971,103.83091
574860,50,5,55,1.37811,103.830868
574861,143,0,143,1.378232,103.830812
574862,1,19,20,1.377702,103.830533
574863,1,5,6,1.377767,103.830561
574864,8,0,8,1.377663,103.830427
574865,1,0,1,1.376987,103.831361
574867,16,0,16,1.377445,103.830257
574868,9,2,11,1.377335,103.83018
574869,0,4,4,1.377423,103.830741
574878,19,95,114,1.379808,103.831812
574879,2,16,18,1.379432,103.831894
574880,8,60,68,1.37986,103.831863
574881,42,0,42,1.37946,103.831989
574882,13,140,153,1.379893,103.831989
574883,5,2,7,1.379542,103.832098
574884,22,7,29,1.379821,103.832082
574885,2,0,2,1.377529,103.830802
574886,25,168,193,1.380014,103.832218
574887,3,0,3,1.378242,103.834291
574888,295,9,304,1.379991,103.832268
574889,2,4,6,1.379638,103.832365
574890,0,4,4,1.377286,103.830145
574891,5,67,72,1.380068,103.832396
574892,1,9,10,1.379817,103.832554
574893,5,342,347,1.380106,103.832457
574894,3,13,16,1.379857,103.832684
574895,0,14,14,1.380187,103.832613
574896,78,0,78,1.379766,103.832744
574897,0,127,127,1.380188,103.832695
574899,0,5,5,1.380239,103.832822
574900,7,1,8,1.379873,103.83295
574901,1,4,5,1.380182,103.832959
574903,1,6,7,1.380214,103.833124
574904,1,0,1,1.37761,103.830378
574905,6,3,9,1.38033,103.833122
574906,12,0,12,1.379966,103.833299
574907,3,9,12,1.380233,103.8332
574908,10,2,12,1.379999,103.833368
574909,6,141,147,1.380255,103.833289
574910,9,2,11,1.379812,103.833553
574911,1,0,1,1.379932,103.833173
574913,10,0,10,1.38036,103.833583
574914,2,4,6,1.379711,103.833271
574915,17,4,21,1.38021,103.833671
574916,1,2,3,1.379619,103.832304
574918,52,1,53,1.379595,103.833069
574919,0,1,1,1.380366,103.833489
574920,23,0,23,1.379567,103.832962
574921,14,1,15,1.379843,103.833613
574922,8,0,8,1.379522,103.832865
574923,15,0,15,1.379831,103.833887
574924,1,0,1,1.38001,103.833753
574925,13,4,17,1.379761,103.833902
574926,13,8,21,1.379473,103.832627
574927,10,0,10,1.379641,103.833968
574928,2,2,4,1.379697,103.832496
574929,17,0,17,1.379494,103.833862
574930,25,4,29,1.379385,103.832411
574931,18,0,18,1.379428,103.834075
574932,13,1,14,1.37937,103.832369
574933,18,0,18,1.37929,103.833981
574934,17,18,35,1.379304,103.832279
574935,4,2,6,1.379254,103.83419
574936,10,6,16,1.379274,103.832178
574937,12,2,14,1.379161,103.83426
574938,4,0,4,1.379451,103.832551
574939,2,0,2,1.379548,103.832166
574940,9,2,11,1.379161,103.831941
574941,1,0,1,1.379485,103.832783
574942,2,4,6,1.378876,103.834415
574943,7,0,7,1.378784,103.834303
574944,1,0,1,1.378925,103.834213
574945,80,0,80,1.378658,103.834134
574946,12,2,14,1.378454,103.834254
574947,3,7,10,1.378608,103.834012
574948,8,1,9,1.378547,103.833815
574949,3,3,6,1.378359,103.833844
574950,26,0,26,1.37847,103.833624
574951,12,5,17,1.378987,103.833052
574952,21,0,21,1.378444,103.833558
574953,2,0,2,1.379047,103.834139
574954,9,1,10,1.378416,103.833437
574955,1,0,1,1.378703,103.83419
574956,6,0,6,1.378198,103.833457
574957,72,1,73,1.379042,103.833263
574958,3,0,3,1.379619,103.83322
574960,5,0,5,1.378119,103.833229
574961,19,1,20,1.379163,103.833591
574962,68,0,68,1.378284,103.83307
574963,1,0,1,1.379019,103.833212
574964,37,9,46,1.378256,103.83297
574965,1,2,3,1.378362,103.833278
574966,25,2,27,1.379295,103.833728
574968,2,9,11,1.377948,103.832744
574969,83,9,92,1.379156,103.833554
574970,12,5,17,1.377919,103.83256
574971,0,1,1,1.37959,103.833449
574972,9,1,10,1.3791,103.833238
574973,44,3,47,1.377767,103.832278
574974,0,2,2,1.378995,103.833094
574975,5,0,5,1.377695,103.83223
574976,3,0,3,1.379469,103.833687
574978,1,0,1,1.379108,103.833434
574979,17,0,17,1.377609,103.832142
574980,2,0,2,1.379029,103.833185
574981,6,0,6,1.377573,103.832103
574983,10,0,10,1.377562,103.832081
574984,4,0,4,1.379203,103.832008
574985,9,0,9,1.377493,103.831991
574987,1,2,3,1.378974,103.833019
574988,35,0,35,1.378808,103.833442
574991,7,0,7,1.379098,103.833686
574992,0,1,1,1.37895,103.832947
574993,0,3,3,1.377439,103.831989
574994,0,5,5,1.378813,103.834087
574995,3,0,3,1.379005,103.833958
574996,10,4,14,1.378707,103.833853
574998,1,1,2,1.378406,103.833111
574999,27,13,40,1.378989,103.833404
575000,11,1,12,1.37851,103.833386
575001,4,2,6,1.378512,103.833403
575002,9,4,13,1.378439,103.833183
575003,5,0,5,1.378391,103.833064
575012,0,2,2,1.379022,103.833505
575013,12,4,16,1.377685,103.834308
575014,1,2,3,1.378774,103.833948
575015,7,1,8,1.377706,103.834494
575016,13,1,14,1.377812,103.834772
575017,2,0,2,1.377684,103.834245
575018,3,2,5,1.377816,103.834798
575019,1,2,3,1.377695,103.83442
575020,13,2,15,1.377767,103.834742
575021,0,1,1,1.378998,103.833857
575030,1,39,40,1.360657,103.830519
575031,0,12,12,1.360745,103.830425
575032,12,3,15,1.360649,103.830451
575033,14,2,16,1.360748,103.830373
575035,0,2,2,1.377731,103.834618
575036,6,1,7,1.360649,103.830339
575037,0,2,2,1.360748,103.830316
575038,4,0,4,1.378523,103.83342
575039,0,4,4,1.360641,103.830271
575040,58,1,59,1.360641,103.830206
575041,21,2,23,1.36075,103.830131
575042,1,0,1,1.377772,103.834781
575043,1,0,1,1.360641,103.830141
575044,5,0,5,1.360623,103.830056
575045,23,2,25,1.360758,103.829998
575046,9,0,9,1.360589,103.829978
575047,34,1,35,1.360761,103.829936
575048,18,0,18,1.360594,103.829863
575049,0,23,23,1.36084,103.829644
575050,67,2,69,1.360602,103.829749
575051,0,4,4,1.360748,103.830193
575052,4,1,5,1.360641,103.830002
575053,6,0,6,1.360903,103.829627
575054,0,1,1,1.360758,103.830063
575055,2,0,2,1.360748,103.830261
575057,0,3,3,1.377757,103.834707
575058,116,0,116,1.360639,103.829805
575059,1,6,7,1.361046,103.829587
575060,3,0,3,1.360983,103.829604
575061,12,0,12,1.361103,103.829581
575062,0,7,7,1.360679,103.829625
575063,2,2,4,1.360869,103.829632
575064,0,1,1,1.360647,103.82994
575065,5,2,7,1.361241,103.829552
575066,4,1,5,1.360805,103.829503
575067,46,57,103,1.361321,103.829541
575068,3,11,14,1.360893,103.829485
575069,21,7,28,1.361401,103.829524
575070,0,10,10,1.36095,103.82946
575071,1,0,1,1.360729,103.829525
575072,7,85,92,1.361024,103.829459
575074,4,32,36,1.361084,103.829422
575075,1,0,1,1.361421,103.829913
575076,3,71,74,1.36114,103.829431
575077,8,2,10,1.361353,103.830128
575078,74,25,99,1.361207,103.829428
575079,7,0,7,1.36133,103.830201
575080,7,44,51,1.361269,103.82941
575081,0,2,2,1.360943,103.829615
575082,41,9,50,1.361344,103.829409
575083,11,0,11,1.361293,103.830347
575084,4,27,31,1.361403,103.82943
575085,3,2,5,1.36128,103.830409
575086,1,3,4,1.361172,103.829564
575087,0,2,2,1.361314,103.830274
575088,1,5,6,1.36151,103.829466
575089,14,16,30,1.361221,103.830498
575090,17,0,17,1.361541,103.829506
575091,0,2,2,1.361257,103.830469
575092,14,0,14,1.361578,103.829626
575093,1,0,1,1.361371,103.830058
575094,27,0,27,1.361553,103.829777
575095,5,0,5,1.361544,103.829863
575097,1,1,2,1.361562,103.82957
575098,6,0,6,1.361611,103.82971
575099,159,3,162,1.361613,103.829775
575101,8,5,13,1.361566,103.829887
575102,5,2,7,1.361535,103.829972
575103,2,2,4,1.361474,103.829439
575104,0,1,1,1.361578,103.829696
575106,15,1,16,1.361439,103.830305
575107,7,9,16,1.361413,103.830396
575108,28,2,30,1.361377,103.830482
575109,0,1,1,1.361483,103.830147
575110,1,2,3,1.360643,103.829714
575111,1,1,2,1.361605,103.82964
575112,4,0,4,1.361507,103.830063
575113,2,0,2,1.361167,103.830555
575114,2,7,9,1.360882,103.830549
575115,0,3,3,1.361262,103.830557
575116,2,39,41,1.360692,103.830545
575125,2,4,6,1.351708,103.834911
575126,104,9,113,1.351856,103.83486
575127,1,2,3,1.360787,103.830547
575128,9,0,9,1.351797,103.834871
575129,1,4,5,1.35166,103.83483
575130,4,3,7,1.351822,103.834741
575131,1,2,3,1.351685,103.834878
575132,15,2,17,1.351745,103.834763
575133,36,17,53,1.351614,103.83474
575134,266,11,277,1.351776,103.83465
575135,1,0,1,1.361292,103.830547
575136,17,3,20,1.351725,103.834648
575137,1,0,1,1.351591,103.834681
575138,2,0,2,1.360977,103.830551
575139,4,0,4,1.361072,103.830553
575140,1,0,1,1.35173,103.834547
575142,3,11,14,1.351522,103.834525
575143,0,1,1,1.351541,103.834578
575144,6,0,6,1.351487,103.834471
575145,18,9,27,1.351627,103.834285
575146,0,10,10,1.351441,103.834322
575147,1,5,6,1.351545,103.834306
575148,0,6,6,1.351414,103.834262
575149,4,0,4,1.351671,103.834558
575150,6,4,10,1.351393,103.834188
575151,185,0,185,1.351494,103.834198
575152,2,0,2,1.351566,103.834636
575153,4,0,4,1.351581,103.834189
575155,2,5,7,1.351459,103.834095
575156,4,0,4,1.351504,103.834083
575157,8,0,8,1.351468,103.833987
575158,88,12,100,1.351328,103.834034
575160,2,2,4,1.351353,103.834098
575161,1,0,1,1.351619,103.834433
575162,3,0,3,1.351629,103.834773
575164,0,4,4,1.3513,103.833979
575165,1,0,1,1.351417,103.833868
575166,3,3,6,1.351232,103.833822
575167,0,1,1,1.351398,103.833728
575168,26,0,26,1.351219,103.833789
575169,2,0,2,1.351371,103.834143
575170,1,2,3,1.351262,103.833901
575172,1,0,1,1.35131,103.833748
575173,0,2,2,1.35134,103.833614
575174,1,0,1,1.351108,103.833587
575176,3,0,3,1.351064,103.83376
575177,3,0,3,1.350996,103.833626
575179,12,0,12,1.351178,103.833441
575180,8,3,11,1.350947,103.833483
575183,2,1,3,1.351254,103.833432
575184,3,0,3,1.351115,103.833316
575185,4,0,4,1.351246,103.833865
575186,0,1,1,1.35103,103.833645
575187,4,0,4,1.351105,103.833242
575189,0,3,3,1.35087,103.833358
575191,1,0,1,1.350837,103.833308
575192,11,10,21,1.350796,103.833157
575193,39,0,39,1.350957,103.832823
575194,13,6,19,1.350688,103.832989
575195,4,7,11,1.350902,103.832826
575196,1,11,12,1.350667,103.832904
575197,9,2,11,1.350895,103.832675
575199,3,1,4,1.351045,103.833191
575200,0,1,1,1.350976,103.833003
575201,2,2,4,1.350822,103.832619
575202,1,0,1,1.350582,103.83273
575203,3,0,3,1.351037,103.832994
575204,102,5,107,1.350492,103.832542
575205,43,0,43,1.350646,103.83229
575206,2,7,9,1.350297,103.832554
575207,3,0,3,1.35074,103.832499
575208,2,1,3,1.350603,103.832334
575209,2,1,3,1.350281,103.832585
575210,3,0,3,1.350486,103.832181
575212,15,2,17,1.350111,103.832939
575213,17,1,18,1.350272,103.832145
575214,40,15,55,1.350104,103.832998
575215,14,0,14,1.350283,103.832202
575216,0,6,6,1.349965,103.833513
575217,8,0,8,1.350147,103.832248
575218,15,0,15,1.350031,103.833567
575219,0,2,2,1.3513,103.833528
575220,10,0,10,1.350001,103.83364
575221,6,0,6,1.350009,103.832425
575223,34,1,35,1.349981,103.83251
575224,9,0,9,1.350059,103.833702
575225,19,3,22,1.349947,103.832613
575226,4,0,4,1.350804,103.832481
575228,2,0,2,1.350095,103.832311
575229,6,0,6,1.349893,103.832843
575231,10,1,11,1.349882,103.832917
575233,1,0,1,1.350515,103.832603
575235,1,2,3,1.350247,103.832694
575236,0,6,6,1.350241,103.834062
575237,84,0,84,1.349831,103.833276
575238,1,0,1,1.34985,103.833047
575239,6,7,13,1.349802,103.833367
575241,25,0,25,1.349789,103.833509
575242,1,0,1,1.350225,103.834097
575243,0,4,4,1.350062,103.83375
575244,14,0,14,1.349806,103.833583
575245,2,0,2,1.350122,103.833839
575246,9,0,9,1.349896,103.833735
575247,3,0,3,1.349831,103.833163
575248,6,1,7,1.349869,103.833673
575249,5,3,8,1.350389,103.834422
575251,1,0,1,1.349794,103.83356
575255,1,0,1,1.350414,103.834481
575256,3,0,3,1.35031,103.834307
575258,1,1,2,1.350298,103.834297
575259,4,1,5,1.350502,103.83466
575260,2,1,3,1.349927,103.833833
575261,2,0,2,1.349947,103.833926
575262,36,0,36,1.350013,103.834085
575263,9,0,9,1.350035,103.834126
575264,0,2,2,1.350507,103.834697
575265,19,0,19,1.35007,103.834181
575266,1,0,1,1.350424,103.834592
575267,4,0,4,1.350297,103.834226
575268,1,0,1,1.350628,103.834968
575269,1,0,1,1.350635,103.834984
575270,34,1,35,1.350692,103.835064
575272,6,0,6,1.350677,103.835094
575273,2,1,3,1.349997,103.834048
575274,0,1,1,1.350111,103.834265
575275,1,0,1,1.350684,103.835169
575276,17,0,17,1.350713,103.835231
575277,1,0,1,1.350207,103.834434
575278,4,0,4,1.350091,103.834219
575280,1,0,1,1.350255,103.834542
575281,0,8,8,1.350303,103.834616
575283,31,1,32,1.350329,103.834685
575284,1,0,1,1.350784,103.835297
575285,21,0,21,1.350372,103.834788
575286,3,3,6,1.35044,103.834916
575287,8,2,10,1.350447,103.834966
575288,3,3,6,1.35048,103.835014
575289,0,1,1,1.350347,103.834747
575290,4,0,4,1.350728,103.835266
575291,2,0,2,1.350567,103.834898
575292,6,12,18,1.350562,103.835183
575293,5,0,5,1.3506,103.835291
575294,48,0,48,1.350046,103.832766
575302,4,9,13,1.353353,103.832792
575303,1,12,13,1.353467,103.832802
575305,2,1,3,1.350177,103.834388
575307,2,1,3,1.353451,103.832748
575308,1,1,2,1.350508,103.835183
575309,0,1,1,1.350445,103.835097
575310,0,1,1,1.3534,103.83265
575311,2,2,4,1.350528,103.835081
575312,8,0,8,1.353248,103.832581
575313,1,0,1,1.353271,103.832644
575314,50,1,51,1.353231,103.832513
575316,11,2,13,1.353208,103.832445
575317,1,0,1,1.353383,103.832514
575318,20,2,22,1.353185,103.832382
575319,30,0,30,1.353162,103.832319
575320,1,4,5,1.353114,103.832217
575322,2,1,3,1.353423,103.832699
575324,0,8,8,1.352978,103.831942
575325,7,0,7,1.352942,103.831876
575326,1,1,2,1.353337,103.832633
575327,12,1,13,1.352873,103.831745
575328,13,0,13,1.352839,103.831677
575329,9,0,9,1.352805,103.831614
575330,2,1,3,1.353051,103.832086
575331,9,0,9,1.35273,103.831483
575333,1,1,2,1.352908,103.831813
575334,1,5,6,1.352633,103.831273
575335,61,8,69,1.352784,103.831292
575338,4,2,6,1.352519,103.831099
575339,10,2,12,1.35248,103.831032
575340,8,0,8,1.352402,103.831
575341,0,3,3,1.352764,103.831546
575343,0,1,1,1.353332,103.832383
575345,5,3,8,1.352167,103.830812
575346,11,1,12,1.352127,103.830806
575348,5,4,9,1.352035,103.830778
575349,1,1,2,1.352661,103.831347
575357,5,137,142,1.354445,103.83179
575358,3,13,16,1.354427,103.831846
575359,8,52,60,1.354382,103.831903
575360,4,6,10,1.354332,103.831968
575361,0,1,1,1.352265,103.830869
575362,1,0,1,1.354308,103.832002
575363,7,13,20,1.354272,103.832086
575364,0,3,3,1.352356,103.830949
575365,9,3,12,1.354249,103.832195
575366,22,0,22,1.354231,103.832241
575367,4,122,126,1.354197,103.832293
575368,0,2,2,1.353315,103.832315
575369,11,2,13,1.354152,103.832386
575371,0,4,4,1.353379,103.832598
575372,0,1,1,1.354296,103.832059
575373,5,0,5,1.354049,103.832585
575374,3,0,3,1.35426,103.832143
575376,0,6,6,1.353951,103.832734
575377,11,61,72,1.353923,103.832779
575378,5,0,5,1.353877,103.832825
575380,3,0,3,1.354026,103.832637
575381,4,21,25,1.353736,103.832887
575382,45,13,58,1.353707,103.832892
575383,2,4,6,1.353659,103.832904
575384,1,0,1,1.354066,103.83254
575385,0,15,15,1.353554,103.832944
575386,6,20,26,1.353439,103.833083
575394,1,6,7,1.353731,103.829577
575395,0,22,22,1.353701,103.829549
575396,2,14,16,1.353681,103.829618
575397,0,4,4,1.3541,103.832489
575398,16,1,17,1.353641,103.829676
575399,1,1,2,1.354163,103.83235
575400,0,1,1,1.353617,103.832927
575401,5,2,7,1.353538,103.829724
575402,0,1,1,1.353586,103.829735
575404,21,0,21,1.353489,103.829849
575405,1,2,3,1.353793,103.832872
575406,1,0,1,1.353537,103.829795
575407,2,1,3,1.35342,103.82985
575408,2,1,3,1.353401,103.829924
575409,1,2,3,1.353335,103.829959
575410,2,0,2,1.353614,103.829654
575411,6,0,6,1.353333,103.829997
575412,4,3,7,1.353253,103.830036
575414,14,0,14,1.353212,103.830077
575415,5,1,6,1.353256,103.830075
575416,0,1,1,1.353378,103.829901
575417,0,3,3,1.353364,103.829967
575418,2,3,5,1.353151,103.830148
575419,2,0,2,1.353297,103.829994
575420,2,0,2,1.353198,103.830135
575421,5,2,7,1.353173,103.830164
575422,3,2,5,1.353087,103.830231
575423,1,3,4,1.353647,103.829606
575424,3,2,5,1.35305,103.830267
575425,1,0,1,1.353183,103.83011
575426,12,0,12,1.353016,103.830302
575427,1,0,1,1.352797,103.830543
575428,10,0,10,1.352977,103.830337
575429,1,0,1,1.352774,103.83056
575430,4,0,4,1.353145,103.830197
575431,1,0,1,1.352753,103.830587
575432,3,0,3,1.353231,103.830101
575433,5,1,6,1.352711,103.830628
575434,4,1,5,1.352861,103.830441
575435,0,1,1,1.352734,103.830605
575437,17,0,17,1.352671,103.830674
575438,5,0,5,1.352797,103.830509
575439,3,0,3,1.352903,103.830395
575440,0,3,3,1.352648,103.830697
575441,7,2,9,1.352737,103.830572
575443,91,0,91,1.352677,103.830635
575444,6,1,7,1.352639,103.830668
575453,1,8,9,1.354149,103.829901
575455,1,16,17,1.354075,103.829985
575457,0,9,9,1.353998,103.83007
575458,4,2,6,1.353961,103.830134
575459,0,2,2,1.353117,103.830195
575460,0,3,3,1.352772,103.830538
575462,6,2,8,1.353811,103.830282
575463,0,5,5,1.353767,103.830337
575465,94,17,111,1.353729,103.830379
575466,4,0,4,1.352946,103.830364
575467,17,0,17,1.353694,103.830422
575468,3,7,10,1.3538,103.830349
575469,3,3,6,1.353667,103.830447
575470,10,0,10,1.353769,103.830382
575471,73,0,73,1.353637,103.830487
575472,0,4,4,1.353823,103.830327
575473,1,1,2,1.353936,103.830163
575474,0,5,5,1.353704,103.830469
575475,21,4,25,1.353542,103.830591
575476,4,0,4,1.35374,103.830419
575477,3,32,35,1.353233,103.830933
575478,69,2,71,1.353612,103.830568
575479,0,1,1,1.352688,103.830651
575480,0,16,16,1.353548,103.83064
575481,1,0,1,1.353202,103.830959
575482,1,0,1,1.353179,103.830982
575483,0,1,1,1.353165,103.831061
575484,0,24,24,1.353148,103.831078
575485,5,0,5,1.353133,103.831028
575487,2,2,4,1.353667,103.830506
575488,0,1,1,1.353156,103.831005
575490,9,2,11,1.353096,103.831135
575491,2,0,2,1.353583,103.830539
575493,5,0,5,1.353062,103.831175
575494,16,3,19,1.353045,103.831192
575504,17,4,21,1.354352,103.831641
575505,3,45,48,1.354306,103.831584
575506,5,5,10,1.35426,103.831538
575507,3,3,6,1.354214,103.831487
575508,1,40,41,1.354169,103.831442
575509,3,5,8,1.354123,103.831396
575510,26,0,26,1.354071,103.831351
575511,1,19,20,1.35402,103.831294
575512,1,3,4,1.35311,103.83105
575513,32,5,37,1.353877,103.831111
575514,1,1,2,1.353051,103.831118
575515,2,0,2,1.353832,103.83106
575516,15,1,16,1.353744,103.830994
575517,1,0,1,1.353113,103.831118
575518,7,8,15,1.353652,103.830886
575519,3,2,5,1.353612,103.830846
575520,12,10,22,1.353566,103.830801
575521,2,51,53,1.353424,103.830674
575522,11,0,11,1.353378,103.830623
575523,18,4,22,1.353333,103.830572
575524,10,1,11,1.353287,103.830526
575525,0,1,1,1.353698,103.830943
575527,2,0,2,1.353796,103.83104
575528,0,1,1,1.353241,103.830475
575537,3,4,7,1.354254,103.83065
575538,1,2,3,1.353902,103.830202
575539,1,0,1,1.35312,103.83035
575540,5,0,5,1.35418,103.830777
575542,0,5,5,1.354137,103.830838
575544,9,4,13,1.354089,103.830906
575545,6,5,11,1.354056,103.83094
575546,3,0,3,1.354231,103.830693
575548,3,0,3,1.354016,103.830981
575549,1,0,1,1.354206,103.830736
575550,1,0,1,1.353672,103.831344
575551,2,0,2,1.353166,103.830395
575553,1,0,1,1.353621,103.83139
575554,1,2,3,1.353705,103.831325
575555,54,24,78,1.353419,103.831632
575556,2,5,7,1.353361,103.831665
575565,321,1022,1343,1.364364,103.832825
575566,579,72,651,1.36613,103.829903
575567,77,3,80,1.366205,103.831649
575568,610,113,723,1.366006,103.831983
575569,773,704,1477,1.365482,103.83192
575570,833,175,1008,1.365174,103.831419
575571,518,140,658,1.365878,103.830947
575572,1026,81,1107,1.366365,103.830973
575574,2112,767,2879,1.364019,103.832484
575575,2396,449,2845,1.364003,103.831869
575576,217,388,605,1.364221,103.831451
575577,2884,159,3043,1.364412,103.831056
575578,2359,250,2609,1.365007,103.8307
575579,418,127,545,1.299509,103.837
575580,196,63,259,1.299509,103.837
575581,438,263,701,1.299509,103.837
575583,390,3049,3439,1.352134,103.835732
575584,235,52,287,1.352175,103.835824
575585,312,84,396,1.352852,103.836423
575592,1,3,4,1.353985,103.831254
575593,3,12,15,1.35784,103.840255
575608,7,600,607,1.354163,103.836022
575609,8,304,312,1.354209,103.836054
575610,7,0,7,1.354244,103.836088
575611,4,143,147,1.354278,103.836122
575612,25,91,116,1.354549,103.836341
575613,5,540,545,1.354584,103.836375
575614,6,554,560,1.354618,103.836409
575615,5,191,196,1.354644,103.836435
575616,7,203,210,1.35467,103.836469
575617,1,194,195,1.354784,103.836704
575618,1,170,171,1.354695,103.836495
575619,1,118,119,1.354721,103.836529
575620,0,111,111,1.354747,103.836554
575621,2,131,133,1.354773,103.83658
575622,5,827,832,1.354799,103.836606
575623,1,1037,1038,1.354824,103.83664
575624,144,2686,2830,1.356527,103.83791
575625,279,320,599,1.356166,103.83765
575626,6,12707,12713,1.359455,103.839755
575627,28,8262,8290,1.360197,103.840464
575628,146,1373,1519,1.353772,103.835874
575629,581,257,838,1.353108,103.835675
575630,259,2687,2946,1.352992,103.8355
575636,44,39,83,1.358764,103.838038
575642,43,2345,2388,1.358333,103.838551
575643,36,1985,2021,1.358392,103.838377
575644,39,163,202,1.3582,103.838305
575645,27,193,220,1.358089,103.838513
575654,177,51,228,1.357418,103.840252
575655,21,43,64,1.357476,103.840066
575656,11,16,27,1.357118,103.840436
575657,19,46,65,1.356648,103.840194
575658,18,80,98,1.356506,103.84013
575660,8,185,193,1.35789,103.840381
575661,2,5,7,1.358037,103.8402
575662,0,3,3,1.353454,103.83158
575663,0,19,19,1.357811,103.840654
575673,68,9,77,1.355569,103.839636
575674,3,19,22,1.355805,103.839202
575675,10,51,61,1.355998,103.839089
575676,10,24,34,1.356038,103.838593
575677,5,7,12,1.35575,103.838344
575678,34,1455,1489,1.355496,103.838304
575679,66,33,99,1.35526,103.839214
575680,29,28,57,1.355647,103.839838
575681,5,2809,2814,1.356389,103.83849
575682,15,4922,4937,1.357579,103.836175
575683,9,1193,1202,1.358034,103.836192
575684,1,366,367,1.356286,103.838466
575685,0,614,614,1.356125,103.83842
575686,0,326,326,1.35632,103.838395
575687,2,241,243,1.355967,103.838271
575688,0,159,159,1.356205,103.838367
575689,1,257,258,1.356086,103.83828
575690,2,32,34,1.35594,103.838359
575691,1,769,770,1.356617,103.838538
575692,0,90,90,1.355825,103.838328
575701,1264,2974,4238,1.356512,103.836226
575702,39,2654,2693,1.357409,103.83593
575703,84,84,168,1.357709,103.835789
575704,10,80,90,1.35793,103.836462
575705,20,473,493,1.358107,103.836507
575706,20,204,224,1.358603,103.836719
575707,29,3688,3717,1.359077,103.836464
575708,45,1799,1844,1.358738,103.837335
575710,233,1268,1501,1.358747,103.837157
575711,115,155,270,1.361559,103.83834
575712,106,6247,6353,1.361243,103.838307
575713,84,8673,8757,1.361412,103.838431
575715,89,852,941,1.361273,103.839252
575717,2298,14383,16681,1.35994,103.83768
575718,168,7615,7783,1.361065,103.838255
575719,61,2440,2501,1.361625,103.838506
575720,17,568,585,1.360883,103.839086
575721,1193,1378,2571,1.360113,103.83938
575722,66,456,522,1.359577,103.838693
575728,2161,439,2600,1.360985,103.828957
575731,1,19,20,1.361593,103.831421
575732,0,12,12,1.361877,103.831938
575733,595,1682,2277,1.359968,103.840937
575734,10,3194,3204,1.362151,103.839687
575735,8,3019,3027,1.361444,103.840579
575736,297,3483,3780,1.299509,103.837
575741,31,37,68,1.352029,103.836602
575750,57,3,60,1.378481,103.835047
575751,0,5,5,1.378137,103.835106
575752,7,9,16,1.378546,103.835027
575753,2,0,2,1.353582,103.83143
575754,2,0,2,1.378177,103.835143
575756,0,4,4,1.357594,103.840501
575757,16,8,24,1.378201,103.835255
575758,1,0,1,1.353498,103.831522
575759,1,0,1,1.378688,103.834889
575760,1,3,4,1.378595,103.834894
575761,4,2,6,1.378284,103.835398
575762,4,0,4,1.378763,103.834808
575763,1,10,11,1.378271,103.835437
575764,4,1,5,1.378897,103.83475
575766,13,1,14,1.378805,103.834881
575767,0,1,1,1.378218,103.835327
575769,1,120,121,1.378529,103.835455
575770,21,0,21,1.379094,103.834731
575771,2,55,57,1.378609,103.835349
575772,8,1,9,1.379126,103.834673
575773,4,34,38,1.378644,103.835123
575774,2,1,3,1.357818,103.84068
575775,1,1,2,1.378592,103.834982
575778,0,1,1,1.378358,103.835556
575779,29,1677,1706,1.378768,103.835016
575780,4,1,5,1.37937,103.834585
575781,0,1,1,1.379302,103.834625
575782,1,5,6,1.379453,103.834535
575783,1,12,13,1.378937,103.835101
575784,4,0,4,1.378845,103.834775
575785,0,8,8,1.37899,103.834904
575786,0,14,14,1.379637,103.83436
575787,0,79,79,1.379089,103.835016
575788,1,3,4,1.379581,103.834465
575789,6,919,925,1.379145,103.834995
575790,8,0,8,1.379814,103.834267
575791,0,3,3,1.379137,103.834586
575793,7,288,295,1.379237,103.834761
575794,6,44,50,1.380014,103.834277
575795,3,1,4,1.379762,103.834386
575796,2,0,2,1.378723,103.835278
575797,2,3938,3940,1.379327,103.834713
575798,2,3,5,1.380242,103.834136
575800,15,0,15,1.3803,103.833931
575801,0,29,29,1.380523,103.833771
575802,6,345,351,1.380442,103.834004
575811,90,5,95,1.372908,103.828142
575812,24,4,28,1.372906,103.828121
575813,0,27,27,1.372899,103.828192
575815,1,81,82,1.372901,103.828171
575816,13,268,281,1.372901,103.828244
575817,3,1,4,1.379268,103.83473
575818,6,6,12,1.373711,103.827106
575819,1,0,1,1.378819,103.834985
575820,8,0,8,1.373769,103.827122
575822,1,1,2,1.380174,103.834205
575823,3,0,3,1.379182,103.834782
575824,8,0,8,1.373858,103.827119
575825,14,0,14,1.373081,103.827614
575826,5,0,5,1.373906,103.827112
575828,4,0,4,1.373641,103.827067
575829,0,1,1,1.372924,103.827806
575830,0,1,1,1.373193,103.827507
575831,6,0,6,1.373311,103.827374
575832,5,1,6,1.374072,103.827095
575833,1,0,1,1.374014,103.827092
575835,19,0,19,1.373362,103.827252
575836,5,0,5,1.374188,103.827109
575837,68,1,69,1.373415,103.82717
575838,0,1,1,1.373323,103.827339
575839,2,2,4,1.373966,103.827113
575841,2,2,4,1.373452,103.827045
575843,3,0,3,1.373026,103.827675
575844,10,0,10,1.374415,103.827074
575845,6,0,6,1.373516,103.82684
575846,33,0,33,1.374458,103.827066
575847,1,3,4,1.373477,103.827
575849,24,0,24,1.373553,103.826671
575850,11,1,12,1.374563,103.827069
575851,2,1,3,1.373518,103.826901
575852,0,1,1,1.374255,103.827094
575853,0,1,1,1.374602,103.827064
575854,14,0,14,1.374654,103.827053
575855,6,11,17,1.373668,103.826589
575856,19,0,19,1.374702,103.827043
575858,2,0,2,1.373812,103.827127
575859,4,3,7,1.373653,103.826829
575860,0,1,1,1.373592,103.82652
575861,0,3,3,1.373578,103.826558
575862,0,2,2,1.374739,103.827049
575863,0,1,1,1.374796,103.827042
575864,121,1,122,1.374047,103.826996
575866,24,0,24,1.374271,103.826982
575867,1,2,3,1.373648,103.826943
575868,14,5,19,1.374481,103.826951
575869,0,2,2,1.373792,103.82701
575870,3,1,4,1.373554,103.826741
575880,4,2,6,1.376831,103.829555
575881,89,163,252,1.377482,103.828572
575882,6,0,6,1.376791,103.829595
575883,0,3,3,1.374368,103.826959
575884,0,2,2,1.374584,103.826944
575885,10,0,10,1.37735,103.828701
575887,4,5,9,1.377418,103.828768
575889,2,9,11,1.377391,103.82874
575890,0,3,3,1.377059,103.829175
575891,145,12,157,1.376805,103.829396
575894,1,3,4,1.374703,103.826933
575895,0,2,2,1.376745,103.829634
575896,28,6,34,1.376127,103.830075
575898,0,1,1,1.373924,103.827013
575899,18,6,24,1.37646,103.830113
575902,6,0,6,1.37607,103.830109
575903,12,0,12,1.376374,103.829983
575904,4,3,7,1.375574,103.83074
575905,0,2,2,1.376459,103.829885
575906,24,0,24,1.375512,103.83074
575907,8,0,8,1.376321,103.830274
575908,2,0,2,1.37625,103.830152
575909,0,5,5,1.376208,103.830203
575910,3,0,3,1.376608,103.829777
575911,0,1,1,1.376081,103.830051
575912,9,1,10,1.376097,103.830378
575913,1,1,2,1.376265,103.830302
575914,1,0,1,1.376142,103.830332
575916,4,0,4,1.376718,103.829456
575917,1,1,2,1.376039,103.830452
575918,4,3,7,1.375833,103.830703
575919,12,0,12,1.375799,103.830754
575920,0,2,2,1.375873,103.830651
575921,1,0,1,1.375988,103.830498
575924,0,3,3,1.376169,103.830252
575925,13,3,16,1.375442,103.831182
575926,111,0,111,1.375418,103.831251
575927,4,0,4,1.375913,103.830606
575928,240,10,250,1.375392,103.831388
575929,6,0,6,1.37538,103.83144
575930,1,0,1,1.375719,103.830862
575931,4,0,4,1.375402,103.831319
575932,9,8,17,1.375328,103.831622
575933,1,0,1,1.375357,103.831503
575935,2,2,4,1.37534,103.83156
575936,10,0,10,1.375248,103.831867
575938,5,0,5,1.375208,103.831987
575939,0,4,4,1.375277,103.83181
575940,0,10,10,1.375168,103.832106
575941,14,0,14,1.375145,103.832163
575942,0,11,11,1.375147,103.832225
575943,24,2,26,1.375128,103.832289
575944,16,10,26,1.375123,103.832357
575945,26,0,26,1.375088,103.832432
575946,3,4,7,1.375085,103.832516
575954,964,903,1867,1.345712,103.845871
575955,58,12,70,1.34669,103.844114
575963,29,602,631,1.352523,103.842991
575964,1,0,1,1.375317,103.831691
575965,3,2,5,1.352638,103.842991
575966,156,0,156,1.352709,103.842991
575967,0,28,28,1.352778,103.842991
575968,4,15,19,1.352847,103.842991
575969,9,0,9,1.352915,103.842991
575971,1,0,1,1.35258,103.842991
575972,5,2,7,1.35313,103.84299
575973,6,0,6,1.353207,103.842982
575974,8,2,10,1.353276,103.842982
575975,134,1,135,1.353336,103.842982
575976,2,1,3,1.375581,103.831004
575977,44,2,46,1.353465,103.842973
575978,57,6,63,1.353534,103.842973
575979,2,3,5,1.353603,103.842965
575980,22,0,22,1.353654,103.842965
575981,18,3,21,1.353723,103.842965
575982,26,3,29,1.353783,103.842956
575983,8,0,8,1.353835,103.842956
575984,19,0,19,1.353878,103.842956
575985,24,1,25,1.353929,103.842947
575986,0,2,2,1.375765,103.830805
575987,34,9,43,1.35405,103.842939
575988,58,1,59,1.354093,103.842939
575989,8,1,9,1.354144,103.842939
575990,36,1,37,1.354196,103.842939
575999,14,3,17,1.354319,103.842821
576000,9,1,10,1.354314,103.843178
576001,2,0,2,1.353998,103.842939
576003,4,1,5,1.354345,103.84271
576006,0,2,2,1.354336,103.842778
576007,3,0,3,1.353405,103.842973
576008,0,3,3,1.354379,103.842624
576009,0,4,4,1.375191,103.832044
576010,1,0,1,1.353061,103.842991
576011,17,0,17,1.354528,103.842546
576012,5,0,5,1.354439,103.842462
576013,11,5,16,1.354571,103.842452
576014,1,0,1,1.354494,103.842657
576015,0,2,2,1.354417,103.842862
576016,0,4,4,1.354396,103.842581
576017,0,1,1,1.354465,103.842411
576018,11,0,11,1.354516,103.842291
576019,3,4,7,1.354691,103.842136
576020,13,0,13,1.354533,103.842231
576021,0,6,6,1.354726,103.842033
576022,9,1,10,1.354551,103.842172
576023,4,6,10,1.35476,103.841922
576024,3,0,3,1.35446,103.842768
576025,1,1,2,1.354606,103.842349
576026,1,0,1,1.354648,103.842238
576027,1,3,4,1.35449,103.842351
576028,7,15,22,1.354628,103.841995
576029,1,434,435,1.354872,103.841624
576031,2,6,8,1.354906,103.841513
576032,3,0,3,1.354585,103.84212
576033,8,599,607,1.354949,103.841401
576034,0,4,4,1.354829,103.841717
576035,7,103,110,1.354716,103.841495
576036,1,1,2,1.354803,103.84182
576037,10,18,28,1.354636,103.841455
576038,2,3,5,1.354691,103.841671
576039,2,14,16,1.354555,103.841427
576041,3,4,7,1.354475,103.841398
576042,0,4,4,1.354668,103.841807
576043,3,9,12,1.354389,103.841364
576044,3,0,3,1.354656,103.84187
576045,2,2,4,1.353896,103.841325
576046,2,3,5,1.353776,103.841291
576047,3,22,25,1.354223,103.84129
576048,7,4,11,1.353716,103.841274
576049,8,4,12,1.354137,103.841262
576051,3,9,12,1.354051,103.841239
576052,4,0,4,1.354303,103.841324
576053,14,3,17,1.353965,103.841205
576054,12,0,12,1.353576,103.841769
576055,4,8,12,1.353879,103.841182
576057,0,45,45,1.353788,103.841154
576058,89,1,90,1.353775,103.841866
576059,3,23,26,1.353696,103.841131
576060,2,0,2,1.354679,103.841745
576061,4,0,4,1.353683,103.841797
576062,117,2,119,1.353702,103.841924
576063,0,1,1,1.354605,103.842058
576064,67,2,69,1.353636,103.84188
576065,0,1,1,1.353549,103.841157
576066,0,1,1,1.353523,103.841218
576067,8,125,133,1.353483,103.841303
576068,3,1,4,1.353599,103.84112
576069,5,0,5,1.353442,103.841388
576070,10,2,12,1.353657,103.84192
576071,19,11,30,1.353408,103.84148
576072,0,3,3,1.353836,103.841308
576073,16,0,16,1.353374,103.841559
576074,16,0,16,1.353336,103.842292
576075,1,31,32,1.353351,103.84165
576076,10,0,10,1.353382,103.842309
576077,4,1,5,1.353317,103.84173
576078,7,4,11,1.353427,103.842332
576079,0,123,123,1.353271,103.84181
576080,2,1,3,1.353296,103.84227
576081,0,37,37,1.353225,103.841895
576082,1,0,1,1.353582,103.841868
576083,7,24,31,1.353185,103.841981
576084,1,1,2,1.353539,103.841837
576085,2,0,2,1.353719,103.842518
576087,0,7,7,1.353116,103.842146
576088,16,0,16,1.353737,103.842374
576089,27,2,29,1.353082,103.842231
576090,45,0,45,1.353782,103.842361
576091,146,0,146,1.353048,103.842311
576092,30,1,31,1.353808,103.842299
576093,2,68,70,1.353013,103.84239
576094,1,0,1,1.353513,103.842383
576095,2,1,3,1.353468,103.842355
576097,0,44,44,1.352927,103.842556
576098,20,0,20,1.354062,103.841872
576099,29,2,31,1.353101,103.842117
576100,7,2,9,1.354045,103.841923
576101,10,15,25,1.353025,103.842219
576102,1,1,2,1.353151,103.842066
576103,1,24,25,1.352991,103.842365
576104,52,0,52,1.353993,103.842025
576105,2,25,27,1.352948,103.842386
576106,3,13,16,1.353976,103.842077
576107,0,22,22,1.352882,103.842641
576108,44,0,44,1.35395,103.842128
576109,0,30,30,1.352847,103.842726
576110,1,0,1,1.354096,103.841769
576111,2,19,21,1.352824,103.842795
576113,72,2,74,1.352811,103.842834
576115,0,245,245,1.352777,103.842894
576116,5,0,5,1.354029,103.841597
576117,70,3,73,1.354071,103.841544
576118,66,15,81,1.353876,103.842773
576119,5,3,8,1.353933,103.842559
576121,3,0,3,1.352973,103.84247
576122,7,0,7,1.353952,103.842457
576123,1,2,3,1.353937,103.842492
576126,9,19,28,1.353895,103.842613
576127,3,0,3,1.353974,103.842388
576128,1,16,17,1.35413,103.842267
576130,1,1,2,1.354019,103.841974
576131,2,0,2,1.354213,103.841743
576132,48,0,48,1.354033,103.842348
576133,7,0,7,1.354075,103.842026
576134,1,3,4,1.353587,103.841923
576136,5,1,6,1.35411,103.841985
576137,0,1,1,1.353933,103.842179
576138,3,3,6,1.354292,103.841528
576147,114,244,358,1.352553,103.842382
576148,481,2107,2588,1.353203,103.840987
576149,1576,508,2084,1.352156,103.841542
576150,1051,250,1301,1.352075,103.840994
576151,1358,573,1931,1.351867,103.842895
576157,7,0,7,1.354445,103.829423
576158,7,5,12,1.354737,103.829617
576160,2,0,2,1.354227,103.841693
576161,2,0,2,1.354922,103.829549
576162,12,1,13,1.35504,103.829474
576163,13,1,14,1.354904,103.829223
576165,3,1,4,1.354064,103.842198
576166,3,3,6,1.355542,103.828821
576168,3,1,4,1.355436,103.828758
576169,0,2,2,1.354763,103.829278
576170,3,1,4,1.355467,103.828895
576171,87,0,87,1.355278,103.829089
576173,13,0,13,1.355735,103.828644
576174,0,3,3,1.35412,103.841932
576175,0,1,1,1.354291,103.841585
576176,13,1,14,1.355473,103.828334
576177,0,2,2,1.35537,103.828986
576178,19,1,20,1.355452,103.828143
576179,13,2,15,1.355407,103.827981
576180,0,2,2,1.355738,103.828272
576189,41,29,70,1.35772,103.827577
576190,784,53,837,1.357506,103.827653
576191,346,23,369,1.357366,103.827637
576192,405,297,702,1.35698,103.828538
576193,413,29,442,1.356693,103.828262
576194,222,42,264,1.356423,103.827927
576195,42,0,42,1.357297,103.82725
576196,420,34,454,1.355602,103.827148
576197,318,13,331,1.355981,103.827523
576198,19,2,21,1.357257,103.827068
576199,186,21,207,1.357253,103.827616
576200,14,31,45,1.357253,103.827661
576201,24,2,26,1.357188,103.82688
576202,41,1,42,1.357039,103.826781
576203,0,6,6,1.357153,103.826692
576204,4,0,4,1.355293,103.82894
576205,6,1,7,1.356979,103.826574
576207,2,33,35,1.299509,103.837
576208,44,28,72,1.357331,103.827398
576209,31,13,44,1.299509,103.837
576210,50,0,50,1.299509,103.837
576214,33,7,40,1.372556,103.827894
576215,10,2,12,1.372639,103.827749
576216,1,0,1,1.355734,103.828481
576217,0,1,1,1.373685,103.826543
576218,34,3,37,1.373996,103.826733
576221,67,0,67,1.374358,103.826538
576222,18,0,18,1.374343,103.82677
576223,5,0,5,1.374495,103.826557
576224,2,3,5,1.374518,103.826742
576226,0,1,1,1.373918,103.82637
576227,3,3,6,1.375427,103.826643
576228,35,1,36,1.375477,103.826496
576229,2,2,4,1.357102,103.826493
576230,1,0,1,1.375273,103.826508
576231,18,2,20,1.375711,103.826421
576232,13,1,14,1.375764,103.826414
576233,46,1,47,1.37586,103.826375
576234,154,6,160,1.373453,103.827491
576235,14,4,18,1.373201,103.827802
576236,15,1,16,1.373509,103.82749
576237,0,1,1,1.375634,103.82644
576238,20,1,21,1.373564,103.82746
576239,30,0,30,1.37337,103.82778
576240,0,2,2,1.355217,103.827919
576241,2,1,3,1.355455,103.82854
576242,2,2,4,1.375569,103.826481
576243,4,3,7,1.373506,103.827794
576244,50,0,50,1.373731,103.827487
576245,17,1,18,1.373551,103.827802
576246,0,4,4,1.373714,103.827495
576247,2,0,2,1.373621,103.827493
576250,6,1,7,1.373724,103.827793
576251,10,0,10,1.373935,103.827471
576253,2,1,3,1.37342,103.827803
576254,1,1,2,1.373814,103.827462
576259,1,0,1,1.373286,103.827782
576261,0,2,2,1.373822,103.827612
576262,66,0,66,1.374044,103.827648
576263,0,14,14,1.374288,103.827456
576264,2,4,6,1.374092,103.827633
576265,7,5,12,1.374376,103.827457
576266,3,0,3,1.373976,103.827479
576267,22,3,25,1.3744,103.827456
576268,0,8,8,1.374229,103.827639
576269,2,1,3,1.374138,103.827635
576270,0,3,3,1.374459,103.827425
576271,2,2,4,1.373586,103.827766
576272,0,2,2,1.374229,103.827464
576273,3,1,4,1.374538,103.827412
576274,1,5,6,1.374415,103.827753
576275,6,4,10,1.374624,103.827422
576277,24,1,25,1.374701,103.827448
576279,21,0,21,1.374762,103.82745
576280,13,3,16,1.374573,103.827747
576281,3,24,27,1.37478,103.827439
576283,66,5,71,1.374875,103.827425
576284,2,0,2,1.374351,103.827654
576285,1,2,3,1.374309,103.827663
576286,2,2,4,1.374596,103.827423
576287,0,1,1,1.374028,103.827465
576288,15,36,51,1.374825,103.827735
576289,0,1,1,1.375099,103.827384
576290,43,8,51,1.374866,103.827748
576291,1,0,1,1.375242,103.827385
576292,1,10,11,1.375076,103.827709
576293,0,2,2,1.374714,103.82771
576295,24,1,25,1.375445,103.827387
576296,1,1,2,1.375371,103.827384
576297,34,1,35,1.375541,103.82735
576298,0,1,1,1.375266,103.827379
576300,50,1,51,1.375291,103.827695
576301,1,1,2,1.375213,103.827687
576302,1,0,1,1.375275,103.827698
576303,1,0,1,1.375354,103.827721
576304,0,1,1,1.375775,103.827378
576305,1,0,1,1.375412,103.827681
576306,1,0,1,1.375896,103.82737
576308,1,0,1,1.375486,103.827676
576309,2,6,8,1.376044,103.827351
576310,1,1,2,1.375702,103.827392
576311,0,1,1,1.375544,103.827702
576312,33,0,33,1.375649,103.827695
576313,0,1,1,1.376135,103.827341
576314,2,0,2,1.375605,103.827708
576316,0,1,1,1.376169,103.827345
576318,4,0,4,1.374743,103.827748
576320,8,1,9,1.375937,103.827557
576321,21,0,21,1.376585,103.827343
576322,9,2,11,1.375986,103.827563
576323,1,1,2,1.375683,103.827694
576324,22,0,22,1.376042,103.827546
576325,0,1,1,1.375744,103.82755
576326,0,3,3,1.375036,103.827406
576328,1,0,1,1.376737,103.827323
576330,6,2,8,1.376183,103.827544
576331,11,13,24,1.377008,103.827306
576332,4,0,4,1.375852,103.827553
576333,0,2,2,1.376627,103.827325
576335,7,0,7,1.376428,103.827628
576337,0,7,7,1.376592,103.827622
576338,0,1,1,1.376142,103.827565
576339,5,2,7,1.376672,103.827614
576341,0,1,1,1.376648,103.827644
576343,7,1,8,1.376893,103.827636
576346,51,1,52,1.377065,103.827634
576347,0,20,20,1.377139,103.827632
576356,20,269,289,1.35116,103.840284
576357,4,71,75,1.351105,103.840277
576358,4,186,190,1.351041,103.840263
576359,2,60,62,1.350982,103.840251
576360,0,97,97,1.350931,103.840237
576361,1,41,42,1.350874,103.84024
576362,0,69,69,1.350832,103.84023
576363,2,40,42,1.350782,103.840228
576364,1,41,42,1.350723,103.840222
576365,0,19,19,1.350666,103.840212
576366,1,31,32,1.350615,103.840212
576367,1,7,8,1.350567,103.840202
576368,4,8,12,1.350478,103.84014
576369,0,36,36,1.35043,103.840134
576370,1,26,27,1.35037,103.840121
576371,1,35,36,1.350322,103.840115
576372,1,24,25,1.350246,103.840104
576373,0,21,21,1.350165,103.840105
576374,0,108,108,1.350111,103.840101
576375,4,174,178,1.350054,103.840101
576376,0,110,110,1.349977,103.840095
576377,1,88,89,1.349809,103.840092
576378,1,152,153,1.34973,103.840093
576379,1,87,88,1.349635,103.840096
576380,1,35,36,1.349567,103.840096
576381,0,22,22,1.349486,103.840087
576382,1,23,24,1.349437,103.84009
576383,2,0,2,1.37631,103.827521
576384,9,3,12,1.353425,103.829237
576385,17,10,27,1.35433,103.829794
576386,21,0,21,1.354283,103.829752
576389,6,0,6,1.354321,103.829725
576392,7,0,7,1.354389,103.829762
576393,2,0,2,1.353338,103.829421
576394,6,0,6,1.354251,103.829918
576395,4,0,4,1.376243,103.827536
576396,1,0,1,1.37678,103.827642
576397,16,0,16,1.35426,103.829945
576398,24,0,24,1.354327,103.829932
576399,7,0,7,1.354305,103.829892
576400,1,1,2,1.354379,103.829793
576402,20,6,26,1.354347,103.830352
576403,1,0,1,1.354264,103.829843
576404,15,0,15,1.354253,103.829878
576406,5,0,5,1.35353,103.828927
576407,4,5,9,1.354315,103.829802
576408,0,1,1,1.354307,103.829955
576409,1,1,2,1.354274,103.829894
576410,12,8,20,1.353855,103.829465
576411,20,1,21,1.353924,103.829522
576412,20,0,20,1.353606,103.828619
576413,155,2,157,1.35397,103.829573
576414,3,1,4,1.353453,103.82908
576415,5,5,10,1.354101,103.829658
576416,14,4,18,1.354135,103.829695
576417,5,0,5,1.353943,103.827976
576418,7,4,11,1.354373,103.828097
576419,9,4,13,1.35388,103.828141
576421,14,1,15,1.353834,103.828289
576422,2,13,15,1.354107,103.827949
576423,5,1,6,1.353794,103.828414
576424,13,0,13,1.354004,103.828086
576425,4,0,4,1.354033,103.829613
576426,16,11,27,1.354194,103.827917
576427,3,1,4,1.353886,103.827835
576428,72,1,73,1.354517,103.828089
576429,4,0,4,1.354373,103.828013
576430,7,1,8,1.353935,103.828245
576431,25,0,25,1.35404,103.827843
576432,3,6,9,1.299509,103.837
576438,696,118,814,1.360169,103.830843
576439,580,3422,4002,1.360771,103.831193
576441,17,5,22,1.361508,103.830882
576442,0,3,3,1.376094,103.827559
576443,3,108,111,1.299509,103.837
576444,17,146,163,1.299509,103.837
576445,28,23,51,1.299509,103.837
576446,1,0,1,1.35378,103.829414
576447,2,0,2,1.353593,103.828759
576449,0,9,9,1.299509,103.837
576451,6,1,7,1.358623,103.825144
576452,36,3,39,1.358606,103.825099
576453,0,8,8,1.358589,103.825053
576454,2,0,2,1.299509,103.837
576455,13,7,20,1.358549,103.824979
576456,5,1,6,1.358532,103.824934
576457,0,2,2,1.358572,103.825008
576458,2,0,2,1.358492,103.824854
576460,0,1,1,1.299509,103.837
576461,18,26,44,1.358434,103.824672
576462,0,1,1,1.358451,103.824729
576471,2,5,7,1.358367,103.826008
576472,1,11,12,1.35838,103.826097
576473,35,46,81,1.358397,103.825992
576474,3,2,5,1.35845,103.826076
576475,0,1,1,1.358678,103.825242
576476,11,0,11,1.358511,103.826054
576477,12,1,13,1.358459,103.825967
576479,0,1,1,1.358425,103.825984
576480,2,1,3,1.361609,103.831477
576481,2,21,23,1.35854,103.825938
576482,1,0,1,1.358488,103.825956
576484,232,0,232,1.358586,103.825937
576485,1,6,7,1.358752,103.825957
576486,1,0,1,1.358641,103.826
576487,2,3,5,1.358801,103.825965
576488,1,19,20,1.358683,103.825891
576489,4,0,4,1.354626,103.828188
576490,12,0,12,1.358785,103.825861
576507,39,11,50,1.358257,103.827004
576508,1,0,1,1.358642,103.825908
576509,0,7,7,1.358284,103.826935
576510,4,55,59,1.358406,103.827015
576512,65,0,65,1.358498,103.826781
576513,4,17,21,1.358226,103.826826
576514,1,0,1,1.35812,103.827095
576515,3,0,3,1.358599,103.826014
576516,1,0,1,1.358475,103.82669
576517,1,2,3,1.358233,103.826758
576518,242,6,248,1.358411,103.826474
576519,1,0,1,1.358446,103.826594
576520,16,7,23,1.358117,103.826674
576522,1,2,3,1.358193,103.826726
576523,21,1,22,1.358171,103.825985
576524,349,0,349,1.358177,103.826047
576525,340,0,340,1.358183,103.826098
576526,13,0,13,1.358194,103.826144
576527,1,0,1,1.358389,103.826377
576528,3,2,5,1.35824,103.826229
576529,10,0,10,1.358246,103.826286
576530,47,0,47,1.358252,103.826338
576532,1,0,1,1.358217,103.826195
576533,4,2,6,1.357967,103.825921
576534,14,0,14,1.357977,103.825867
576535,5,0,5,1.357934,103.825816
576536,1,2,3,1.358165,103.826631
576537,2,3,5,1.357825,103.825759
576538,5,6,11,1.357864,103.825698
576539,3,0,3,1.35792,103.825766
576540,1,0,1,1.358286,103.826451
576541,12,0,12,1.357939,103.825075
576543,28,4,32,1.358005,103.824997
576545,19,2,21,1.358349,103.824451
576546,6,0,6,1.358315,103.824508
576547,13,2,15,1.358275,103.82457
576548,2,1,3,1.357862,103.825169
576549,1,1,2,1.358474,103.824814
576550,2,0,2,1.358194,103.824724
576551,17,0,17,1.358131,103.824861
576553,2,0,2,1.358166,103.824792
576554,25,0,25,1.358294,103.824388
576555,71,0,71,1.358322,103.824358
576556,103,2,105,1.358498,103.826969
576557,1,3,4,1.358726,103.825889
576558,11,26,37,1.358486,103.824563
576559,4,0,4,1.358503,103.826878
576560,173,1,174,1.358303,103.827038
576564,6,202,208,1.355866,103.829963
576565,32,0,32,1.355949,103.829892
576566,1,47,48,1.356031,103.829813
576567,0,2,2,1.358051,103.824997
576568,0,23,23,1.356164,103.829696
576569,1,16,17,1.356226,103.829624
576570,0,14,14,1.356288,103.829581
576571,0,25,25,1.356323,103.829541
576572,5,0,5,1.356374,103.829501
576573,0,19,19,1.356414,103.829456
576574,1,29,30,1.356449,103.829422
576575,4,26,30,1.356489,103.829376
576576,0,2,2,1.356089,103.829747
576577,1,53,54,1.356517,103.829342
576578,7,262,269,1.35658,103.829268
576579,4,7,11,1.355469,103.829889
576580,12,25,37,1.355417,103.829912
576581,15,6,21,1.355371,103.829929
576582,37,71,108,1.35532,103.829946
576583,17,5,22,1.355268,103.829969
576584,16,6,22,1.355165,103.829963
576585,6,9,15,1.355102,103.829946
576586,13,3,16,1.355045,103.829929
576587,4,6,10,1.354982,103.829906
576588,16,2,18,1.354821,103.83
576589,64,12,76,1.354589,103.829861
576590,3,3,6,1.354462,103.829707
576591,7,0,7,1.354185,103.829269
576592,16,1,17,1.3543,103.829383
576593,6,0,6,1.354403,103.82948
576594,2,1,3,1.35824,103.824644
576595,32,5,37,1.353709,103.829118
576612,0,4,4,1.358211,103.827072
576613,6,302,308,1.353785,103.835033
576614,8,3,11,1.353845,103.834909
576615,0,31,31,1.353828,103.835068
576616,0,3,3,1.353787,103.829213
576617,5,10,15,1.353871,103.835102
576618,1,1,2,1.356546,103.829308
576619,2,1,3,1.353856,103.834941
576620,4,3,7,1.353959,103.835018
576621,1,14,15,1.353983,103.835143
576623,0,12,12,1.354024,103.835165
576624,2,27,29,1.354056,103.835174
576625,5,3,8,1.354095,103.835195
576627,23,23,46,1.35414,103.835218
576629,2,12,14,1.354172,103.835234
576630,1,0,1,1.357884,103.825119
576631,0,1,1,1.354252,103.835197
576634,2,3,5,1.354355,103.835248
576635,1,1,2,1.353908,103.834984
576636,39,0,39,1.354398,103.835265
576637,1,1,2,1.354261,103.835284
576638,1,1,2,1.35429,103.835297
576639,3,1,4,1.35377,103.83486
576640,2,1,3,1.353941,103.835117
576641,1,0,1,1.354192,103.835267
576642,69,0,69,1.354518,103.835342
576643,3,0,3,1.354475,103.835316
576644,0,2,2,1.354441,103.835291
576645,1,1,2,1.354553,103.835367
576646,8,0,8,1.354596,103.835393
576647,13,1,14,1.355011,103.835926
576648,0,2,2,1.354915,103.835832
576650,22,0,22,1.354681,103.835436
576651,40,2,42,1.35517,103.835988
576653,0,2,2,1.354647,103.83541
576655,14,0,14,1.354767,103.835504
576656,0,2,2,1.355222,103.836038
576657,8,0,8,1.354862,103.835538
576658,11,0,11,1.354914,103.835555
576660,1,1,2,1.354819,103.835521
576662,0,1,1,1.354368,103.835357
576663,13,10,23,1.355137,103.835658
576672,10,6,16,1.377121,103.829054
576673,0,197,197,1.377156,103.828645
576674,71,8,79,1.377045,103.829081
576675,3,4,7,1.377134,103.828712
576676,1,0,1,1.355085,103.83564
576677,0,142,142,1.377043,103.828664
576678,40,1,41,1.376972,103.829154
576679,13,2,15,1.377015,103.828705
576681,5,5,10,1.376964,103.8287
576682,5,2,7,1.376808,103.828915
576683,19,110,129,1.376904,103.828705
576684,48,143,191,1.376854,103.828706
576685,0,2,2,1.355,103.835598
576686,8,0,8,1.376785,103.828714
576687,1,0,1,1.377017,103.829031
576688,4,148,152,1.376666,103.828709
576689,2,0,2,1.376752,103.828923
576690,3,124,127,1.376617,103.828712
576691,2,4,6,1.376587,103.828919
576692,0,2,2,1.376624,103.828915
576693,2,1,3,1.354859,103.835834
576694,5,10,15,1.376525,103.828701
576695,3,2,5,1.376491,103.828921
576696,1,115,116,1.376466,103.828687
576697,7,0,7,1.376419,103.828917
576698,0,2,2,1.376581,103.828744
576700,1,66,67,1.376344,103.828678
576701,0,2,2,1.376422,103.828687
576702,0,18,18,1.376279,103.828677
576703,1,0,1,1.376717,103.828919
576704,2,16,18,1.376193,103.828705
576705,23,0,23,1.37614,103.829068
576706,0,23,23,1.376113,103.828743
576708,1,4,5,1.37608,103.82876
576709,0,2,2,1.376278,103.829084
576710,32,26,58,1.375998,103.828704
576711,7,0,7,1.375957,103.829078
576712,1,102,103,1.375973,103.828718
576721,16,0,16,1.37279,103.831124
576722,13,2,15,1.372932,103.831306
576724,171,1,172,1.373054,103.831349
576725,0,1,1,1.376246,103.829093
576726,1,4,5,1.373167,103.831409
576727,3,0,3,1.376537,103.828921
576728,11,5,16,1.373287,103.831424
576729,11,7,18,1.373186,103.831255
576731,0,1,1,1.372985,103.831187
576732,4,2,6,1.373536,103.831516
576733,1,0,1,1.373277,103.831289
576734,2,0,2,1.376006,103.829077
576735,60,3,63,1.373759,103.831578
576736,24,5,29,1.373535,103.831369
576737,7,1,8,1.373866,103.83162
576738,18,1,19,1.373615,103.831403
576739,23,0,23,1.373986,103.83162
576740,5,3,8,1.373701,103.831431
576741,7,3,10,1.374095,103.831631
576742,5,3,8,1.373782,103.831442
576743,37,1,38,1.374209,103.831631
576744,3,0,3,1.373083,103.831209
576745,0,2,2,1.373455,103.831346
576746,25,1,26,1.373971,103.831471
576747,0,2,2,1.37433,103.831631
576748,0,1,1,1.373647,103.831539
576749,3,1,4,1.354332,103.835326
576750,107,4,111,1.374148,103.831465
576752,8,0,8,1.374234,103.831471
576753,3,3,6,1.374794,103.831636
576754,0,1,1,1.374062,103.831471
576756,0,2,2,1.374444,103.831631
576757,6,1,7,1.375027,103.831624
576758,109,0,109,1.374515,103.831453
576759,3,14,17,1.375134,103.83164
576760,0,11,11,1.374607,103.831453
576762,1,1,2,1.374429,103.831454
576763,3,1,4,1.374565,103.831625
576764,0,1,1,1.374326,103.831465
576765,28,3,31,1.375053,103.831453
576766,2,0,2,1.374778,103.831453
576775,4,11,15,1.364653,103.828662
576776,20,371,391,1.364637,103.828519
576778,25,8,33,1.365145,103.828541
576779,0,3,3,1.373868,103.831459
576780,0,1,1,1.374956,103.831448
576781,5,3,8,1.364547,103.829025
576782,8,0,8,1.364516,103.829064
576783,4,6,10,1.364281,103.829545
576784,152,0,152,1.364324,103.829476
576785,34,1,35,1.364366,103.829408
576786,3,0,3,1.364608,103.82885
576787,0,10,10,1.364958,103.82908
576788,0,2,2,1.375145,103.831459
576789,35,4,39,1.364539,103.829566
576790,3,0,3,1.364401,103.829348
576791,59,1,60,1.364582,103.829498
576792,4,1,5,1.364521,103.829152
576793,127,4,131,1.364608,103.829438
576794,3,0,3,1.364487,103.82922
576796,2,6,8,1.364177,103.829774
576797,2,3,5,1.364668,103.82931
576799,4,0,4,1.37487,103.831448
576800,1,1,2,1.364444,103.829288
576801,0,5,5,1.364745,103.82919
576802,16,0,16,1.364028,103.830013
576803,16,0,16,1.364779,103.829139
576804,0,5,5,1.364017,103.830121
576805,16,3,19,1.364616,103.829776
576806,16,1,17,1.364006,103.830108
576807,3,0,3,1.364186,103.829687
576808,16,4,20,1.363966,103.830176
576811,10,1,11,1.36449,103.829737
576812,0,1,1,1.364601,103.828888
576813,4,5,9,1.364444,103.829833
576814,0,35,35,1.363869,103.830421
576815,1,1,2,1.36407,103.829962
576816,45,11,56,1.363817,103.830518
576817,1,5,6,1.364376,103.82997
576818,21,14,35,1.363794,103.830592
576819,0,2,2,1.364422,103.829902
576820,1,6,7,1.364307,103.830113
576821,1,18,19,1.364273,103.830186
576822,8,2,10,1.364227,103.830255
576823,2,66,68,1.364181,103.830323
576824,1,20,21,1.364141,103.830391
576825,4,53,57,1.364107,103.830454
576826,13,128,141,1.364073,103.830528
576836,2,42,44,1.36435,103.82858
576837,3,2,5,1.364277,103.828847
576838,8,3,11,1.363962,103.82878
576839,28,2,30,1.363924,103.829345
576841,6,0,6,1.363958,103.829263
576842,12,1,13,1.363824,103.829258
576843,1,1,2,1.364341,103.830044
576844,4,1,5,1.36388,103.829132
576845,0,1,1,1.363903,103.830336
576846,2,0,2,1.364004,103.829151
576847,4,0,4,1.364702,103.829241
576848,0,1,1,1.364045,103.829069
576849,3,3,6,1.363639,103.829384
576850,71,0,71,1.363975,103.82952
576852,4,6,10,1.363893,103.829628
576853,36,1,37,1.363549,103.829642
576854,34,0,34,1.363896,103.829739
576855,41,1,42,1.363976,103.828688
576863,13,1,14,1.355451,103.835984
576864,2,2,4,1.36395,103.828943
576865,1,0,1,1.36411,103.828941
576866,1,0,1,1.355502,103.835882
576867,10,0,10,1.355577,103.835779
576868,0,2,2,1.363919,103.829033
576869,3,0,3,1.364569,103.829915
576870,5,9,14,1.355697,103.835614
576871,1,2,3,1.355663,103.835665
576872,0,1,1,1.355537,103.835831
576873,0,4,4,1.355474,103.835927
576875,1,0,1,1.35576,103.835535
576876,1,5,6,1.355883,103.835355
576877,0,21,21,1.355909,103.835313
576878,19,0,19,1.355943,103.835278
576879,4,2,6,1.35596,103.835227
576880,22,0,22,1.355986,103.835184
576881,0,2,2,1.355622,103.835722
576882,0,9,9,1.356039,103.834776
576886,0,1,1,1.355849,103.835398
576889,7,1,8,1.356301,103.834543
576890,10,0,10,1.356176,103.834458
576891,34,1,35,1.356341,103.834464
576892,2,1,3,1.355726,103.835574
576893,8,0,8,1.356375,103.834384
576894,45,0,45,1.356257,103.834293
576895,2,1,3,1.356217,103.834372
576896,1,1,2,1.356135,103.834873
576897,3,0,3,1.356421,103.834304
576906,2,10,12,1.372453,103.830673
576907,88,6,94,1.372348,103.830293
576908,6,0,6,1.372459,103.830761
576909,0,3,3,1.356291,103.83419
576910,32,10,42,1.372342,103.830537
576911,25,3,28,1.372466,103.830923
576912,1,1,2,1.356456,103.834212
576913,7,2,9,1.37246,103.830982
576914,5,2,7,1.37236,103.830754
576915,12,0,12,1.372458,103.831013
576916,9,0,9,1.372377,103.830868
576917,2,0,2,1.372348,103.830634
576918,0,7,7,1.372648,103.83132
576919,25,7,32,1.372394,103.831095
576920,2,1,3,1.372462,103.830838
576921,21,2,23,1.372412,103.831181
576922,2,21,23,1.372642,103.831485
576923,2,1,3,1.372648,103.8314
576924,3,1,4,1.355788,103.835483
576925,5,7,12,1.372435,103.831408
576926,1,0,1,1.356108,103.834623
576927,81,4,85,1.372452,103.831517
576928,15,7,22,1.372737,103.831802
576929,5,8,13,1.372492,103.831613
576930,25,0,25,1.372342,103.830401
576938,8,9,17,1.371772,103.829862
576939,3,2,5,1.37164,103.830022
576940,6,0,6,1.371785,103.829929
576941,0,1,1,1.372654,103.831667
576943,3,0,3,1.372429,103.831283
576944,13,9,22,1.371791,103.830083
576945,2,0,2,1.372383,103.830959
576946,3,0,3,1.371651,103.830187
576947,2,2,4,1.372648,103.831576
576948,7,3,10,1.371802,103.830323
576949,5,1,6,1.371674,103.830426
576950,3,6,9,1.371686,103.8305
576951,16,1,17,1.371821,103.830455
576952,29,0,29,1.371697,103.830574
576953,25,4,29,1.371831,103.830511
576954,5,7,12,1.371709,103.830654
576955,6,4,10,1.371825,103.830631
576956,53,0,53,1.371715,103.830739
576957,5,3,8,1.371831,103.8307
576958,2,0,2,1.371657,103.830267
576959,78,4,82,1.371839,103.830805
576961,50,0,50,1.371846,103.830878
576963,5,0,5,1.371856,103.830976
576964,9,1,10,1.37176,103.831041
576965,0,2,2,1.371732,103.830824
576966,12,1,13,1.371766,103.831115
576968,1,0,1,1.371645,103.830107
576969,16,1,17,1.371878,103.831235
576970,2,5,7,1.371778,103.83128
576972,19,7,26,1.371789,103.831354
576973,0,2,2,1.371867,103.831062
576974,5,0,5,1.371915,103.831483
576975,4,10,14,1.371919,103.831563
576984,53,87,140,1.36407,103.828338
576985,1,76,77,1.363984,103.828338
576986,10,5,15,1.36389,103.828338
576987,11,22,33,1.363786,103.828338
576988,4,118,122,1.363413,103.828317
576990,2,7,9,1.363224,103.828317
576991,66,117,183,1.363129,103.828317
576992,1,129,130,1.362854,103.828276
576993,24,20,44,1.362751,103.828276
576994,17,15,32,1.362665,103.828276
576995,2,17,19,1.362571,103.828276
576996,0,29,29,1.362412,103.828396
576997,4,2,6,1.362526,103.828728
576998,3,1,4,1.371663,103.830346
576999,1,1,2,1.371894,103.831387
577000,0,1,1,1.371772,103.831194
577001,5,4,9,1.362536,103.828456
577002,13,1,14,1.362388,103.828711
577003,2,2,4,1.362394,103.828505
577004,2,0,2,1.362526,103.828604
577006,23,4,27,1.362568,103.829102
577007,3,0,3,1.371806,103.830248
577008,0,13,13,1.362672,103.829305
577018,0,9,9,1.353793,103.836673
577020,7,1,8,1.353776,103.836719
577021,1,4,5,1.353905,103.836763
577022,44,1,45,1.353759,103.836753
577023,2,2,4,1.362434,103.828806
577024,2,1,3,1.362613,103.829212
577025,2,9,11,1.353709,103.837192
577026,0,1,1,1.362397,103.828605
577027,1,0,1,1.353725,103.836832
577029,2,2,4,1.353888,103.836806
577030,7,1,8,1.35369,103.836918
577031,1,0,1,1.353689,103.837237
577032,3,0,3,1.353742,103.836793
577034,3,0,3,1.353673,103.836963
577035,9,3,12,1.353567,103.837389
577036,4,0,4,1.353674,103.837289
577037,65,0,65,1.353541,103.837434
577039,14,0,14,1.353515,103.837466
577040,0,1,1,1.353637,103.837326
577041,0,1,1,1.353604,103.83714
577042,1,1,2,1.362474,103.828903
577043,1,1,2,1.353581,103.83718
577044,2,3,5,1.353564,103.83722
577045,2,0,2,1.353478,103.837492
577046,13,0,13,1.352984,103.837635
577047,1,0,1,1.353452,103.837522
577048,0,1,1,1.353382,103.837565
577049,1,0,1,1.352956,103.837668
577050,2,1,3,1.353656,103.837009
577051,0,1,1,1.352868,103.838038
577053,0,1,1,1.35281,103.83807
577054,0,4,4,1.353639,103.837049
577055,1,5,6,1.352746,103.838121
577056,2,1,3,1.352852,103.837734
577057,7,2,9,1.3527,103.838158
577058,26,3,29,1.352598,103.837864
577059,1,5,6,1.352632,103.838151
577060,3,2,5,1.352574,103.837931
577061,2,0,2,1.353408,103.837532
577062,10,3,13,1.352486,103.837989
577071,0,2,2,1.352526,103.837953
577072,1,4,5,1.354597,103.838176
577073,3,5,8,1.35458,103.838253
577074,4,0,4,1.352713,103.837845
577075,0,4,4,1.354563,103.838322
577076,0,10,10,1.354511,103.838484
577077,0,2,2,1.354614,103.8381
577078,0,7,7,1.354468,103.838629
577079,0,10,10,1.354442,103.838697
577080,4,16,20,1.354417,103.838766
577081,1,2,3,1.352672,103.837868
577082,13,8,21,1.3544,103.838843
577083,0,1,1,1.352769,103.838094
577084,3,9,12,1.354391,103.838919
577086,0,2,2,1.354494,103.838552
577087,1,4,5,1.354255,103.838655
577088,1,20,21,1.354365,103.839047
577089,9,0,9,1.354246,103.838698
577090,1,7,8,1.354348,103.839124
577091,13,0,13,1.354238,103.838741
577092,0,7,7,1.354322,103.83921
577093,7,0,7,1.354229,103.838783
577095,31,2,33,1.35422,103.838826
577096,3,3,6,1.35434,103.839355
577097,7,2,9,1.354212,103.83886
577098,0,2,2,1.354382,103.838996
577099,23,0,23,1.354203,103.838903
577100,50,3,53,1.35444,103.838814
577101,0,1,1,1.354272,103.83857
577102,2,1,3,1.354281,103.838527
577104,14,0,14,1.354385,103.839003
577105,0,2,2,1.354436,103.838775
577106,3,5,8,1.354359,103.839061
577108,2,7,9,1.354341,103.839102
577110,1,0,1,1.354203,103.838937
577111,0,4,4,1.354537,103.838398
577112,0,4,4,1.354325,103.839218
577113,4,0,4,1.35433,103.839265
577115,3,0,3,1.3544,103.839577
577116,3,0,3,1.354665,103.839976
577117,2,2,4,1.35438,103.839378
577118,2,0,2,1.354169,103.839014
577119,13,1,14,1.35477,103.840028
577120,1,1,2,1.354744,103.840019
577121,12,2,14,1.354821,103.840062
577122,6,2,8,1.354847,103.840079
577124,0,9,9,1.354888,103.840104
577125,12,0,12,1.354914,103.840113
577126,0,6,6,1.354939,103.840121
577127,2,1,3,1.354697,103.839993
577128,34,7,41,1.354621,103.839996
577130,7,2,9,1.354672,103.840039
577131,3,0,3,1.354965,103.84013
577132,9,0,9,1.354715,103.840073
577133,2,0,2,1.354796,103.840045
577134,3,1,4,1.354717,103.84001
577137,0,1,1,1.354365,103.839149
577140,0,1,1,1.355092,103.840199
577142,0,1,1,1.354858,103.840145
577143,1,1,2,1.355041,103.840174
577144,3,3,6,1.354909,103.84018
577145,7,3,10,1.355184,103.840245
577146,3,16,19,1.354947,103.840196
577147,9,1,10,1.355209,103.840258
577148,1,3,4,1.35475,103.840099
577151,1,0,1,1.354881,103.840161
577152,3,0,3,1.355017,103.840155
577153,3,0,3,1.355042,103.840252
577154,0,4,4,1.354973,103.840227
577156,1,0,1,1.355262,103.840291
577157,1,0,1,1.355111,103.840287
577158,9,0,9,1.355145,103.840304
577159,0,1,1,1.355331,103.840351
577160,1,0,1,1.355374,103.840362
577161,5,0,5,1.355391,103.840388
577162,33,0,33,1.355222,103.840329
577163,4,1,5,1.35483,103.840136
577176,233,108,341,1.349441,103.840771
577177,550,1293,1843,1.348965,103.841328
577178,787,1166,1953,1.348627,103.841549
577179,42,248,290,1.348627,103.841549
577180,13,462,475,1.348132,103.842078
577181,166,243,409,1.347807,103.842441
577182,213,445,658,1.349312,103.8411
577183,370,53,423,1.349637,103.840559
577184,105,114,219,1.349422,103.840952
577185,540,22,562,1.348605,103.842303
577186,342,42,384,1.350084,103.841563
577190,5,437,442,1.349524,103.84205
577191,2,91,93,1.349602,103.842119
577192,16,67,83,1.350092,103.842202
577195,19,27,46,1.349679,103.842187
577196,2,18,20,1.349756,103.842247
577197,256,77,333,1.350769,103.842375
577198,1,39,40,1.349873,103.842362
577199,6,49,55,1.34993,103.842417
577200,192,151,343,1.349979,103.841159
577201,33,73,106,1.350048,103.842535
577202,0,183,183,1.350094,103.842568
577203,1385,79,1464,1.350857,103.841874
577204,2,109,111,1.350568,103.842938
577205,0,118,118,1.350641,103.842999
577206,237,20,257,1.351649,103.84221
577207,2,71,73,1.350727,103.843083
577208,7,138,145,1.350782,103.843124
577209,1,81,82,1.350834,103.843186
577210,142,0,142,1.350916,103.843256
577211,1,19,20,1.351583,103.842389
577212,1,0,1,1.355179,103.840321
577214,0,1,1,1.351482,103.842515
577215,94,166,260,1.350965,103.843316
577216,25,19,44,1.351399,103.842614
577217,5,118,123,1.351002,103.843368
577218,365,125,490,1.3513,103.842522
577219,153,115,268,1.351316,103.843321
577220,0,22,22,1.351744,103.843717
577221,1,48,49,1.352323,103.843663
577222,9,80,89,1.352514,103.843528
577223,1,5,6,1.352478,103.843655
577224,30,8,38,1.352626,103.843528
577225,5,5,10,1.352632,103.843646
577226,3,1,4,1.355076,103.840269
577227,0,1,1,1.351354,103.842674
577228,20,0,20,1.352841,103.843528
577229,4,2,6,1.352942,103.84362
577230,101,2,103,1.352959,103.843507
577231,1,2,3,1.355288,103.840308
577232,1,2,3,1.353079,103.84362
577233,34,2,36,1.353225,103.843603
577235,1,0,1,1.352787,103.843629
577236,1,0,1,1.353363,103.843603
577238,10,7,17,1.353394,103.843473
577239,9,1,10,1.353663,103.843594
577240,0,5,5,1.353504,103.843466
577241,7,0,7,1.353792,103.843586
577242,1,0,1,1.353286,103.843483
577243,0,1,1,1.353592,103.843469
577244,0,1,1,1.35393,103.843577
577245,1,1,2,1.355154,103.840238
577246,49,3,52,1.353793,103.843434
577247,13,2,15,1.354222,103.84358
577248,4,3,7,1.353884,103.843434
577249,12,0,12,1.353982,103.843434
577250,1,1,2,1.354076,103.843577
577251,6,2,8,1.352846,103.843638
577252,4,0,4,1.352738,103.843528
577259,4,0,4,1.299509,103.837
577260,1,0,1,1.353686,103.843449
577261,0,2,2,1.354073,103.843431
577263,1,2,3,1.353062,103.843507
577264,4,0,4,1.351219,103.835115
577265,6,4,10,1.35117,103.834795
577266,1,2,3,1.351247,103.834909
577268,1,5,6,1.351116,103.834864
577269,162,1,163,1.35105,103.83461
577270,0,2,2,1.351282,103.835
577271,6,4,10,1.35107,103.834773
577272,15,5,20,1.351015,103.834507
577273,6,3,9,1.351052,103.834739
577275,5,1,6,1.350865,103.83453
577277,1,0,1,1.351196,103.835075
577279,12,0,12,1.350815,103.834432
577280,0,2,2,1.351032,103.834553
577281,5,1,6,1.350798,103.834381
577282,0,1,1,1.350833,103.834478
577283,86,2,88,1.350781,103.83433
577284,1,0,1,1.350895,103.834251
577285,4,0,4,1.351156,103.834972
577286,2,1,3,1.351133,103.834921
577288,8,0,8,1.350832,103.834103
577289,2,0,2,1.350923,103.834297
577291,0,2,2,1.350729,103.834193
577292,0,1,1,1.350872,103.834206
577293,1,0,1,1.350792,103.834001
577295,5,16,21,1.350672,103.834045
577296,18,0,18,1.350763,103.833904
577298,1,0,1,1.350695,103.834096
577299,59,1,60,1.350638,103.833943
577300,0,2,2,1.350712,103.834148
577301,3,7,10,1.35062,103.833892
577302,24,0,24,1.350683,103.83375
577303,1,0,1,1.350734,103.833853
577306,4,0,4,1.350764,103.834284
577307,14,2,16,1.350557,103.833749
577308,27,12,39,1.350614,103.833574
577310,6,0,6,1.350591,103.833528
577311,20,0,20,1.350483,103.833579
577312,2,0,2,1.350706,103.833807
577316,6,0,6,1.350528,103.833363
577317,1,1,2,1.350574,103.833471
577318,2,1,3,1.350855,103.834154
577319,0,5,5,1.350377,103.833321
577323,13,0,13,1.350237,103.833203
577324,0,2,2,1.350402,103.833395
577325,18,2,20,1.350055,103.833294
577334,5,120,125,1.353573,103.836313
577335,0,15,15,1.354071,103.836552
577336,0,1,1,1.350597,103.833846
577337,113,0,113,1.354114,103.836586
577339,2,2,4,1.350637,103.833636
577341,24,3,27,1.354174,103.836646
577342,9,4,13,1.353762,103.836356
577344,3,0,3,1.350511,103.833306
577345,4,2,6,1.354226,103.836705
577346,3,0,3,1.353797,103.836364
577347,0,1,1,1.353616,103.836322
577348,3,0,3,1.35384,103.836364
577349,1,2,3,1.353883,103.836373
577352,0,1,1,1.354251,103.83674
577353,6,2,8,1.354329,103.836816
577354,0,3,3,1.354277,103.836774
577356,0,3,3,1.354304,103.83664
577357,0,2,2,1.350113,103.833251
577358,3,3,6,1.354381,103.836708
577359,2,0,2,1.35438,103.836868
577360,5,14,19,1.354407,103.836734
577361,1,5,6,1.35432,103.836936
577362,6,3,9,1.354433,103.836759
577364,0,3,3,1.354338,103.836674
577365,2,0,2,1.354355,103.836902
577366,2,3,5,1.354485,103.836819
577367,0,5,5,1.35451,103.836853
577368,0,1,1,1.353977,103.836381
577369,2,1,3,1.354459,103.836785
577370,7,1,8,1.354536,103.836938
577371,1,2,3,1.354562,103.836913
577372,2,43,45,1.354519,103.836998
577373,0,2,2,1.35432,103.837004
577374,0,1,1,1.354536,103.836879
577375,0,1,1,1.35451,103.837075
577376,0,1,1,1.354519,103.837109
577377,1,1,2,1.35451,103.837041
577380,1,3,4,1.354148,103.836612
577389,1,14,15,1.370819,103.831852
577391,0,2,2,1.35451,103.837186
577392,11,4,15,1.370988,103.831923
577393,5,0,5,1.371091,103.831985
577394,1,2,3,1.354519,103.836964
577395,7,8,15,1.371266,103.83209
577396,3,5,8,1.371371,103.832142
577397,46,0,46,1.371504,103.832192
577399,3,0,3,1.371189,103.832036
577408,3,0,3,1.371688,103.832288
577409,2,0,2,1.370949,103.83189
577410,168,0,168,1.370933,103.829832
577411,0,3,3,1.371066,103.829784
577412,3,1,4,1.354511,103.837314
577413,2,3,5,1.37107,103.829894
577415,4,0,4,1.370937,103.829861
577416,2,0,2,1.371069,103.829857
577417,30,0,30,1.371062,103.830111
577418,4,0,4,1.371073,103.83003
577419,2,24,26,1.371096,103.830162
577420,2,0,2,1.370954,103.829976
577421,0,1,1,1.35451,103.837152
577422,4,0,4,1.37096,103.830026
577423,1,0,1,1.370963,103.830133
577424,9,0,9,1.371112,103.830244
577425,5,0,5,1.370979,103.830239
577426,0,1,1,1.370989,103.830192
577427,0,1,1,1.371139,103.830319
577429,1,0,1,1.370813,103.830303
577430,7,3,10,1.371138,103.830431
577431,22,0,22,1.371043,103.830455
577432,0,2,2,1.370952,103.830067
577433,1,2,3,1.371065,103.82995
577434,3,0,3,1.37104,103.830498
577435,4,0,4,1.371099,103.830192
577436,3,0,3,1.37115,103.830518
577437,22,0,22,1.371055,103.8306
577438,5,0,5,1.371171,103.83069
577439,0,1,1,1.371037,103.830403
577440,110,2,112,1.37118,103.830754
577441,6,2,8,1.371067,103.830688
577444,7,0,7,1.371201,103.830863
577445,3,3,6,1.371074,103.830784
577446,2,0,2,1.371146,103.830475
577448,7,8,15,1.371201,103.83099
577449,36,0,36,1.371089,103.830894
577450,3,1,4,1.371048,103.830544
577451,13,2,15,1.371086,103.830951
577452,0,3,3,1.371157,103.830566
577453,5,13,18,1.3711,103.83101
577454,2,0,2,1.371193,103.830923
577455,1,6,7,1.371107,103.831068
577457,0,1,1,1.371067,103.830641
577458,46,14,60,1.371225,103.831216
577459,4,0,4,1.371209,103.831029
577460,6,0,6,1.371229,103.831271
577461,1,8,9,1.371136,103.831216
577462,2,2,4,1.371129,103.831169
577463,4,1,5,1.371376,103.831393
577472,13,15,28,1.352921,103.833485
577473,0,7,7,1.352965,103.833048
577474,1,1,2,1.371219,103.831116
577475,4,2,6,1.352942,103.832985
577476,12,0,12,1.352873,103.833354
577478,1,4,5,1.35285,103.833291
577479,2,1,3,1.371212,103.831053
577480,23,0,23,1.352827,103.833223
577481,3,2,5,1.352868,103.832797
577482,3,4,7,1.352804,103.833155
577484,2,0,2,1.352895,103.833422
577485,2,3,5,1.352822,103.832666
577486,0,1,1,1.371126,103.831121
577487,11,1,12,1.352799,103.832604
577488,22,0,22,1.352723,103.832967
577489,7,0,7,1.352776,103.832541
577490,11,0,11,1.352695,103.832899
577491,2,1,3,1.352885,103.83286
577492,192,8,200,1.352672,103.832836
577493,11,2,13,1.352736,103.832405
577494,3,0,3,1.352759,103.832473
577495,3,0,3,1.352643,103.832773
577497,5,0,5,1.352684,103.832279
577498,39,2,41,1.352586,103.832642
577499,3,10,13,1.352661,103.832217
577500,3,2,5,1.352557,103.832574
577501,4,0,4,1.371237,103.83131
577502,65,2,67,1.352528,103.832506
577503,9,0,9,1.352604,103.832092
577504,6,0,6,1.3525,103.832443
577505,1,1,2,1.352781,103.833092
577506,1,1,2,1.352581,103.832023
577507,24,0,24,1.352552,103.831961
577508,3,1,4,1.352633,103.832154
577509,0,3,3,1.352713,103.832342
577510,12,2,14,1.352478,103.831836
577511,7,0,7,1.352385,103.832199
577512,4,1,5,1.352449,103.831773
577514,0,2,2,1.352471,103.832381
577515,3,7,10,1.352328,103.832073
577518,35,0,35,1.352346,103.831579
577520,2,0,2,1.35242,103.83171
577521,32,2,34,1.35223,103.831869
577522,5,0,5,1.352254,103.831449
577523,2,0,2,1.3523,103.831511
577524,6,11,17,1.352214,103.83138
577525,55,0,55,1.352179,103.831743
577526,19,6,25,1.352145,103.831329
577528,1,0,1,1.352758,103.833029
577530,6,0,6,1.352065,103.831238
577531,5,1,6,1.352087,103.831561
577532,8,0,8,1.352008,103.831204
577535,2,0,2,1.352207,103.831806
577536,6,0,6,1.351773,103.831102
577537,1,0,1,1.352105,103.831272
577546,101,1388,1489,1.371972,103.828816
577547,21,1783,1804,1.371322,103.82892
577548,12,0,12,1.371317,103.828985
577549,9,3,12,1.371541,103.828986
577550,26,95,121,1.371584,103.829065
577551,4,0,4,1.352518,103.831898
577552,65,82,147,1.371664,103.829143
577553,22,0,22,1.371605,103.829254
577554,87,25,112,1.371709,103.829169
577555,9,61,70,1.371757,103.829191
577556,92,268,360,1.371844,103.829211
577557,13,0,13,1.371832,103.829367
577558,0,4,4,1.371626,103.829101
577559,0,10,10,1.37239,103.829786
577560,0,3,3,1.352419,103.832261
577561,14,7,21,1.372394,103.829963
577562,7,4,11,1.372548,103.830183
577563,3,3,6,1.372372,103.830023
577564,3,7,10,1.372562,103.830247
577565,6,0,6,1.372377,103.830088
577566,16,1,17,1.372709,103.830372
577567,64,2,66,1.372371,103.830185
577568,10,4,14,1.372909,103.830466
577569,2,3,5,1.372826,103.83059
577570,158,0,158,1.373007,103.830514
577571,2,0,2,1.35183,103.831124
577572,1,0,1,1.35171,103.831085
577574,1,1,2,1.372895,103.830613
577575,12,3,15,1.373032,103.830658
577576,5,0,5,1.373303,103.830657
577577,7,0,7,1.373101,103.830681
577578,103,1,104,1.373342,103.830651
577579,1,3,4,1.371797,103.829365
577580,3,2,5,1.37348,103.830708
577581,3,6,9,1.373238,103.830721
577582,10,0,10,1.373517,103.830699
577583,92,0,92,1.373301,103.830743
577584,2,8,10,1.373663,103.830748
577585,6,0,6,1.37337,103.830766
577586,14,0,14,1.373694,103.830727
577587,9,0,9,1.373433,103.830789
577588,37,3,40,1.373841,103.830776
577589,7,6,13,1.373502,103.830812
577590,44,0,44,1.373938,103.830782
577592,3,2,5,1.374024,103.830799
577593,2,3,5,1.373628,103.830846
577594,84,0,84,1.374105,103.83081
577596,4,0,4,1.37317,103.830698
577597,1,2,3,1.372555,103.829956
577598,1,2,3,1.373754,103.830874
577599,0,2,2,1.373217,103.830623
577600,4,3,7,1.374357,103.83081
577601,23,0,23,1.373874,103.830897
577602,9,0,9,1.374444,103.830816
577603,0,2,2,1.373817,103.830885
577604,0,6,6,1.374528,103.83081
577606,3,0,3,1.374276,103.83081
577607,0,5,5,1.374052,103.830942
577608,0,2,2,1.373932,103.830914
577609,2,0,2,1.374695,103.83081
577611,1,4,5,1.374115,103.830942
577612,2,0,2,1.37402,103.831178
577613,14,10,24,1.374172,103.830942
577614,6,0,6,1.374935,103.83081
577615,13,0,13,1.374235,103.830942
577616,14,6,20,1.375016,103.83081
577617,6,0,6,1.374304,103.830942
577618,19,4,23,1.375101,103.83081
577619,3,2,5,1.374373,103.830942
577620,1,2,3,1.374614,103.83081
577621,26,2,28,1.374442,103.830942
577622,1,1,2,1.374855,103.83081
577623,1,8,9,1.374505,103.830942
577624,12,0,12,1.374562,103.830942
577625,12,7,19,1.374625,103.830942
577626,6,0,6,1.374687,103.831037
577627,32,0,32,1.374744,103.831037
577628,4,0,4,1.374191,103.83081
577629,2,0,2,1.375279,103.83081
577630,6,3,9,1.374933,103.831037
577633,0,4,4,1.374807,103.831037
577634,7,0,7,1.375163,103.831037
577635,7,1,8,1.37522,103.831037
577636,2,12,14,1.375277,103.831037
577637,21,0,21,1.372636,103.830315
577638,18,0,18,1.372768,103.83042
577639,4,1,5,1.372556,103.829907
577645,87,5,92,1.370392,103.829809
577646,3,2,5,1.370226,103.829515
577647,2,0,2,1.37487,103.831037
577648,5,0,5,1.370222,103.82957
577649,2,0,2,1.370395,103.829865
577650,33,0,33,1.370219,103.829622
577652,18,1,19,1.37022,103.829665
577653,8,1,9,1.370417,103.83003
577654,17,0,17,1.370217,103.829699
577655,7,1,8,1.370425,103.830063
577657,4,0,4,1.3751,103.831037
577658,5,4,9,1.370448,103.830085
577659,85,2,87,1.370242,103.829856
577660,1,0,1,1.373131,103.830572
577661,5,1,6,1.37025,103.829934
577662,0,2,2,1.370398,103.829915
577663,1,2,3,1.375302,103.830844
577664,10,0,10,1.37053,103.830384
577665,16,0,16,1.370251,103.830051
577666,8,0,8,1.370473,103.830341
577667,13,1,14,1.370268,103.830095
577668,0,2,2,1.370465,103.830216
577670,9,1,10,1.370482,103.830432
577671,5,3,8,1.370276,103.830213
577672,55,2,57,1.370499,103.830483
577673,4,1,5,1.370277,103.830266
577674,4,4,8,1.370486,103.830656
577675,12,1,13,1.370287,103.830315
577676,4,4,8,1.37048,103.830615
577678,15,0,15,1.370493,103.830705
577679,0,3,3,1.370242,103.829982
577680,14,8,22,1.370493,103.830778
577681,2,1,3,1.370293,103.830419
577682,7,1,8,1.370499,103.830823
577683,3,0,3,1.370299,103.830457
577684,5,0,5,1.37051,103.830879
577685,17,0,17,1.370334,103.830581
577686,1,2,3,1.370317,103.830529
577687,2,5,7,1.37034,103.830635
577688,41,11,52,1.370517,103.831024
577689,2,1,3,1.370534,103.830888
577690,44,0,44,1.370523,103.831091
577691,4,1,5,1.370362,103.830761
577692,1,0,1,1.370453,103.830148
577694,25,10,35,1.370544,103.831182
577695,0,6,6,1.370379,103.830921
577696,3,4,7,1.370671,103.831418
577697,0,1,1,1.370538,103.831136
577698,60,1,61,1.37065,103.83136
577700,8,0,8,1.370726,103.831423
577701,17,3,20,1.370411,103.831066
577703,8,1,9,1.370418,103.831154
577704,45,22,67,1.37065,103.831576
577705,195,2,197,1.370427,103.831222
577706,0,12,12,1.37065,103.831645
577707,0,1,1,1.370392,103.830965
577708,1,0,1,1.370427,103.831283
577709,4,0,4,1.370229,103.829788
577710,3,0,3,1.370357,103.830703
577711,20,4,24,1.370438,103.83137
577712,4,2,6,1.37044,103.831423
577714,0,8,8,1.370447,103.831539
577715,1,0,1,1.37065,103.831713
577716,33,20,53,1.370484,103.831685
577722,16,48,64,1.372608,103.829519
577723,15,2,17,1.372672,103.829537
577724,5,7,12,1.372755,103.829551
577725,95,25,120,1.372795,103.829552
577726,20,11,31,1.372847,103.829531
577727,5,0,5,1.372915,103.829537
577728,10,21,31,1.372968,103.829538
577729,11,93,104,1.373092,103.829542
577730,12,17,29,1.373763,103.829705
577731,2,2,4,1.370431,103.831336
577732,4,0,4,1.373787,103.829706
577733,55,0,55,1.373922,103.829708
577734,14,2,16,1.374038,103.829698
577735,1,0,1,1.370462,103.831601
577736,0,1,1,1.374061,103.829683
577737,0,2,2,1.370488,103.830381
577738,7,0,7,1.374226,103.82968
577739,1,0,1,1.374139,103.829701
577740,0,5,5,1.374361,103.829668
577741,60,0,60,1.374394,103.829679
577742,9,14,23,1.374526,103.829701
577743,6,2,8,1.374585,103.829678
577744,4,1,5,1.374618,103.829693
577745,17,0,17,1.37467,103.829713
577746,1,7,8,1.374724,103.829705
577747,1,0,1,1.374288,103.829708
577748,0,1,1,1.374797,103.829568
577749,1,0,1,1.374865,103.829565
577750,3,1,4,1.373874,103.829709
577751,0,1,1,1.374933,103.829561
577752,3,0,3,1.370792,103.831756
577753,1,5,6,1.375182,103.829544
577754,23,0,23,1.375226,103.829544
577756,10,1,11,1.375339,103.829549
577757,4,0,4,1.375018,103.829551
577758,96,0,96,1.375498,103.829744
577759,5,0,5,1.375581,103.82971
577760,0,3,3,1.375117,103.829548
577761,6,0,6,1.375659,103.829664
577763,2,0,2,1.374195,103.829709
577764,48,3,51,1.375829,103.829671
577765,1,2,3,1.375629,103.829695
577766,9,0,9,1.375886,103.829684
577767,0,3,3,1.375958,103.829405
577768,3,1,4,1.375402,103.829721
577769,0,2,2,1.375794,103.829737
577770,16,3,19,1.376076,103.829686
577771,72,0,72,1.376143,103.829388
577772,1,0,1,1.375079,103.829543
577773,1,1,2,1.37611,103.829398
577774,4,0,4,1.375987,103.82972
577775,1,0,1,1.376124,103.829717
577776,5,0,5,1.376216,103.829665
577777,12,0,12,1.376327,103.829388
577778,2,3,5,1.376297,103.829688
577780,4,1,5,1.376327,103.829672
577782,1,3,4,1.376152,103.8297
577793,3,49,52,1.354367,103.84035
577794,0,4,4,1.376374,103.82969
577795,2,0,2,1.376214,103.829391
577796,5,4,9,1.35445,103.840304
577797,0,2,2,1.35444,103.840394
577799,1,0,1,1.376265,103.829392
577800,1,0,1,1.354496,103.840437
577801,1,4,5,1.354524,103.840452
577802,3,0,3,1.376025,103.829402
577803,0,4,4,1.354402,103.840375
577805,9,8,17,1.354572,103.840477
577807,1,4,5,1.354602,103.840495
577808,0,1,1,1.354523,103.840348
577809,0,3,3,1.354554,103.84034
577810,0,1,1,1.354995,103.840631
577811,0,2,2,1.354466,103.840412
577812,15,0,15,1.355078,103.840669
577813,0,3,3,1.354633,103.840511
577814,21,0,21,1.354979,103.84061
577815,0,1,1,1.355102,103.840681
577816,3,0,3,1.354702,103.840549
577817,0,1,1,1.35474,103.840569
577819,0,2,2,1.354664,103.840532
577821,4,4,8,1.354861,103.840641
577823,0,7,7,1.354898,103.840665
577825,0,10,10,1.354942,103.840699
577827,0,4,4,1.354547,103.840468
577829,0,10,10,1.35503,103.840739
577831,0,1,1,1.354776,103.840589
577832,13,1,14,1.354956,103.840605
577833,0,4,4,1.354992,103.840726
577834,1,0,1,1.355069,103.840755
577835,1,5,6,1.35516,103.840804
577837,3,2258,2261,1.355207,103.840834
577847,1,0,1,1.355029,103.84064
577848,158,2,160,1.353878,103.837448
577849,26,1,27,1.354027,103.837065
577850,2,1,3,1.35476,103.840498
577851,0,4,4,1.355106,103.84078
577852,0,4,4,1.354038,103.837093
577853,1,1,2,1.354814,103.84061
577854,4,0,4,1.353843,103.837517
577855,2,2,4,1.353826,103.837562
577856,14,1,15,1.353786,103.837591
577857,12,4,16,1.354067,103.837219
577858,4,0,4,1.354061,103.837173
577859,1,2,3,1.35386,103.837477
577860,18,0,18,1.353694,103.837665
577862,0,8,8,1.353649,103.837687
577863,7,4,11,1.354073,103.837338
577864,27,10,37,1.353608,103.837716
577865,1,1,2,1.35405,103.837133
577866,0,2,2,1.354056,103.837378
577868,4,1,5,1.353517,103.837767
577869,11,0,11,1.354021,103.837475
577870,1,0,1,1.354015,103.837025
577872,2,0,2,1.353563,103.83775
577873,9,0,9,1.353987,103.837572
577874,0,1,1,1.353482,103.837807
577875,1,2,3,1.354078,103.837258
577876,1,0,1,1.353391,103.837875
577879,0,1,1,1.353351,103.837921
577880,0,19,19,1.352752,103.83828
577881,1,1,2,1.353437,103.837841
577882,4,0,4,1.35374,103.83763
577883,0,4,4,1.353809,103.837742
577884,4,9,13,1.353712,103.837805
577885,8,3,11,1.353672,103.837839
577886,5,0,5,1.353632,103.837868
577888,1,1,2,1.353855,103.837703
577889,7,1,8,1.3535,103.837948
577890,4,0,4,1.353758,103.837777
577891,3,0,3,1.35397,103.837606
577892,0,1,1,1.35389,103.837674
577893,1,0,1,1.35338,103.838039
577894,1,13,14,1.3533,103.838084
577903,2,60,62,1.354527,103.834158
577904,3,50,53,1.354423,103.834086
577905,5,21,26,1.354693,103.834351
577906,0,8,8,1.354771,103.834383
577907,4,10,14,1.354823,103.834412
577908,1,5,6,1.354869,103.83444
577909,9,16,25,1.35492,103.834463
577910,46,0,46,1.354972,103.834486
577911,6,10,16,1.355018,103.834508
577913,8,0,8,1.355115,103.834559
577914,0,1,1,1.35334,103.838067
577916,4,2,6,1.355258,103.834628
577917,81,5,86,1.355304,103.834645
577918,107,0,107,1.35535,103.834673
577919,6,18,24,1.355402,103.834696
577920,1,0,1,1.355161,103.834576
577921,48,0,48,1.355499,103.83473
577922,17,6,23,1.355534,103.834753
577923,3,48,51,1.356321,103.835107
577924,0,12,12,1.355994,103.835087
577925,2,0,2,1.35354,103.837913
577926,12,53,65,1.356476,103.834843
577927,4,24,28,1.356597,103.834704
577928,9,0,9,1.356576,103.834669
577929,33,59,92,1.356674,103.834521
577931,69,56,125,1.355342,103.8345
577932,75,8,83,1.355145,103.834415
577933,161,7,168,1.355265,103.833838
577934,2,23,25,1.356304,103.834334
577935,0,16,16,1.356344,103.834253
577936,2,0,2,1.356439,103.834921
577939,5,7,12,1.353507,103.836539
577940,6,185,191,1.353434,103.836494
577941,4,0,4,1.35346,103.837982
577942,0,15,15,1.353417,103.836551
577943,15,1,16,1.353467,103.836636
577944,2,11,13,1.3534,103.836608
577945,0,1,1,1.355453,103.834713
577946,7,7,14,1.353383,103.836659
577947,49,1,50,1.353438,103.836744
577948,7,33,40,1.35336,103.836705
577950,0,10,10,1.353343,103.83675
577951,15,5,20,1.353404,103.836852
577952,1,15,16,1.353325,103.836801
577953,1,0,1,1.353455,103.836693
577954,0,16,16,1.353297,103.836841
577955,30,0,30,1.353369,103.836954
577956,0,14,14,1.353277,103.836916
577957,9,4,13,1.353352,103.837006
577958,2,25,27,1.353225,103.83695
577962,6,11,17,1.353134,103.837018
577963,0,1,1,1.353387,103.836903
577964,15,38,53,1.353088,103.837035
577965,11,2,13,1.353198,103.837165
577966,9,3,12,1.353042,103.837064
577967,2,5,7,1.353158,103.837196
577968,2,11,13,1.352991,103.837104
577969,65,10,75,1.353112,103.837225
577970,0,10,10,1.352939,103.837138
577971,1,2,3,1.35342,103.83801
577972,3,61,64,1.352893,103.837172
577974,0,45,45,1.352847,103.837206
577975,4,0,4,1.35349,103.83659
577976,0,41,41,1.352796,103.837229
577977,19,0,19,1.352452,103.837753
577978,0,45,45,1.352744,103.837263
577980,13,20,33,1.352704,103.837292
577981,3,62,65,1.352365,103.837806
577982,1,29,30,1.352658,103.837314
577983,1,26,27,1.352624,103.837332
577984,3,35,38,1.352544,103.837377
577985,8,29,37,1.352515,103.8374
577986,2,7,9,1.352487,103.837417
577987,68,326,394,1.352458,103.837434
577988,9,6,15,1.352424,103.837451
577989,19,26,45,1.352395,103.837468
577990,0,62,62,1.352366,103.837485
577991,5,56,61,1.352338,103.837502
577992,0,62,62,1.352309,103.837514
577993,0,85,85,1.35228,103.837531
577994,2,2,4,1.352477,103.837721
577995,0,4,4,1.352252,103.837548
577996,2,1029,1031,1.352194,103.837582
578005,1,2,3,1.35259,103.837687
578006,24,0,24,1.352847,103.845809
578007,5,6,11,1.353037,103.845708
578008,79,2,81,1.353204,103.845768
578009,2,4,6,1.352883,103.845733
578010,5,0,5,1.35355,103.845673
578011,2,0,2,1.356394,103.834164
578012,22,2,24,1.35369,103.845716
578013,15,2,17,1.353795,103.845843
578014,11,0,11,1.35369,103.845858
578015,5,0,5,1.353737,103.84578
578016,30,0,30,1.353595,103.845988
578018,12,5,17,1.353618,103.8461
578019,0,1,1,1.353238,103.837131
578020,49,1,50,1.353463,103.846226
578021,1,3,4,1.352223,103.837565
578022,14,0,14,1.353148,103.846471
578023,8,2,10,1.352999,103.846624
578024,1,2,3,1.352765,103.84574
578025,1,2,3,1.35289,103.846693
578032,2,1,3,1.352828,103.846728
578033,6,8,14,1.354027,103.834609
578034,17,7,24,1.354211,103.834486
578035,18,0,18,1.354095,103.834652
578036,2,2,4,1.353309,103.846357
578037,35,2,37,1.354138,103.834686
578038,4,2,6,1.354352,103.834572
578039,67,6,73,1.35419,103.834711
578040,0,1,1,1.353007,103.846452
578041,1,1,2,1.35332,103.845696
578042,4,0,4,1.354267,103.834506
578043,78,0,78,1.354267,103.83478
578046,11,0,11,1.354362,103.834814
578047,5,0,5,1.354853,103.834855
578048,0,3,3,1.354182,103.834451
578050,1,0,1,1.354386,103.834569
578051,0,1,1,1.354741,103.834804
578052,1,0,1,1.354508,103.834856
578053,2,0,2,1.354224,103.834737
578054,29,2,31,1.354638,103.834744
578055,1,0,1,1.35469,103.83477
578056,0,9,9,1.354587,103.834702
578057,9,4,13,1.354671,103.834907
578058,6,21,27,1.354535,103.834693
578059,0,2,2,1.354568,103.834873
578060,0,2,2,1.354723,103.834916
578061,1,2,3,1.354413,103.834831
578062,0,3,3,1.354766,103.83495
578063,4,0,4,1.354453,103.83463
578064,33,0,33,1.355271,103.835051
578065,80,36,116,1.354852,103.835027
578066,23,0,23,1.355337,103.835081
578067,33,30,63,1.354903,103.835061
578068,1,0,1,1.354611,103.83489
578069,2,0,2,1.355163,103.835013
578070,8,2,10,1.355461,103.835191
578071,0,1,1,1.355442,103.835126
578072,4,0,4,1.354809,103.834984
578073,3,1,4,1.355537,103.835215
578075,15,3,18,1.355084,103.835189
578076,2,6,8,1.355627,103.83525
578077,4,0,4,1.355041,103.835155
578078,1,1,2,1.354955,103.835087
578079,4,6,10,1.355153,103.83524
578080,4,8,12,1.355187,103.835274
578082,1,4,5,1.355247,103.835343
578083,5,0,5,1.355282,103.835377
578084,1,6,7,1.355316,103.835411
578093,3,18,21,1.354561,103.837509
578094,2,3,5,1.354509,103.837483
578095,7,1,8,1.354493,103.837599
578096,3,5,8,1.354484,103.837534
578097,8,0,8,1.354468,103.837642
578098,46,1,47,1.354458,103.837568
578099,4,0,4,1.355118,103.835215
578100,1,0,1,1.354998,103.835121
578101,0,20,20,1.354399,103.837727
578103,0,2,2,1.355693,103.835279
578104,4,2,6,1.354381,103.837654
578105,2,12,14,1.35425,103.837931
578106,0,1,1,1.354432,103.837603
578107,0,1,1,1.354346,103.837679
578108,41,0,41,1.35432,103.837705
578111,0,2,2,1.354285,103.837897
578112,2,8,10,1.354269,103.837773
578113,0,2,2,1.354165,103.838017
578114,3,3,6,1.354243,103.837799
578115,0,1,1,1.354216,103.837965
578116,1,1,2,1.354139,103.838042
578117,1,0,1,1.354115,103.838057
578118,1,0,1,1.354076,103.838096
578120,7,0,7,1.354147,103.837923
578121,5,13,18,1.353993,103.838157
578122,0,1,1,1.354174,103.837879
578124,19,1,20,1.354079,103.837972
578125,3,14,17,1.35367,103.838359
578126,1,1,2,1.354217,103.837833
578127,12,2,14,1.353637,103.838374
578128,6,0,6,1.354013,103.838018
578129,2,0,2,1.354054,103.837994
578130,0,1,1,1.354118,103.837957
578131,1,6,7,1.353572,103.838406
578133,1,2,3,1.355186,103.835024
578134,1,1,2,1.353612,103.8384
578135,3,1,4,1.354433,103.837684
578137,7,0,7,1.353489,103.838476
578138,2,0,2,1.353935,103.838079
578140,1,0,1,1.353991,103.838035
578141,1,0,1,1.353251,103.838468
578143,5,10,15,1.353404,103.838553
578144,1,0,1,1.353429,103.838528
578145,7,0,7,1.353373,103.838555
578148,5,1,6,1.353068,103.838609
578149,0,1,1,1.353158,103.838557
578150,2,35,37,1.352978,103.838608
578151,18,2,20,1.353269,103.838621
578152,0,1,1,1.353295,103.838596
578153,0,7,7,1.353209,103.838672
578162,3,0,3,1.353541,103.838425
578163,7,1,8,1.363396,103.829308
578164,1,0,1,1.353235,103.838647
578165,0,1,1,1.363383,103.828675
578166,12,4,16,1.36324,103.829313
578167,19,0,19,1.363473,103.829103
578170,2,1,3,1.363757,103.828698
578171,3,1,4,1.353515,103.838451
578172,20,0,20,1.363602,103.828813
578173,4,0,4,1.363352,103.82904
578175,3,1,4,1.363395,103.828946
578176,1,0,1,1.363439,103.829206
578177,3,0,3,1.363309,103.829125
578178,1,7,8,1.363362,103.829584
578187,1035,108,1143,1.373156,103.829851
578188,39,18,57,1.373173,103.829915
578189,44,0,44,1.37319,103.82996
578190,20,0,20,1.373214,103.829991
578191,25,7,32,1.373235,103.830012
578192,4,3,7,1.373287,103.830089
578193,37,20,57,1.373377,103.83012
578194,32,3,35,1.373434,103.830164
578195,1,3,4,1.363109,103.829436
578196,2,1,3,1.363049,103.829525
578197,0,1,1,1.363423,103.829526
578198,1,0,1,1.37362,103.830211
578199,5,2,7,1.373776,103.830021
578200,4,3,7,1.373669,103.830423
578201,57,0,57,1.373809,103.829944
578202,30,3,33,1.373796,103.830276
578203,0,3,3,1.37356,103.830182
578204,1,3,4,1.373508,103.83018
578206,9,1,10,1.373912,103.830293
578207,8,1,9,1.373996,103.830041
578208,0,1,1,1.373678,103.83024
578212,0,3,3,1.373857,103.830047
578213,4,1,5,1.374204,103.830021
578215,4,0,4,1.373874,103.830276
578216,5,12,17,1.374143,103.830301
578218,0,8,8,1.374216,103.830301
578219,14,2,16,1.374382,103.830076
578220,0,1,1,1.373962,103.830302
578221,24,0,24,1.374436,103.830041
578222,1,3,4,1.37425,103.830067
578223,2,0,2,1.353275,103.838434
578224,120,11,131,1.374403,103.830284
578225,7,0,7,1.374545,103.830115
578226,30,14,44,1.374449,103.830281
578227,13,1,14,1.374613,103.830109
578228,0,3,3,1.374055,103.830308
578229,0,1,1,1.37431,103.830282
578230,10,17,27,1.374559,103.830265
578231,4,0,4,1.374355,103.830282
578232,20,2,22,1.374609,103.830281
578233,7,0,7,1.374886,103.830106
578234,6,3,9,1.3747,103.830284
578235,2,1,3,1.374508,103.830276
578236,22,1,23,1.374758,103.830281
578237,5,0,5,1.374918,103.830102
578238,7,5,12,1.374833,103.830279
578239,1,0,1,1.374691,103.830108
578240,6,1,7,1.37489,103.830284
578241,1,2,3,1.374823,103.830106
578242,1,5,6,1.374935,103.830284
578244,5,0,5,1.374995,103.830282
578245,3,1,4,1.374754,103.830108
578246,6,0,6,1.375037,103.83029
578247,35,1,36,1.37524,103.830067
578248,5,0,5,1.375079,103.830281
578249,85,0,85,1.375297,103.830077
578250,0,2,2,1.374496,103.830018
578251,3,0,3,1.375015,103.830112
578252,1,12,13,1.375239,103.83028
578253,9,1,10,1.375433,103.830052
578254,0,1,1,1.374961,103.830113
578255,2,0,2,1.375159,103.830281
578256,0,2,2,1.375464,103.830081
578257,5,0,5,1.375507,103.830046
578258,62,0,62,1.37548,103.83028
578260,1,0,1,1.37532,103.83028
578261,10,0,10,1.375702,103.830027
578264,22,1,23,1.375721,103.83028
578266,3,9,12,1.375801,103.830275
578267,9,0,9,1.375844,103.830032
578273,17,729,746,1.356224,103.844137
578285,41,1,42,1.370873,103.831442
578286,1,5,6,1.371041,103.831521
578288,1,0,1,1.37556,103.83028
578289,40,0,40,1.371287,103.831618
578290,25,2,27,1.371379,103.831652
578291,51,4,55,1.37147,103.83168
578292,1,0,1,1.371201,103.831578
578293,1,3,4,1.375181,103.830041
578294,107,0,107,1.371757,103.831771
578295,0,1,1,1.371568,103.831697
578297,1,1,2,1.3754,103.83028
578300,1,0,1,1.371854,103.831794
578301,2,0,2,1.372095,103.831879
578302,6,1,7,1.372456,103.831999
578306,19,1,20,1.372737,103.832067
578308,0,3,3,1.375342,103.830056
578310,6,1,7,1.372939,103.831866
578311,3,0,3,1.372868,103.832084
578312,1,2,3,1.373006,103.832135
578313,3,7,10,1.373069,103.832152
578314,1,0,1,1.372324,103.831947
578315,10,0,10,1.373132,103.832169
578316,58,5,63,1.373118,103.831821
578317,135,8,143,1.373195,103.832192
578318,7,0,7,1.373181,103.831832
578319,1,2,3,1.372986,103.831787
578320,9,0,9,1.373249,103.831849
578321,7,2,9,1.373327,103.832231
578322,126,1,127,1.373313,103.831872
578323,1,0,1,1.373055,103.831804
578324,97,0,97,1.373376,103.831895
578325,1,1,2,1.372393,103.83197
578326,30,6,36,1.373433,103.831918
578327,2,0,2,1.373447,103.83226
578328,26,0,26,1.373496,103.83194
578330,1,5,6,1.373559,103.831963
578331,20,0,20,1.373612,103.832316
578332,8,3,11,1.373622,103.83198
578333,0,5,5,1.373681,103.832328
578334,0,3,3,1.373258,103.832209
578337,5,11,16,1.373807,103.832356
578338,4,8,12,1.3738,103.832037
578339,72,7,79,1.373875,103.832367
578340,1,0,1,1.37339,103.832249
578341,35,0,35,1.373944,103.832379
578342,1,4,5,1.37392,103.832071
578343,15,1,16,1.374007,103.83239
578344,3,1,4,1.371671,103.831743
578345,6,0,6,1.374047,103.832396
578347,5,0,5,1.374093,103.832402
578349,13,16,29,1.37415,103.832401
578350,1,0,1,1.373863,103.832054
578353,9,0,9,1.374276,103.832401
578354,9,1,10,1.374292,103.832082
578355,1,4,5,1.374345,103.832401
578356,3,0,3,1.373679,103.832008
578357,4,5,9,1.374402,103.832401
578358,11,1,12,1.374413,103.832082
578359,18,0,18,1.374471,103.832401
578360,8,0,8,1.374476,103.832082
578361,3,5,8,1.374534,103.832401
578362,3,0,3,1.374349,103.832082
578363,1,0,1,1.37416,103.832082
578365,55,10,65,1.374666,103.832401
578366,0,2,2,1.373486,103.832288
578367,1,2,3,1.374539,103.832082
578368,6,0,6,1.37471,103.832082
578369,4,0,4,1.373977,103.832082
578370,0,3,3,1.374729,103.832401
578371,9,4,13,1.374861,103.832401
578372,9,2,11,1.374831,103.832082
578373,48,40,88,1.374924,103.832401
578374,2,6,8,1.374894,103.832082
578375,97,24,121,1.374957,103.832082
578376,2,0,2,1.374653,103.832082
578384,1,20,21,1.372143,103.829548
578385,17,10,27,1.371233,103.829344
578386,1,0,1,1.374603,103.832401
578387,0,1,1,1.372092,103.829548
578390,1,15,16,1.371995,103.829548
578391,3,2,5,1.371069,103.829328
578392,7,2,9,1.37196,103.829548
578393,6,0,6,1.371023,103.829325
578394,17,9,26,1.37192,103.829548
578395,36,79,115,1.370994,103.829319
578397,29,1,30,1.371897,103.829548
578398,7,3,10,1.37089,103.829288
578399,33,0,33,1.371874,103.829548
578400,5,2,7,1.370815,103.829287
578401,0,2,2,1.370949,103.831487
578402,6,0,6,1.370751,103.829281
578403,1,4,5,1.371568,103.829523
578404,21,0,21,1.370773,103.829232
578405,8,0,8,1.371528,103.829523
578406,17,12,29,1.37072,103.829255
578407,9,0,9,1.371487,103.829523
578408,16,0,16,1.37058,103.829272
578409,1,3,4,1.374798,103.832401
578410,0,2,2,1.371851,103.829548
578411,12,0,12,1.371407,103.829512
578412,1,0,1,1.371187,103.829327
578413,3,1,4,1.371447,103.829523
578414,2,0,2,1.370484,103.829285
578416,3,0,3,1.374773,103.832082
578417,2,1,3,1.370415,103.829207
578418,0,6,6,1.370347,103.82919
578419,0,2,2,1.370356,103.829285
578420,1,0,1,1.370541,103.829207
578421,0,8,8,1.371172,103.829512
578422,82,0,82,1.370215,103.82919
578423,1,3,4,1.371356,103.829512
578424,96,0,96,1.370113,103.829235
578425,15,0,15,1.370839,103.829477
578427,1,8,9,1.370788,103.829477
578428,2,0,2,1.371218,103.829512
578429,2,1,3,1.371258,103.829512
578430,0,1,1,1.370193,103.829267
578431,1,0,1,1.370691,103.829477
578432,5,3,8,1.370582,103.829478
578433,2,0,2,1.369987,103.829195
578434,60,0,60,1.370479,103.829478
578435,25,6,31,1.370421,103.829478
578444,6,19,25,1.354096,103.83906
578445,136,0,136,1.354062,103.839077
578446,2,0,2,1.370536,103.829478
578448,7,0,7,1.353985,103.83912
578451,1,7,8,1.353907,103.839171
578452,2,0,2,1.354036,103.839094
578454,9,0,9,1.353821,103.839214
578456,0,11,11,1.353761,103.839239
578459,0,7,7,1.353684,103.839265
578460,0,7,7,1.353658,103.839274
578461,0,31,31,1.353632,103.839282
578470,8,11,19,1.353916,103.838509
578471,0,1,1,1.370633,103.829477
578473,3,0,3,1.370736,103.829477
578474,4,0,4,1.370891,103.829477
578475,6,0,6,1.353877,103.838755
578476,10,0,10,1.353832,103.838798
578477,1,21,22,1.353779,103.838823
578479,3,4,7,1.353848,103.838669
578480,23,1,24,1.353714,103.838851
578481,1,1,2,1.353881,103.839179
578482,0,5,5,1.353818,103.838708
578483,4,0,4,1.353918,103.838715
578484,117,0,117,1.353793,103.838742
578485,1,3,4,1.353654,103.83892
578486,5,0,5,1.353746,103.838781
578487,1,1,2,1.353689,103.838885
578488,0,1,1,1.353927,103.838579
578489,367,0,367,1.353568,103.838984
578491,2,1,3,1.353915,103.83869
578493,1,1,2,1.353594,103.838979
578494,7,1,8,1.353537,103.83889
578495,0,2,2,1.353517,103.839035
578496,0,1,1,1.353691,103.838818
578497,0,1,1,1.353511,103.838915
578498,15,0,15,1.353485,103.838941
578499,20,1,21,1.353442,103.839087
578500,0,1,1,1.353465,103.839087
578501,1,0,1,1.353456,103.838949
578502,25,0,25,1.35343,103.838974
578503,0,1,1,1.353417,103.839113
578504,0,1,1,1.353391,103.839147
578505,3,0,3,1.353543,103.83901
578506,78,2,80,1.353385,103.839007
578507,0,1,1,1.353413,103.838991
578508,3,5,8,1.353356,103.839026
578509,2,4,6,1.353368,103.839145
578518,1,49,50,1.352079,103.844211
578520,30,7,37,1.352207,103.844849
578521,1,11,12,1.352207,103.845002
578522,8,2,10,1.352207,103.845182
578523,0,3,3,1.353357,103.839173
578524,0,4,4,1.35362,103.838954
578525,3,3,6,1.352181,103.84572
578526,0,7,7,1.352173,103.845873
578527,6,4,10,1.352169,103.845969
578528,24,13,37,1.352164,103.846044
578529,8,18,26,1.352124,103.846435
578530,250,19,269,1.352159,103.846651
578531,0,19,19,1.352228,103.846834
578532,25,11,36,1.352308,103.847016
578533,0,20,20,1.352342,103.847107
578534,8,0,8,1.352594,103.847322
578535,1,0,1,1.353384,103.83918
578537,0,2,2,1.353491,103.839061
578538,4,0,4,1.35219,103.845549
578539,0,1,1,1.352697,103.847288
578540,1,0,1,1.353121,103.847094
578542,4,0,4,1.353023,103.847162
578544,13,0,13,1.353655,103.846694
578545,1,1,2,1.352912,103.847202
578546,13,2,15,1.353861,103.846511
578547,7,2,9,1.353964,103.846426
578548,7,0,7,1.35405,103.84634
578549,6,0,6,1.354159,103.846255
578550,8,5,13,1.354082,103.846458
578551,25,0,25,1.354157,103.846538
578552,1,1,2,1.35377,103.846597
578553,21,498,519,1.354288,103.846708
578554,6,648,654,1.354254,103.846778
578555,9,1,10,1.354179,103.846699
578556,2,3,5,1.35411,103.846613
578557,1,8,9,1.354036,103.846528
578558,1,9,10,1.353685,103.846841
578559,26,1,27,1.353759,103.846921
578560,0,5,5,1.353834,103.847006
578561,4,69,73,1.353908,103.847091
578562,0,155,155,1.353855,103.847187
578564,6,0,6,1.3537,103.847022
578565,67,10,77,1.35362,103.846931
578567,31,2,33,1.35327,103.847286
578568,4,2,6,1.353313,103.847397
578569,2,0,2,1.354225,103.846623
578570,7,611,618,1.353382,103.84761
578571,7,294,301,1.353255,103.847582
578572,2,0,2,1.353348,103.847508
578574,8,1,9,1.353164,103.847298
578575,3,1,4,1.353466,103.846864
578577,0,23,23,1.352536,103.847509
578579,12,68,80,1.352603,103.847669
578580,27,9,36,1.352215,103.844336
578581,4,4,8,1.352212,103.844501
578582,7,1,8,1.352091,103.844883
578583,2,1,3,1.352198,103.845361
578584,1,4,5,1.351873,103.844517
578585,8,8,16,1.352536,103.847509
578586,4,149,153,1.352584,103.847599
578587,64,5,69,1.351905,103.844688
578588,11,27,38,1.352321,103.844185
578589,1,4,5,1.352609,103.844313
578590,8,1,9,1.352475,103.84415
578591,0,1,1,1.353266,103.847035
578593,2,1,3,1.351889,103.844435
578595,0,6,6,1.353264,103.844139
578596,3,0,3,1.35289,103.844159
578598,6,2,8,1.35378,103.844121
578599,3,0,3,1.353453,103.84413
578601,9,1,10,1.35277,103.844291
578602,11,1,12,1.352936,103.844285
578603,99,8,107,1.353125,103.84428
578604,5,0,5,1.35332,103.844268
578605,9,12,21,1.35352,103.844262
578606,4,4,8,1.353692,103.844251
578607,78,15,93,1.353847,103.844239
578608,13,0,13,1.352621,103.844883
578609,2,0,2,1.353227,103.847491
578610,6,0,6,1.352981,103.844724
578611,3,0,3,1.35396,103.844121
578612,65,0,65,1.35332,103.844701
578613,5,1,6,1.353544,103.844701
578614,3,0,3,1.35308,103.844718
578615,4,1,5,1.352604,103.84508
578616,1,4,5,1.352765,103.844865
578617,11,0,11,1.352908,103.844871
578618,24,0,24,1.353063,103.844859
578620,1,0,1,1.352606,103.84453
578621,2,0,2,1.352813,103.844727
578622,4,1,5,1.352595,103.845267
578623,8,8,16,1.353242,103.845279
578626,6,1,7,1.353376,103.845277
578627,98,2,100,1.353582,103.845272
578629,6,3,9,1.352793,103.845393
578630,8,1,9,1.352959,103.845387
578631,0,2,2,1.353544,103.844836
578632,3,4,7,1.353325,103.84537
578633,0,6,6,1.353503,103.84537
578634,6,0,6,1.353669,103.845358
578635,20,0,20,1.35257,103.845669
578636,1,0,1,1.353389,103.844848
578637,17,1,18,1.352591,103.845793
578639,1,3,4,1.35264,103.847737
578640,1,3,4,1.352688,103.8462
578641,60,9,69,1.352726,103.846544
578642,2,1,3,1.353741,103.844692
578643,1,0,1,1.352553,103.845857
578644,117,0,117,1.352698,103.846702
578645,129,0,129,1.353586,103.844395
578646,2,0,2,1.353153,103.845375
578647,5,2,7,1.352447,103.846208
578649,2,1,3,1.35256,103.846327
578650,4,0,4,1.352522,103.846216
578653,1,25,26,1.355612,103.83463
578654,21,5,26,1.355751,103.834663
578655,1,11,12,1.355663,103.834528
578656,21,2,23,1.35575,103.834584
578657,2,34,36,1.355698,103.834431
578658,18,0,18,1.355819,103.834459
578659,0,11,11,1.355732,103.834306
578660,2,4,6,1.355853,103.834362
578661,0,5,5,1.355755,103.834209
578663,78,1,79,1.355772,103.834124
578664,8,0,8,1.355916,103.834174
578665,101,4,105,1.355956,103.834077
578666,2,2,4,1.353688,103.844838
578668,1,0,1,1.352629,103.846515
578677,1,18,19,1.37108,103.828812
578678,1,11,12,1.371023,103.828812
578679,1,44,45,1.37096,103.828812
578681,8,0,8,1.370834,103.828812
578682,11,0,11,1.370771,103.828795
578683,2,0,2,1.353787,103.844249
578684,1,208,209,1.37065,103.828795
578685,1,0,1,1.355829,103.833845
578686,3,0,3,1.352902,103.844721
578688,8,14,22,1.370444,103.828778
578689,9,11,20,1.370393,103.828778
578690,1,42,43,1.370324,103.828778
578691,8,9,17,1.370278,103.828778
578692,0,11,11,1.370226,103.828778
578693,4,55,59,1.370181,103.828778
578694,1,0,1,1.370586,103.828776
578695,13,28,41,1.370078,103.828778
578696,4,550,554,1.370037,103.828778
578705,44,2,46,1.363134,103.82858
578706,4,0,4,1.355806,103.83393
578707,2,0,2,1.370708,103.828795
578708,9,2,11,1.36297,103.828772
578709,0,1,1,1.370129,103.828778
578710,4,5,9,1.362808,103.828902
578711,80,0,80,1.363,103.828925
578712,13,12,25,1.362945,103.829041
578714,0,3,3,1.37053,103.828778
578715,2,2,4,1.363004,103.828586
578724,11,40,51,1.361841,103.828513
578725,13,643,656,1.36175,103.828552
578727,15,0,15,1.361767,103.828592
578728,7,23,30,1.361859,103.828581
578730,23,0,23,1.36187,103.828627
578731,2,0,2,1.363086,103.82871
578732,5,0,5,1.361893,103.828667
578733,328,2,330,1.361819,103.828728
578734,10,2,12,1.361905,103.828712
578735,0,1,1,1.363047,103.828825
578736,10,2,12,1.361933,103.828758
578738,25,1,26,1.361939,103.828803
578739,1,0,1,1.361824,103.828779
578740,1,0,1,1.361859,103.828865
578741,42,4,46,1.361876,103.828905
578742,4,1,5,1.361973,103.828889
578743,121,2,123,1.361888,103.828967
578744,11,3,14,1.361996,103.828929
578745,6,2,8,1.36191,103.829013
578746,7,0,7,1.362014,103.82898
578747,17,3,20,1.361939,103.82907
578748,98,2,100,1.362031,103.829025
578750,3,0,3,1.362841,103.829265
578751,4,2,6,1.361974,103.829218
578752,1,0,1,1.361956,103.828849
578753,2,6,8,1.361991,103.829292
578755,2,0,2,1.36179,103.828683
578756,1,0,1,1.362088,103.829134
578758,13,0,13,1.362203,103.829316
578759,49,0,49,1.362071,103.829508
578762,3,42,45,1.362272,103.829469
578763,3,2,5,1.362123,103.829656
578774,7076,1016,8092,1.359803,103.819582
578775,88,17,105,1.357326,103.812471
578783,13,0,13,1.354075,103.829055
578784,4,7,11,1.354318,103.829297
578786,5,1,6,1.354518,103.829244
578787,4,0,4,1.362811,103.829328
578788,60,1,61,1.354673,103.82918
578790,6,0,6,1.354782,103.829114
578791,3,3,6,1.354927,103.828692
578792,2,1,3,1.362059,103.829077
578793,9,1,10,1.354829,103.828766
578794,38,2,40,1.354982,103.828779
578795,65,2,67,1.354868,103.82887
578796,18,7,25,1.35448,103.828966
578797,66,1,67,1.355337,103.828497
578798,6,8,14,1.355043,103.828418
578799,3,0,3,1.355062,103.828677
578800,54,2,56,1.355204,103.827988
578801,22,3,25,1.355264,103.828043
578802,33,1,34,1.299509,103.837
578809,10,7,17,1.355228,103.829807
578810,2,4,6,1.355678,103.829869
578811,0,1,1,1.362163,103.829253
578812,6,1,7,1.355725,103.829854
578813,11,4,15,1.355536,103.82963
578814,8,9,17,1.355741,103.829802
578815,4,0,4,1.354417,103.828988
578818,1,0,1,1.355423,103.829727
578819,3,1,4,1.356041,103.829184
578820,9,0,9,1.356135,103.829234
578821,1,2,3,1.355329,103.828182
578822,13,0,13,1.35564,103.829605
578823,7,10,17,1.356067,103.829303
578824,0,1,1,1.356164,103.829194
578825,5,1,6,1.356032,103.829348
578826,1,0,1,1.356014,103.828954
578827,10,0,10,1.355872,103.829496
578828,1,2,3,1.356101,103.829268
578830,0,2,2,1.362014,103.829366
578831,30,2,32,1.356348,103.829185
578832,3,0,3,1.355809,103.82957
578833,1,1,2,1.35629,103.829236
578834,18,8,26,1.356291,103.828721
578835,1,6,7,1.356279,103.828659
578836,0,2,2,1.356314,103.828767
578837,2,0,2,1.356268,103.828619
578838,0,2,2,1.356251,103.828573
578839,1,9,10,1.356216,103.828488
578840,39,3,42,1.356188,103.828448
578841,1,7,8,1.35617,103.828402
578842,1,5,6,1.356159,103.828374
578843,12,0,12,1.356153,103.828334
578844,1,6,7,1.356125,103.828294
578845,5,1,6,1.356107,103.828249
578846,55,0,55,1.35609,103.828215
578847,0,1,1,1.355952,103.829411
578848,4,1,5,1.35605,103.828146
578849,1,1,2,1.356233,103.828528
578850,82,2,84,1.355563,103.827621
578851,0,3,3,1.356325,103.828824
578852,0,1,1,1.356073,103.828186
578853,0,1,1,1.355419,103.827525
578854,7,3,10,1.355328,103.827413
578855,6,2,8,1.354874,103.827533
578856,10,3,13,1.354987,103.827388
578857,55,0,55,1.35485,103.827269
578858,0,1,1,1.355359,103.827469
578861,8,0,8,1.355038,103.827176
578862,1,0,1,1.354482,103.827447
578863,1,4,5,1.355007,103.827158
578864,4,1,5,1.354344,103.827436
578865,14,0,14,1.354959,103.82714
578866,0,1,1,1.354373,103.827475
578867,3,9,12,1.354873,103.827087
578868,16,1,17,1.354413,103.827351
578869,2,0,2,1.355608,103.827651
578870,12,0,12,1.354429,103.827253
578871,0,3,3,1.355495,103.827551
578872,0,1,1,1.354387,103.827414
578873,1,0,1,1.355114,103.827339
578874,18,0,18,1.354873,103.827162
578875,18,0,18,1.354748,103.827042
578876,4,0,4,1.355812,103.829446
578877,1,0,1,1.354994,103.827259
578879,20,14,34,1.356325,103.828824
578885,3,24,27,1.361589,103.832799
578886,8,3025,3033,1.361599,103.832463
578887,16,0,16,1.361566,103.83285
578888,9,5,14,1.361581,103.832532
578890,3,0,3,1.354792,103.827041
578891,0,4,4,1.35462,103.826912
578892,1,9,10,1.36153,103.83268
578893,1,0,1,1.355154,103.826885
578894,34,3,37,1.361507,103.832742
578895,10,1,11,1.361497,103.833078
578896,105,11,116,1.361484,103.832811
578897,11,0,11,1.361461,103.832879
578898,129,0,129,1.361463,103.833192
578899,13,0,13,1.361433,103.832947
578901,0,1,1,1.361514,103.833015
578902,4,0,4,1.361532,103.832958
578903,4,5,9,1.361387,103.833084
578904,0,1,1,1.36141,103.833016
578905,2,0,2,1.354854,103.827044
578906,1,2,3,1.361553,103.832606
578908,5,0,5,1.361371,103.833488
578909,0,6,6,1.361313,103.833289
578910,0,3,3,1.361389,103.833431
578912,1,0,1,1.361406,103.833368
578913,0,1,1,1.361337,103.833602
578914,25,2,27,1.361314,103.833664
578915,1,0,1,1.361255,103.833454
578916,14,0,14,1.361297,103.833721
578919,1,1,2,1.361364,103.833152
578920,27,18,45,1.361246,103.833858
578921,1,0,1,1.361227,103.833528
578923,5,2,7,1.361141,103.833796
578924,4,1,5,1.361177,103.833989
578925,4,0,4,1.361423,103.833306
578926,0,2,2,1.361187,103.833665
578928,1,0,1,1.361164,103.833727
578930,31,1,32,1.361102,103.834182
578931,0,2,2,1.361148,103.834057
578932,2,0,2,1.361032,103.834052
578933,2,2,4,1.361107,103.833858
578934,8,6,14,1.361062,103.834313
578935,15,5,20,1.360975,103.834188
578936,1,22,23,1.361034,103.834387
578937,14,1,15,1.360952,103.834251
578938,24,10,34,1.361496,103.834732
578939,38,2,40,1.360924,103.834319
578940,3,0,3,1.361354,103.833545
578941,18,3,21,1.360895,103.834382
578942,2,0,2,1.361085,103.834245
578943,1,3,4,1.361004,103.83412
578944,3,1,4,1.360872,103.83445
578945,116,42,158,1.361005,103.834532
578947,6,2028,2034,1.361047,103.83455
578948,30,0,30,1.361812,103.83487
578949,14,2,16,1.36113,103.834588
578950,3,5,8,1.361883,103.8349
578951,2,2,4,1.361672,103.834809
578952,2,2,4,1.361213,103.834625
578953,50,2,52,1.361295,103.834662
578954,3,794,797,1.361378,103.8347
578955,7,2,9,1.361451,103.834727
578956,15,6,21,1.361492,103.83475
578957,42,202,244,1.361522,103.834764
578958,6,196,202,1.361584,103.83479
578959,3,5,8,1.361646,103.834817
578960,1,10,11,1.361707,103.834844
578961,1,6,7,1.361768,103.834871
578962,5,4,9,1.36183,103.834898
578963,2,83,85,1.361892,103.834924
578964,3,256,259,1.361943,103.834941
578965,0,2,2,1.361602,103.834778
578966,2,1,3,1.361531,103.834748
578967,1,0,1,1.361125,103.83412
578968,38,305,343,1.360815,103.834663
578973,7,33,40,1.361785,103.832608
578974,34,33,67,1.362002,103.832972
578975,1,34,35,1.361825,103.832631
578976,3,62,65,1.361985,103.833035
578977,10,3,13,1.361865,103.832648
578978,1,5,6,1.361968,103.833092
578979,5,18,23,1.3619,103.832665
578980,2,11,13,1.361945,103.833149
578981,6,24,30,1.361934,103.832682
578983,10,190,200,1.361974,103.832699
578984,1,4,5,1.361911,103.833274
578985,0,7,7,1.361894,103.833337
578986,2,0,2,1.360872,103.83445
578987,3,4,7,1.361859,103.833456
578988,1,0,1,1.360835,103.834577
578989,23,0,23,1.361814,103.833576
578990,3,4,7,1.361791,103.833633
578991,1,0,1,1.361842,103.833513
578992,1,0,1,1.361762,103.833695
578993,1,9,10,1.361722,103.833821
578994,0,163,163,1.361993,103.833709
578995,10,1,11,1.361705,103.833883
578996,0,4,4,1.361953,103.834931
578997,0,1,1,1.361739,103.833758
578998,48,12,60,1.36217,103.833771
579000,13,13,26,1.362251,103.833828
579001,4,1,5,1.361636,103.834077
579002,0,4,4,1.362096,103.833754
579003,1,1,2,1.361877,103.833394
579004,5,4,9,1.361786,103.83419
579006,3,1,4,1.361734,103.834163
579007,6,4,10,1.361568,103.834265
579008,4,30,34,1.361907,103.834238
579009,8,0,8,1.361539,103.834327
579013,0,13,13,1.361482,103.834464
579014,0,1,1,1.361682,103.833946
579015,7,9,16,1.361453,103.834532
579016,6,26,32,1.362152,103.83435
579017,8,34,42,1.362156,103.834411
579018,14,0,14,1.362101,103.834387
579019,0,4,4,1.361843,103.834215
579020,30,2,32,1.361984,103.83435
579021,3,0,3,1.360859,103.834517
579022,3,8,11,1.361878,103.834306
579023,0,6,6,1.361809,103.834277
579024,6,7,13,1.361744,103.834238
579034,2,35,37,1.356536,103.827207
579035,0,4,4,1.362039,103.834357
579036,0,5,5,1.35649,103.826996
579037,0,6,6,1.356596,103.827006
579038,1,1,2,1.361619,103.834139
579040,0,1,1,1.362096,103.83432
579041,7,8,15,1.356417,103.826518
579050,0,1,1,1.356299,103.826532
579051,2,3,5,1.353867,103.828667
579052,113,3,116,1.353964,103.828655
579053,1,2,3,1.361936,103.834324
579054,31,0,31,1.354209,103.828639
579056,5,6,11,1.354353,103.828619
579057,12,4,16,1.354578,103.828454
579058,3,0,3,1.353964,103.828675
579059,19,0,19,1.354737,103.828237
579060,13,1,14,1.354662,103.82836
579061,0,3,3,1.354578,103.828474
579062,107,1,108,1.354843,103.828035
579063,14,1,15,1.354827,103.828215
579064,23,1,24,1.354953,103.827918
579065,17,0,17,1.354932,103.828075
579066,0,1,1,1.353964,103.828655
579067,0,1,1,1.355081,103.827759
579068,0,2,2,1.3564,103.826783
579069,0,2,2,1.355181,103.827598
579077,174,497,671,1.350136,103.842787
579078,42,27,69,1.350107,103.842821
579079,16,15,31,1.350081,103.842866
579080,31,0,31,1.350047,103.8429
579081,13,13,26,1.350012,103.842935
579082,16,21,37,1.349978,103.842969
579083,0,3,3,1.354747,103.828247
579084,14,0,14,1.349662,103.843317
579085,2,0,2,1.354209,103.828659
579086,98,3,101,1.349616,103.843385
579087,1,0,1,1.35501,103.827965
579088,0,10,10,1.349576,103.843465
579089,1,0,1,1.349549,103.843392
579090,18,0,18,1.349547,103.843551
579092,4,9,13,1.349515,103.843648
579093,0,3,3,1.349622,103.843295
579094,5,3,8,1.349504,103.843753
579095,4,0,4,1.356638,103.827156
579096,0,5,5,1.349494,103.843822
579098,0,7,7,1.349481,103.843918
579099,36,0,36,1.349392,103.843967
579100,6,1,7,1.349464,103.843996
579101,8,0,8,1.349448,103.844082
579102,7,3,10,1.349434,103.844214
579104,0,2,2,1.349593,103.843339
579105,9,0,9,1.349527,103.844367
579106,4,6,10,1.349581,103.844413
579107,1,0,1,1.349506,103.843486
579109,5,17,22,1.34986,103.844603
579110,21,1,22,1.349912,103.844645
579112,1,0,1,1.349647,103.844467
579113,1,1,2,1.349477,103.844339
579115,5,0,5,1.350101,103.844833
579116,5,0,5,1.349963,103.844808
579118,11,0,11,1.349997,103.844848
579119,2,0,2,1.350058,103.844791
579120,1,0,1,1.349998,103.844739
579121,0,16,16,1.350247,103.844978
579122,1,0,1,1.350037,103.844887
579123,86,0,86,1.350273,103.84503
579124,7,0,7,1.350106,103.844973
579125,2,2,4,1.349432,103.843721
579126,11,0,11,1.350135,103.845013
579127,13,0,13,1.350333,103.84514
579128,3,2,5,1.350166,103.845047
579129,6,0,6,1.350359,103.8452
579130,0,2,2,1.350204,103.844927
579131,0,6,6,1.350402,103.845311
579132,12,0,12,1.350419,103.84538
579134,0,1,1,1.350072,103.844933
579135,3,0,3,1.349455,103.843634
579136,0,3,3,1.350485,103.845559
579137,1,2,3,1.350494,103.845619
579138,22,5,27,1.350522,103.845755
579139,18,0,18,1.350531,103.845815
579140,2,2,4,1.350307,103.845081
579141,15,0,15,1.35054,103.845951
579142,9,1,10,1.35054,103.846062
579143,0,3,3,1.350505,103.845687
579144,11,5,16,1.350537,103.846267
579153,10,0,10,1.349203,103.842959
579154,2,18,20,1.348993,103.84301
579155,10,0,10,1.349177,103.842984
579156,3,0,3,1.350543,103.846154
579157,2,0,2,1.350385,103.84526
579158,14,0,14,1.348899,103.842916
579159,0,2,2,1.349152,103.843019
579160,6,0,6,1.348847,103.842874
579161,22,2,24,1.3491,103.843095
579162,2,0,2,1.349126,103.843061
579163,7,0,7,1.349074,103.84313
579164,0,3,3,1.34895,103.842968
579165,12,4,16,1.348721,103.842872
579166,0,6,6,1.349022,103.843177
579167,1,0,1,1.350474,103.845502
579168,20,0,20,1.348982,103.843213
579169,7,5,12,1.34879,103.84294
579170,101,1,102,1.348945,103.843267
579171,3,0,3,1.348753,103.842806
579172,2,0,2,1.348804,103.84284
579173,2,19,21,1.34891,103.843059
579182,1,0,1,1.348755,103.842906
579183,3,0,3,1.348833,103.842974
579184,75,0,75,1.350066,103.843818
579185,2,28,30,1.350052,103.843891
579186,2,0,2,1.348867,103.843017
579187,4,0,4,1.35054,103.845875
579188,132,1,133,1.350061,103.844113
579189,3,1,4,1.350031,103.844027
579190,31,0,31,1.350086,103.84415
579191,1,1,2,1.35004,103.843966
579192,2,3,5,1.350125,103.844199
579193,11,4,15,1.35019,103.844154
579194,6,0,6,1.350152,103.844235
579195,12,1,13,1.350241,103.844201
579196,1,1,2,1.350146,103.844116
579197,257,1,258,1.350286,103.844232
579198,6,0,6,1.350258,103.844329
579199,16,0,16,1.350308,103.84438
579200,67,21,88,1.350373,103.844452
579201,1,0,1,1.350109,103.843709
579202,42,10,52,1.350513,103.844565
579203,14,0,14,1.350574,103.844628
579204,14,11,25,1.350694,103.844728
579205,1,3,4,1.350109,103.844066
579206,7,8,15,1.350803,103.844899
579207,8,28,36,1.350845,103.844985
579208,63,13,76,1.350885,103.845076
579209,0,70,70,1.350908,103.845162
579210,1,1,2,1.350196,103.844278
579211,3,0,3,1.35008,103.843769
579213,3,2,5,1.350952,103.845462
579214,4,3,7,1.351003,103.845078
579215,3,2,5,1.350951,103.845548
579217,8,5,13,1.350951,103.845644
579218,6,0,6,1.351038,103.845297
579219,36,3,39,1.350945,103.845735
579220,2,0,2,1.350929,103.845266
579221,0,7,7,1.350945,103.845827
579222,2,5,7,1.351038,103.845511
579223,1,4,5,1.35094,103.845923
579224,2,3,5,1.351038,103.845622
579225,24,0,24,1.350934,103.84602
579227,3,1,4,1.350751,103.844813
579228,0,6,6,1.351038,103.845835
579229,32,2,34,1.350923,103.846208
579230,1,0,1,1.350448,103.844508
579231,7,5,12,1.350917,103.846299
579232,2,0,2,1.351038,103.845408
579234,9,7,16,1.351039,103.846262
579243,0,11,11,1.349637,103.844586
579244,13,3,16,1.349588,103.844572
579245,0,2,2,1.351038,103.846049
579246,0,2,2,1.349601,103.844641
579247,4,0,4,1.350928,103.846117
579249,0,1,1,1.351038,103.845938
579250,19,0,19,1.349464,103.844687
579251,1,0,1,1.349524,103.844742
579252,4,0,4,1.349562,103.844689
579253,6,0,6,1.349445,103.844832
579254,10,0,10,1.349397,103.84475
579255,8,2,10,1.349361,103.844804
579256,1,0,1,1.349485,103.844789
579257,1,0,1,1.349419,103.844867
579258,5,5,10,1.349389,103.844912
579259,16,0,16,1.349281,103.8449
579260,3,1,4,1.34943,103.844714
579262,137,3,140,1.349314,103.844997
579263,7,1,8,1.349385,103.845296
579264,1,0,1,1.349324,103.844864
579267,7,0,7,1.349507,103.845367
579268,8,0,8,1.349636,103.845367
579269,28,3,31,1.349565,103.845406
579270,11,7,18,1.349606,103.845346
579272,18,0,18,1.349684,103.845397
579274,8,0,8,1.349718,103.845417
579275,2,0,2,1.349545,103.844619
579276,1,0,1,1.349491,103.845261
579277,5,0,5,1.34977,103.845526
579278,0,1,1,1.349754,103.845434
579279,1,0,1,1.349799,103.845467
579280,7,2,9,1.349829,103.845487
579290,2,1,3,1.350941,103.845351
579291,4,1,5,1.349044,103.842469
579292,43,0,43,1.349231,103.842513
579294,28,0,28,1.349338,103.84259
579295,2,1,3,1.349158,103.842469
579296,2,3,5,1.349428,103.842669
579298,14,4,18,1.349512,103.842721
579300,0,9,9,1.349597,103.842774
579301,1,4,5,1.349253,103.842633
579302,0,2,2,1.34972,103.845493
579303,1,12,13,1.349767,103.842835
579304,36,1,37,1.349486,103.84281
579305,60,32,92,1.349836,103.842903
579306,1,4,5,1.34952,103.842847
579307,69,2,71,1.350298,103.843299
579308,21,4,25,1.349563,103.842881
579309,1,16,17,1.350349,103.843333
579310,2,4,6,1.349614,103.842924
579312,0,4,4,1.349346,103.84496
579313,37,6,43,1.350455,103.843418
579314,0,3,3,1.349107,103.842522
579315,4,5,9,1.349735,103.843034
579316,0,1,1,1.349809,103.84554
579317,1,6,7,1.349954,103.843116
579318,2,2,4,1.349657,103.842958
579319,2,2,4,1.350606,103.843533
579320,2,0,2,1.349439,103.842779
579322,1,0,1,1.350557,103.843479
579323,1,1,2,1.350646,103.843565
579324,0,9,9,1.350742,103.843656
579325,5,0,5,1.350117,103.843278
579327,13,2,15,1.350152,103.843312
579328,3,59,62,1.350826,103.843762
579329,2,0,2,1.350074,103.843236
579330,16,10,26,1.350229,103.843381
579331,7,71,78,1.35112,103.843596
579332,17,0,17,1.351083,103.843638
579333,0,2,2,1.350186,103.843346
579334,98,0,98,1.351042,103.843684
579335,0,1,1,1.350699,103.843618
579336,2,1,3,1.3497,103.842992
579337,6,3,9,1.350496,103.84364
579338,2,0,2,1.350403,103.843535
579340,20,14,34,1.350941,103.843794
579342,0,6,6,1.351335,103.844229
579343,79,0,79,1.350629,103.843779
579345,3,8,11,1.35066,103.843835
579346,12,4,16,1.351422,103.844141
579347,2,1,3,1.351005,103.843725
579348,4,1,5,1.351506,103.844047
579349,11,2,13,1.351551,103.844002
579350,0,1,1,1.35045,103.843602
579351,1,1,2,1.350973,103.843761
579352,2,2,4,1.349988,103.84315
579353,1,0,1,1.351624,103.843989
579354,1,1,2,1.351579,103.844029
579355,2,0,2,1.351593,103.844788
579356,0,1,1,1.351534,103.844092
579357,0,2,2,1.351501,103.84413
579358,0,2,2,1.35147,103.844178
579359,2,0,2,1.351614,103.84513
579360,4,6,10,1.351597,103.845255
579361,2,0,2,1.351442,103.844221
579362,0,5,5,1.351589,103.84534
579363,1,2,3,1.351466,103.844091
579364,2,0,2,1.351412,103.84426
579365,2,1,3,1.351375,103.844295
579367,0,10,10,1.351668,103.844755
579368,3,1,4,1.351515,103.844615
579369,46,2,48,1.351721,103.844957
579370,45,0,45,1.351553,103.845808
579371,3,5,8,1.351702,103.845153
579372,3,0,3,1.35161,103.844616
579373,15,2,17,1.351684,103.845368
579375,114,8,122,1.351665,103.845603
579376,3,0,3,1.351543,103.845932
579377,0,3,3,1.351541,103.846184
579378,4,8,12,1.351527,103.84629
579379,12,0,12,1.351655,103.846003
579380,0,5,5,1.351643,103.846187
579381,2,5,7,1.351636,103.846288
579382,4,12,16,1.351587,103.843951
579383,1,0,1,1.351622,103.845016
579384,8,4,12,1.351655,103.845883
579390,5,20,25,1.373033,103.828027
579391,3,125,128,1.373054,103.828335
579393,0,22,22,1.373107,103.828333
579394,4,0,4,1.351563,103.845716
579395,0,11,11,1.373168,103.828327
579396,15,0,15,1.373209,103.828003
579397,6,53,59,1.373184,103.828304
579399,2,5,7,1.373277,103.828315
579400,0,2,2,1.351585,103.845486
579401,0,3,3,1.351674,103.845769
579402,1,2,3,1.373296,103.828317
579403,2,1,3,1.373381,103.828272
579404,12,5,17,1.373435,103.828299
579405,0,4,4,1.373154,103.827968
579406,4,1168,1172,1.373495,103.828262
579407,1,16,17,1.373512,103.827978
579408,1,61,62,1.373543,103.82829
579409,24,60,84,1.373535,103.827991
579410,4,0,4,1.373454,103.828016
579411,0,3,3,1.373396,103.828004
579412,27,4,31,1.373653,103.828277
579413,0,5,5,1.373658,103.827978
579414,2,283,285,1.373684,103.828294
579415,2,1,3,1.37359,103.827984
579416,4,1,5,1.373744,103.828279
579417,6,1,7,1.373763,103.827965
579418,3,262,265,1.373828,103.82827
579419,79,0,79,1.373845,103.827987
579420,0,26,26,1.373872,103.828292
579421,13,2,15,1.373897,103.827982
579422,6,5,11,1.373968,103.828234
579424,12,3,15,1.374015,103.828238
579425,1,1,2,1.373351,103.828028
579426,4,86,90,1.374069,103.828247
579427,91,0,91,1.374054,103.827968
579428,1,5,6,1.374153,103.82823
579429,4,3,7,1.374113,103.827964
579430,6,17,23,1.374217,103.828227
579431,1,0,1,1.35168,103.844803
579432,0,5,5,1.374267,103.828255
579433,4,0,4,1.373579,103.828281
579434,7,16,23,1.374326,103.828278
579435,7,0,7,1.374318,103.827957
579436,81,8,89,1.374357,103.828273
579437,0,1,1,1.37415,103.827962
579438,13,6,19,1.374438,103.828132
579439,1,2,3,1.373727,103.827968
579440,1,9,10,1.37447,103.828134
579441,1,1,2,1.373988,103.827974
579442,1,5,6,1.374535,103.828145
579443,12,2,14,1.37453,103.827936
579444,1,2,3,1.374449,103.827944
579445,138,2,140,1.374623,103.827929
579446,0,7,7,1.374655,103.828143
579447,22,1,23,1.37467,103.827926
579449,21,3,24,1.374725,103.827931
579450,0,1,1,1.374357,103.827943
579451,2,3,5,1.37478,103.827924
579452,0,26,26,1.374799,103.828139
579454,5,8,13,1.374845,103.828141
579455,8,1,9,1.374858,103.827912
579456,0,5,5,1.374894,103.828139
579457,2,3,5,1.375107,103.827901
579458,1,3,4,1.374277,103.82796
579459,1,3,4,1.374944,103.828125
579460,107,4,111,1.375013,103.828193
579461,2,3,5,1.375191,103.827929
579462,63,1,64,1.375092,103.828244
579463,0,1,1,1.374742,103.82815
579464,35,15,50,1.375116,103.828212
579466,11,13,24,1.375203,103.828211
579467,87,2,89,1.375369,103.827892
579468,0,7,7,1.375262,103.828232
579469,30,0,30,1.375419,103.82791
579470,13,4,17,1.375308,103.828205
579471,2,0,2,1.374486,103.827967
579472,1,30,31,1.375344,103.828228
579473,1,0,1,1.375247,103.827928
579474,0,14,14,1.375483,103.828217
579476,0,1,1,1.375559,103.827892
579477,0,2,2,1.375495,103.827887
579478,0,4,4,1.375144,103.82791
579480,6,43,49,1.37564,103.828193
579481,0,4,4,1.37562,103.828206
579482,19,2,21,1.375725,103.828179
579483,3,1,4,1.375772,103.827881
579485,0,1,1,1.375534,103.828211
579486,0,3,3,1.374582,103.828147
579487,2,2,4,1.375868,103.827889
579488,0,4,4,1.376009,103.827873
579489,0,2,2,1.375637,103.827878
579490,1,1,2,1.376063,103.827872
579491,2,0,2,1.375949,103.828215
579492,1,4,5,1.375971,103.828218
579493,1,0,1,1.375963,103.827892
579494,0,4,4,1.375863,103.828195
579495,5,4,9,1.376185,103.82789
579496,0,2,2,1.376178,103.827872
579497,4,0,4,1.376056,103.828188
579498,0,1,1,1.376121,103.827872
579499,0,1,1,1.376172,103.828184
579500,0,1,1,1.376285,103.827867
579501,2,0,2,1.376088,103.828203
579502,9,25,34,1.37628,103.828148
579503,2,2,4,1.376258,103.827858
579504,0,1,1,1.376219,103.828142
579505,2,3,5,1.376495,103.827874
579506,10,1,11,1.376368,103.828139
579507,0,4,4,1.376413,103.827871
579508,7,106,113,1.376444,103.828136
579509,2,2,4,1.376575,103.827839
579510,85,116,201,1.376614,103.827952
579511,6,2,8,1.376684,103.827826
579512,8,32,40,1.376681,103.827946
579513,2,1,3,1.375814,103.828188
579514,16,69,85,1.376797,103.827952
579515,2,2,4,1.376622,103.827853
579516,80,36,116,1.376857,103.827965
579517,0,1,1,1.376331,103.828174
579518,5,60,65,1.37698,103.827926
579519,3,0,3,1.376738,103.827849
579520,13,161,174,1.376948,103.827925
579521,5,0,5,1.376957,103.827828
579522,15,102,117,1.377002,103.827955
579523,2,4,6,1.377008,103.82784
579524,67,36,103,1.377114,103.827955
579525,3,1,4,1.376814,103.827823
579526,40,42,82,1.377185,103.828065
579527,11,0,11,1.37713,103.827833
579528,65,349,414,1.377259,103.827919
579529,30,61,91,1.377192,103.827801
579538,2,6,8,1.354897,103.829692
579539,18,1,19,1.355071,103.829605
579542,6,1,7,1.355621,103.829162
579543,7,0,7,1.35546,103.829356
579545,1,4,5,1.355842,103.828782
579546,1,3,4,1.37709,103.827837
579555,17,0,17,1.357492,103.825589
579557,4,0,4,1.355865,103.828619
579558,26,2,28,1.358374,103.825406
579559,6,2,8,1.358491,103.82538
579560,40,5,45,1.358653,103.825334
579561,0,9,9,1.358546,103.825353
579562,70,6,76,1.35814,103.825478
579563,104,0,104,1.358175,103.825468
579564,1,1,2,1.37637,103.827869
579565,18,2,20,1.358457,103.825575
579566,2,0,2,1.358271,103.825443
579567,37,0,37,1.358607,103.825558
579568,1,0,1,1.376855,103.827856
579569,8,1,9,1.35832,103.825421
579570,4,2,6,1.358764,103.825486
579572,1,2,3,1.376925,103.827851
579580,67,266,333,1.356771,103.832049
579581,2,7,9,1.356944,103.83215
579582,13,5,18,1.356877,103.832107
579583,102,7,109,1.356909,103.83229
579584,9,4,13,1.356777,103.832106
579585,11,4,15,1.356683,103.832073
579586,23,18,41,1.356852,103.832233
579587,13,20,33,1.355749,103.83186
579588,66,0,66,1.3558,103.831918
579589,1,0,1,1.358667,103.825539
579590,0,1,1,1.355744,103.83191
579591,1,0,1,1.355898,103.831873
579592,24,0,24,1.355476,103.831883
579593,20,662,682,1.355411,103.831873
579594,215,218,433,1.355982,103.831045
579595,103,13,116,1.356029,103.831034
579596,27,9,36,1.356052,103.830973
579597,11,20,31,1.356124,103.830936
579598,58,68,126,1.355914,103.832458
579599,2334,11,2345,1.356521,103.830777
579600,8,1,9,1.356826,103.830319
579601,3,2,5,1.356903,103.830261
579602,8,0,8,1.356898,103.830232
579603,4,2,6,1.356957,103.830176
579604,40,2,42,1.357034,103.830162
579605,53,1,54,1.357049,103.83009
579606,7,3,10,1.357114,103.830102
579607,15,3,18,1.357193,103.830073
579608,2,0,2,1.358536,103.825567
579609,5,0,5,1.357287,103.829885
579610,1,0,1,1.355599,103.831919
579611,10,1,11,1.357323,103.829785
579613,0,3,3,1.357628,103.825521
579614,18,12,30,1.357493,103.829693
579615,58,2,60,1.357534,103.829654
579616,1,1,2,1.35721,103.829918
579617,2,5,7,1.357673,103.829541
579618,5,26,31,1.35773,103.829465
579619,94,12,106,1.357774,103.829454
579620,72,23,95,1.357831,103.829404
579621,77,326,403,1.357847,103.829344
579622,9,4,13,1.357907,103.829329
579623,1,130,131,1.357953,103.829294
579624,5,8,13,1.358106,103.829247
579625,1,198,199,1.358118,103.829227
579626,1,34,35,1.358192,103.829222
579627,0,47,47,1.358292,103.829174
579628,2,42,44,1.358319,103.829167
579629,1,3,4,1.358222,103.825462
579630,137,119,256,1.358503,103.829124
579631,12,29,41,1.358562,103.829096
579632,4,29,33,1.358638,103.829146
579633,21,45,66,1.358722,103.829145
579634,232,71,303,1.358846,103.829156
579635,11,818,829,1.358923,103.829139
579636,12,14,26,1.356403,103.832091
579637,3,17,20,1.35655,103.83213
579638,14,115,129,1.356657,103.832152
579640,40,1,41,1.357237,103.832809
579641,66,84,150,1.356974,103.832331
579642,2,5,7,1.357055,103.832382
579646,1279,869,2148,1.360415,103.832615
579647,2,241,243,1.359657,103.833462
579648,20,1389,1409,1.359526,103.833486
579649,0,7,7,1.357407,103.832526
579650,27,6,33,1.357452,103.83255
579651,20,0,20,1.357602,103.832661
579652,92,25,117,1.357553,103.832626
579653,1586,500,2086,1.359762,103.832687
579654,7,21,28,1.356138,103.832048
579655,2,11,13,1.35602,103.83223
579656,20,11,31,1.355812,103.832038
579657,3,46,49,1.356171,103.832391
579658,8,0,8,1.356209,103.832335
579660,8,2,10,1.355714,103.832593
579661,18,3,21,1.356229,103.832248
579662,17,2,19,1.356123,103.832427
579663,11,1,12,1.35556,103.832689
579664,27,0,27,1.356034,103.832505
579665,1,0,1,1.357299,103.829796
579666,3,0,3,1.357425,103.829722
579667,56,9,65,1.355447,103.832996
579668,4,14,18,1.355748,103.832733
579670,23,11,34,1.355498,103.833263
579671,0,3,3,1.355949,103.832746
579672,32,2,34,1.355641,103.833416
579673,20,0,20,1.35563,103.833455
579674,1,0,1,1.355537,103.832797
579675,5,3,8,1.355704,103.833467
579676,34,0,34,1.356904,103.832864
579677,1,1,2,1.357652,103.829559
579678,1,0,1,1.356626,103.832875
579679,2,0,2,1.356971,103.832812
579680,36,0,36,1.355864,103.833489
579681,30,1,31,1.355933,103.833492
579683,45,7,52,1.356539,103.83341
579684,2,6,8,1.357182,103.832934
579685,21,3,24,1.35643,103.833447
579686,2,6,8,1.357124,103.833061
579687,5,151,156,1.357075,103.833179
579688,21,6,27,1.356979,103.833517
579689,20,231,251,1.356938,103.833609
579690,1,54,55,1.35684,103.833822
579692,19,0,19,1.355949,103.832746
579693,24,5,29,1.355949,103.832746
579694,0,17,17,1.355949,103.832578
579695,8,0,8,1.355949,103.832746
579696,9,9,18,1.355949,103.832746
579697,79,10,89,1.355949,103.832746
579698,6,0,6,1.356421,103.833199
579699,2,0,2,1.355788,103.833473
579700,5105,5571,10676,1.34439,103.858527
579701,2375,6266,8641,1.342819,103.859222
579702,717,3507,4224,1.342913,103.851895
579704,99,720,819,1.343135,103.852325
579705,9,4129,4138,1.344108,103.849099
579706,8,562,570,1.343517,103.846259
579707,1,169,170,1.343556,103.845871
579708,0,3,3,1.356351,103.833245
579709,2,163,165,1.342957,103.843998
579710,4,713,717,1.343297,103.843104
579711,285,34,319,1.34267,103.851923
579719,121,49,170,1.34209,103.841065
579720,1196,649,1845,1.342789,103.841486
579721,1633,1030,2663,1.343084,103.84084
579722,1384,316,1700,1.342679,103.840301
579723,1375,730,2105,1.342365,103.839672
579724,1193,1081,2274,1.341894,103.840042
579725,1278,435,1713,1.34171,103.842034
579726,1655,275,1930,1.341812,103.841072
579727,1688,197,1885,1.340723,103.840741
579728,218,31,249,1.341174,103.841087
579729,87,30,117,1.341067,103.841772
579730,136,38,174,1.340616,103.841619
579731,784,98,882,1.34027,103.841024
579732,147,66,213,1.339935,103.840983
579733,247,40,287,1.340086,103.841619
579734,200,123,323,1.340456,103.842163
579735,508,77,585,1.34107,103.842309
579736,4,98,102,1.340762,103.841212
579737,2,55,57,1.341812,103.841072
579738,2,26,28,1.342027,103.840461
579747,583,161,744,1.355497,103.843265
579757,55,849,904,1.357588,103.847534
579767,689,2240,2929,1.355193,103.846228
579768,187,3014,3201,1.361003,103.842795
579778,208,221,429,1.354401,103.850439
579779,22,426,448,1.354138,103.850368
579780,68,48,116,1.354944,103.850573
579781,30,29,59,1.351244,103.853082
579782,122,648,770,1.353139,103.852334
579783,699,242,941,1.355272,103.850811
579784,279,448,727,1.355076,103.851273
579785,143,1025,1168,1.353823,103.850628
579786,130,593,723,1.353539,103.851306
579787,44,7,51,1.299509,103.837
579790,17,1662,1679,1.348172,103.850034
579792,219,1519,1738,1.347374,103.854621
579793,329,1,330,1.349116,103.854727
579794,29,2034,2063,1.349175,103.854531
579795,446,266,712,1.350135,103.854907
579798,41,2965,3006,1.347525,103.854656
579799,287,1043,1330,1.349679,103.850599
579800,1347,1559,2906,1.347824,103.843502
579801,1508,1221,2729,1.348044,103.843325
579802,38,13,51,1.299509,103.837
579804,264,2843,3107,1.349332,103.853573
579806,164,597,761,1.346017,103.849681
579807,371,495,866,1.344693,103.850566
579808,59,888,947,1.347588,103.850139
579819,2518,796,3314,1.347263,103.851934
579820,2019,2344,4363,1.346911,103.85216
579821,91,1016,1107,1.34725,103.852445
579827,2269,18246,20515,1.350614,103.848126
579828,3277,1129,4406,1.359262,103.852445
579837,5076,13373,18449,1.349971,103.848794
579838,307,1786,2093,1.349575,103.849068
579841,49,1089,1138,1.349918,103.849014
579846,20,4,24,1.364849,103.836238
579847,239,776,1015,1.299509,103.837
579855,0,13,13,1.351771,103.846519
579856,0,1,1,1.356744,103.832685
579857,13,0,13,1.351504,103.846511
579858,51,2,53,1.351376,103.846502
579859,5,2,7,1.351247,103.846494
579860,5,0,5,1.351118,103.846485
579861,3,2,5,1.350869,103.846485
579862,7,4,11,1.35074,103.846486
579863,1,3,4,1.358394,103.829178
579872,26,2,28,1.349235,103.844264
579873,15,10,25,1.349114,103.844178
579874,1,2,3,1.341689,103.843691
579875,8,2,10,1.349068,103.844195
579876,212,3,215,1.348892,103.844341
579877,0,8,8,1.349008,103.844226
579878,1,11,12,1.348756,103.844692
579879,1,2,3,1.349072,103.844298
579880,142,7,149,1.348795,103.844793
579881,4,0,4,1.350608,103.846488
579882,18,11,29,1.348826,103.844871
579883,44,5,49,1.348794,103.844295
579884,11,2,13,1.348855,103.844978
579885,3,9,12,1.348885,103.845064
579886,2,0,2,1.35632,103.832998
579887,1,199,200,1.348516,103.84408
579888,29,0,29,1.34897,103.845295
579889,12,49,61,1.348532,103.844154
579890,1,1,2,1.348934,103.845201
579891,1,29,30,1.348565,103.844288
579893,1,16,17,1.348584,103.844359
579894,5,7,12,1.349064,103.845563
579895,0,38,38,1.348634,103.844499
579896,3,4,7,1.349113,103.845686
579897,4,7,11,1.348657,103.844559
579898,5,0,5,1.349174,103.845778
579899,0,51,51,1.348682,103.844619
579900,5,2,7,1.349232,103.845829
579901,0,11,11,1.348705,103.844685
579902,21,0,21,1.349304,103.845882
579903,10,47,57,1.348731,103.844758
579904,10,0,10,1.349387,103.845911
579905,24,52,76,1.348753,103.84483
579906,9,0,9,1.349467,103.84595
579908,4,48,52,1.348846,103.845078
579909,10,3,13,1.348879,103.84518
579910,5,27,32,1.34891,103.845265
579911,0,7,7,1.348937,103.84535
579912,0,56,56,1.348972,103.845452
579913,0,8,8,1.350677,103.846919
579914,8,57,65,1.34901,103.845542
579915,0,2,2,1.348996,103.845381
579916,0,14,14,1.349046,103.845615
579917,2,3,5,1.350986,103.846966
579918,11,42,53,1.349066,103.845677
579919,8,12,20,1.351134,103.846956
579920,0,50,50,1.349102,103.845769
579921,8,2,10,1.351245,103.84696
579922,37,125,162,1.349134,103.845821
579923,22,3,25,1.351373,103.84696
579924,3,3,6,1.349168,103.84586
579925,21,12,33,1.351468,103.846957
579926,12,16,28,1.349217,103.845902
579927,7,0,7,1.351587,103.846987
579929,87,0,87,1.351669,103.847067
579930,1,49,50,1.349323,103.84596
579931,1,3,4,1.348866,103.844266
579933,2,3,5,1.351766,103.847271
579934,2,4,6,1.349384,103.845988
579936,1,4,5,1.349415,103.846
579937,1,1,2,1.35084,103.846952
579938,2,2,4,1.351723,103.847154
579939,22,5,27,1.349481,103.846022
579940,4,9,13,1.349605,103.846106
579941,0,29,29,1.349679,103.846183
579942,1,3,4,1.349448,103.846015
579943,4,122,126,1.349777,103.846297
579944,0,16,16,1.349829,103.846349
579945,0,3,3,1.348959,103.844238
579946,1,28,29,1.349905,103.846452
579947,0,122,122,1.349948,103.846486
579948,1,80,81,1.35,103.846528
579949,6,5,11,1.350086,103.846605
579951,1,10,11,1.350252,103.846725
579952,3,1,4,1.349738,103.846247
579954,0,2,2,1.351852,103.84748
579955,5,726,731,1.350636,103.846986
579956,0,1,1,1.351633,103.846519
579957,8,167,175,1.350767,103.847046
579958,26,2,28,1.350832,103.847044
579959,4,0,4,1.350332,103.846782
579960,11,118,129,1.351028,103.847054
579961,1,4,5,1.351101,103.847067
579963,0,432,432,1.3513,103.847074
579964,0,1,1,1.350701,103.847032
579965,1,0,1,1.351393,103.847071
579966,107,0,107,1.351535,103.847103
579967,2,7,9,1.351716,103.847345
579968,0,2,2,1.350543,103.846937
579969,9,17020,17029,1.351787,103.847549
579970,28,2596,2624,1.351877,103.847578
579971,6,0,6,1.348953,103.8442
579972,2,0,2,1.351752,103.847458
579973,6,46,52,1.299509,103.837
579974,8,3,11,1.299509,103.837
579978,549,34,583,1.361941,103.830182
579979,415,47,462,1.362128,103.830874
579980,668,158,826,1.362554,103.831352
579981,1464,216,1680,1.363372,103.831297
579982,174,19,193,1.363138,103.829984
579991,166,212,378,1.355264,103.854328
587757,9,7,16,1.346626,103.777588
587758,6,0,6,1.34636,103.777222
587759,13,0,13,1.346398,103.777229
587760,7,9,16,1.346388,103.777227
587761,9,0,9,1.346465,103.777378
587762,7,0,7,1.34632,103.777022
587763,5,0,5,1.346314,103.77702
587764,2,0,2,1.348593,103.844435
587765,13,0,13,1.346304,103.777187
587766,34,0,34,1.346234,103.776792
587767,4,0,4,1.350921,103.847054
587768,103,0,103,1.346234,103.776799
587769,13,0,13,1.346243,103.776988
587770,54,0,54,1.346493,103.776819
587771,2,0,2,1.346313,103.776994
587772,75,0,75,1.34652,103.776812
587774,4,0,4,1.346261,103.776773
587775,26,0,26,1.346183,103.776734
587776,61,0,61,1.346184,103.776738
587777,15,0,15,1.346466,103.776829
587778,11,0,11,1.346443,103.776794
587779,7,0,7,1.346438,103.776794
587780,440,0,440,1.346445,103.776799
587781,37,0,37,1.346596,103.776993
587782,5,0,5,1.346618,103.776965
587783,1,0,1,1.351474,103.84708
587784,68,0,68,1.346592,103.776974
587785,4,0,4,1.346193,103.776758
587786,6,0,6,1.346782,103.777172
587787,7,0,7,1.346757,103.77717
587788,101,0,101,1.346745,103.777168
587789,10,10,20,1.346671,103.777398
587797,47,7,54,1.340022,103.788824
587798,22,0,22,1.340022,103.788824
587799,3,10,13,1.299509,103.837
587800,42,10,52,1.339552,103.789068
587804,8,0,8,1.299509,103.837
587806,1,0,1,1.346592,103.776993
587810,1,0,1,1.299509,103.837
587811,0,1,1,1.299509,103.837
587812,0,3,3,1.349862,103.846392
587814,3,0,3,1.299509,103.837
587819,1,0,1,1.299509,103.837
587821,0,2,2,1.346514,103.776796
587825,1,0,1,1.299509,103.837
587828,1,0,1,1.299509,103.837
587831,0,1,1,1.299509,103.837
587832,0,1,1,1.299509,103.837
587834,0,1,1,1.299509,103.837
587837,0,3,3,1.299509,103.837
587839,1,14,15,1.299509,103.837
587840,1,28,29,1.299509,103.837
587841,1032,966,1998,1.348378,103.774291
587842,434,40,474,1.349223,103.774291
587843,420,77,497,1.349083,103.774119
587844,936,33,969,1.348888,103.773993
587845,856,7,863,1.348834,103.773747
587846,445,8,453,1.348558,103.773884
587847,757,6,763,1.348417,103.774048
587848,678,15,693,1.348126,103.77465
587849,450,39,489,1.348081,103.774673
587850,443,50,493,1.348034,103.774688
587851,13,161,174,1.345821,103.775647
587852,33,123,156,1.345779,103.775707
587853,21,0,21,1.3458,103.775687
587854,162,36,198,1.345779,103.775707
587855,1,0,1,1.345779,103.775727
587856,13,2,15,1.345677,103.775836
587857,3,0,3,1.345734,103.775815
587858,3,0,3,1.345734,103.775815
587860,3,7,10,1.345448,103.776
587861,7,0,7,1.34562,103.775897
587862,14,2,16,1.345334,103.776082
587864,2,3,5,1.345505,103.775979
587866,54,1,55,1.345391,103.776061
587867,2,0,2,1.299509,103.837
587868,88,9,97,1.344682,103.788748
587869,9,0,9,1.344677,103.788774
587870,19,10,29,1.344656,103.788738
587871,2,0,2,1.345344,103.776092
587873,10,0,10,1.344681,103.788745
587874,1,0,1,1.345779,103.775727
587875,90,0,90,1.344657,103.788747
587877,14,0,14,1.344657,103.788746
587878,28,0,28,1.34468,103.78875
587879,97,0,97,1.344682,103.788743
587880,20,0,20,1.34465,103.78875
587881,4,0,4,1.34675,103.777146
587882,12,0,12,1.344648,103.78877
587883,22,0,22,1.344653,103.788741
587884,457,0,457,1.344656,103.788742
587885,12,0,12,1.34465,103.788768
587886,30,0,30,1.34468,103.788767
587887,88,0,88,1.34468,103.788746
587888,16,0,16,1.344648,103.788751
587889,8,0,8,1.344654,103.788777
587891,19,0,19,1.344656,103.788774
587893,21,0,21,1.344686,103.788738
587894,12,0,12,1.344682,103.788772
587895,3,0,3,1.345563,103.775918
587896,32,0,32,1.344652,103.788777
587897,4,0,4,1.344684,103.788771
587898,4,0,4,1.344648,103.788748
587899,40,0,40,1.344647,103.788745
587900,56,0,56,1.344654,103.78874
587902,36,0,36,1.344686,103.788771
587903,10,0,10,1.344655,103.788744
587904,324,22,346,1.344676,103.788766
587905,20,31,51,1.344675,103.788741
587906,167,292,459,1.344653,103.788748
587908,65,0,65,1.344678,103.788768
587909,3,5,8,1.344663,103.78875
587910,20,0,20,1.344656,103.788749
587912,8,0,8,1.344682,103.788748
587913,16,0,16,1.344661,103.788742
587914,16,0,16,1.344652,103.788752
587915,16,0,16,1.344684,103.788781
587916,22,0,22,1.344685,103.788751
587918,10,0,10,1.344652,103.788744
587919,12,0,12,1.344657,103.788746
587920,36,0,36,1.344663,103.788753
587921,2,0,2,1.344678,103.788744
587922,6,0,6,1.344681,103.78878
587923,38,0,38,1.344686,103.788746
587924,12,0,12,1.34468,103.788746
587925,4,0,4,1.344651,103.788767
587926,23,0,23,1.344682,103.788743
587927,2,0,2,1.344683,103.788745
587928,2,0,2,1.344657,103.788741
587929,12,0,12,1.344656,103.788747
587930,2,1,3,1.344657,103.788739
587931,33,0,33,1.344685,103.788774
587932,29,0,29,1.344679,103.788742
587933,3,0,3,1.344661,103.788776
587934,139,12,151,1.344683,103.788781
587935,46,0,46,1.344682,103.788772
587936,7,0,7,1.344661,103.78878
587937,12,0,12,1.34466,103.788774
587938,15,0,15,1.344684,103.788754
587939,2,0,2,1.344655,103.788754
587941,47,0,47,1.344676,103.788752
587942,13,0,13,1.34465,103.788784
587943,18,0,18,1.344649,103.788777
587944,38,0,38,1.344657,103.788783
587945,3,0,3,1.344681,103.788772
587946,16,42,58,1.34468,103.788755
587947,13,0,13,1.344682,103.788746
587948,8,0,8,1.344682,103.788783
587949,15,0,15,1.344678,103.788759
587950,99,1,100,1.344677,103.788755
587951,7,0,7,1.344687,103.788773
587952,4,0,4,1.344658,103.788775
587953,135,0,135,1.344658,103.788751
587954,13,0,13,1.344682,103.788748
587955,15,0,15,1.344688,103.788754
587956,20,0,20,1.344682,103.788749
587957,13,0,13,1.344655,103.788773
587958,5,0,5,1.344689,103.788748
587959,26,128,154,1.344653,103.788783
587960,9,0,9,1.344653,103.788755
587961,2,0,2,1.344651,103.788757
587962,9,0,9,1.34469,103.788775
587963,5,0,5,1.344651,103.788752
587964,12,0,12,1.344681,103.788776
587966,5,0,5,1.344655,103.788776
587967,825,248,1073,1.346128,103.773259
587968,1404,811,2215,1.346754,103.772362
587969,532,95,627,1.347022,103.772755
587970,463,51,514,1.346589,103.773213
587971,808,178,986,1.346727,103.774098
587972,1576,185,1761,1.347128,103.77378
587973,707,94,801,1.34753,103.773461
587974,74,324,398,1.348757,103.772246
587975,946,126,1072,1.349136,103.772189
587976,1008,1811,2819,1.348213,103.771481
587977,596,1364,1960,1.347686,103.771792
587978,1186,13,1199,1.34825,103.771787
587979,67,30,97,1.337545,103.783999
587980,2,12,14,1.337535,103.783989
587981,12,9,21,1.337829,103.783726
587983,6,5,11,1.337938,103.783823
587984,17,0,17,1.33863,103.783736
587985,0,5,5,1.337938,103.783823
587986,77,1,78,1.338832,103.783323
587987,12,35,47,1.338822,103.783313
587988,2,1,3,1.344658,103.78878
587989,92,4,96,1.338842,103.783313
587990,9,7,16,1.339931,103.783798
587991,58,0,58,1.338832,103.783303
587992,18,0,18,1.340519,103.784379
587993,40,0,40,1.339232,103.782495
587994,4,15,19,1.340417,103.78379
587995,0,3,3,1.338821,103.783312
587996,1,0,1,1.344648,103.788742
587997,22,65,87,1.339603,103.78225
587998,23,0,23,1.341168,103.783709
587999,26,4,30,1.339657,103.783135
588000,2,0,2,1.344678,103.788785
588001,29,1,30,1.33979,103.783665
588002,7,2,9,1.340042,103.783811
588003,24,0,24,1.340689,103.783565
588004,95,1,96,1.341053,103.7835
588005,0,1,1,1.341302,103.784201
588006,0,9,9,1.341588,103.783735
588007,28,0,28,1.337957,103.783867
588008,7,0,7,1.340944,103.784334
588009,21,7,28,1.340041,103.78383
588010,32,0,32,1.341693,103.78344
588011,9,7,16,1.341678,103.783716
588012,24,1,25,1.33993,103.783797
588013,70,2,72,1.339209,103.782254
588014,17,0,17,1.339562,103.782064
588015,88,16,104,1.339427,103.782881
588016,11,2,13,1.337938,103.783823
588035,2,40,42,1.33752,103.783816
588036,301,31,332,1.337506,103.783622
588037,8,14,22,1.337491,103.783409
588039,23,34,57,1.337513,103.783699
588040,8,8,16,1.337491,103.783409
588041,1,2,3,1.340024,103.782216
588043,5,1,6,1.338006,103.783228
588044,0,1,1,1.341028,103.783704
588045,4,5,9,1.338082,103.783
588046,1,4,5,1.338651,103.782603
588047,12,4,16,1.338651,103.782603
588048,3,1,4,1.344657,103.788754
588049,6,1,7,1.338812,103.782524
588050,28,9,37,1.338672,103.782604
588051,10,0,10,1.338924,103.782623
588052,18,1,19,1.338834,103.783023
588054,25,0,25,1.338934,103.782455
588055,53,8,61,1.338952,103.783051
588084,13,0,13,1.339337,103.78117
588085,1,1,2,1.341578,103.783745
588086,4,0,4,1.338662,103.782614
588087,2,14,16,1.3397,103.780862
588088,1,0,1,1.338521,103.782765
588089,19,0,19,1.339302,103.781573
588090,6,0,6,1.339182,103.781679
588091,29,0,29,1.339319,103.781585
588092,41,0,41,1.33913,103.781738
588093,1,0,1,1.339233,103.781621
588094,0,1,1,1.339353,103.781608
588095,5,6,11,1.339386,103.78163
588096,0,2,2,1.339285,103.781562
588097,11,0,11,1.33942,103.781653
588098,3,4,7,1.338975,103.781914
588099,7,1,8,1.339454,103.781676
588100,8,0,8,1.338923,103.781973
588101,31,6,37,1.339488,103.781699
588102,0,4,4,1.339259,103.781591
588103,24,1,25,1.33882,103.78209
588104,2,2,4,1.338872,103.782031
588132,624,203,827,1.347202,103.770878
588133,327,203,530,1.346704,103.771309
588134,719,65,784,1.346046,103.771463
588135,295,89,384,1.346382,103.771043
588136,437,1,438,1.346385,103.771069
588137,712,25,737,1.34727,103.7707
588138,23,30,53,1.347247,103.770524
588139,1,1,2,1.339027,103.781855
588140,0,29,29,1.347303,103.770573
588141,3,6,9,1.34734,103.770606
588142,4,753,757,1.347378,103.770639
588143,51,86,137,1.347415,103.770672
588144,0,28,28,1.347452,103.770704
588145,5,405,410,1.34749,103.770737
588146,3,7,10,1.347527,103.77077
588147,4,6,10,1.347565,103.770803
588148,14,15,29,1.347602,103.770835
588149,1,0,1,1.339078,103.781797
588150,0,7,7,1.347585,103.770194
588151,1,2,3,1.337913,103.783265
588152,3,0,3,1.347562,103.770135
588153,7,2,9,1.34742,103.770038
588154,2,3,5,1.347388,103.770297
588155,2,0,2,1.347265,103.770541
588156,87,2,89,1.347292,103.770424
588157,11,50,61,1.347228,103.770508
588166,77,4163,4240,1.338636,103.776808
588168,7,752,759,1.340182,103.776342
588169,50,332,382,1.340645,103.776039
588170,6,69,75,1.340711,103.776031
588171,3,113,116,1.34077,103.77602
588172,124,65,189,1.340829,103.775995
588173,24,9,33,1.340902,103.775963
588174,15,12,27,1.340977,103.775935
588175,59,423,482,1.341025,103.775919
588176,350,614,964,1.341621,103.776156
588177,1058,776,1834,1.34234,103.776131
588178,102,2402,2504,1.342677,103.775981
588179,998,15138,16136,1.343236,103.775833
588180,41,161,202,1.344056,103.774728
588181,360,522,882,1.344516,103.774355
588182,527,380,907,1.345152,103.773467
588183,25,135,160,1.345236,103.773148
588184,275,514,789,1.34536,103.773044
588185,374,2027,2401,1.345599,103.772616
588186,51,98,149,1.345901,103.77217
588190,278,558,836,1.34913,103.770534
588191,5,703,708,1.352323,103.768954
588192,408,1345,1753,1.352316,103.768832
588195,1764,213,1977,1.352252,103.768148
588196,958,130,1088,1.351996,103.767055
588197,1694,109,1803,1.352807,103.767872
588198,51,42,93,1.352342,103.767467
588199,5,16,21,1.352323,103.768954
588200,0,71,71,1.352323,103.768954
588201,1,15,16,1.352323,103.768954
588202,0,53,53,1.352323,103.768954
588203,0,11,11,1.352323,103.768954
588204,2,12,14,1.352323,103.768954
588205,3,161,164,1.352323,103.768954
588207,55,22,77,1.349523,103.770466
588208,8,48,56,1.349523,103.770466
588209,3,12,15,1.349523,103.770466
588210,0,7,7,1.349523,103.770466
588211,36,0,36,1.349523,103.770466
588212,106,61,167,1.349523,103.770466
588213,154,100,254,1.349523,103.770466
588214,269,25,294,1.35019,103.770963
588215,126,5111,5237,1.339521,103.776288
588216,938,1172,2110,1.299509,103.837
588217,28,162,190,1.299509,103.837
588223,0,4,4,1.339259,103.781591
588224,14,5,19,1.335996,103.785567
588225,2,0,2,1.347356,103.770339
588226,3,1,4,1.335998,103.785579
588227,7,0,7,1.335943,103.78575
588229,8,1,9,1.335906,103.785864
588230,1,1,2,1.33598,103.785636
588231,2,0,2,1.33589,103.785893
588232,1,0,1,1.347639,103.770868
588233,3,0,3,1.347483,103.770084
588236,1,0,1,1.335848,103.786024
588237,50,2,52,1.335721,103.786415
588238,0,1,1,1.335758,103.786321
588267,12,7,19,1.335721,103.786415
588268,3,3,6,1.336029,103.786392
588269,2,0,2,1.335869,103.785978
588270,10,6,16,1.336009,103.786392
588271,0,2,2,1.336196,103.786427
588272,7,4,11,1.336344,103.7864
588273,2,3,5,1.33693,103.786194
588274,51,0,51,1.336318,103.786337
588275,24,0,24,1.336612,103.786358
588277,4,0,4,1.335975,103.785632
588278,7,1,8,1.336793,103.786303
588279,8,2,10,1.337686,103.786119
588280,75,0,75,1.33693,103.786214
588281,3,0,3,1.335832,103.786093
588282,7,11,18,1.337777,103.786107
588283,0,1,1,1.335731,103.786425
588285,7,1,8,1.337696,103.786129
588286,2,0,2,1.336308,103.786347
588287,0,1,1,1.33694,103.786204
588288,2,4,6,1.337695,103.786128
588289,1,0,1,1.337695,103.786128
588290,4,3,7,1.337797,103.786126
588291,13,3,16,1.338198,103.78609
588292,20,11,31,1.338789,103.786028
588293,13,0,13,1.338293,103.786059
588294,40,8,48,1.338931,103.786057
588295,12,0,12,1.338475,103.785975
588296,6,4,10,1.339052,103.786043
588297,5,0,5,1.33857,103.785942
588298,0,2,2,1.337695,103.786128
588299,16,5,21,1.338664,103.78591
588300,6,1,7,1.339257,103.786063
588301,39,1,40,1.338834,103.785878
588302,0,2,2,1.339121,103.786054
588303,10,0,10,1.338982,103.785862
588304,12,1,13,1.33948,103.786065
588305,2,5,7,1.33913,103.785846
588306,36,0,36,1.339018,103.785878
588307,33,2,35,1.339277,103.78583
588308,6,1,7,1.339189,103.78586
588309,21,1,22,1.339425,103.785814
588310,3,0,3,1.336929,103.786213
588311,1,3,4,1.336619,103.78628
588312,16,0,16,1.339533,103.785823
588313,29,0,29,1.339721,103.785782
588314,10,0,10,1.339705,103.785804
588315,12,3,15,1.339869,103.785766
588316,8,16,24,1.339877,103.785785
588317,0,4,4,1.339573,103.785798
588318,9,0,9,1.340048,103.785767
588319,17,0,17,1.340164,103.785734
588320,9,0,9,1.34022,103.785748
588321,4,0,4,1.340016,103.78575
588322,25,0,25,1.340392,103.78573
588324,91,32,123,1.340564,103.785711
588325,18,12,30,1.340608,103.785687
588326,4,1,5,1.340736,103.785693
588327,4,6,10,1.340755,103.785671
588328,157,18,175,1.340907,103.785674
588330,35,0,35,1.341079,103.785656
588332,7,0,7,1.341251,103.785637
588333,6,0,6,1.341199,103.785623
588334,33,29,62,1.341423,103.785619
588335,9,0,9,1.341347,103.785607
588336,57,0,57,1.341594,103.7856
588337,29,6,35,1.341495,103.785591
588338,3,0,3,1.339361,103.785841
588339,3,6,9,1.341642,103.785575
588340,5,0,5,1.341938,103.785563
588341,6,5,11,1.34179,103.785559
588342,5,0,5,1.342058,103.785503
588343,51,2,53,1.341938,103.785543
588344,4,0,4,1.340312,103.785718
588345,19,0,19,1.338268,103.785607
588346,2,1,3,1.341766,103.785582
588373,82,56,138,1.337453,103.781462
588374,191,1339,1530,1.337205,103.781221
588375,227,380,607,1.337588,103.781153
588376,275,71,346,1.338407,103.781457
588377,116,39,155,1.338428,103.781871
588378,231,607,838,1.338169,103.782195
588379,5,0,5,1.338709,103.782244
588384,2,73,75,1.340944,103.779397
588386,2,4,6,1.341047,103.779446
588387,56,10,66,1.341093,103.779496
588388,9,0,9,1.34115,103.779619
588389,11,18,29,1.341172,103.779678
588390,40,77,117,1.341207,103.779723
588391,11,95,106,1.341252,103.779763
588393,10,43,53,1.343775,103.779766
588397,513,208,721,1.351952,103.790818
588398,517,12,529,1.355485,103.796025
588399,638,369,1007,1.353562,103.788591
588400,28,7,35,1.338427,103.780922
588401,2,0,2,1.339358,103.786087
588402,28,0,28,1.338711,103.780804
588403,2,0,2,1.338597,103.780854
588404,23,10,33,1.338912,103.78071
588405,0,9,9,1.339007,103.780649
588406,2702,1389,4091,1.3464,103.780597
588458,1,13,14,1.339611,103.780722
588460,0,2,2,1.338805,103.780758
588461,1,18,19,1.339884,103.780956
588462,54,7,61,1.339827,103.780968
588463,19,3,22,1.339955,103.781021
588464,21,0,21,1.339881,103.781046
588465,4,1,5,1.340033,103.781081
588466,22,3,25,1.33995,103.781105
588468,8,0,8,1.340044,103.781197
588469,1,4,5,1.340168,103.781193
588470,5,33,38,1.340126,103.781274
588471,118,1,119,1.340106,103.781294
588472,7,0,7,1.340249,103.781232
588473,5,4,9,1.340205,103.78134
588475,2,0,2,1.339547,103.780806
588476,1,9,10,1.340381,103.781389
588477,84,4,88,1.340862,103.781943
588478,0,5,5,1.340587,103.781513
588480,2,0,2,1.340499,103.781603
588481,6,0,6,1.341011,103.782047
588482,1,0,1,1.338019,103.786099
588483,0,1,1,1.340691,103.78164
588484,3,0,3,1.339188,103.785859
588485,96,4,100,1.341165,103.782164
588486,5,3,8,1.340801,103.781754
588487,0,1,1,1.341087,103.782118
588488,10,0,10,1.340874,103.781817
588490,1,0,1,1.341237,103.782237
588492,1,0,1,1.340956,103.781875
588493,2,0,2,1.340635,103.781569
588494,1,0,1,1.341019,103.781931
588495,0,1,1,1.34111,103.781994
588496,2,0,2,1.341438,103.782398
588497,6,0,6,1.341248,103.782116
588498,2,1,3,1.340761,103.781698
588500,15,8,23,1.341463,103.782305
588529,58,3,61,1.340817,103.781856
588530,5,1,6,1.340749,103.781918
588531,11,0,11,1.340675,103.782912
588532,12,1,13,1.340689,103.781999
588533,0,1,1,1.341496,103.782454
588534,3,2,5,1.340652,103.782191
588535,6,2,8,1.340958,103.7829
588536,2,0,2,1.341171,103.782052
588537,36,0,36,1.34125,103.782898
588538,2,0,2,1.34064,103.78239
588539,1,1,2,1.340645,103.782512
588540,1,1,2,1.341348,103.78288
588541,2,0,2,1.340655,103.782717
588542,1,1,2,1.340655,103.782912
588543,1,1,2,1.341576,103.782471
588545,3,1,4,1.342048,103.785493
588546,8,3,11,1.341104,103.782919
588547,7,23,30,1.34125,103.782918
588548,1,7,8,1.341348,103.7829
588549,1,0,1,1.340811,103.782901
588551,0,3,3,1.341321,103.782169
588552,2,0,2,1.340738,103.782922
588553,0,9,9,1.341617,103.782397
588554,42,6,48,1.341648,103.782313
588555,0,6,6,1.34171,103.782146
588556,1,2,3,1.341562,103.782556
588557,0,75,75,1.341835,103.78181
588558,3,0,3,1.341773,103.781978
588559,4,2,6,1.340737,103.78292
588560,3,3,6,1.340658,103.782073
588586,200,8,208,1.334813,103.78863
588587,4,0,4,1.340958,103.78292
588588,0,119,119,1.334325,103.789189
588589,1,2,3,1.340639,103.782442
588590,10,0,10,1.33438,103.789172
588591,1,3,4,1.334552,103.789038
588592,2,1,3,1.334724,103.788924
588593,29,0,29,1.33535,103.788882
588594,34,0,34,1.334609,103.78902
588595,12,1,13,1.335676,103.788894
588596,17,9,26,1.335675,103.788893
588597,118,0,118,1.334724,103.788944
588598,10,8,18,1.335582,103.789114
588599,193,8,201,1.336329,103.788917
588600,37,10,47,1.335769,103.789145
588601,17,13,30,1.336655,103.788929
588602,6,5,11,1.336024,103.789113
588603,16,1,17,1.336981,103.788941
588604,9,33,42,1.336196,103.789138
588605,40,6,46,1.337307,103.788952
588606,50,6,56,1.336561,103.789102
588607,5,4,9,1.336833,103.789143
588608,29,0,29,1.33713,103.789182
588609,83,14,97,1.337063,103.788799
588610,1,0,1,1.341436,103.782859
588611,1,4,5,1.337381,103.788784
588612,35,6,41,1.337584,103.788794
588613,16,11,27,1.337864,103.788787
588614,34,10,44,1.338152,103.788815
588615,19,4,23,1.338324,103.78878
588616,0,4,4,1.335024,103.788871
588617,21,3,24,1.338724,103.788756
588618,50,2,52,1.338787,103.789211
588619,20,0,20,1.338907,103.788512
588620,35,13,48,1.33911,103.78921
588621,16,22,38,1.338933,103.78875
588622,47,1,48,1.339261,103.788686
588623,32,0,32,1.339189,103.788472
588624,7,0,7,1.340651,103.788975
588625,78,0,78,1.340853,103.788945
588626,13,2,15,1.341156,103.789004
588627,25,12,37,1.341759,103.788328
588628,11,52,63,1.342638,103.788616
588630,11,4,15,1.347864,103.786881
588631,60,0,60,1.348144,103.787035
588632,49,1,50,1.34848,103.786818
588633,13,24,37,1.348492,103.786438
588634,68,108,176,1.343447,103.788524
588635,110,12,122,1.344685,103.788765
588636,13,0,13,1.344676,103.788735
588637,38,0,38,1.344675,103.788736
588638,18,0,18,1.344648,103.788765
588639,11,0,11,1.344677,103.788741
588640,5,0,5,1.344686,103.788738
588641,17,0,17,1.34466,103.788771
588642,11,0,11,1.344656,103.78876
588643,6,0,6,1.344653,103.788735
588644,3,0,3,1.334495,103.789096
588645,10,0,10,1.344685,103.788765
588646,19,0,19,1.344654,103.788732
588647,1,0,1,1.337452,103.789331
588648,57,0,57,1.344657,103.788768
588649,1,0,1,1.344653,103.78877
588650,4,0,4,1.338513,103.788764
588651,10,0,10,1.344681,103.78874
588652,210,0,210,1.344655,103.788734
588653,3,0,3,1.344649,103.788764
588654,16,0,16,1.344649,103.78877
588655,6,0,6,1.344686,103.788733
588656,5,0,5,1.344656,103.788736
588657,20,0,20,1.344677,103.788767
588658,23,0,23,1.344654,103.788772
588659,23,2,25,1.344676,103.788766
588660,12,0,12,1.344657,103.78877
588661,62,0,62,1.344675,103.788739
588662,3,5,8,1.335144,103.788204
588663,5,13,18,1.335147,103.788216
588664,0,4,4,1.344679,103.788738
588665,28,15,43,1.335167,103.788158
588666,0,9,9,1.335197,103.788052
588667,1,2,3,1.344684,103.788734
588668,5,0,5,1.335233,103.787951
588669,34,0,34,1.335249,103.787925
588670,1,6,7,1.335268,103.787851
588671,1,2,3,1.335208,103.788041
588673,1,0,1,1.344657,103.788738
588675,22,0,22,1.335372,103.787576
588676,1,0,1,1.335331,103.787692
588677,3,10,13,1.335414,103.787459
588678,1,1,2,1.341586,103.782481
588679,25,7,32,1.335455,103.787343
588680,2,0,2,1.335411,103.787447
588681,1,0,1,1.335375,103.787548
588682,6,0,6,1.335482,103.787245
588684,2,0,2,1.335446,103.787346
588685,4,4,8,1.335578,103.786994
588686,11,0,11,1.335553,103.787044
588688,18,8,26,1.335589,103.786943
588689,2,44,46,1.33566,103.786761
588690,2,3,5,1.335624,103.786842
588691,2,106,108,1.33565,103.786751
588720,6,7,13,1.335759,103.788204
588721,21,4,25,1.335763,103.788212
588722,3,11,14,1.335778,103.788151
588723,1,0,1,1.335496,103.787227
588724,7,1,8,1.335816,103.788043
588725,10,9,19,1.335833,103.788016
588726,5,0,5,1.335854,103.787936
588728,3,0,3,1.33529,103.787808
588729,14,2,16,1.335926,103.787753
588730,0,4,4,1.335162,103.788153
588731,83,0,83,1.335946,103.787671
588733,7,0,7,1.336019,103.787491
588734,0,5,5,1.336006,103.787506
588735,32,3,35,1.336065,103.787359
588736,18,1,19,1.336044,103.787399
588737,10,0,10,1.336112,103.787228
588738,81,0,81,1.336082,103.787292
588739,1,21,22,1.336158,103.787097
588740,17,2,19,1.33612,103.787184
588741,9,48,57,1.336148,103.787087
588770,2,0,2,1.335518,103.787144
588771,6,1,7,1.334827,103.788271
588773,2,6,8,1.335203,103.788274
588774,4,1,5,1.33528,103.788275
588776,17,2,19,1.335586,103.788277
588777,0,1,1,1.335786,103.788147
588778,29,3,32,1.335797,103.788296
588779,1,1,2,1.334572,103.788176
588780,1,2,3,1.335892,103.787829
588781,72,4,76,1.335968,103.78831
588782,11,2,13,1.336022,103.78832
588783,1,2,3,1.335922,103.78831
588784,0,7,7,1.336111,103.788322
588785,14,7,21,1.336153,103.788332
588786,0,1,1,1.33573,103.788268
588789,43,17,60,1.335843,103.788263
588790,28,10,38,1.336454,103.788086
588791,16,5,21,1.335946,103.788269
588792,3,2,5,1.336534,103.787818
588793,0,1,1,1.336199,103.788322
588794,132,0,132,1.336594,103.787636
588795,4,8,12,1.336256,103.788285
588796,6,11,17,1.336658,103.787449
588797,1,2,3,1.336065,103.788316
588798,121,10,131,1.336873,103.786862
588799,72,2,74,1.336432,103.787973
588800,7,5,12,1.336978,103.786842
588801,4,2,6,1.336491,103.787793
588803,6,1,7,1.33655,103.787613
588804,12,0,12,1.337398,103.786761
588805,42,0,42,1.336609,103.787432
588806,55,0,55,1.337609,103.786721
588807,1,29,30,1.336658,103.787262
588808,3,5,8,1.337819,103.78668
588809,86,3,89,1.336813,103.786853
588810,20,5,25,1.338029,103.78664
588811,2,3,5,1.336858,103.786845
588812,1,5,6,1.336948,103.786827
588813,0,2,2,1.335868,103.788304
588814,21,5,26,1.337128,103.786793
588815,9,1,10,1.337218,103.786776
588816,1,0,1,1.336153,103.78828
588817,10,3,13,1.337398,103.786741
588818,4,0,4,1.33593,103.787721
588819,0,2,2,1.337038,103.78681
588820,32,2,34,1.337669,103.786689
588821,23,4,27,1.337759,103.786672
588822,2,0,2,1.337579,103.786706
588824,175,0,175,1.338019,103.78663
588825,2,11,13,1.336474,103.788019
588827,1,6,7,1.337818,103.786679
588853,4,2,6,1.340938,103.781022
588854,17,0,17,1.34098,103.78106
588855,0,2,2,1.337849,103.786655
588856,2,0,2,1.341066,103.781135
588857,49,2,51,1.341237,103.781285
588858,1,1,2,1.341151,103.78121
588859,1,2,3,1.336373,103.788154
588861,12,0,12,1.341579,103.781585
588862,0,3,3,1.341408,103.781435
588863,39,4,43,1.34175,103.781735
588864,7,3,10,1.341825,103.7818
588893,13,209,222,1.340394,103.779608
588894,0,104,104,1.340393,103.779607
588895,6,547,553,1.340374,103.779608
588896,4,0,4,1.337489,103.786724
588897,3,1,4,1.340433,103.779653
588898,0,5,5,1.340413,103.779653
588899,6,8,14,1.340511,103.779743
588902,3,0,3,1.341655,103.781666
588903,2,0,2,1.341322,103.78136
588904,12,0,12,1.34057,103.779834
588906,0,2,2,1.340589,103.779832
588907,10,5,15,1.340648,103.779924
588909,0,1,1,1.337308,103.786758
588911,8,0,8,1.340824,103.780104
588912,8,1,9,1.340804,103.780104
588913,1,0,1,1.340745,103.780013
588914,11,1,12,1.340888,103.780182
588915,37,1,38,1.340964,103.780226
588916,1,9,10,1.341044,103.780277
588917,2,5,7,1.341034,103.780287
588946,1,51,52,1.339968,103.779997
588947,4,15,19,1.339905,103.780197
588948,1,0,1,1.340888,103.780162
588949,10,1,11,1.33995,103.780251
588950,1,1,2,1.340667,103.779923
588951,1,0,1,1.340022,103.780063
588952,4,0,4,1.340432,103.779652
588953,2,2,4,1.340168,103.780226
588954,2,0,2,1.340117,103.780173
588955,39,0,39,1.340201,103.780509
588956,1,4,5,1.340386,103.780463
588958,0,1,1,1.34001,103.780311
588959,155,0,155,1.340347,103.780652
588960,2,1,3,1.34059,103.779834
588961,2,0,2,1.340307,103.780398
588962,9,1,10,1.340631,103.780643
588963,45,0,45,1.340525,103.780784
588964,4,4,8,1.340696,103.780693
588965,2,0,2,1.340432,103.780711
588966,0,1,1,1.340268,103.780564
588967,5,4,9,1.340719,103.780959
588996,8321,352,8673,1.339001,103.778958
588997,542,2155,2697,1.339407,103.779624
588998,641,32248,32889,1.338625,103.778606
588999,5,751,756,1.341237,103.777909
589031,4,1,5,1.336632,103.785364
589032,8,0,8,1.336635,103.78532
589033,8,1,9,1.336643,103.785234
589034,7,5,12,1.33665,103.785148
589035,2,4,6,1.336658,103.785061
589036,15,18,33,1.336688,103.784966
589037,0,8,8,1.336726,103.784934
589038,43,1,44,1.336812,103.784896
589041,2,1,3,1.340555,103.78056
589042,2,0,2,1.340582,103.780829
589043,1,0,1,1.340667,103.780909
589045,1,0,1,1.337204,103.784964
589046,2,14,16,1.33745,103.785024
589047,72,0,72,1.337496,103.784762
589048,2,21,23,1.337468,103.784908
589049,1,0,1,1.337368,103.785004
589051,1,0,1,1.33746,103.785034
589052,1,8,9,1.337423,103.785213
589053,2,0,2,1.337121,103.784944
589054,0,1,1,1.337437,103.785129
589055,1,6,7,1.337393,103.785457
589084,0,1,1,1.337396,103.785382
589085,31,3,34,1.337345,103.785495
589086,3,106,109,1.336017,103.785502
589088,0,1,1,1.337165,103.785487
589089,16,0,16,1.336294,103.785376
589090,10,1,11,1.33757,103.785505
589091,2,0,2,1.33741,103.785298
589092,9,0,9,1.336374,103.785376
589093,4,0,4,1.34007,103.780378
589094,4,6,10,1.336488,103.785379
589095,13,3,16,1.337706,103.786119
589096,4,2,6,1.336638,103.785417
589097,1,0,1,1.336229,103.785376
589099,4,0,4,1.336427,103.785379
589100,19,3,22,1.336948,103.785383
589101,0,1,1,1.336741,103.785373
589102,2,3,5,1.337048,103.785432
589103,1,2,3,1.337039,103.784924
589104,6,2,8,1.337047,103.785431
589105,1,2,3,1.337047,103.785431
589106,16,6,22,1.337047,103.785431
589107,35,0,35,1.337764,103.785496
589109,5,5,10,1.337763,103.785495
589110,6,5,11,1.337763,103.785495
589111,6,0,6,1.337871,103.785238
589112,6,11,17,1.33787,103.785237
589113,2,0,2,1.336628,103.785407
589114,9,0,9,1.338073,103.785216
589115,9,0,9,1.337893,103.785215
589116,7,3,10,1.338207,103.785201
589117,4,1,5,1.337981,103.785206
589118,47,0,47,1.338341,103.785186
589119,14,0,14,1.338158,103.785186
589120,10,5,15,1.338476,103.785172
589121,41,1,42,1.338335,103.785167
589122,41,4,45,1.33861,103.785157
589123,69,2,71,1.338512,103.785148
589124,30,12,42,1.338744,103.785142
589125,4,0,4,1.33688,103.78538
589126,6,5,11,1.338878,103.785128
589127,19,1,20,1.338866,103.785109
589128,25,6,31,1.339013,103.785113
589129,21,2,23,1.339043,103.78509
589130,38,0,38,1.339147,103.785098
589131,2,0,2,1.337938,103.78523
589132,28,5,33,1.339281,103.785084
589133,22,13,35,1.339397,103.785051
589134,1,21,22,1.339416,103.785069
589136,45,5,50,1.33955,103.785054
589138,1,0,1,1.337764,103.785496
589139,15,2,17,1.339929,103.784993
589141,41,0,41,1.340106,103.784974
589142,168,0,168,1.339953,103.785011
589143,19,22,41,1.340283,103.784955
589144,11,0,11,1.340087,103.784996
589145,100,0,100,1.34046,103.784935
589146,0,5,5,1.340222,103.784981
589147,9,0,9,1.340637,103.784916
589148,1,1,2,1.33922,103.78507
589149,44,1,45,1.340814,103.784897
589150,5,2,7,1.34049,103.784952
589151,30,17,47,1.340991,103.784877
589152,0,1,1,1.339684,103.78504
589153,21,2,23,1.341168,103.784858
589154,5,0,5,1.340759,103.784923
589155,15,1,16,1.341345,103.784839
589157,3,9,12,1.341522,103.784819
589158,43,1,44,1.341027,103.784893
589159,4,0,4,1.338689,103.785128
589160,25,0,25,1.341162,103.784879
589161,8,0,8,1.341699,103.7848
589162,4,0,4,1.341689,103.78481
589163,24,1,25,1.34213,103.784767
589164,14,0,14,1.34143,103.784849
589165,41,34,75,1.342342,103.784706
589166,30,2,32,1.341565,103.784835
589167,15,8,23,1.342399,103.78479
589168,3,4,7,1.341699,103.78482
589169,24,1,25,1.342448,103.78487
589170,25,3,28,1.342253,103.784787
589171,5,25,30,1.342511,103.784965
589172,1,1,2,1.340356,103.784967
589173,2,6,8,1.342553,103.785047
589174,11,1,12,1.342369,103.784883
589175,11,17,28,1.342612,103.78514
589176,4,0,4,1.341296,103.784864
589177,18,5,23,1.343104,103.785697
589178,149,46,195,1.343149,103.785721
589179,107,2,109,1.342523,103.785125
589180,80,6,86,1.343225,103.785811
589181,5,0,5,1.3426,103.785246
589182,3,2,5,1.342947,103.785895
589183,11,0,11,1.342677,103.785367
589184,14,0,14,1.3429,103.785928
589185,40,5,45,1.342754,103.785488
589186,4,3,7,1.342806,103.785995
589188,4,0,4,1.342446,103.785004
589189,3,6,9,1.342907,103.78573
589190,70,2,72,1.342618,103.78613
589191,71,4,75,1.342984,103.785851
589192,0,1,1,1.340625,103.784937
589193,51,7,58,1.342501,103.786137
589194,20,35,55,1.342456,103.7861
589195,1,2,3,1.337047,103.785431
589196,2,0,2,1.342253,103.784787
589197,12,1,13,1.342401,103.785989
589198,2,0,2,1.342398,103.786014
589199,87,0,87,1.342334,103.78589
589201,9,41,50,1.342268,103.78579
589202,4,4,8,1.342058,103.785503
589203,19,1,20,1.342201,103.785691
589204,3,1,4,1.342712,103.786063
589205,38,6,44,1.342135,103.785592
589206,6,0,6,1.342068,103.785493
589207,30,3,33,1.342068,103.785493
589208,3,0,3,1.342467,103.786088
589209,4,0,4,1.341972,103.785399
589210,0,1,1,1.342534,103.786187
589211,16,4,20,1.342448,103.78487
589212,17,3,20,1.342511,103.784965
589213,22,3,25,1.343303,103.785896
589214,33,12,45,1.343359,103.785933
589215,4,0,4,1.341846,103.785102
589216,16,0,16,1.342903,103.785667
589217,4,10,14,1.342962,103.785745
589218,44,0,44,1.341521,103.784818
589219,2,2,4,1.342856,103.785565
589220,1,5,6,1.299509,103.837
589221,21,0,21,1.299509,103.837
589222,11,0,11,1.299509,103.837
589223,47,1,48,1.299509,103.837
589224,30,9,39,1.299509,103.837
589226,9,6,15,1.299509,103.837
589227,73,8,81,1.299509,103.837
589239,26,814,840,1.344546,103.77534
589240,115,736,851,1.344545,103.775339
589241,10,30,40,1.344553,103.775337
589242,119,200,319,1.344568,103.775332
589317,21,142,163,1.347037,103.776105
589318,74,54,128,1.34711,103.775796
589319,89,6,95,1.346979,103.776083
589320,431,30,461,1.34737,103.775858
589321,27,1,28,1.346863,103.77604
589323,9,7,16,1.346748,103.775996
589325,16,1,17,1.346632,103.775952
589326,2,6,8,1.347014,103.776589
589327,42,2,44,1.347053,103.776545
589328,3,10,13,1.347109,103.776486
589329,3,1,4,1.299509,103.837
589330,32,6,38,1.347139,103.776428
589331,74,4,78,1.347182,103.776384
589332,45,249,294,1.34723,103.776311
589333,75,18,93,1.348585,103.776634
589362,15,2,17,1.346377,103.788082
589363,0,4,4,1.347111,103.776446
589364,28,0,28,1.346447,103.788117
589365,0,8,8,1.347461,103.788469
589366,4,0,4,1.347328,103.788491
589367,197,2,199,1.347572,103.788433
589368,4,3,7,1.346724,103.788256
589369,2,0,2,1.342281,103.78584
589370,1,4,5,1.347431,103.788061
589371,35,1,36,1.347204,103.788317
589372,9,2,11,1.347037,103.78832
589373,69,0,69,1.34745,103.788285
589375,36,0,36,1.347695,103.788252
589376,31,2,33,1.347349,103.788278
589377,63,2,65,1.347941,103.788219
589378,7,1,8,1.347506,103.788257
589379,26,0,26,1.348186,103.788186
589380,2,0,2,1.347738,103.788413
589381,11,4,15,1.348432,103.788154
589382,18,11,29,1.347818,103.788216
589383,48,8,56,1.348677,103.788121
589384,1,0,1,1.341709,103.78481
589385,8,4,12,1.348659,103.788694
589386,34,0,34,1.34813,103.788174
589387,6,0,6,1.348604,103.788702
589388,0,11,11,1.348287,103.788153
589389,58,1,59,1.348493,103.788718
589390,2,4,6,1.348443,103.788132
589391,1,0,1,1.347974,103.788195
589392,29,6,35,1.348599,103.788111
589393,80,3,83,1.348272,103.78875
589394,4,0,4,1.346586,103.788186
589395,32,1,33,1.348162,103.788766
589396,106,0,106,1.348692,103.788184
589397,0,4,4,1.348667,103.788111
589398,51,0,51,1.348696,103.788257
589399,6,6,12,1.34794,103.788798
589401,1,3,4,1.348051,103.788782
589403,72,4,76,1.348723,103.788794
589405,1,1,2,1.347662,103.788236
589406,0,1,1,1.348382,103.788734
589407,16,1,17,1.34878,103.789088
589409,10,23,33,1.348818,103.789284
589410,20,0,20,1.348781,103.78899
589411,60,0,60,1.34881,103.789137
589412,3,35,38,1.348838,103.789284
589413,2,0,2,1.348742,103.788892
589414,9,12,21,1.34805,103.788781
589415,45,33,78,1.347029,103.788458
589417,5,15,20,1.3472,103.788484
589418,102,6,108,1.346376,103.788081
589419,0,12,12,1.346376,103.788081
589420,11,13,24,1.346376,103.788081
589439,1,6,7,1.334398,103.788874
589440,6,357,363,1.334398,103.788874
589441,3,63,66,1.334493,103.788622
589442,2,41,43,1.334493,103.788622
589443,5,120,125,1.334563,103.788319
589444,2,90,92,1.334563,103.788319
589445,78,957,1035,1.334615,103.788057
589446,56,942,998,1.334614,103.788056
589447,3,0,3,1.341994,103.785363
589448,8,853,861,1.334657,103.787936
589449,15,336,351,1.334744,103.787698
589451,0,2,2,1.34805,103.788781
589452,3,37,40,1.334829,103.787458
589453,3,37,40,1.334916,103.78722
589454,1,26,27,1.334915,103.787219
589455,2,74,76,1.335002,103.786981
589456,3,313,316,1.335088,103.786742
589457,30,1949,1979,1.335174,103.786503
589458,9,690,699,1.335195,103.786443
589459,8,695,703,1.335216,103.786384
589460,0,82,82,1.335257,103.786265
589462,1,58,59,1.335341,103.786027
589463,1,37,38,1.335382,103.785907
589464,1,1,2,1.33483,103.787459
589465,0,104,104,1.335466,103.785669
589466,3,89,92,1.335507,103.78555
589467,5,956,961,1.335549,103.785431
589471,52,1190,1242,1.336112,103.784068
589472,2503,7910,10413,1.336502,103.783339
589473,2845,2078,4923,1.336777,103.782354
589474,800,121,921,1.3381,103.780066
589482,374,561,935,1.338981,103.779784
589483,288,5,293,1.338766,103.780032
589484,228,1,229,1.338621,103.780242
589485,437,2,439,1.338371,103.780426
589486,370,6,376,1.338119,103.780498
589487,372,1034,1406,1.337847,103.780564
589488,1299,121,1420,1.337673,103.780139
589489,774,1485,2259,1.337285,103.780244
589510,6,6,12,1.337001,103.785592
589511,1,0,1,1.348738,103.78877
589512,27,1,28,1.336984,103.785858
589514,10,5,15,1.336938,103.786012
589515,191,8,199,1.337059,103.785926
589544,89,25,114,1.33797,103.783834
589545,10,0,10,1.338144,103.784219
589546,8,6,14,1.338143,103.784218
589547,30,1,31,1.338143,103.784218
589548,8,0,8,1.339199,103.784022
589549,4,1,5,1.338725,103.784142
589550,41,5,46,1.339169,103.783857
589551,0,1,1,1.337084,103.785549
589552,44,12,56,1.33979,103.783685
589553,6,0,6,1.338724,103.784141
589615,42,4,46,1.333167,103.79071
589616,11,49,60,1.333197,103.790635
589617,19,1,20,1.333394,103.790179
589619,60,434,494,1.333168,103.790329
589620,224,1621,1845,1.333183,103.790289
589622,86,82,168,1.333195,103.789041
589623,450,978,1428,1.333711,103.788488
589624,1129,1394,2523,1.33381,103.787841
589626,763,0,763,1.33256,103.785851
589627,2091,1314,3405,1.334821,103.785107
589628,1686,116,1802,1.333898,103.785163
589629,1623,89,1712,1.333442,103.784324
589630,2603,173,2776,1.334078,103.783292
589631,2657,1393,4050,1.334729,103.784429
589632,194,132,326,1.334902,103.783474
589633,781,97,878,1.334404,103.783214
589637,0,12,12,1.33421,103.781744
589638,27,90,117,1.333167,103.790829
589639,583,77,660,1.333534,103.787752
589640,653,8,661,1.333255,103.787655
589641,155,3,158,1.333056,103.787459
589642,226,0,226,1.332664,103.787047
589643,581,3,584,1.332435,103.786935
589644,976,3,979,1.332557,103.786487
589645,584,0,584,1.332805,103.786589
589646,298,5,303,1.332983,103.786709
589647,487,15,502,1.333187,103.784792
589648,641,2,643,1.332954,103.785152
589649,903,1,904,1.332795,103.785426
589650,190,4,194,1.333822,103.78637
589651,589,42,631,1.333821,103.786343
589652,431,1178,1609,1.334162,103.786773
589653,370,161,531,1.334192,103.786806
589654,89,1489,1578,1.333871,103.786777
589655,1067,6,1073,1.333671,103.786636
589656,355,126,481,1.333644,103.786619
589657,491,8,499,1.333118,103.786941
589658,441,28,469,1.333467,103.787128
589659,838,7,845,1.333606,103.787331
589660,961,2728,3689,1.333906,103.787478
589661,117,0,117,1.332975,103.787226
589662,1674,462,2136,1.333405,103.786284
589663,1906,315,2221,1.333012,103.786021
589664,1141,25,1166,1.333245,103.785272
589666,5,79,84,1.339787,103.777946
589695,1,2,3,1.334658,103.787937
589696,6,30,36,1.346872,103.787849
589697,3,1,4,1.34783,103.788814
589698,109,0,109,1.347029,103.787704
589699,52,0,52,1.347029,103.787724
589700,79,6,85,1.347158,103.787614
589701,5,0,5,1.347158,103.787634
589702,21,3,24,1.347415,103.787435
589703,2,0,2,1.335424,103.785788
589704,2,1,3,1.346872,103.787849
589705,12,0,12,1.347672,103.787276
589734,3,37,40,1.337875,103.787792
589735,29,10,39,1.337915,103.787732
589736,0,1,1,1.338725,103.784142
589737,1,0,1,1.337929,103.787685
589738,21,2,23,1.338037,103.787469
589739,8,4,12,1.338199,103.787166
589740,4,7,11,1.338145,103.787254
589741,43,2,45,1.338521,103.78695
589742,14,0,14,1.338199,103.787146
589743,3,2,5,1.338809,103.786912
589744,4,1,5,1.338336,103.787006
589745,54,1,55,1.339193,103.786887
589746,31,3,34,1.338732,103.786897
589747,1,1,2,1.347415,103.787455
589748,112,8,120,1.339183,103.786877
589777,74,14,88,1.34293,103.78727
589779,42,9,51,1.343023,103.787093
589780,166,4,170,1.343356,103.786934
589781,22,11,33,1.343237,103.78683
589782,4,0,4,1.346872,103.787869
589783,2,1,3,1.347662,103.787266
589784,23,0,23,1.343247,103.78682
589785,7,21,28,1.343684,103.787218
589786,2,1,3,1.343409,103.787001
589787,95,17,112,1.343893,103.787397
589788,7,30,37,1.343257,103.78683
589789,1,11,12,1.343739,103.786376
589790,44,3,47,1.343187,103.787591
589791,16,0,16,1.342758,103.787736
589818,16,27,43,1.335711,103.786489
589819,59,0,59,1.335701,103.786544
589820,47,11,58,1.33568,103.786652
589821,137,93,230,1.33567,103.786751
589822,14,21,35,1.335965,103.786943
589823,190,8,198,1.335987,103.786958
589824,20,17,37,1.336072,103.787017
589825,3,7,10,1.336115,103.787047
589826,130,7,137,1.336158,103.787077
589827,18,0,18,1.336217,103.787105
589828,34,15,49,1.336276,103.787132
589829,14,8,22,1.336335,103.78716
589831,24,24,48,1.33656,103.787228
589832,24,25,49,1.336668,103.787252
589833,9,4,13,1.337349,103.787632
589834,42,23,65,1.336678,103.787262
589835,29,1,30,1.337277,103.787759
589836,18,7,25,1.337349,103.787632
589837,34,0,34,1.337188,103.787935
589838,36,0,36,1.337155,103.78813
589840,32,0,32,1.337124,103.788335
589841,1,10,11,1.338501,103.787639
589842,10,0,10,1.337349,103.787652
589843,24,0,24,1.339037,103.787816
589844,20,20,40,1.337811,103.78791
589845,29,14,43,1.339575,103.787648
589846,37,12,49,1.338094,103.788013
589847,78,33,111,1.339585,103.787638
589849,10,0,10,1.338094,103.788013
589850,82,17,99,1.340314,103.787378
589851,24,6,30,1.339687,103.7867
589852,0,23,23,1.338391,103.78803
589853,1,2,3,1.343414,103.786669
589854,18,35,53,1.338802,103.787912
589855,11,1,12,1.339115,103.78781
589856,65,37,102,1.339428,103.787709
589857,122,5,127,1.341543,103.787098
589858,8,0,8,1.339585,103.787658
589859,14,4,18,1.341654,103.787543
589860,9,34,43,1.339604,103.787745
589861,13,0,13,1.341664,103.787553
589864,1,2,3,1.340585,103.78735
589865,35,6,41,1.34277,103.788128
589866,86,3,89,1.339749,103.788228
589867,31,0,31,1.342855,103.788138
589868,93,0,93,1.343473,103.787996
589869,3,6,9,1.339807,103.788422
589870,48,9,57,1.343024,103.788159
589871,111,19,130,1.339595,103.787648
589872,8,15,23,1.343193,103.788179
589873,7,15,22,1.340314,103.787398
589874,7,40,47,1.340595,103.78736
589875,4,6,10,1.340392,103.788112
589876,53,0,53,1.340322,103.788413
589877,32,12,44,1.340586,103.788421
589878,21,5,26,1.340586,103.788015
589879,25,0,25,1.340587,103.788237
589880,100,29,129,1.340807,103.787352
589881,34,16,50,1.341644,103.787553
589882,2,18,20,1.341644,103.787553
589883,1,7,8,1.341264,103.788251
589884,7,5,12,1.341612,103.787742
589885,40,8,48,1.341517,103.78815
589886,3,15,18,1.341654,103.787563
589887,55,62,117,1.342593,103.787864
589888,1,29,30,1.342676,103.788128
589889,6,378,384,1.342613,103.788626
589890,1,0,1,1.33801,103.787543
589918,1,0,1,1.336677,103.787261
589919,9,2,11,1.340854,103.787167
589920,55,0,55,1.340315,103.786756
589921,8,2,10,1.34101,103.78691
589922,0,2,2,1.338963,103.786882
589923,3,0,3,1.339691,103.788035
589924,24,1,25,1.341719,103.78661
589925,1,2,3,1.341619,103.78659
589926,5,2,7,1.342242,103.786599
589927,3,2,5,1.342232,103.786589
589956,1,2,3,1.34198,103.786584
589957,3,2,5,1.336605,103.785473
589958,0,1,1,1.340827,103.787242
589959,19,2,21,1.336582,103.785538
589960,12,5,17,1.336548,103.785657
589961,5,2,7,1.336537,103.78567
589963,2,0,2,1.341326,103.786669
589964,4,2,6,1.336468,103.785887
589965,5,0,5,1.336445,103.785933
589966,5,1,6,1.336428,103.786002
589969,0,2,2,1.336491,103.785801
589970,2,2,4,1.343551,103.787704
589971,0,3,3,1.336608,103.785484
590001,817,210,1027,1.318309,103.773096
590002,320,100,420,1.339168,103.775206
590003,267,95,362,1.338795,103.775106
590004,713,200,913,1.338532,103.774497
590005,608,167,775,1.338216,103.77446
590006,544,151,695,1.337743,103.774975
590007,391,119,510,1.337403,103.775023
590008,130,24,154,1.337922,103.77411
590009,675,320,995,1.338333,103.773294
590010,439,88,527,1.337764,103.773302
590011,701,41,742,1.338076,103.772657
590012,733,218,951,1.338392,103.772782
590013,568,312,880,1.33875,103.77251
590014,285,129,414,1.339053,103.772626
590015,169,111,280,1.339316,103.772082
590016,293,222,515,1.339378,103.77267
590017,587,354,941,1.339749,103.772568
590018,211,3044,3255,1.339986,103.773299
590019,192,2485,2677,1.339922,103.773874
590021,389,76,465,1.299509,103.837
591001,985,119,1104,1.318061,103.773103
591021,2,16,18,1.299509,103.837
591101,138,28,166,1.318325,103.775346
591201,135,61,196,1.318325,103.775346
591301,922,1004,1926,1.319363,103.774059
591401,1295,323,1618,1.318371,103.774199
591501,481,254,735,1.339559,103.774639
591601,7,390,397,1.33918,103.774385
592001,936,115,1051,1.317376,103.774127
593001,1097,210,1307,1.317376,103.774127
594001,460,137,597,1.317373,103.775099
595001,937,167,1104,1.31754,103.775908
596001,212,136,348,1.318356,103.776062
596150,96,906,1002,1.299509,103.837
596151,219,637,856,1.299509,103.837
596152,40,552,592,1.344059,103.76984
596155,1,1,2,1.336348,103.786232
596156,4,0,4,1.336308,103.786327
596160,0,9,9,1.299509,103.837
596161,11,1,12,1.299509,103.837
596162,10,0,10,1.299509,103.837
596163,1,1,2,1.299509,103.837
596164,99,0,99,1.299509,103.837
596165,181,7,188,1.299509,103.837
596166,0,5,5,1.299509,103.837
596167,25,0,25,1.299509,103.837
596168,42,0,42,1.299509,103.837
596169,7,2,9,1.299509,103.837
596170,0,1,1,1.336588,103.785542
596171,21,5,26,1.299509,103.837
596172,4,2,6,1.299509,103.837
596173,9,0,9,1.299509,103.837
596174,5,0,5,1.299509,103.837
596180,109,107,216,1.340527,103.773639
596181,107,14,121,1.344059,103.76984
596182,55,1,56,1.299509,103.837
596183,22,210,232,1.299509,103.837
596184,82,346,428,1.299509,103.837
596185,57,3,60,1.299509,103.837
596190,4,1,5,1.333905,103.768768
596191,1,0,1,1.299509,103.837
596195,895,0,895,1.339099,103.769175
596196,4,26,30,1.340688,103.771099
596197,0,14,14,1.299509,103.837
596200,4,1,5,1.344807,103.772839
596202,1,0,1,1.299509,103.837
596203,1,0,1,1.344807,103.772839
596204,1,0,1,1.344807,103.772839
596205,9,0,9,1.344876,103.772621
596206,11,0,11,1.344876,103.772621
596207,2,0,2,1.299509,103.837
596208,17,2,19,1.344876,103.772621
596209,32,2,34,1.344876,103.772621
596211,31,0,31,1.344964,103.772452
596212,44,1,45,1.344964,103.772452
596213,29,19,48,1.344964,103.772452
596214,1,2,3,1.336318,103.786337
596215,72,5,77,1.299509,103.837
596220,7,1,8,1.345307,103.771913
596221,17,0,17,1.340819,103.769822
596222,252,153,405,1.330876,103.757959
596223,49,208,257,1.330309,103.757702
596224,438,36,474,1.330586,103.757108
596225,325,161,486,1.331162,103.758186
596226,60,499,559,1.331405,103.757883
596227,200,140,340,1.331431,103.757348
596228,1644,208,1852,1.329739,103.756996
596229,1318,1001,2319,1.358318,103.765848
596230,2734,556,3290,1.35836,103.765649
596231,1986,65,2051,1.359766,103.765683
596232,91,2,93,1.359241,103.766206
596233,8,13,21,1.335993,103.771279
596234,4,19,23,1.336016,103.771286
596235,16,0,16,1.335981,103.771241
596236,13,1,14,1.336006,103.771256
596238,9,0,9,1.335987,103.771196
596239,9,1,10,1.335934,103.771092
596242,61,0,61,1.335949,103.771077
596244,1,3,4,1.299509,103.837
596245,9,2,11,1.335863,103.770867
596246,17,1,18,1.335911,103.770957
596247,3,2,5,1.335839,103.770792
596248,0,2,2,1.344876,103.772621
596249,4,2,6,1.335816,103.770717
596250,18,1,19,1.335874,103.770837
596251,2,0,2,1.335892,103.770897
596252,11,4,15,1.335855,103.770777
596253,6,0,6,1.335768,103.770568
596254,2,1,3,1.344098,103.77431
596255,2,9,11,1.335745,103.770493
596256,0,1,1,1.344876,103.772621
596257,1,0,1,1.335817,103.770657
596258,4,0,4,1.33593,103.771017
596259,11,1,12,1.335634,103.77048
596261,11,0,11,1.335537,103.770533
596262,1,1,2,1.335792,103.770643
596263,4,1,5,1.335343,103.770638
596264,46,0,46,1.335741,103.770418
596265,3,2,5,1.335159,103.770733
596266,229,1,230,1.335727,103.770372
596267,2,1,3,1.335836,103.770717
596268,2,0,2,1.33576,103.770478
596269,3,2,5,1.335657,103.770144
596270,2,10,12,1.335699,103.770426
596271,1,0,1,1.335731,103.770428
596272,1,0,1,1.335666,103.770443
596273,57,0,57,1.335537,103.770513
596274,26,1,27,1.335472,103.770548
596275,0,2,2,1.335685,103.770235
596276,2,1,3,1.335713,103.770327
596277,1,0,1,1.335602,103.770478
596278,2,1,3,1.335343,103.770618
596279,0,3,3,1.335214,103.770688
596280,2,6,8,1.335121,103.771154
596281,0,3,3,1.335149,103.770723
596282,2,1,3,1.33519,103.771165
596283,8,1,9,1.335465,103.771212
596284,7,4,11,1.335602,103.771236
596285,10,0,10,1.33574,103.771259
596286,45,1,46,1.335877,103.771283
596287,13,4,17,1.336015,103.771306
596288,2067,9395,11462,1.335748,103.78213
596289,927,29,956,1.335023,103.781893
596290,924,118,1042,1.338944,103.77142
596291,0,25,25,1.339656,103.766428
596292,23,0,23,1.339655,103.766427
596293,12,28,40,1.339579,103.765964
596294,8,3,11,1.339578,103.765964
596295,21,58,79,1.339493,103.765976
596296,18,1,19,1.339492,103.765975
596297,1,10,11,1.339319,103.765999
596298,5,17,22,1.339318,103.765998
596299,8,24,32,1.339156,103.766012
596300,71,62,133,1.339155,103.766011
596301,155,825,980,1.357579,103.765507
596302,907,226,1133,1.328935,103.773437
596305,44,65,109,1.353489,103.765773
596306,3,2,5,1.342233,103.774757
596307,1,4,5,1.341872,103.774906
596308,0,1,1,1.335278,103.770653
596309,0,1,1,1.342276,103.774748
596310,5,2,7,1.342308,103.774736
596312,3,22,25,1.342349,103.774726
596313,50,0,50,1.342184,103.774831
596314,12,44,56,1.341911,103.774892
596315,0,2,2,1.335408,103.770583
596316,5,31,36,1.34197,103.774878
596318,0,20,20,1.342087,103.774849
596320,4,16,20,1.342205,103.774821
596321,2,1,3,1.335327,103.771189
596322,3,12,15,1.342323,103.774793
596323,5,0,5,1.342808,103.774681
596324,0,1,1,1.341934,103.774891
596326,0,2,2,1.342309,103.774801
596327,7,1,8,1.343057,103.77462
596328,5,1,6,1.343182,103.77459
596329,3,2,5,1.343307,103.77456
596330,48,3,51,1.343432,103.77453
596331,1,0,1,1.342475,103.774714
596332,1,0,1,1.343557,103.7745
596333,46,2,48,1.343191,103.774857
596334,0,3,3,1.342683,103.774711
596335,1,2,3,1.342627,103.774666
596336,3,1,4,1.335798,103.770598
596337,1,1,2,1.342608,103.774709
596338,16,4,20,1.342812,103.774617
596339,8,0,8,1.343321,103.774859
596340,2,2,4,1.342777,103.774626
596341,11,0,11,1.343401,103.774817
596342,1,5,6,1.34303,103.774552
596343,27,1,28,1.343453,103.774829
596344,1,5,6,1.34317,103.774519
596345,3,0,3,1.343214,103.774874
596346,0,3,3,1.343488,103.774804
596347,5,0,5,1.343543,103.774781
596348,2,2,4,1.342985,103.774555
596349,10,3,13,1.343602,103.774763
596350,0,1,1,1.343146,103.774594
596351,5,3,8,1.344447,103.773749
596353,0,3,3,1.343271,103.7745
596354,3,0,3,1.344531,103.773681
596355,4,0,4,1.343383,103.774467
596356,0,2,2,1.343267,103.774843
596357,1,22,23,1.344599,103.773495
596358,1,1,2,1.343801,103.774372
596359,36,0,36,1.344612,103.773396
596360,25,9,34,1.344437,103.773739
596361,1,4,5,1.34463,103.773298
596362,0,1,1,1.343459,103.774442
596364,0,2,2,1.344386,103.773857
596365,1,2,3,1.343697,103.774398
596366,3,0,3,1.344654,103.77315
596368,2,2,4,1.344531,103.773681
596369,0,2,2,1.344661,103.7731
596370,73,2,75,1.344722,103.772868
596371,0,2,2,1.344692,103.773004
596372,2,0,2,1.344717,103.772907
596373,5,0,5,1.344742,103.77281
596374,1,0,1,1.344651,103.773139
596376,1,1,2,1.344742,103.77279
596377,7,15,22,1.344792,103.772616
596378,1,0,1,1.344762,103.772712
596379,26,0,26,1.344818,103.772519
596380,1,6,7,1.344823,103.77248
596381,19,0,19,1.344853,103.772432
596382,8,71,79,1.344818,103.772442
596383,6,5,11,1.344875,103.772374
596384,15,24,39,1.34503,103.772316
596385,9,17,26,1.344846,103.772364
596386,23,12,35,1.34497,103.772164
596387,0,16,16,1.345078,103.772224
596388,0,1,1,1.344803,103.772557
596389,0,6,6,1.345096,103.771991
596390,10,5,15,1.345128,103.772126
596391,6,1,7,1.345501,103.771494
596392,2,0,2,1.344782,103.772635
596393,82,14,96,1.345287,103.772443
596394,1,0,1,1.345112,103.771953
596395,9,3,12,1.345334,103.772309
596396,6,3,9,1.345356,103.772364
596397,5,0,5,1.345396,103.771345
596398,1,1,2,1.345229,103.772474
596399,47,12,59,1.345406,103.772269
596400,1,0,1,1.345466,103.771444
596401,7,11,18,1.3454,103.771954
596402,0,2,2,1.345448,103.772134
596403,25,3,28,1.345556,103.771544
596404,1,0,1,1.345327,103.771246
596405,1,1,2,1.345257,103.771146
596406,4,1,5,1.345117,103.770947
596407,31,1,32,1.345481,103.771437
596408,1,1,2,1.345531,103.771508
596409,0,1,1,1.345187,103.771047
596410,4,1,5,1.344978,103.770748
596411,0,2,2,1.345047,103.770848
596412,16,0,16,1.344908,103.770649
596413,2,0,2,1.345382,103.771295
596414,1,0,1,1.345431,103.771366
596415,61,1,62,1.345282,103.771153
596417,1,0,1,1.344838,103.770549
596418,0,1,1,1.345232,103.771082
596419,2,0,2,1.345332,103.771224
596420,45,0,45,1.344582,103.770708
596421,3,1,4,1.344702,103.772945
596422,0,1,1,1.34468,103.770629
596423,5,3,8,1.345082,103.770869
596424,0,13,13,1.344396,103.770856
596425,0,1,1,1.344484,103.770787
596426,16,0,16,1.344983,103.770727
596427,3,5,8,1.344982,103.770726
596428,0,3,3,1.344681,103.773023
596429,0,1,1,1.345032,103.770798
596430,0,4,4,1.345132,103.77094
596431,32,0,32,1.344742,103.770559
596432,2,0,2,1.345182,103.771011
596433,0,1,1,1.344883,103.770585
596434,6,8,14,1.344457,103.770789
596435,2,0,2,1.3446,103.770674
596436,12,19,31,1.344671,103.770616
596437,35,0,35,1.34467,103.770615
596438,123,7,130,1.345558,103.772096
596439,5,4,9,1.345591,103.772031
596440,8,0,8,1.345647,103.771943
596441,6,1,7,1.34567,103.771888
596442,4,1,5,1.345666,103.77162
596443,21,3,24,1.345708,103.771712
596444,43,4,47,1.345591,103.771703
596445,4,4,8,1.345451,103.77169
596446,2,0,2,1.344386,103.770846
596455,5,30,35,1.299509,103.837
596456,1,3,4,1.344778,103.77053
596457,1,0,1,1.344529,103.770731
596458,1,0,1,1.299509,103.837
596459,2,0,2,1.345377,103.771755
596460,1,2,3,1.344933,103.770656
596464,0,2,2,1.299509,103.837
596465,0,1,1,1.299509,103.837
596466,0,13,13,1.299509,103.837
596468,4161,1240,5401,1.319258,103.775738
596469,17,1407,1424,1.319108,103.771964
596470,28,249,277,1.321844,103.773324
596471,40,235,275,1.321744,103.779003
596472,50,899,949,1.320181,103.775068
596484,11,14,25,1.337604,103.770288
596485,20,1,21,1.337584,103.770282
596486,0,14,14,1.337608,103.770353
596487,5,2,7,1.337587,103.770341
596488,2,17,19,1.337614,103.770481
596489,12,0,12,1.337593,103.770458
596490,57,6,63,1.337621,103.77061
596491,34,3,37,1.337599,103.770575
596492,36,0,36,1.337627,103.770739
596493,3,0,3,1.299509,103.837
596494,3,0,3,1.337605,103.770692
596495,2,0,2,1.299509,103.837
596496,1,0,1,1.299509,103.837
596497,8,0,8,1.337647,103.771125
596498,19,0,19,1.337623,103.771043
596499,4,0,4,1.299509,103.837
596500,105,0,105,1.337629,103.77116
596501,9,0,9,1.33766,103.771382
596502,1,0,1,1.337641,103.770996
596503,1,4,5,1.337667,103.771511
596504,52,0,52,1.337641,103.771394
596505,26,6,32,1.337647,103.771511
596506,1,14,15,1.337676,103.772404
596507,52,3,55,1.33764,103.772396
596508,15,0,15,1.337566,103.772379
596509,2,0,2,1.337611,103.770809
596512,2,2,4,1.337654,103.771254
596513,1,1,2,1.337493,103.772363
596515,16,2,18,1.33709,103.772272
596517,0,1,1,1.337635,103.771277
596518,4,2,6,1.337008,103.772082
596519,4,0,4,1.337273,103.772313
596532,1,20,21,1.338085,103.771639
596533,58,1,59,1.338098,103.771607
596534,0,1,1,1.336916,103.772248
596535,0,1,1,1.338123,103.771545
596537,5,0,5,1.3382,103.771357
596538,17,0,17,1.338225,103.771295
596539,7,2,9,1.338251,103.771232
596540,0,6,6,1.338276,103.77117
596541,20,6,26,1.338302,103.771107
596542,0,2,2,1.3372,103.772297
596543,2,23,25,1.338353,103.770982
596544,51,6,57,1.337614,103.771515
596545,6,3,9,1.337572,103.77151
596546,8,16,24,1.337487,103.771498
596548,3,4,7,1.337317,103.771476
596550,0,19,19,1.337146,103.771454
596551,159,0,159,1.337061,103.771442
596552,8,9,17,1.3376,103.771494
596553,67,29,96,1.33657,103.771951
596554,0,7,7,1.337544,103.771486
596555,5,0,5,1.336571,103.771976
596556,5,0,5,1.33743,103.771471
596557,0,5,5,1.337429,103.77147
596558,15,10,25,1.337429,103.77147
596559,7,0,7,1.336806,103.771408
596560,1,0,1,1.338149,103.771482
596561,21,0,21,1.336721,103.771397
596562,9,8,17,1.337203,103.771441
596563,107,0,107,1.336636,103.771386
596564,1,0,1,1.337317,103.771456
596565,17,25,42,1.336976,103.771411
596566,6,2,8,1.336863,103.771396
596567,6,3,9,1.336749,103.771381
596568,0,1,1,1.33709,103.771426
596569,93,1814,1907,1.340632,103.771837
596581,13,8,21,1.337179,103.764486
596582,3,5,8,1.337159,103.764488
596583,0,1,1,1.336646,103.771376
596584,1,0,1,1.337186,103.764526
596585,3,0,3,1.337634,103.770868
596586,2,3,5,1.337181,103.764617
596587,0,2,2,1.338327,103.771045
596589,7,0,7,1.337228,103.764769
596590,51,7,58,1.337211,103.764789
596591,53,11,64,1.337241,103.764851
596592,1,1,2,1.337214,103.764688
596594,7,0,7,1.337269,103.765013
596595,1,0,1,1.337167,103.764531
596596,1,12,13,1.337283,103.765094
596598,1,0,1,1.337255,103.765046
596599,4,0,4,1.336809,103.772026
596600,6,1,7,1.337311,103.765256
596601,2,0,2,1.337226,103.764874
596604,1,3,4,1.337284,103.765218
596605,63,1,64,1.337328,103.765476
596606,3,0,3,1.3372,103.764607
596607,2,0,2,1.337299,103.765304
596608,11,0,11,1.337366,103.765581
596609,1,0,1,1.337297,103.765175
596610,1,7,8,1.33738,103.765662
596613,5,5,10,1.337387,103.765819
596615,2,0,2,1.337343,103.765561
596616,8,2,10,1.337422,103.765905
596617,0,1,1,1.337358,103.765647
596618,4,0,4,1.337339,103.765418
596619,3,0,3,1.337353,103.765499
596620,3,0,3,1.337509,103.765884
596621,1,2,3,1.337418,103.765876
596622,8,0,8,1.337209,103.765937
596623,4,0,4,1.337605,103.765854
596624,0,5,5,1.336813,103.765971
596638,1,0,1,1.337654,103.765838
596639,1,67,68,1.339343,103.768716
596640,3,3,6,1.338533,103.768404
596641,8,21,29,1.339524,103.768664
596642,1,0,1,1.339583,103.768654
596643,9,0,9,1.339287,103.768704
596644,5,0,5,1.339168,103.768723
596645,19,6,25,1.33905,103.768743
596646,0,4,4,1.337006,103.765959
596647,1,3,4,1.338813,103.768783
596648,5,0,5,1.338576,103.768822
596649,53,16,69,1.338458,103.768842
596650,8,5,13,1.338339,103.768862
596651,2,0,2,1.337402,103.765905
596652,2,34,36,1.338236,103.768894
596653,4,1,5,1.338241,103.768917
596656,2,0,2,1.338231,103.768872
596657,1,1,2,1.33827,103.769051
596658,1,0,1,1.339405,103.768684
596659,0,1,1,1.33829,103.769141
596661,4,46,50,1.338319,103.769275
596662,4,32,36,1.337731,103.768967
596677,3,470,473,1.34209,103.770616
596678,3,438,441,1.34209,103.770616
596679,4,3,7,1.338843,103.770196
596680,1,8,9,1.34209,103.770616
596681,4,17,21,1.34209,103.770616
596683,2,0,2,1.33828,103.769096
596684,1,0,1,1.338299,103.769185
596685,10,61,71,1.340145,103.769592
596686,4,95,99,1.34054,103.770796
596687,6,82,88,1.340544,103.770122
596688,1,55,56,1.340538,103.770041
596689,60,0,60,1.340533,103.770021
596690,4,5,9,1.340103,103.769511
596691,3,50,53,1.340363,103.770319
596692,0,2,2,1.340166,103.769632
596693,1,37,38,1.340362,103.770318
596694,1,2,3,1.33731,103.765926
596695,1,6,7,1.340062,103.76943
596696,6,0,6,1.340311,103.769919
596697,16,233,249,1.34031,103.769918
596698,2,23,25,1.340725,103.76953
596699,47,0,47,1.340748,103.769602
596700,6,17,23,1.340772,103.769667
596701,1,14,15,1.340788,103.769737
596703,12,8,20,1.340996,103.769685
596704,14,298,312,1.339978,103.769268
596705,4,1,5,1.341109,103.769555
596706,3,11,14,1.341014,103.769532
596707,7,4,11,1.340977,103.769438
596708,4,17,21,1.340964,103.769391
596709,8,112,120,1.339936,103.769187
596710,65,21,86,1.340823,103.769122
596711,4,62,66,1.339894,103.769107
596712,292,128,420,1.341028,103.768637
596713,1,18,19,1.339853,103.769026
596714,594,55,649,1.34068,103.768107
596715,14,252,266,1.339811,103.768945
596716,361,110,471,1.340053,103.767626
596717,410,931,1341,1.33949,103.767948
596718,98,42,140,1.340074,103.768597
596719,430,65,495,1.340384,103.769115
596720,1009,446,1455,1.339341,103.767354
596721,23,1,24,1.340656,103.768626
596722,455,217,672,1.338874,103.76729
596723,468,13,481,1.34101,103.765253
596724,587,65,652,1.341649,103.765422
596725,5,88,93,1.339656,103.765943
596726,106,0,106,1.339655,103.765942
596727,4,23,27,1.341575,103.765826
596728,4,44,48,1.339646,103.765774
596729,4,46,50,1.339645,103.765773
596730,935,131,1066,1.341836,103.766287
596731,3,60,63,1.339624,103.765436
596732,14,0,14,1.339624,103.765435
596733,566,15,581,1.341427,103.766366
596734,0,41,41,1.339604,103.765098
596735,4,25,29,1.339602,103.765097
596736,234,0,234,1.339541,103.764722
596737,2,94,96,1.33954,103.764721
596738,699,89,788,1.340421,103.767266
596739,820,86,906,1.34134,103.76726
596740,377,226,603,1.34211,103.767283
596741,842,44,886,1.34238,103.768353
596742,1040,95,1135,1.342388,103.769101
596743,743,1302,2045,1.342944,103.769512
596744,1269,75,1344,1.342019,103.769761
596745,365,34,399,1.341577,103.769362
596746,1831,231,2062,1.341813,103.768589
596747,64,92,156,1.341767,103.767972
596748,851,241,1092,1.340967,103.767767
596749,5,192,197,1.33961,103.76724
596750,12,0,12,1.339609,103.767239
596751,7,104,111,1.339294,103.764189
596752,0,20,20,1.339255,103.764192
596753,21,85,106,1.339178,103.764198
596754,96,4,100,1.3391,103.764205
596755,34,0,34,1.339022,103.764211
596756,7,4,11,1.338945,103.764217
596757,0,2,2,1.340362,103.770318
596758,12,4,16,1.338711,103.764236
596759,5,2,7,1.338634,103.764242
596760,21,0,21,1.338556,103.764248
596761,2,0,2,1.338789,103.76423
596762,1,3,4,1.338695,103.768803
596763,2,2,4,1.338401,103.764261
596777,3,0,3,1.340362,103.770318
596778,14,3,17,1.33832,103.76429
596779,1,1,2,1.338478,103.764255
596780,4,0,4,1.338333,103.764257
596781,3,0,3,1.338484,103.764844
596783,4,0,4,1.338327,103.764324
596785,164,0,164,1.338724,103.764816
596786,1,0,1,1.339253,103.769601
596787,72,0,72,1.338792,103.764808
596788,2,0,2,1.338518,103.76484
596789,64,1,65,1.338398,103.764658
596790,2,8,10,1.338929,103.764792
596791,17,0,17,1.338412,103.764724
596792,1,0,1,1.338369,103.764524
596793,7,1,8,1.338426,103.764791
596794,2,1,3,1.338587,103.764832
596796,0,2,2,1.338384,103.764591
596797,66,2,68,1.338448,103.764906
596799,10,4,14,1.338456,103.764953
596800,16,1,17,1.339323,103.764735
596801,7,0,7,1.338471,103.765048
596804,38,27,65,1.339531,103.764712
596805,3,0,3,1.339051,103.764776
596806,7,1,8,1.33901,103.764815
596808,27,1,28,1.339012,103.764836
596810,1,0,1,1.338987,103.764794
596811,24,0,24,1.338549,103.765524
596812,17,0,17,1.339022,103.76492
596813,2,0,2,1.339106,103.764768
596814,4,0,4,1.338655,103.764824
596815,1,0,1,1.339017,103.764878
596817,5,2,7,1.338596,103.76581
596818,1,0,1,1.338581,103.765714
596819,68,0,68,1.338612,103.765905
596820,2,0,2,1.338565,103.765619
596822,72,25,97,1.339217,103.765736
596824,3,7,10,1.339311,103.765834
596825,0,5,5,1.338439,103.765954
596826,0,7,7,1.338967,103.76591
596827,0,6,6,1.339064,103.765256
596828,6,0,6,1.339069,103.765298
596829,0,1,1,1.339038,103.765046
596830,51,0,51,1.339079,103.765382
596832,1,0,1,1.339074,103.76534
596834,8,4,12,1.339099,103.76555
596835,8,1,9,1.338768,103.764929
596836,7,3,10,1.338641,103.764987
596837,0,3,3,1.338502,103.765239
596838,1,0,1,1.339089,103.765466
596839,1,1,2,1.339043,103.765088
596840,18,1,19,1.33913,103.765802
596841,1,9,10,1.339135,103.765844
596843,16,4,20,1.339146,103.765928
596844,0,1,1,1.338653,103.765198
596845,3,6,9,1.339156,103.766012
596859,2,13,15,1.339774,103.76889
596874,10,399,409,1.340582,103.770754
596875,97,1,98,1.340634,103.770723
596876,3,3,6,1.340738,103.77066
596877,1,0,1,1.339151,103.76597
596879,0,1,1,1.340843,103.770596
596880,1,0,1,1.341041,103.77048
596881,8,0,8,1.341026,103.770336
596882,7,3,10,1.341062,103.770291
596883,2,2,4,1.339028,103.764962
596884,3,0,3,1.338663,103.765046
596886,0,1,1,1.341041,103.77048
596887,2,1,3,1.341113,103.770222
596888,11,3,14,1.34136,103.770307
596889,1,2,3,1.341299,103.77027
596890,6,10,16,1.34145,103.770364
596891,0,5,5,1.341471,103.77036
596892,8,12,20,1.341492,103.770356
596893,9,74,83,1.341533,103.770349
596894,19,36,55,1.341565,103.770351
596908,7,7,14,1.33781,103.764399
596909,1,9,10,1.337795,103.764427
596910,15,0,15,1.337817,103.764437
596911,8,0,8,1.337807,103.764494
596912,6,0,6,1.33783,103.764512
596913,18,3,21,1.337831,103.764627
596914,1,0,1,1.341239,103.770232
596915,1,0,1,1.337844,103.764588
596916,11,0,11,1.337857,103.764663
596917,0,1,1,1.337854,103.76476
596918,2,0,2,1.338665,103.765294
596920,1,2,3,1.34142,103.770345
596921,5,0,5,1.337877,103.764892
596922,2,2,4,1.341087,103.770257
596924,0,2,2,1.337877,103.764892
596925,131,0,131,1.337877,103.764892
596926,8,1,9,1.337871,103.764739
596927,3,0,3,1.337877,103.764892
596928,8,1,9,1.337926,103.765159
596929,46,0,46,1.337898,103.76489
596930,2,1,3,1.337902,103.765026
596931,3,2,5,1.337911,103.764965
596933,1,0,1,1.337878,103.764893
596934,7,1,8,1.337997,103.765558
596935,0,3,3,1.337949,103.765292
596936,5,1,6,1.338021,103.765691
596937,11,1,12,1.337952,103.765192
596938,4,0,4,1.337877,103.764892
596939,7,0,7,1.337965,103.765268
596940,32,33,65,1.338068,103.765957
596941,32,3,35,1.337978,103.765343
596942,6,0,6,1.33808,103.766023
596943,43,1,44,1.337992,103.765419
596944,2,0,2,1.337877,103.764892
596946,3,1,4,1.338044,103.765824
596947,0,1,1,1.337925,103.765041
596949,2,0,2,1.338211,103.766074
596950,11,1,12,1.338073,103.765872
596951,5,2,7,1.338087,103.765947
596952,20,0,20,1.3381,103.766023
596953,12,0,12,1.338142,103.766043
596954,31,14,45,1.338221,103.766064
596955,132,4,136,1.339146,103.766048
596956,12,1,13,1.339156,103.766083
596957,1,11,12,1.339173,103.766168
596958,18,0,18,1.339173,103.766168
596959,9,3,12,1.339178,103.766293
596960,5,2,7,1.339176,103.766367
596961,2,3,5,1.339174,103.766442
596962,25,1,26,1.339172,103.766516
596963,0,10,10,1.33917,103.766591
596964,3,0,3,1.337938,103.765116
596965,1,3,4,1.338019,103.76557
596968,23,6,29,1.338231,103.766143
596969,7,0,7,1.337954,103.766182
596970,2,9,11,1.33823,103.766211
596971,3,0,3,1.339168,103.766666
596972,8,1,9,1.338294,103.766331
596973,0,3,3,1.33803,103.766235
596974,15,4,19,1.338358,103.76634
596975,42,1,43,1.338089,103.766339
596976,3,2,5,1.338485,103.766357
596977,6,8,14,1.338165,103.766408
596978,7,2,9,1.338612,103.766374
596979,7,0,7,1.338205,103.766431
596980,2,2,4,1.339334,103.7661
596981,1,4,5,1.338298,103.76648
596982,1,1,2,1.33806,103.765796
596983,27,2,29,1.338376,103.766501
596984,3,0,3,1.338053,103.76631
596985,2,3,5,1.338468,103.766487
596986,4,16,20,1.338504,103.766506
596987,0,4,4,1.338739,103.766392
596988,38,1,39,1.339172,103.766533
596989,2,5,7,1.33917,103.766582
596990,0,9,9,1.339169,103.76663
596991,9,7,16,1.339168,103.766679
596992,10,6,16,1.339167,103.766703
597001,202,0,202,1.318325,103.775346
597006,334,461,795,1.333859,103.759655
597007,6,6,12,1.330098,103.758623
597020,3,8,11,1.341947,103.774386
597021,10,2,12,1.342005,103.774373
597022,158,4,162,1.342119,103.774346
597023,3,5,8,1.341992,103.774396
597024,81,3,84,1.342234,103.774318
597025,0,15,15,1.342094,103.774372
597026,5,3,8,1.342348,103.774291
597027,0,1,1,1.338033,103.765645
597028,2,6,8,1.342463,103.774264
597029,6,0,6,1.342503,103.774275
597030,6,0,6,1.342707,103.774226
597031,6,3,9,1.342692,103.77421
597032,0,1,1,1.342299,103.774323
597033,0,4,4,1.339173,103.766485
597034,2,0,2,1.338866,103.766409
597035,0,2,2,1.343116,103.774129
597036,2,0,2,1.342921,103.774155
597037,18,6,24,1.343036,103.774128
597038,12,1,13,1.343524,103.774033
597039,3,0,3,1.33893,103.766418
597040,3,0,3,1.34315,103.774101
597041,0,1,1,1.342911,103.774178
597042,2,1,3,1.343728,103.773984
597043,9,2,11,1.34338,103.774047
597045,24,0,24,1.343494,103.77402
597046,1,2,3,1.343933,103.773936
597048,4,0,4,1.342807,103.774183
597049,2,0,2,1.34332,103.774081
597051,0,1,1,1.343265,103.774074
597052,4,4,8,1.344067,103.773884
597053,11,4,15,1.344182,103.773857
597054,1,0,1,1.343953,103.773911
597055,0,4,4,1.343964,103.774159
597056,0,2,2,1.343723,103.773965
597057,9,3,12,1.342413,103.774263
597071,1283,201,1484,1.323497,103.767503
597072,5,172,177,1.323738,103.768088
597073,2,80,82,1.323842,103.768003
597074,11,205,216,1.323604,103.767942
597075,27,539,566,1.323752,103.76764
597077,9,87,96,1.323794,103.767579
597079,2,30,32,1.323826,103.767508
597081,9,32,41,1.32389,103.767366
597083,21,36,57,1.323954,103.767224
597085,15,6,21,1.324018,103.767083
597086,922,159,1081,1.323928,103.767261
597087,130,74,204,1.324082,103.766941
597088,286,9,295,1.323461,103.766769
597089,0,13,13,1.324146,103.766799
597090,374,2,376,1.323673,103.766241
597092,368,30,398,1.324024,103.766291
597093,3,51,54,1.324273,103.766515
597095,38,23,61,1.324337,103.766373
597097,27,5,32,1.324401,103.766232
597098,1,6,7,1.324465,103.76609
597099,5,8,13,1.324529,103.765948
597100,5,0,5,1.324593,103.765806
597101,244,27,271,1.324718,103.765765
597102,10,9,19,1.324821,103.765752
597103,9,24,33,1.324795,103.76577
597104,3,2,5,1.324924,103.765758
597105,10,23,33,1.324873,103.765775
597106,11,2,13,1.325131,103.765772
597107,0,3,3,1.344239,103.773863
597108,33,9,42,1.325337,103.765785
597109,0,15,15,1.325182,103.765795
597110,64,38,102,1.325347,103.765795
597111,2,6,8,1.325327,103.765795
597112,130,3,133,1.325651,103.765808
597113,8,12,20,1.325359,103.765807
597114,11,58,69,1.325965,103.765831
597115,5,0,5,1.325865,103.765402
597116,70,2,72,1.32588,103.765176
597117,27,1,28,1.325859,103.765023
597118,43,11,54,1.325382,103.765808
597119,2,10,12,1.325975,103.765841
597120,195,1,196,1.326045,103.765423
597121,12,3,15,1.32606,103.765197
597122,15,40,55,1.326039,103.765044
597123,5,17,22,1.325427,103.765812
597124,4,11,15,1.326272,103.765868
597125,9,18,27,1.325472,103.765815
597126,126,28,154,1.326579,103.765906
597127,2,0,2,1.344437,103.773739
597128,149,0,149,1.326504,103.765182
597129,10,100,110,1.326509,103.765026
597130,5,21,26,1.325516,103.765818
597131,45,29,74,1.326705,103.765653
597132,17,0,17,1.326731,103.765512
597133,204,3,207,1.326734,103.765356
597134,4,0,4,1.344343,103.773786
597135,0,51,51,1.326742,103.765027
597136,23,16,39,1.326589,103.765916
597137,76,53,129,1.327112,103.766128
597138,25,16,41,1.327176,103.765546
597139,54,4,58,1.327179,103.76539
597140,12,12,24,1.327177,103.765192
597141,7,58,65,1.327187,103.765061
597142,55,16,71,1.327122,103.766138
597143,15,1,16,1.32743,103.765759
597144,91,8,99,1.327433,103.765603
597145,11,1,12,1.327434,103.765431
597146,17,6,23,1.327433,103.765248
597147,114,28,142,1.327594,103.765018
597148,66,231,297,1.32747,103.766348
597149,350,57,407,1.327708,103.766539
597150,579,22,601,1.328404,103.766421
597151,472,34,506,1.328465,103.765946
597152,761,3,764,1.32728,103.766826
597153,48,11,59,1.327907,103.765964
597154,310,61,371,1.327925,103.765225
597155,184,16,200,1.328009,103.765584
597156,178,39,217,1.32843,103.765462
597157,543,44,587,1.328531,103.765085
597158,3130,391,3521,1.328971,103.766524
597159,3609,286,3895,1.330817,103.766033
597173,3,2,5,1.324338,103.767881
597174,115,0,115,1.324289,103.768008
597175,9,0,9,1.32423,103.768145
597176,7,6,13,1.324348,103.767891
597177,7,1,8,1.324626,103.768008
597178,168,2,170,1.324893,103.768115
597192,170,4,174,1.324941,103.768315
597193,4,0,4,1.326732,103.765158
597195,27,12,39,1.325728,103.768625
597196,11,0,11,1.325225,103.768434
597197,72,1,73,1.325597,103.768409
597198,0,2,2,1.326489,103.765408
597199,41,3,44,1.325753,103.76847
597200,0,2,2,1.325414,103.768513
597201,0,1,1,1.344239,103.773843
597202,57,2,59,1.325791,103.768672
597203,19,0,19,1.326099,103.768663
597204,4,1,5,1.32598,103.768751
597205,25,5,30,1.326169,103.76883
597206,9,1,10,1.326358,103.76891
597207,17,1,18,1.326547,103.768989
597208,2,0,2,1.325602,103.768592
597209,1,6,7,1.326924,103.769148
597210,7,0,7,1.327113,103.769227
597211,6,2,8,1.327302,103.769307
597212,6,2,8,1.327481,103.769376
597213,4,5,9,1.327491,103.769386
597214,31,23,54,1.327501,103.769376
597215,29,2,31,1.327762,103.769495
597216,32,0,32,1.328032,103.769584
597217,58,2,60,1.328022,103.769594
597218,3,6,9,1.325067,103.768348
597219,152,1,153,1.299509,103.837
597231,84,3,87,1.328918,103.768922
597232,164,2,166,1.328918,103.768942
597233,47,3,50,1.329041,103.768766
597234,16,17,33,1.329041,103.768786
597235,6,0,6,1.329164,103.768609
597236,1,6,7,1.329221,103.768547
597237,3,1,4,1.325288,103.76844
597238,26,10,36,1.329428,103.768202
597239,26,16,42,1.329634,103.767857
597240,21,0,21,1.329752,103.76764
597241,14,6,20,1.329841,103.767512
597242,42,5,47,1.329831,103.767502
597243,3,2,5,1.329851,103.767502
597244,33,6,39,1.330134,103.767088
597245,28,30,58,1.329099,103.768831
597246,111,1,112,1.329427,103.768201
597247,80,1,81,1.330133,103.767087
597248,5,5,10,1.330133,103.767087
597249,11,82,93,1.330133,103.767087
597250,11,102,113,1.330133,103.767087
597251,6,18,24,1.330133,103.767087
597252,0,6,6,1.330133,103.767087
597258,0,7,7,1.32437,103.767822
597259,1,10,11,1.324416,103.767738
597260,10,0,10,1.324392,103.767773
597261,4,4,8,1.324484,103.767585
597262,38,5,43,1.324435,103.767674
597263,39,6,45,1.324619,103.767279
597264,6,11,17,1.324479,103.767576
597265,2,3,5,1.324755,103.766974
597266,3,0,3,1.325028,103.765785
597267,30,1,31,1.32489,103.766668
597268,37,2,39,1.324566,103.76738
597269,29,8,37,1.324958,103.766515
597270,61,3,64,1.325251,103.76649
597271,0,1,1,1.325955,103.768606
597272,54,7,61,1.325587,103.766516
597273,7,0,7,1.324697,103.767085
597274,0,1,1,1.324653,103.767183
597275,13,0,13,1.324784,103.766888
597276,7,3,10,1.324827,103.76679
597277,30,1,31,1.324871,103.766692
597278,17,14,31,1.324914,103.766593
597279,5,5,10,1.324958,103.766495
597280,1,5,6,1.325051,103.76647
597281,0,1,1,1.32474,103.766986
597282,10,0,10,1.325251,103.76647
597283,13,0,13,1.325412,103.766482
597284,4,0,4,1.329398,103.768231
597285,34,11,45,1.325597,103.766506
597299,108,5,113,1.325597,103.766526
597300,30,8,38,1.325782,103.766613
597302,4,0,4,1.325536,103.766498
597303,1,11,12,1.326142,103.766564
597304,108,1,109,1.326113,103.766797
597305,129,0,129,1.326287,103.766663
597306,1,0,1,1.325184,103.76647
597307,2,2,4,1.325782,103.766613
597308,4,2,6,1.326597,103.767073
597309,26,0,26,1.326618,103.766861
597310,2,0,2,1.326736,103.769069
597311,43,2,45,1.327082,103.76735
597312,18,4,22,1.326785,103.766946
597313,19,5,24,1.327324,103.767488
597314,5,2,7,1.326952,103.767036
597315,26,3,29,1.327435,103.767547
597316,6,1,7,1.327102,103.767138
597317,143,0,143,1.327461,103.767956
597318,52,0,52,1.327288,103.76723
597319,34,22,56,1.327511,103.767601
597320,68,3,71,1.327444,103.767321
597321,20,1,21,1.32771,103.767609
597322,21,6,27,1.327511,103.767581
597323,41,4,45,1.32806,103.767578
597324,9,1,10,1.32771,103.767589
597325,5,5,10,1.328235,103.767563
597326,6,6,12,1.32806,103.767558
597327,28,7,35,1.328902,103.767555
597328,81,8,89,1.328225,103.767553
597329,1,0,1,1.326355,103.766935
597330,7,3,10,1.328245,103.767553
597331,14,3,17,1.328564,103.767544
597332,4,7,11,1.328892,103.767545
597333,3,7,10,1.329011,103.767538
597334,3,1,4,1.32647,103.766765
597335,14,9,23,1.329366,103.767518
597336,9,11,20,1.329604,103.767505
597337,16,19,35,1.329831,103.767502
597351,39,9,48,1.325223,103.767728
597352,51,1,52,1.325206,103.767698
597353,7,5,12,1.325335,103.76779
597354,15,4,19,1.3253,103.767751
597355,59,1,60,1.325557,103.767914
597356,3,1,4,1.329129,103.767532
597357,64,2,66,1.32578,103.768038
597358,1,0,1,1.329841,103.767512
597359,1,1,2,1.32684,103.767212
597360,31,1,32,1.325865,103.768066
597361,47,8,55,1.326225,103.768286
597362,22,0,22,1.326447,103.76841
597363,1,9,10,1.326242,103.768276
597364,52,3,55,1.32667,103.768534
597365,15,83,98,1.32643,103.76838
597366,4,0,4,1.325489,103.767856
597367,28,1,29,1.326618,103.768485
597368,6,3,9,1.327115,103.768782
597369,1,0,1,1.325677,103.767961
597370,0,1,1,1.326807,103.76859
597371,20,0,20,1.326995,103.768695
597372,29,2,31,1.32756,103.76903
597373,63,1,64,1.327183,103.7688
597374,78,7,85,1.32759,103.769097
597375,48,9,57,1.327491,103.769366
597376,4,0,4,1.326892,103.768658
597390,1,0,1,1.327337,103.768906
597391,1,3,4,1.327501,103.769376
597392,37,0,37,1.32557,103.767141
597393,57,14,71,1.32562,103.76719
597394,21,4,25,1.325769,103.767258
597395,4,3,7,1.325869,103.767336
597396,73,2,75,1.325969,103.767374
597397,66,0,66,1.326119,103.767481
597398,1,0,1,1.32547,103.767083
597399,61,0,61,1.326368,103.767626
597400,41,1,42,1.326618,103.767772
597401,13,12,25,1.326568,103.767723
597402,0,1,1,1.326169,103.76749
597403,2,12,14,1.326768,103.767839
597404,3,0,3,1.324522,103.767478
597405,1,1,2,1.326002,103.768162
597406,2,1,3,1.327117,103.768063
597407,0,1,1,1.326868,103.767917
597408,3,4,7,1.327471,103.768274
597409,1,2,3,1.327357,103.768198
597410,8,0,8,1.327574,103.76834
597411,49,0,49,1.327496,103.76827
597412,1,1,2,1.326968,103.767955
597413,0,1,1,1.327167,103.768072
597414,25,1,26,1.328143,103.768707
597415,13,13,26,1.3284,103.768897
597416,92,6,98,1.3284,103.768897
597417,19,0,19,1.328623,103.769044
597418,89,9,98,1.328795,103.769079
597419,1,7,8,1.328785,103.769089
597420,49,4,53,1.328744,103.769223
597421,207,16,223,1.328785,103.769089
597422,53,2,55,1.328693,103.769348
597423,120,3,123,1.32859,103.769576
597424,10,4,14,1.32859,103.769596
597425,0,1,1,1.327885,103.768517
597426,19,3,22,1.328488,103.769844
597427,1,0,1,1.328386,103.770073
597428,4,2,6,1.32873,103.768994
597441,6,1,7,1.325327,103.765795
597442,7,0,7,1.325339,103.765784
597443,1,0,1,1.328396,103.770083
597444,15,1,16,1.325537,103.765159
597445,1,4,5,1.325406,103.764782
597446,17,19,36,1.325537,103.764967
597448,186,4,190,1.325376,103.765278
597449,6,0,6,1.325376,103.765278
597461,44,10,54,1.324903,103.768105
597462,79,0,79,1.324913,103.768115
597463,3,6,9,1.325008,103.767876
597464,48,7,55,1.325008,103.767896
597465,15,5,20,1.325102,103.767656
597466,22,8,30,1.325112,103.767666
597467,2,0,2,1.327626,103.768352
597468,8,7,15,1.325122,103.767656
597469,14,14,28,1.325241,103.767336
597470,4,7,11,1.32537,103.767045
597471,25,4,29,1.32536,103.767035
597472,10,8,18,1.32538,103.767035
597473,58,8,66,1.325483,103.766786
597474,1,4,5,1.32537,103.767025
597475,16,13,29,1.325597,103.766526
597476,116,19,135,1.325587,103.766516
597490,64,2,66,1.328245,103.767553
597491,3,0,3,1.327367,103.768188
597492,158,1,159,1.32864,103.768227
597493,19,3,22,1.32826,103.76798
597494,3,3,6,1.32864,103.768227
597495,27,0,27,1.328358,103.768149
597496,30,3,33,1.328858,103.767987
597497,30,2,32,1.32863,103.768237
597498,0,2,2,1.325112,103.767646
597499,7,1,8,1.328588,103.768225
597500,2,0,2,1.328882,103.767555
597501,15,1,16,1.328997,103.768092
597502,32,3,35,1.329131,103.767909
597503,3,4,7,1.32889,103.76789
597516,2,0,2,1.328378,103.768149
597517,1,0,1,1.325376,103.765278
597518,40,2,42,1.324735,103.765444
597519,1,4,5,1.324762,103.765153
597520,4,5,9,1.324742,103.765153
597521,59,0,59,1.324909,103.765146
597522,1,1,2,1.324708,103.765755
597523,3,12,15,1.324835,103.76514
597524,1,1,2,1.324568,103.765735
597525,4,2,6,1.324752,103.765143
597526,18,5,23,1.324477,103.765656
597527,46,15,61,1.32469,103.765144
597528,4,7,11,1.324628,103.765145
597529,8,1,9,1.32436,103.765595
597530,1,28,29,1.324505,103.765148
597531,22,10,32,1.324302,103.765565
597532,50,44,94,1.324408,103.765162
597533,44,1,45,1.324243,103.765534
597534,20,0,20,1.324341,103.76523
597535,161,2,163,1.324185,103.765504
597537,20,0,20,1.324175,103.765494
597538,7,4,11,1.324185,103.765484
597539,31,2,33,1.323922,103.765415
597553,72,465,537,1.346712,103.763783
597554,0,3,3,1.328242,103.767766
597555,1,0,1,1.324728,103.765755
597556,63,1,64,1.34615,103.764396
597557,8,8,16,1.346564,103.763911
597559,2,1,3,1.346141,103.764371
597561,2,2,4,1.325495,103.767118
597562,8,1,9,1.346365,103.764061
597563,3,32,35,1.346317,103.764143
597564,38,0,38,1.346317,103.764163
597565,3,2,5,1.346328,103.76424
597566,3,0,3,1.346464,103.763996
597567,3,30,33,1.346372,103.764367
597568,3,0,3,1.346328,103.76426
597570,0,3,3,1.346372,103.764387
597571,7,222,229,1.34646,103.76462
597572,4,3,7,1.34646,103.76464
597573,41,0,41,1.346504,103.764746
597574,30,1,31,1.346504,103.764766
597575,1,319,320,1.346548,103.764873
597576,2,3,5,1.346538,103.764883
597590,1066,1578,2644,1.318027,103.776704
597591,443,190,633,1.317563,103.776476
597592,1059,1292,2351,1.318438,103.776711
597593,958,218,1176,1.316962,103.774947
597594,1298,333,1631,1.31651,103.775414
597595,1069,177,1246,1.316702,103.77598
597596,20,3,23,1.318147,103.773982
597610,164,291,455,1.338081,103.77613
597611,57,10,67,1.338288,103.775658
597625,991,2312,3303,1.319788,103.777777
597626,2010,2676,4686,1.320431,103.778992
597627,2554,864,3418,1.319938,103.779565
597628,2996,459,3455,1.318799,103.779025
597629,1161,258,1419,1.319021,103.77793
597630,711,663,1374,1.31831,103.777705
597631,647,531,1178,1.318667,103.778071
597645,3,232,235,1.328639,103.75716
597646,6,4,10,1.329076,103.756662
597647,44,73,117,1.329305,103.756454
597648,8,6,14,1.329432,103.755951
597649,2,43,45,1.3315,103.756161
597651,1,27,28,1.330839,103.756397
597652,269,0,269,1.332274,103.756247
597653,12,73,85,1.330962,103.756632
597654,57,484,541,1.332536,103.758497
597655,5,195,200,1.332273,103.757684
597656,8,4,12,1.330693,103.751546
597657,14,227,241,1.334213,103.758832
597658,188,550,738,1.331189,103.757094
597664,2,802,804,1.346894,103.765399
597665,1,99,100,1.346123,103.76555
597666,1,293,294,1.346089,103.765232
597667,1,18,19,1.346254,103.765815
597668,2,18,20,1.346309,103.7659
597682,5,288,293,1.331782,103.765192
597696,3,1,4,1.346365,103.764081
597697,1,1,2,1.324538,103.765709
597698,0,2,2,1.342153,103.772036
597699,1,0,1,1.346663,103.763825
597701,1,2,3,1.346416,103.764513
597702,0,1,1,1.34236,103.771997
597703,1,0,1,1.342757,103.772036
597704,131,2,133,1.342997,103.772023
597705,1,0,1,1.342837,103.772032
597706,2,1,3,1.342657,103.772048
597708,9,0,9,1.343402,103.772038
597709,1,1,2,1.342231,103.772013
597710,4,0,4,1.342748,103.771843
597711,2,0,2,1.343524,103.772051
597712,25,0,25,1.343848,103.772081
597714,37,1,38,1.344001,103.772129
597715,118,1,119,1.344114,103.772171
597716,15,1,16,1.344228,103.772213
597717,28,2,30,1.344341,103.772255
597718,2,0,2,1.343769,103.772075
597719,20,10,30,1.3448,103.772389
597733,2,0,2,1.344351,103.772265
597734,0,6,6,1.342991,103.773573
597738,0,1,1,1.343152,103.772022
597739,1,1,2,1.342991,103.773553
597740,0,4,4,1.343647,103.772063
597741,29,1,30,1.343009,103.773244
597743,6,6,12,1.343016,103.773158
597744,8,2,10,1.343016,103.773133
597745,19,0,19,1.343011,103.77322
597747,4,1,5,1.343037,103.772988
597748,0,12,12,1.34303,103.773062
597749,4,9,13,1.343048,103.772904
597751,8,2,10,1.343058,103.772819
597752,12,2,14,1.34305,103.772904
597753,3,4,7,1.343068,103.772734
597754,3,0,3,1.343218,103.77202
597755,0,1,1,1.342999,103.773441
597756,203,4,207,1.343069,103.772746
597759,1,1,2,1.343004,103.773332
597760,1,0,1,1.343079,103.772649
597761,1,2,3,1.34306,103.772825
597762,7,3,10,1.343099,103.772508
597765,5,0,5,1.343131,103.772226
597768,10,0,10,1.343128,103.772271
597769,37,2,39,1.343152,103.772056
597770,4,1,5,1.343138,103.772192
597771,12,1,13,1.343155,103.772032
597772,2,1,3,1.34311,103.772395
597773,2,2,4,1.343004,103.773352
597787,2,12,14,1.34409,103.773258
597788,0,3,3,1.343147,103.772113
597789,1,0,1,1.343089,103.772587
597790,4,3,7,1.344156,103.773
597791,1,2,3,1.344103,103.773207
597792,1,0,1,1.34413,103.773103
597793,6,0,6,1.344209,103.772793
597794,5,2,7,1.344235,103.772689
597795,1,3,4,1.343158,103.772029
597797,7,0,7,1.34419,103.772846
597798,3,0,3,1.344183,103.772896
597799,0,6,6,1.344228,103.772699
597800,18,1,19,1.344315,103.772378
597801,32,0,32,1.344266,103.772551
597802,2,4,6,1.344341,103.772275
597803,20,0,20,1.344303,103.772403
597804,5,0,5,1.344331,103.772265
597818,4,11,15,1.34246,103.773711
597819,3,3,6,1.34246,103.773731
597820,1,0,1,1.344096,103.773216
597821,10,0,10,1.342462,103.773689
597823,1,1,2,1.3431,103.77248
597828,9,13,22,1.342482,103.773334
597829,0,1,1,1.342462,103.773669
597830,16,0,16,1.342487,103.77325
597832,19,4,23,1.342492,103.773167
597833,17,11,28,1.342492,103.773187
597835,1,0,1,1.342482,103.773354
597836,1,2,3,1.344288,103.772482
597837,2,4,6,1.342502,103.773019
597838,63,1,64,1.342507,103.772915
597839,1,0,1,1.342497,103.773103
597840,4,0,4,1.344152,103.772994
597844,2,0,2,1.342467,103.773606
597845,1,0,1,1.342507,103.772936
597846,1,1,2,1.342522,103.772664
597847,8,3,11,1.342527,103.7726
597848,0,1,1,1.342522,103.772684
597849,127,0,127,1.342532,103.772517
597850,0,5,5,1.342537,103.772413
597851,1,3,4,1.342512,103.772832
597852,2,1,3,1.342502,103.772999
597853,0,2,2,1.342527,103.77258
597854,0,1,1,1.342532,103.772497
597855,0,4,4,1.342537,103.772433
597856,0,10,10,1.342552,103.772162
597858,2,3,5,1.342553,103.772099
597860,1,0,1,1.342547,103.772246
597861,0,4,4,1.342547,103.772266
597867,8,5,13,1.342709,103.771622
597868,17,1,18,1.342659,103.771685
597869,1,0,1,1.342567,103.772024
597870,9,3,12,1.342709,103.771598
597871,3,1,4,1.342576,103.771998
597875,2,0,2,1.342542,103.772349
597876,1,0,1,1.342835,103.771472
597877,5,1,6,1.343452,103.771525
597878,4,5,9,1.343033,103.771438
597879,105,0,105,1.34362,103.77155
597880,0,2,2,1.343284,103.7715
597881,16,0,16,1.343787,103.771575
597883,1,2,3,1.342542,103.772329
597884,20,1,21,1.343338,103.771484
597885,3,1,4,1.342933,103.771457
597886,44,0,44,1.343439,103.771499
597887,8,1,9,1.34429,103.771651
597889,13,1,14,1.344458,103.771676
597890,0,2,2,1.343135,103.771453
597892,5,0,5,1.343744,103.771545
597893,19,1,20,1.344803,103.77168
597894,14,0,14,1.343846,103.77156
597895,66,1,67,1.344898,103.771589
597896,1,0,1,1.342933,103.771433
597897,0,1,1,1.343947,103.771575
597898,8,0,8,1.34415,103.771606
597900,10,3,13,1.344353,103.771637
597901,23,1,24,1.344455,103.771652
597902,2,3,5,1.344557,103.771667
597903,1,0,1,1.344049,103.771591
597904,3,1,4,1.344122,103.771626
597906,2,1,3,1.343955,103.771601
597920,0,18,18,1.341983,103.773889
597921,1,0,1,1.344658,103.771682
597922,2,0,2,1.343642,103.77153
597923,60,2,62,1.342246,103.773822
597924,8,7,15,1.342352,103.773796
597925,67,0,67,1.342457,103.773769
597926,1,1,2,1.342141,103.773849
597928,3,0,3,1.344888,103.771575
597929,3,1,4,1.344803,103.771656
597930,5,2,7,1.34304,103.773604
597931,0,1,1,1.342035,103.773875
597932,7,0,7,1.343193,103.773563
597933,12,0,12,1.343296,103.773537
597934,1,0,1,1.343091,103.77359
597935,1,0,1,1.343398,103.77351
597936,6,2,8,1.343575,103.773474
597937,30,1,31,1.34365,103.773466
597938,3,2,5,1.343725,103.773457
597939,2,0,2,1.342546,103.773744
597940,3,0,3,1.342812,103.773668
597941,4,0,4,1.342989,103.773617
597942,204,3,207,1.344177,103.773269
597943,4,0,4,1.344077,103.77331
597944,7,0,7,1.344463,103.773156
597945,32,11,43,1.344631,103.773188
597959,2,0,2,1.343886,103.773401
597960,1,0,1,1.3435,103.773483
597961,19,2,21,1.343525,103.773315
597962,1,0,1,1.343512,103.773389
597963,1,0,1,1.343537,103.773241
597964,0,1,1,1.34355,103.773168
597966,13,4,17,1.343589,103.772945
597968,2,0,2,1.343506,103.773426
597969,2,0,2,1.34362,103.772794
597970,0,2,2,1.343636,103.772718
597971,8,0,8,1.343667,103.772567
597972,63,2,65,1.343683,103.772491
597973,3,0,3,1.344013,103.77334
597976,2,0,2,1.343652,103.772642
597977,4,3,7,1.343581,103.773003
597978,133,2,135,1.34373,103.772264
597979,7,0,7,1.343635,103.772744
597981,2,1,3,1.34384,103.772603
597982,7,3,10,1.343761,103.772113
597983,3,0,3,1.343688,103.772484
597984,3,2,5,1.343759,103.772085
597985,0,4,4,1.344277,103.773228
597999,12,102,114,1.338668,103.771615
598000,1,15,16,1.338734,103.771473
598001,323,19,342,1.318325,103.775346
598003,0,5,5,1.338865,103.771188
598004,6,11,17,1.338911,103.770862
598005,3,5,8,1.338773,103.770801
598006,4,0,4,1.343779,103.772085
598007,0,3,3,1.343742,103.772225
598008,396,26,422,1.33806,103.769875
598009,0,8,8,1.337887,103.770376
598010,387,14,401,1.337924,103.770373
598012,1,3,4,1.338478,103.770659
598013,23,17,40,1.3376,103.770213
598014,24,5,29,1.337599,103.770201
598015,0,12,12,1.337596,103.770178
598017,4,2,6,1.337592,103.770133
598018,3,0,3,1.338182,103.770518
598020,2,8,10,1.337717,103.769346
598021,3,0,3,1.337814,103.769503
598022,0,5,5,1.337748,103.769231
598023,2,0,2,1.343714,103.77234
598024,1,11,12,1.337688,103.769126
598025,41,1,42,1.337569,103.770101
598027,2,0,2,1.337763,103.769187
598028,12,7,19,1.337507,103.769485
598029,7,0,7,1.337483,103.769238
598030,4,0,4,1.338015,103.769342
598035,1,0,1,1.343562,103.773094
598041,2,6,8,1.337266,103.767875
598042,14,200,214,1.336977,103.767426
598044,2,0,2,1.337532,103.769731
598045,22,0,22,1.336433,103.767478
598047,6,1,7,1.336433,103.767478
598049,4,1,5,1.336099,103.767482
598050,0,1,1,1.337377,103.768476
598051,7,0,7,1.335577,103.767568
598052,1,0,1,1.33609,103.767493
598053,2,0,2,1.336433,103.767478
598054,0,3,3,1.33778,103.76929
598055,12,3,15,1.336056,103.767381
598056,4,0,4,1.337458,103.768992
598057,21,0,21,1.336031,103.767279
598058,3,0,3,1.335576,103.767567
598060,9,2,11,1.335982,103.767074
598063,0,1,1,1.335576,103.767567
598065,9,1,10,1.336268,103.767385
598066,3,0,3,1.33603,103.767278
598067,7,3,10,1.336723,103.767319
598068,101,65,166,1.336934,103.767266
598069,15,0,15,1.33695,103.766942
598070,2,19,21,1.3369,103.766763
598071,1,0,1,1.335885,103.766666
598072,4,4,8,1.336843,103.766481
598073,26,2,28,1.336721,103.766259
598074,5,8,13,1.336805,103.76593
598075,10,1,11,1.336793,103.765971
598076,2,0,2,1.335576,103.767567
598077,34,2,36,1.33678,103.765905
598078,7,2,9,1.336781,103.765807
598079,49,13,62,1.336767,103.76584
598080,2,0,2,1.336797,103.765889
598081,2,0,2,1.336765,103.765725
598082,1,2,3,1.336489,103.767357
598083,6,1,7,1.336716,103.765578
598084,8,0,8,1.336732,103.765562
598085,4,2,6,1.33669,103.765447
598086,1,0,1,1.336868,103.766629
598087,0,2,2,1.336741,103.765709
598088,1,0,1,1.336716,103.76548
598089,4,0,4,1.336055,103.76738
598090,1,0,1,1.3367,103.765398
598091,20,2,22,1.336674,103.765245
598092,9,1,10,1.336664,103.765175
598093,0,1,1,1.336679,103.765281
598095,2,0,2,1.336587,103.765379
598096,1,0,1,1.336654,103.765104
598097,2,16,18,1.336613,103.764821
598098,19,3,22,1.336603,103.76475
598101,4,1,5,1.335982,103.767074
598102,2,2,4,1.336684,103.765316
598103,21,0,21,1.335982,103.767074
598104,5,0,5,1.335982,103.767074
598105,2,3,5,1.336976,103.767425
598106,7,1,8,1.336976,103.767425
598107,2,0,2,1.336634,103.764962
598108,7,1,8,1.336976,103.767425
598109,1,1,2,1.336976,103.767425
598110,6,1,7,1.335982,103.767074
598111,1,3,4,1.335982,103.767074
598112,498,5,503,1.337385,103.766768
598113,7,2,9,1.299509,103.837
598114,17,50,67,1.341057,103.773984
598115,10,69,79,1.341046,103.773607
598116,4,0,4,1.335982,103.767074
598118,16,23,39,1.341055,103.773366
598119,10,32,42,1.341053,103.773291
598120,169,8,177,1.340965,103.773614
598121,2,3,5,1.341055,103.773221
598122,4,15,19,1.341055,103.773221
598123,323,2,325,1.340981,103.773134
598124,4,9,13,1.341057,103.773152
598125,0,6,6,1.341065,103.773078
598126,21,9,30,1.341039,103.772851
598127,5,1,6,1.341066,103.773001
598128,61,44,105,1.341261,103.772639
598129,4,46,50,1.341102,103.772884
598130,0,12,12,1.341182,103.772721
598131,2,10,12,1.341271,103.772649
598132,49,10,59,1.341271,103.772629
598133,2,2,4,1.341051,103.773531
598134,7,3,10,1.341373,103.772507
598136,1,3,4,1.341281,103.772639
598137,0,9,9,1.341475,103.772406
598139,125,41,166,1.340935,103.774176
598152,26,0,26,1.336083,103.765492
598153,1,1,2,1.335982,103.767074
598154,0,1,1,1.336623,103.764892
598155,4,0,4,1.341407,103.772487
598156,3,0,3,1.336749,103.765644
598158,66,7,73,1.336133,103.765746
598159,1,1,2,1.336613,103.765318
598160,1,0,1,1.336093,103.765543
598161,6,0,6,1.336185,103.765406
598162,22,0,22,1.336173,103.765949
598163,6,1,7,1.336063,103.765431
598164,9,4,13,1.335884,103.765477
598166,0,1,1,1.336153,103.765848
598167,19,3,22,1.336233,103.766254
598168,2,0,2,1.336307,103.765381
598169,1,0,1,1.336064,103.765499
598170,1,0,1,1.336099,103.765673
598171,0,1,1,1.336122,103.765789
598172,41,0,41,1.336167,103.766022
598173,15,1,16,1.33619,103.766138
598174,13,0,13,1.336213,103.766254
598175,3,0,3,1.336113,103.765644
598176,0,14,14,1.335883,103.765476
598177,1,0,1,1.336144,103.765906
598178,2,0,2,1.336076,103.765557
598179,18,1,19,1.335883,103.765476
598180,20,0,20,1.299509,103.837
598188,5,8,13,1.335031,103.77086
598189,1,1,2,1.335883,103.765476
598191,3,1,4,1.336552,103.765331
598192,4,0,4,1.335042,103.771152
598193,0,2,2,1.335033,103.770919
598195,2,2,4,1.335046,103.771189
598196,2,1,3,1.335883,103.765476
598197,5,2,7,1.335084,103.771519
598198,23,6,29,1.335071,103.771232
598199,2,0,2,1.33505,103.771225
598200,38,1,39,1.33508,103.771311
598201,3,7,10,1.335097,103.771629
598202,1,1,2,1.335093,103.771592
598203,4,4,8,1.335108,103.7717
598204,16,3,19,1.335117,103.771629
598205,1,2,3,1.335076,103.771446
598206,1,0,1,1.335883,103.765476
598207,10,0,10,1.335129,103.771841
598208,14,0,14,1.335166,103.771958
598209,2,0,2,1.335099,103.77147
598210,0,2,2,1.335139,103.771911
598211,1,12,13,1.33515,103.771982
598212,0,1,1,1.335142,103.771794
598214,17,4,21,1.335326,103.772387
598215,2,0,2,1.335191,103.772123
598216,39,2,41,1.335376,103.772455
598217,4,0,4,1.335067,103.771372
598218,20,1,21,1.335477,103.772591
598219,8,0,8,1.33525,103.772305
598220,25,5,30,1.335567,103.772717
598221,114,0,114,1.335278,103.772346
598222,0,1,1,1.33522,103.772218
598223,75,2,77,1.335278,103.772346
598224,0,1,1,1.335628,103.772785
598225,8,0,8,1.335352,103.772449
598226,4,0,4,1.3352,103.772218
598227,4,3,7,1.335397,103.772511
598228,49,2,51,1.33587,103.773067
598229,7,1,8,1.335443,103.772572
598230,5,2,7,1.335919,103.77313
598231,0,2,2,1.335171,103.772123
598233,6,3,9,1.335534,103.772696
598234,0,1,1,1.335678,103.772844
598235,4,2,6,1.335557,103.772727
598236,2,0,2,1.335489,103.772634
598238,1,0,1,1.336035,103.773288
598239,0,2,2,1.336113,103.773394
598241,2,5,7,1.335708,103.772902
598242,0,1,1,1.33619,103.773499
598243,4,1,5,1.335784,103.77299
598244,1,0,1,1.336345,103.77371
598245,62,6,68,1.33586,103.773077
598247,1,5,6,1.33595,103.7732
598248,7,2,9,1.336595,103.774035
598249,13,1,14,1.336041,103.773323
598250,19,4,23,1.336657,103.774115
598251,3,0,3,1.335118,103.77177
598252,4,3,7,1.336709,103.774185
598253,4,0,4,1.335779,103.77296
598254,44,10,54,1.336813,103.774324
598255,2,8,10,1.336413,103.773826
598256,1,4,5,1.336917,103.774464
598257,42,2,44,1.336494,103.77393
598258,57,16,73,1.337087,103.774539
598259,0,1,1,1.336413,103.773806
598260,2,9,11,1.337182,103.77457
598261,0,2,2,1.335633,103.772815
598262,0,3,3,1.336222,103.77357
598263,0,14,14,1.336793,103.774324
598264,16,2,18,1.3375,103.774394
598265,5,3,8,1.337633,103.77428
598266,221,48,269,1.33661,103.77525
598267,4,1,5,1.337755,103.774177
598268,123,19,142,1.336893,103.775622
598269,7,21,28,1.337243,103.775978
598283,10,4,14,1.335984,103.780404
598284,49,11,60,1.335728,103.780162
598285,3,3,6,1.335549,103.780393
598286,3,3,6,1.33528,103.78046
598287,4,0,4,1.336403,103.773816
598288,12,5,17,1.333873,103.780653
598289,34,1,35,1.333734,103.7803
598290,20,43,63,1.33319,103.780028
598292,206,800,1006,1.336963,103.779214
598293,24,25,49,1.336151,103.779488
598294,91,415,506,1.336378,103.778815
598295,26,7,33,1.335282,103.779172
598296,2,0,2,1.336689,103.774185
598297,12,3,15,1.335423,103.778718
598298,119,63,182,1.33482,103.778948
598299,4,2,6,1.334739,103.779535
598300,0,7,7,1.33452,103.78016
598301,3,8,11,1.334344,103.780342
598302,4,3,7,1.333851,103.779916
598303,13,0,13,1.33387,103.779542
598304,72,1,73,1.333997,103.77936
598305,193,8,201,1.33455,103.779336
598306,9,48,57,1.333739,103.778752
598307,4,14,18,1.333308,103.778685
598308,1,107,108,1.333264,103.77848
598309,27,4,31,1.333283,103.778853
598310,89,0,89,1.333282,103.778852
598311,8,1,9,1.333282,103.778852
598312,119,14,133,1.333251,103.779646
598313,8,1,9,1.333544,103.77965
598314,3,4,7,1.333645,103.778868
598315,23,13,36,1.333121,103.779631
598316,12,0,12,1.332625,103.78038
598318,59,0,59,1.33234,103.7788
598319,30,11,41,1.332741,103.779523
598320,37,0,37,1.332859,103.7791
598321,1,6,7,1.333273,103.778843
598322,2,2,4,1.334797,103.780545
598323,22,4303,4325,1.332409,103.778454
598324,6,1,7,1.334517,103.779531
598325,4,2,6,1.334267,103.77935
598326,946,2150,3096,1.336723,103.779833
598327,18,0,18,1.33249,103.779402
598328,0,3,3,1.337368,103.774507
598329,415,3,418,1.332468,103.78017
598330,24,1,25,1.33248,103.779412
598331,10,0,10,1.299509,103.837
598332,15,488,503,1.336619,103.779219
598333,36,10,46,1.299509,103.837
598335,14,1,15,1.299509,103.837
598353,2,0,2,1.335066,103.779612
598354,8,4,12,1.345376,103.767103
598368,428,158,586,1.342994,103.768736
598371,18,15,33,1.34364,103.768367
598372,35,1,36,1.343704,103.768316
598373,13,4,17,1.344116,103.768201
598374,9,2,11,1.343826,103.768279
598375,3,1,4,1.333211,103.778491
598376,1,3,4,1.34422,103.768146
598377,74,3,77,1.343936,103.7682
598378,0,2,2,1.345923,103.767479
598379,5,1,6,1.34404,103.768148
598380,162,5,167,1.344632,103.767901
598382,49,2,51,1.344672,103.767833
598384,3,6,9,1.344833,103.767725
598385,78,0,78,1.34453,103.767797
598386,15,2,17,1.344902,103.767639
598388,19,6,25,1.345039,103.76748
598390,0,4,4,1.344315,103.768092
598392,2,2,4,1.345108,103.76744
598393,0,7,7,1.345405,103.766975
598394,81,3,84,1.345466,103.766918
598395,6,0,6,1.345587,103.766803
598396,8,5,13,1.345709,103.766688
598397,166,1,167,1.345831,103.766572
598398,0,3,3,1.332181,103.778956
598399,1,0,1,1.336585,103.774045
598400,24,7,31,1.346186,103.766237
598401,4,1,5,1.344622,103.767708
598402,4,3,7,1.343762,103.768305
598403,3,0,3,1.345953,103.766457
598404,0,1,1,1.346074,103.766342
598405,1,0,1,1.299509,103.837
598415,0,3,3,1.344134,103.768106
598416,34,210,244,1.341214,103.774522
598417,44,3,47,1.341421,103.774502
598418,2,20,22,1.340732,103.77466
598429,174,118,292,1.343615,103.768853
598431,345,65,410,1.343499,103.768888
598433,519,68,587,1.343218,103.768146
598434,1000,41,1041,1.343089,103.767917
598435,260,30,290,1.343826,103.768834
598436,228,278,506,1.343597,103.768978
598448,5,2,7,1.345689,103.765699
598449,43,1,44,1.345622,103.76562
598450,15,0,15,1.345486,103.765464
598451,2,1,3,1.299509,103.837
598452,6,2,8,1.345341,103.765297
598453,2,15,17,1.345072,103.764978
598454,132,2,134,1.345075,103.764881
598455,24,5,29,1.345284,103.765252
598456,32,2,34,1.345238,103.765197
598457,1,8,9,1.345145,103.765088
598458,15,4,19,1.345062,103.764988
598468,15,105,120,1.343252,103.767898
598469,12,47,59,1.343252,103.767918
598470,2,0,2,1.344392,103.768049
598471,0,1,1,1.343838,103.768247
598472,125,0,125,1.343502,103.767726
598473,2,3,5,1.343502,103.767746
598474,79,3,82,1.343668,103.767611
598475,2,1,3,1.345351,103.765307
598476,2,4,6,1.343748,103.76755
598477,15,2,17,1.343748,103.76757
598478,3,21,24,1.343894,103.767426
598479,63,8,71,1.343894,103.767446
598480,15,1,16,1.344031,103.767324
598481,13,12,25,1.344168,103.767182
598482,3,0,3,1.343668,103.767631
598483,11,1,12,1.344304,103.76706
598484,1,2,3,1.344168,103.767202
598485,6,4,10,1.344442,103.766937
598486,114,12,126,1.344442,103.766957
598487,0,2,2,1.343335,103.76784
598488,2,1,3,1.344304,103.76708
598489,1,1,2,1.344578,103.766815
598490,5,2,7,1.344716,103.766713
598491,5,0,5,1.344774,103.766642
598492,2,18,20,1.344784,103.766652
598493,2,1,3,1.344578,103.766835
598494,18,10,28,1.344853,103.76659
598495,15,1,16,1.344922,103.766508
598496,10,6,16,1.344922,103.766528
598497,0,4,4,1.345179,103.767156
598498,79,3,82,1.345059,103.766405
598499,21,14,35,1.345197,103.766261
598500,1,2,3,1.344853,103.76657
598501,0,2,2,1.344716,103.766693
598502,0,2,2,1.345334,103.766138
598503,1,1,2,1.345334,103.766158
598504,0,1,1,1.343335,103.76786
598505,39,1,40,1.345609,103.765891
598506,0,1,1,1.345472,103.766034
598507,0,9,9,1.345737,103.765777
598508,18,7,25,1.345747,103.765787
598509,30,1,31,1.343638,103.767652
598510,6,1,7,1.344031,103.767304
598511,1,1,2,1.345472,103.766014
598513,4,1,5,1.299509,103.837
598522,158,8,166,1.34296,103.767465
598523,162,86,248,1.343017,103.767394
598524,3,11,14,1.343017,103.767414
598525,0,1,1,1.345609,103.765911
598526,0,1,1,1.343131,103.767312
598527,3,0,3,1.345197,103.766281
598528,3,4,7,1.34336,103.767108
598529,8,0,8,1.343806,103.766689
598530,59,1,60,1.343474,103.767005
598532,32,3,35,1.34377,103.766647
598533,10,1,11,1.343702,103.766801
598534,26,4,30,1.343734,103.766606
598535,0,3,3,1.343588,103.766883
598536,12,15,27,1.343816,103.766699
598537,2,0,2,1.345058,103.766384
598538,22,0,22,1.343816,103.766679
598539,18,1,19,1.343588,103.766438
598541,2,1,3,1.343732,103.766604
598542,0,1,1,1.343245,103.76721
598543,16,16,32,1.344253,103.766223
598544,66,3,69,1.344372,103.766202
598545,1,1,2,1.343661,103.766522
598546,73,2,75,1.344446,103.766134
598547,8,1,9,1.34415,103.766112
598548,25,1,26,1.344595,103.765998
598549,4,0,4,1.345059,103.766385
598550,42,1,43,1.34408,103.766037
598551,11,3,14,1.344744,103.765862
598552,4,0,4,1.344081,103.766038
598553,3,0,3,1.343526,103.766365
598554,79,2,81,1.343954,103.7659
598555,2,0,2,1.344218,103.766186
598556,1,1,2,1.345043,103.765589
598557,0,1,1,1.344287,103.76626
598558,3,5,8,1.344506,103.766059
598559,0,2,2,1.344401,103.766155
598560,37,0,37,1.344715,103.765869
598561,1,0,1,1.345192,103.765453
598562,9,0,9,1.345132,103.765488
598563,2,2,4,1.344013,103.765964
598564,2,1,3,1.344894,103.765725
598565,122,7,129,1.343525,103.766364
598566,7,2,9,1.343131,103.767292
598567,2,3,5,1.34336,103.767088
598568,51,0,51,1.34408,103.766037
598569,3,0,3,1.343588,103.766438
598570,1,1,2,1.345341,103.765317
598577,157,4977,5134,1.339937,103.774764
598578,7,1854,1861,1.340307,103.774284
598579,7,162,169,1.340308,103.774244
598580,8,217,225,1.34031,103.774165
598581,5,628,633,1.340312,103.774086
598582,7,682,689,1.340315,103.774007
598583,10,395,405,1.340317,103.773927
598584,28,388,416,1.340319,103.773848
598585,45,479,524,1.340321,103.773769
598586,26,771,797,1.340323,103.773689
598587,3,844,847,1.340492,103.773513
598588,45,103,148,1.339128,103.773504
598589,9,458,467,1.340344,103.773293
598590,5,69,74,1.340353,103.773214
598591,3,48,51,1.340362,103.773134
598592,5,71,76,1.340371,103.773055
598593,4,117,121,1.340375,103.773015
598594,4,165,169,1.340391,103.772916
598595,3,169,172,1.340411,103.772841
598596,0,130,130,1.340432,103.772766
598597,2,180,182,1.340452,103.772691
598598,4,280,284,1.340462,103.772654
598599,4,772,776,1.340507,103.772564
598600,3,717,720,1.340552,103.772486
598601,16,1337,1353,1.340595,103.772419
598602,19,1241,1260,1.340629,103.772363
598603,21,1110,1131,1.340639,103.772353
598604,10,25,35,1.340727,103.77226
598606,30,669,699,1.340938,103.772179
598607,0,196,196,1.341184,103.771772
598608,0,25,25,1.341183,103.771771
598609,3,186,189,1.341245,103.771715
598610,1,0,1,1.344923,103.765678
598611,2,124,126,1.341368,103.771599
598613,0,79,79,1.341491,103.771484
598614,0,3,3,1.34408,103.766037
598615,40,27,67,1.341614,103.771369
598616,11,37,48,1.341613,103.771368
598617,10,88,98,1.341737,103.771253
598618,0,147,147,1.341736,103.771252
598620,2,151,153,1.341859,103.771137
598621,21,0,21,1.341983,103.771023
598622,5,149,154,1.341982,103.771022
598623,0,1,1,1.341244,103.771714
598624,1,197,198,1.342105,103.770906
598625,7,14,21,1.342219,103.770802
598626,0,116,116,1.342294,103.770742
598628,22,136,158,1.342358,103.770693
598629,17,0,17,1.342357,103.770692
598630,3,235,238,1.342488,103.770594
598631,4,0,4,1.345331,103.765307
598632,1,261,262,1.342617,103.770494
598634,2,221,223,1.342746,103.770395
598636,13,1048,1061,1.342876,103.770296
598637,0,105,105,1.342875,103.770295
598638,4,580,584,1.342995,103.770207
598639,3,5,8,1.342994,103.770206
598640,6,410,416,1.343378,103.770201
598641,1,1,2,1.34408,103.766037
598642,0,5,5,1.343532,103.77017
598643,6,3,9,1.343531,103.770169
598644,0,5,5,1.343841,103.770108
598645,3,6,9,1.34384,103.770107
598646,4,8,12,1.344095,103.770072
598647,2,4,6,1.344094,103.770071
598648,108,12,120,1.344531,103.770112
598649,0,9,9,1.34453,103.770111
598650,0,1,1,1.342106,103.770907
598651,2,1,3,1.34149,103.771483
598652,59,1,60,1.345024,103.770163
598657,3,383,386,1.345923,103.767479
598658,3,144,147,1.345922,103.767478
598660,9,119,128,1.345922,103.767478
598661,11,900,911,1.345922,103.767478
598662,1,0,1,1.345024,103.770163
598663,1,0,1,1.345006,103.76981
598664,5,0,5,1.344997,103.769937
598665,5,0,5,1.344405,103.770076
598666,0,1,1,1.344989,103.769937
598668,1557,1640,3197,1.346674,103.768251
598669,801,67,868,1.345384,103.767999
598671,154,288,442,1.344836,103.768529
598672,6,1,7,1.344269,103.770249
598673,10,3,13,1.344332,103.770244
598674,246,1,247,1.341346,103.771123
598675,443,0,443,1.341432,103.771045
598676,119,0,119,1.34151,103.770955
598677,88,0,88,1.341596,103.770877
598678,167,20,187,1.341775,103.770714
598679,146,0,146,1.341866,103.770631
598680,141,119,260,1.299509,103.837
598681,388,130,518,1.341564,103.770686
598687,1,7,8,1.354745,103.765774
598692,0,1,1,1.344825,103.770128
598695,0,1,1,1.353713,103.765137
598696,0,7,7,1.355296,103.764501
598697,0,5,5,1.355308,103.764957
598698,0,5,5,1.35519,103.76498
598699,0,1,1,1.354907,103.764714
598700,3,0,3,1.345024,103.770163
598702,0,1,1,1.355047,103.765149
598704,0,3,3,1.354956,103.765185
598718,705,260,965,1.353343,103.768598
598719,255,116,371,1.353139,103.768015
598720,324,34,358,1.353467,103.767492
598721,144,21,165,1.353858,103.767381
598722,835,88,923,1.354149,103.767821
598723,364,167,531,1.354187,103.768267
598724,65,744,809,1.354536,103.768735
598725,426,123,549,1.353667,103.768418
598726,618,89,707,1.35354,103.767994
598727,747,912,1659,1.354681,103.768322
598728,239,122,361,1.354715,103.768317
598729,712,49,761,1.354627,103.767493
598730,363,54,417,1.354792,103.766907
598731,794,148,942,1.355428,103.767241
598732,662,577,1239,1.355576,103.767689
598733,32,124,156,1.355053,103.767449
598734,1384,40,1424,1.356429,103.767305
598735,445,101,546,1.355837,103.766245
598736,270,15,285,1.355615,103.765796
598737,1056,36,1092,1.356108,103.765548
598738,1064,137,1201,1.356793,103.766567
598739,1047,2169,3216,1.356532,103.767122
598740,86,42,128,1.356363,103.766424
598741,644,157,801,1.358224,103.764176
598742,938,210,1148,1.358083,103.764616
598743,686,263,949,1.358252,103.765154
598744,985,202,1187,1.35727,103.764468
598745,343,209,552,1.357565,103.763801
598746,32,1383,1415,1.358115,103.76367
598747,703,652,1355,1.358652,103.764198
598748,798,272,1070,1.357555,103.766283
598749,345,54,399,1.357003,103.765962
598750,276,51,327,1.356854,103.765427
598751,1187,81,1268,1.356245,103.764881
598752,1777,58,1835,1.356215,103.763961
598753,1184,83,1267,1.356977,103.764937
598754,22,91,113,1.34037,103.766438
598755,2,11,13,1.340366,103.766447
598756,4,2,6,1.340365,103.766466
598757,28,4,32,1.340364,103.766506
598758,1,0,1,1.35522,103.766148
598759,11,6,17,1.340363,103.766585
598760,2,0,2,1.343377,103.7702
598761,85,29,114,1.340361,103.766663
598762,57,5,62,1.34036,103.766703
598763,4,1,5,1.340359,103.766742
598764,4,0,4,1.342487,103.770593
598765,324,2,326,1.340358,103.766821
598766,6,0,6,1.340357,103.76686
598767,0,2,2,1.340362,103.766624
598768,2,1,3,1.355073,103.766257
598782,17,56,73,1.340111,103.766378
598783,3,7,10,1.340112,103.766391
598784,2,14,16,1.340113,103.766336
598785,1,0,1,1.340363,103.766545
598786,0,7,7,1.340116,103.766254
598787,3,1,4,1.340358,103.766781
598788,18,8,26,1.340119,103.766171
598790,0,7,7,1.34012,103.76615
598791,3,2,5,1.34011,103.766037
598792,6,12,18,1.340112,103.766076
598793,75,3,78,1.3401,103.765943
598794,3,14,17,1.340104,103.766002
598795,30,2,32,1.34009,103.76585
598796,9,12,21,1.340096,103.765928
598797,5,0,5,1.34008,103.765756
598798,6,9,15,1.340088,103.765854
598799,5,0,5,1.34007,103.765663
598800,5,13,18,1.34008,103.76578
598801,44,0,44,1.34006,103.765569
598802,23,58,81,1.340072,103.765706
598803,4,0,4,1.340117,103.766246
598804,6,4,10,1.340065,103.765632
598806,2,44,46,1.340057,103.765558
598807,2,1,3,1.340355,103.766939
598808,4,8,12,1.340049,103.765484
598809,103,14,117,1.340035,103.765252
598810,2,6,8,1.340041,103.76541
598811,75,0,75,1.34014,103.76527
598813,2,0,2,1.340356,103.7669
598814,12,7,19,1.340015,103.765252
598815,2,0,2,1.34014,103.76527
598816,9,6,15,1.340014,103.765223
598818,0,9,9,1.340012,103.765193
598819,23,0,23,1.340518,103.765378
598820,1,21,22,1.340009,103.765134
598822,6,25,31,1.340007,103.765076
598823,4,2,6,1.340697,103.765557
598824,4,35,39,1.340004,103.765017
598825,8,2,10,1.340791,103.765651
598826,10,6,16,1.340035,103.765248
598827,1,0,1,1.340113,103.766343
598828,4,10,14,1.340035,103.765243
598829,7,1,8,1.340852,103.765729
598830,4,4,8,1.340034,103.765235
598831,13,0,13,1.34093,103.76591
598832,3,1,4,1.34005,103.765476
598833,3,0,3,1.34003,103.765289
598834,1,1,2,1.340303,103.765299
598835,1,0,1,1.340852,103.765729
598836,0,5,5,1.340033,103.765208
598838,11,5,16,1.340033,103.7652
598839,4,9,13,1.34094,103.766424
598840,0,5,5,1.340032,103.765191
598841,0,19,19,1.34094,103.766465
598843,1,2,3,1.340932,103.766039
598844,1,4,5,1.3407,103.765258
598845,2,0,2,1.340033,103.765217
598846,9,1,10,1.340761,103.765326
598847,0,16,16,1.340937,103.766672
598848,0,1,1,1.340935,103.766167
598849,7,0,7,1.340936,103.766755
598850,1,3,4,1.340034,103.765226
598851,2,0,2,1.340938,103.766589
598852,2,0,2,1.340935,103.766837
598853,0,21,21,1.340934,103.76692
598854,1,3,4,1.340861,103.765459
598855,0,10,10,1.340991,103.765567
598856,0,1,1,1.340779,103.765358
598857,4,31,35,1.34111,103.765643
598858,2,14,16,1.341103,103.765815
598859,1,4,5,1.341112,103.765847
598860,1,10,11,1.341113,103.765906
598861,17,6,23,1.341091,103.765993
598862,0,8,8,1.341109,103.766058
598863,38,2,40,1.341123,103.766111
598864,28,6,34,1.341109,103.766168
598865,46,12,58,1.341129,103.766195
598866,11,27,38,1.341122,103.76629
598867,9,14,23,1.3411,103.76634
598868,1,61,62,1.34096,103.766459
598869,6,18,24,1.340959,103.766495
598870,5,9,14,1.340958,103.766566
598871,9,6,15,1.340957,103.766637
598872,0,15,15,1.340957,103.766707
598873,4,5,9,1.340956,103.766778
598874,0,7,7,1.340955,103.766849
598875,0,3,3,1.340939,103.766507
598889,6,3,9,1.335058,103.7667
598890,1,2,3,1.340954,103.76692
598891,1,1,2,1.340943,103.765488
598892,1,3,4,1.340974,103.765506
598894,1,3,4,1.335013,103.766541
598895,4,0,4,1.33493,103.766337
598897,0,2,2,1.335039,103.766654
598898,0,4,4,1.334965,103.766473
598900,19,21,40,1.335463,103.765953
598901,1,1,2,1.334928,103.766383
598902,1,0,1,1.341055,103.765621
598903,3,1,4,1.334764,103.76593
598904,1,1,2,1.334855,103.766202
598905,0,1,1,1.335466,103.765968
598906,12,6,18,1.335475,103.766028
598907,2,2,4,1.334818,103.766111
598908,18,0,18,1.335479,103.766057
598909,2,9,11,1.334152,103.765973
598910,21,0,21,1.335484,103.766087
598911,1,0,1,1.334781,103.766021
598912,62,0,62,1.335488,103.766117
598913,94,4,98,1.334242,103.765952
598914,2,0,2,1.33547,103.765998
598916,1,0,1,1.334181,103.765964
598917,1,0,1,1.335498,103.766177
598918,3,1,4,1.334754,103.76594
598919,14,0,14,1.334408,103.765938
598920,380,9,389,1.335507,103.766237
598921,4,0,4,1.335502,103.766207
598922,15,0,15,1.335511,103.766266
598923,7,0,7,1.334103,103.766433
598924,3,2,5,1.335516,103.766296
598925,4,0,4,1.334123,103.766465
598926,6,0,6,1.33552,103.766326
598927,13,3,16,1.334077,103.766298
598928,19,0,19,1.335525,103.766356
598929,4,0,4,1.33407,103.766375
598930,35,0,35,1.33548,103.765887
598931,5,33,38,1.334011,103.766209
598932,21,1,22,1.33548,103.765836
598933,6,0,6,1.334022,103.766025
598934,13,0,13,1.335478,103.765735
598935,2,0,2,1.335493,103.766147
598936,4,0,4,1.334057,103.766266
598937,0,1,1,1.334341,103.765942
598938,2,4,6,1.335431,103.765928
598939,3,3,6,1.333683,103.766234
598940,7,0,7,1.335391,103.765927
598941,59,0,59,1.333588,103.76626
598943,17,10,27,1.33338,103.76629
598944,1,0,1,1.333862,103.766144
598945,7,9,16,1.333125,103.766486
598946,1,0,1,1.335232,103.765925
598947,9,0,9,1.33316,103.76659
598948,1,0,1,1.335152,103.765924
598950,13,0,13,1.334993,103.765923
598951,0,1,1,1.335073,103.765924
598952,6,0,6,1.334913,103.765922
598953,3,2,5,1.334834,103.765921
598954,1,13,14,1.334764,103.76593
598955,19,39,58,1.333096,103.76646
598956,2,2,4,1.335477,103.765633
598957,8,4,12,1.333132,103.766583
598958,1,0,1,1.3332,103.766694
598959,1,0,1,1.333136,103.766629
598973,17,6,23,1.336486,103.768951
598975,8,24,32,1.336484,103.768902
598977,17,7,24,1.33648,103.768803
598979,6,2,8,1.336477,103.768703
598980,0,2,2,1.334022,103.766025
598981,4,4,8,1.336473,103.768604
598983,46,13,59,1.336469,103.768505
598984,1,0,1,1.333182,103.76674
598989,5,2,7,1.336458,103.768207
598990,0,10,10,1.335984,103.768133
598991,19,0,19,1.336454,103.768108
598993,22,20,42,1.33645,103.768009
598994,0,2,2,1.336492,103.768576
598995,3,6,9,1.336004,103.768139
598996,1,3,4,1.333122,103.766538
598998,1,3,4,1.335997,103.768376
599000,34,0,34,1.336007,103.76857
599001,167,1,168,1.318325,103.775346
599002,21,9,30,1.336018,103.768408
599003,0,5,5,1.336012,103.768666
599004,6,2,8,1.336024,103.768516
599006,6,9,15,1.33603,103.768623
599007,2,1,3,1.335054,103.766643
599008,96,5,101,1.336036,103.768731
599009,0,2,2,1.335991,103.768279
599010,29,0,29,1.336041,103.768839
599011,6,2,8,1.336033,103.769054
599012,6,1,7,1.336047,103.768946
599013,57,19,76,1.336053,103.769054
599014,16,0,16,1.336518,103.769128
599015,27,0,27,1.336642,103.769925
599016,1,0,1,1.336481,103.768292
599017,6,6,12,1.336662,103.769988
599018,34,6,40,1.336546,103.769509
599020,4,0,4,1.336002,103.768473
599021,3,0,3,1.336023,103.76886
599022,10,0,10,1.336641,103.769861
599023,34,0,34,1.336738,103.770344
599024,0,4,4,1.336559,103.769608
599025,0,1,1,1.336527,103.769255
599026,6,1,7,1.336758,103.770344
599027,0,1,1,1.336764,103.770462
599028,1,1,2,1.336028,103.768957
599029,1,0,1,1.336775,103.770501
599030,0,2,2,1.336784,103.770462
599031,1,0,1,1.336787,103.770541
599033,1,0,1,1.336809,103.770619
599034,31,0,31,1.336822,103.770593
599036,2,0,2,1.336793,103.770495
599038,0,1,1,1.336832,103.770698
599039,4,0,4,1.336708,103.770106
599040,8,12,20,1.336493,103.769064
599041,9,0,9,1.336498,103.769128
599042,4,0,4,1.336887,103.770845
599043,8,1,9,1.336516,103.769382
599044,3,2,5,1.336526,103.769509
599045,33,2,35,1.336539,103.769608
599046,18,4,22,1.3366,103.769798
599047,0,2,2,1.33684,103.770658
599048,1,1,2,1.336877,103.770855
599049,2,15,17,1.299509,103.837
599053,21,3,24,1.336401,103.768009
599054,31,1,32,1.336343,103.768018
599055,34,3,37,1.336225,103.768037
599056,8,0,8,1.336108,103.768056
599057,1,1,2,1.299509,103.837
599058,8,2,10,1.335981,103.768085
599060,6,0,6,1.335438,103.768177
599061,5,4,9,1.335428,103.768187
599062,6,0,6,1.335198,103.768216
599064,2,3,5,1.33502,103.768238
599065,5,0,5,1.334842,103.768259
599066,1,0,1,1.336878,103.770789
599067,4,5,9,1.33478,103.768266
599068,0,11,11,1.334656,103.76828
599069,19,0,19,1.334557,103.768286
599071,2,1,3,1.336713,103.770225
599072,0,2,2,1.335991,103.768075
599074,1,0,1,1.334842,103.768259
599075,20,2,22,1.334112,103.768342
599076,8,1,9,1.334033,103.768357
599077,326,5,331,1.333953,103.768372
599078,0,3,3,1.334366,103.768303
599079,0,1,1,1.334191,103.768327
599080,84,2,86,1.333716,103.768417
599081,8,37,45,1.337174,103.767882
599082,2,2,4,1.336507,103.769255
599083,1,4,5,1.336868,103.767932
599084,6,3,9,1.336664,103.767966
599085,30,2,32,1.33646,103.767999
599086,27,2,29,1.299509,103.837
599087,1,1,2,1.33427,103.768312
599089,2,26,28,1.299509,103.837
599090,2,1,3,1.333874,103.768387
599094,9,7,16,1.334997,103.767634
599095,30,3,33,1.334872,103.767654
599096,2,0,2,1.299509,103.837
599098,1,0,1,1.333795,103.768402
599100,10,0,10,1.334463,103.767741
599101,12,0,12,1.334391,103.767758
599102,1,2,3,1.299509,103.837
599103,6,0,6,1.334249,103.767791
599104,0,1,1,1.334676,103.767692
599106,53,2,55,1.334065,103.767831
599107,7,0,7,1.334024,103.767838
599108,3,0,3,1.33432,103.767774
599109,16,0,16,1.333858,103.767865
599111,6,0,6,1.333691,103.767893
599112,1,0,1,1.334178,103.767807
599113,24,3,27,1.333535,103.76791
599115,0,4,4,1.337072,103.767898
599117,1,0,1,1.333608,103.767906
599119,0,3,3,1.333941,103.767851
599120,3,1,4,1.334723,103.767626
599121,27,4,31,1.334656,103.76743
599122,5,4,9,1.334926,103.767361
599123,18,0,18,1.334629,103.767352
599124,4,0,4,1.334946,103.767427
599126,0,6,6,1.334885,103.76723
599127,20,0,20,1.334574,103.767195
599128,40,0,40,1.334865,103.767164
599129,0,1,1,1.33471,103.767587
599130,0,7,7,1.334844,103.767099
599131,3,0,3,1.334683,103.767508
599132,1,0,1,1.334547,103.767116
599133,1,2,3,1.33452,103.767038
599134,1,0,1,1.334824,103.767033
599136,36,14,50,1.334783,103.766902
599137,0,2,2,1.334757,103.767665
599138,24,11,35,1.334763,103.766836
599139,0,1,1,1.334804,103.766967
599142,3,0,3,1.334493,103.76696
599144,6,2,8,1.335346,103.766677
599145,0,2,2,1.334449,103.766813
599146,0,1,1,1.333919,103.766984
599148,4,0,4,1.334905,103.767296
599149,18,1,19,1.334569,103.766825
599150,1,0,1,1.334753,103.766826
599151,1,3,4,1.333991,103.767205
599152,2,0,2,1.333966,103.767134
599153,8,0,8,1.334458,103.766802
599154,33,1,34,1.334458,103.766802
599155,3,0,3,1.335216,103.766716
599156,13,1,14,1.334034,103.767376
599157,0,2,2,1.334459,103.766803
599158,7,0,7,1.334041,103.767438
599159,0,4,4,1.334005,103.76726
599160,1,7,8,1.334061,103.767498
599161,5,6,11,1.333878,103.766874
599162,2,1,3,1.334458,103.766802
599163,8,0,8,1.333804,103.766889
599164,2,0,2,1.334449,103.766793
599166,3,8,11,1.334095,103.767647
599167,3,0,3,1.334086,103.767554
599168,17,2,19,1.33404,103.767635
599169,2,0,2,1.334088,103.767603
599170,4,0,4,1.33415,103.766792
599171,2,1,3,1.333584,103.766935
599172,11,11,22,1.33401,103.767545
599173,0,3,3,1.333255,103.766829
599174,5,2,7,1.333989,103.767439
599175,1,0,1,1.334568,103.766824
599176,16,1,17,1.333942,103.767245
599177,3,0,3,1.333996,103.767507
599178,4,0,4,1.334024,103.767597
599179,10,0,10,1.33376,103.767109
599180,2,0,2,1.333436,103.766966
599181,0,1,1,1.333978,103.767379
599195,0,7,7,1.336735,103.770483
599196,8,0,8,1.336709,103.77047
599197,100,0,100,1.336696,103.770493
599199,11,3,14,1.336618,103.770515
599200,2,4,6,1.336513,103.770523
599201,6,6,12,1.336539,103.770536
599203,1,0,1,1.333735,103.766997
599204,1,0,1,1.336461,103.770558
599218,5,5,10,1.334856,103.768326
599219,8,3,11,1.334836,103.76833
599220,61,2,63,1.33486,103.768382
599221,4,2,6,1.334841,103.768391
599222,10,0,10,1.334868,103.768496
599223,8,2,10,1.33485,103.768513
599224,19,61,80,1.334876,103.76861
599226,15,2,17,1.334885,103.768723
599227,5,0,5,1.334867,103.768758
599228,0,1,1,1.336393,103.770569
599229,2,0,2,1.333749,103.767058
599230,0,1,1,1.334893,103.768836
599231,3,2,5,1.334909,103.769064
599232,1,0,1,1.334885,103.769002
599233,0,1,1,1.334893,103.769125
599234,2,0,2,1.334876,103.76888
599235,4,0,4,1.333932,103.767157
599236,4,1,5,1.334911,103.769369
599237,209,1,210,1.334933,103.769404
599238,3,3,6,1.33492,103.769491
599239,203,0,203,1.334942,103.769518
599240,10,0,10,1.334928,103.769614
599241,1,5,6,1.33495,103.769631
599243,53,0,53,1.334958,103.769744
599244,0,4,4,1.334925,103.76929
599245,114,9,123,1.334966,103.769858
599246,0,1,1,1.334917,103.769177
599247,72,0,72,1.334995,103.770183
599248,9,3,12,1.334975,103.770183
599249,6,0,6,1.334174,103.770237
599250,0,4,4,1.334946,103.769858
599251,5,0,5,1.334634,103.770329
599252,34,1,35,1.334343,103.770234
599253,3,0,3,1.333932,103.767193
599254,7,4,11,1.334258,103.770236
599255,1,22,23,1.334071,103.770372
599257,23,3,26,1.333869,103.770375
599259,11,6,17,1.333689,103.770011
599261,41,2,43,1.333638,103.76978
599262,3,2,5,1.334446,103.769408
599263,3,1,4,1.334385,103.770234
599265,7,1,8,1.333598,103.769231
599266,6,2,8,1.334501,103.769171
599267,2,1,3,1.334354,103.770374
599268,3,0,3,1.333521,103.768922
599269,21,0,21,1.333594,103.768681
599270,0,5,5,1.334434,103.768973
599271,68,1,69,1.333516,103.768263
599272,8,0,8,1.334464,103.768897
599273,8,1,9,1.333637,103.768433
599274,8,0,8,1.334466,103.768736
599275,25,1,26,1.33361,103.768168
599276,34,0,34,1.334487,103.768683
599277,4,30,34,1.333525,103.76792
599278,2,0,2,1.334902,103.769247
599279,2,2,4,1.333633,103.769486
599280,1,3,4,1.333502,103.76786
599281,28,1,29,1.333489,103.76781
599282,0,1,1,1.334946,103.769858
599283,8,1,9,1.333463,103.767709
599284,12,4,16,1.334135,103.768853
599285,3,2,5,1.333436,103.767609
599286,1,0,1,1.334118,103.768618
599287,24,0,24,1.33341,103.767508
599288,18,0,18,1.333829,103.769354
599289,7,1,8,1.333384,103.767408
599290,4,0,4,1.334464,103.768465
599291,0,1,1,1.333825,103.769118
599292,73,1,74,1.334209,103.769767
599293,5,0,5,1.333331,103.767207
599294,8,4,12,1.334205,103.770023
599296,0,6,6,1.334013,103.77004
599297,2,0,2,1.334438,103.768549
599298,2,3,5,1.333993,103.769872
599299,4,4,8,1.333982,103.769568
599300,10,3,13,1.333961,103.769298
599301,97,3,100,1.333802,103.769045
599302,4,0,4,1.33384,103.769557
599304,1,3,4,1.333791,103.768878
599306,5,1,6,1.333492,103.767746
599307,37,0,37,1.333471,103.767663
599308,54,1,55,1.333449,103.767581
599309,4,5,9,1.333428,103.767499
599310,1,0,1,1.333358,103.767307
599311,7,0,7,1.333385,103.767335
599312,28,6,34,1.333363,103.767253
599313,2,0,2,1.333206,103.766824
599314,19,1,20,1.33332,103.767088
599315,2,0,2,1.333342,103.76717
599316,1,2,3,1.334488,103.769123
599318,5,0,5,1.334291,103.77035
599319,6,0,6,1.334223,103.770358
599320,1,8,9,1.333997,103.77041
599322,1,18,19,1.333754,103.770256
599323,0,1,1,1.333406,103.767417
599324,6,1,7,1.334215,103.769842
599325,3,0,3,1.335022,103.770492
599326,24,7,31,1.333962,103.770238
599327,0,2,2,1.333299,103.767006
599328,101,0,101,1.334037,103.769771
599329,11,1,12,1.333573,103.768469
599330,0,1,1,1.334128,103.770388
599331,5,0,5,1.333429,103.7685
599333,11,2,13,1.333143,103.768564
599334,2,0,2,1.333962,103.770238
599335,3,0,3,1.33428,103.770235
599336,8,0,8,1.333113,103.768517
599337,3,6,9,1.332875,103.768664
599338,1,9,10,1.332863,103.768429
599339,21,4,25,1.332897,103.768737
599341,0,4,4,1.333524,103.767869
599342,3,8,11,1.332855,103.768299
599343,5,0,5,1.332921,103.768897
599344,14,12,26,1.332844,103.76825
599345,13,1,14,1.332938,103.768937
599346,3,0,3,1.332905,103.768763
599347,22,5,27,1.332953,103.768995
599348,1,4,5,1.332828,103.768104
599349,6,14,20,1.33297,103.769045
599350,13,16,29,1.332849,103.768056
599351,17,2,19,1.333279,103.769094
599352,4,9,13,1.333089,103.767998
599353,38,4,42,1.333334,103.769093
599354,2,0,2,1.333143,103.768544
599355,24,1,25,1.333368,103.769089
599356,33,13,46,1.3332,103.767978
599357,27,3,30,1.333455,103.769157
599358,3,0,3,1.332835,103.768207
599359,9,7,16,1.33337,103.769181
599360,10,16,26,1.333131,103.76792
599361,2,3,5,1.333286,103.76916
599362,3,17,20,1.332829,103.767867
599363,6,3,9,1.333241,103.76916
599364,0,1,1,1.333573,103.768449
599365,0,1,1,1.332807,103.767788
599366,4,15,19,1.332805,103.76773
599367,3,19,22,1.333147,103.769187
599368,0,3,3,1.333187,103.7679
599369,47,33,80,1.33319,103.769774
599370,7,0,7,1.332785,103.767587
599371,2,5,7,1.333232,103.769766
599372,0,4,4,1.332902,103.768803
599373,20,0,20,1.333315,103.769749
599375,15,0,15,1.333399,103.769732
599376,0,1,1,1.333184,103.76918
599378,1,1,2,1.333148,103.767992
599379,2,0,2,1.332764,103.767272
599380,2,7,9,1.332756,103.767133
599381,3,4,7,1.332763,103.767097
599382,8,1,9,1.332759,103.767051
599383,38,21,59,1.332765,103.766986
599397,28,4,32,1.335472,103.768301
599398,1,10,11,1.335399,103.768367
599399,1,7,8,1.335478,103.768375
599402,16,0,16,1.335407,103.768603
599403,0,1,1,1.332775,103.767365
599404,1,6,7,1.335411,103.768679
599405,3,4,7,1.335487,103.768559
599407,1,3,4,1.33277,103.767517
599408,1,1,2,1.332756,103.767204
599409,0,4,4,1.335488,103.768633
599410,0,4,4,1.335436,103.769056
599411,1,0,1,1.335479,103.768481
599413,2,2,4,1.335499,103.768734
599414,0,3,3,1.332802,103.767664
599415,3,0,3,1.335505,103.768898
599416,1,0,1,1.33545,103.76925
599417,5,7,12,1.335461,103.769521
599418,0,4,4,1.335453,103.769326
599419,0,18,18,1.335462,103.769664
599420,28,2,30,1.33552,103.76921
599421,8,6,14,1.335461,103.769744
599422,3,3,6,1.335525,103.769273
599423,19,2,21,1.334956,103.769848
599424,0,5,5,1.33553,103.769362
599425,1,46,47,1.335534,103.769418
599426,33,1,34,1.335542,103.769548
599427,50,0,50,1.335546,103.769614
599428,224,4,228,1.335542,103.769763
599429,36,0,36,1.335538,103.769818
599430,7,0,7,1.335474,103.769866
599431,2,1,3,1.335455,103.769445
599432,1,0,1,1.335506,103.768967
599433,0,1,1,1.335267,103.769867
599435,5,2,7,1.334966,103.769858
599437,1,0,1,1.335163,103.769867
599449,10,10,20,1.345553,103.769279
599472,5,702,707,1.325207,103.774854
599473,91,3,94,1.325241,103.775655
599474,13,198,211,1.327124,103.77446
599475,8,721,729,1.328696,103.775356
599476,21,2175,2196,1.330028,103.777632
599477,0,3,3,1.33537,103.769866
599478,0,43,43,1.330079,103.777515
599479,5,0,5,1.330113,103.777437
599480,0,17,17,1.330147,103.777359
599481,2,0,2,1.33542,103.768899
599482,2,26,28,1.330215,103.777203
599483,1,1,2,1.330181,103.777281
599484,22,5464,5486,1.330283,103.777047
599485,35,175,210,1.330317,103.776969
599486,2,43,45,1.330351,103.776891
599487,1,1070,1071,1.330375,103.776823
599488,139,81,220,1.330492,103.776943
599489,3253,2930,6183,1.332823,103.772471
599490,232,35,267,1.330041,103.774976
599491,5368,6898,12266,1.329766,103.776529
599492,12,63,75,1.330844,103.775751
599493,298,87,385,1.334482,103.77472
599504,163,72,235,1.324344,103.772927
599505,6,40,46,1.324358,103.772881
599506,121,9,130,1.324304,103.773002
599507,0,2,2,1.330249,103.777125
599508,0,13,13,1.324223,103.773154
599509,5,1,6,1.324277,103.773033
599512,11,4,15,1.32406,103.773457
599513,6,0,6,1.324169,103.773235
599514,69,6,75,1.323979,103.773608
599515,2,1,3,1.330045,103.777593
599518,62,3,65,1.323817,103.773911
599519,1,1,2,1.324331,103.772932
599520,2,1,3,1.324115,103.773336
599521,8,3,11,1.323952,103.773638
599522,58,1,59,1.324099,103.774207
599523,1,0,1,1.335547,103.769689
599525,1,4,5,1.323922,103.774138
599526,1,0,1,1.323898,103.773739
599527,15,0,15,1.323844,103.77384
599528,0,1,1,1.323922,103.774138
599531,30,5,35,1.32379,103.773941
599532,48,0,48,1.323593,103.773979
599533,25,1,26,1.323592,103.773978
599534,4,0,4,1.335506,103.769027
599535,188,3,191,1.323736,103.774042
599536,0,1,1,1.323736,103.774062
599539,2,0,2,1.324006,103.773537
599540,17,8,25,1.323163,103.773729
599541,16,0,16,1.323162,103.773728
599543,0,1,1,1.32345,103.773896
599547,3,0,3,1.323746,103.774052
599548,1,0,1,1.323613,103.773971
599549,3,0,3,1.323491,103.773899
599551,3,0,3,1.32271,103.77382
599553,1,0,1,1.323368,103.773828
599555,14,1,15,1.322867,103.773553
599556,5,5,10,1.322887,103.773553
599557,2,0,2,1.323675,103.774006
599558,1,0,1,1.32281,103.773654
599559,3,0,3,1.322744,103.773764
599560,0,2,2,1.322926,103.77345
599561,2,0,2,1.322953,103.773418
599562,16,2,18,1.323029,103.773273
599563,1,0,1,1.322915,103.77349
599564,1,0,1,1.323169,103.772983
599565,13,2,15,1.323267,103.772796
599566,14,0,14,1.32318,103.772982
599567,48,4,52,1.323364,103.772609
599568,59,39,98,1.323256,103.772837
599569,10,3,13,1.323462,103.772423
599571,2,68,70,1.323549,103.772246
599573,3,2,5,1.323483,103.772401
599574,20,625,645,1.323559,103.772256
599589,54,6208,6262,1.34185,103.775475
599591,7,22,29,1.341851,103.775438
599593,6,32,38,1.341852,103.775363
599595,8,23,31,1.341854,103.775288
599596,6,13,19,1.342017,103.775191
599597,15,23,38,1.341856,103.775214
599598,4,12,16,1.341869,103.775261
599599,17,12,29,1.341857,103.77514
599600,3,9,12,1.341868,103.775186
599601,12,1,13,1.341859,103.775065
599602,3,0,3,1.322974,103.773356
599603,44,230,274,1.34186,103.77499
599606,0,10,10,1.341931,103.77386
599608,1,4,5,1.341932,103.773818
599609,0,2,2,1.323072,103.77317
599611,0,19,19,1.341939,103.773564
599612,9,62,71,1.341941,103.77348
599613,2,17,19,1.341944,103.773395
599614,2,0,2,1.341934,103.773733
599616,9,0,9,1.34195,103.773142
599617,2,0,2,1.341946,103.773311
599618,0,8,8,1.341955,103.772973
599620,6,0,6,1.341959,103.772804
599621,11,5,16,1.341762,103.772838
599622,3,4,7,1.341962,103.77272
599623,9,4,13,1.34176,103.772773
599625,3,1,4,1.323592,103.773978
599626,7,0,7,1.341966,103.772551
599627,4,3,7,1.341952,103.773038
599628,1,0,1,1.323104,103.773127
599629,3,3,6,1.34196,103.772756
599630,1,0,1,1.341968,103.772466
599631,0,1,1,1.34197,103.772382
599632,0,1,1,1.341968,103.772474
599633,5,3,8,1.341965,103.772203
599634,11,8,19,1.341911,103.772103
599635,2,0,2,1.341952,103.773058
599636,1,6,7,1.341985,103.772203
599637,86,0,86,1.341986,103.772144
599638,1,1,2,1.341925,103.772026
599639,1,0,1,1.341973,103.772297
599640,2,1,3,1.341868,103.775113
599642,5,0,5,1.342698,103.771148
599643,0,1,1,1.341998,103.772094
599644,45,1,46,1.342786,103.771099
599645,3,0,3,1.34261,103.771197
599646,6,0,6,1.342962,103.771002
599648,106,0,106,1.343139,103.770904
599649,9,0,9,1.342144,103.771672
599650,4,0,4,1.341741,103.772709
599651,0,1,1,1.342043,103.771897
599652,0,1,1,1.342205,103.771593
599653,5,0,5,1.34227,103.77152
599654,4,0,4,1.343315,103.770807
599655,0,10,10,1.342338,103.771451
599656,8,9,17,1.343896,103.770678
599658,45,0,45,1.344093,103.770679
599659,3,3,6,1.342474,103.771314
599661,1,0,1,1.343502,103.770742
599662,3,1,4,1.343698,103.77071
599663,8,6,14,1.3426,103.771187
599664,1,3,4,1.344376,103.770856
599665,0,1,1,1.342542,103.771246
599666,33,0,33,1.344478,103.771
599667,49,3,52,1.342679,103.771139
599668,1,3,4,1.344427,103.770928
599669,7,0,7,1.342748,103.771101
599670,1,1,2,1.341985,103.772203
599671,1,6,7,1.342817,103.771062
599672,1,0,1,1.342644,103.771158
599674,0,1,1,1.344786,103.771431
599675,18,0,18,1.342955,103.770986
599676,51,1,52,1.344898,103.771585
599677,1,0,1,1.344888,103.771575
599678,3,3,6,1.345138,103.77186
599679,1,8,9,1.343093,103.77091
599680,3,2,5,1.343162,103.770872
599682,0,1,1,1.343024,103.770948
599685,0,3,3,1.342069,103.7718
599686,6,0,6,1.3436,103.770706
599687,2,4,6,1.343679,103.770693
599690,0,2,2,1.344683,103.771287
599691,2,0,2,1.343915,103.770655
599692,32,1,33,1.344093,103.770659
599693,4,0,4,1.344581,103.771144
599694,15,1,16,1.344186,103.770689
599695,12,0,12,1.344253,103.770741
599696,6,0,6,1.344319,103.770794
599697,5,3,8,1.344386,103.770846
599698,0,7,7,1.344422,103.770892
599699,0,5,5,1.344447,103.770928
599701,0,3,3,1.343521,103.770719
599703,2,11,13,1.344652,103.771216
599704,1,0,1,1.3433,103.770795
599705,6,0,6,1.344754,103.771359
599707,2,3,5,1.344857,103.771503
599708,1,0,1,1.344703,103.771287
599709,5,0,5,1.344939,103.771611
599710,0,1,1,1.344898,103.771565
599711,15,1,16,1.345033,103.771718
599712,5,0,5,1.345096,103.771789
599713,3,1,4,1.34414,103.770674
599715,3,0,3,1.34455,103.771072
599716,4,0,4,1.345148,103.77185
599717,483,24,507,1.341737,103.773356
599718,11,1,12,1.342609,103.771196
599719,3,0,3,1.341683,103.772163
599720,2,0,2,1.343994,103.770642
599727,40,33663,33703,1.341932,103.77548
599728,30,8,38,1.341926,103.775454
599729,26,3585,3611,1.342057,103.775451
599730,40,1897,1937,1.341985,103.775447
599731,12,0,12,1.342212,103.775413
599732,5,93,98,1.342113,103.775422
599733,13,1025,1038,1.342399,103.775368
599734,12,0,12,1.342297,103.775379
599735,24,788,812,1.342586,103.775324
599736,31,236,267,1.3425,103.775338
599737,24,1427,1451,1.342772,103.775279
599738,4,173,177,1.342959,103.775235
599739,54,0,54,1.34268,103.775289
599740,63,11,74,1.343145,103.77519
599741,23,792,815,1.343054,103.775202
599742,31,797,828,1.343332,103.775146
599743,15,0,15,1.343236,103.775161
599744,7,0,7,1.343519,103.775101
599745,12,510,522,1.343425,103.775118
599746,18,252,270,1.343705,103.775057
599747,52,7,59,1.343892,103.775012
599761,3,1,4,1.342609,103.771196
599762,8,1,9,1.336363,103.773838
599763,5,0,5,1.336313,103.77387
599764,0,1,1,1.34497,103.771646
599765,11,1,12,1.336113,103.773997
599766,7,14,21,1.336013,103.774061
599767,7,14,21,1.335913,103.774125
599781,3,7,10,1.334467,103.770908
599782,10,0,10,1.334966,103.770798
599783,0,2,2,1.299509,103.837
599784,2,3,5,1.334892,103.770804
599785,2,0,2,1.334472,103.770963
599786,25,1,26,1.334745,103.770817
599787,5,0,5,1.334495,103.771186
599788,6,0,6,1.334598,103.77083
599789,10,0,10,1.334506,103.771298
599790,1,1,2,1.334483,103.771075
599791,6,0,6,1.334517,103.771409
599792,2,1,3,1.299509,103.837
599793,38,0,38,1.334391,103.770846
599795,13,3,16,1.334331,103.77085
599796,3,2,5,1.334521,103.77147
599797,4,0,4,1.336108,103.77411
599798,81,0,81,1.334526,103.771532
599799,6,2,8,1.33453,103.771593
599801,16,1,17,1.334534,103.771655
599802,29,0,29,1.334539,103.771716
599804,13,17,30,1.33397,103.770873
599805,0,1,1,1.336213,103.773934
599806,6,1,7,1.333909,103.770876
599807,48,0,48,1.334552,103.771901
599808,9,3,12,1.333849,103.77088
599810,9,1,10,1.333789,103.770884
599811,0,11,11,1.334561,103.772024
599812,10,0,10,1.333729,103.770888
599813,12,7,19,1.334565,103.772085
599814,0,4,4,1.334271,103.770854
599815,2,0,2,1.334451,103.770842
599816,6,0,6,1.33445,103.771404
599817,12,7,19,1.334612,103.772274
599818,1,0,1,1.334548,103.771839
599819,1,1,2,1.334588,103.772179
599820,0,1,1,1.334392,103.771409
599821,16,0,16,1.334697,103.772539
599822,8,3,11,1.334278,103.771418
599825,1,7,8,1.33476,103.77262
599826,7,28,35,1.334163,103.771428
599827,3,0,3,1.334421,103.770844
599828,5,2,7,1.334106,103.771433
599829,4,2,6,1.334865,103.772761
599830,7,1,8,1.334049,103.771437
599831,51,0,51,1.334918,103.772832
599832,8,0,8,1.333991,103.771442
599833,0,1,1,1.334335,103.771413
599834,1,4,5,1.333934,103.771447
599835,3,0,3,1.334812,103.77269
599836,6,9,15,1.334507,103.772076
599837,23,4,27,1.335052,103.773009
599838,5,1,6,1.334458,103.772077
599839,3,0,3,1.335013,103.772963
599840,0,1,1,1.33497,103.772902
599841,22,0,22,1.335141,103.773118
599842,4,18,22,1.334265,103.77208
599844,7,7,14,1.334169,103.772081
599846,4,6,10,1.334072,103.772083
599847,2,1,3,1.335082,103.773045
599848,8,9,17,1.33467,103.772558
599849,8,1,9,1.335367,103.773397
599850,1,0,1,1.334362,103.772078
599851,7,2,9,1.335393,103.773428
599852,38,26,64,1.334587,103.772614
599853,3,0,3,1.335318,103.773335
599854,51,7,58,1.334533,103.772652
599855,0,2,2,1.334658,103.772462
599856,0,2,2,1.335441,103.773491
599857,6,1,7,1.335473,103.773533
599858,5,8,13,1.334423,103.772727
599859,1,3,4,1.334478,103.771401
599860,1,0,1,1.334642,103.772577
599861,2,0,2,1.334478,103.772689
599862,0,34,34,1.33481,103.773136
599863,18,13,31,1.335405,103.77347
599865,0,2,2,1.334878,103.773078
599866,4,3,7,1.335548,103.77366
599867,2,6,8,1.335644,103.773786
599881,22,6,28,1.335914,103.772072
599883,8,6,14,1.335962,103.772132
599885,6,0,6,1.336059,103.77225
599886,1,1,2,1.335453,103.773533
599887,0,1,1,1.334945,103.773021
599888,4,1,5,1.336136,103.772369
599889,2,1,3,1.335409,103.773449
599890,129,0,129,1.336173,103.772418
599891,1,1,2,1.336039,103.77225
599892,2,0,2,1.336264,103.772511
599893,48,1,49,1.336372,103.772652
599894,0,1,1,1.336146,103.772359
599895,38,1,39,1.33648,103.772794
599896,21,1,22,1.336361,103.772663
599897,0,2,2,1.336211,103.772467
599898,30,0,30,1.336435,103.772761
599899,1,1,2,1.336588,103.772935
599900,9,0,9,1.33651,103.772859
599901,1,0,1,1.336286,103.772565
599902,1,0,1,1.336805,103.773218
599903,7,3,10,1.336913,103.77336
599905,1,1,2,1.336697,103.773077
599906,186,8,194,1.336735,103.773153
599907,7,2,9,1.337119,103.773633
599908,5,0,5,1.33681,103.773251
599909,2,2,4,1.334979,103.772992
599911,8,2,10,1.337168,103.773689
599912,4,2,6,1.336959,103.773447
599913,12,2,14,1.337206,103.773735
599914,216,2,218,1.337034,103.773545
599915,6,18,24,1.337245,103.773781
599916,10,4,14,1.337109,103.773643
599917,3,2,5,1.337283,103.773826
599918,3,4,7,1.337154,103.773696
599919,6,1,7,1.337322,103.773872
599920,4,0,4,1.337148,103.773666
599921,4,0,4,1.337199,103.77375
599922,18,1,19,1.337289,103.773857
599923,1,0,1,1.336585,103.772957
599924,3,0,3,1.33621,103.77244
599938,10,0,10,1.334316,103.781079
599952,1487,47,1534,1.331087,103.76789
599953,477,23,500,1.33088,103.768385
599954,837,40,877,1.329878,103.76888
599968,428,61,489,1.330585,103.767317
599969,551,25,576,1.330309,103.76771
599970,428,15,443,1.329757,103.768495
599971,802,40,842,1.329346,103.769326
599972,755,25,780,1.329085,103.770192
599986,1650,463,2113,1.332954,103.782566
599987,761,1323,2084,1.299509,103.837
600002,4,372,376,1.322129,103.744939
600003,3,640,643,1.321692,103.744843
600004,8,572,580,1.320936,103.744739
600005,14,3670,3684,1.320748,103.744202
600006,1,1954,1955,1.321147,103.744252
600007,1,124,125,1.321714,103.743782
600009,1,33,34,1.322416,103.744152
600010,1,661,662,1.32218,103.742632
600011,1,1491,1492,1.322306,103.742215
600020,1111,766,1877,1.323734,103.738643
600021,839,176,1015,1.32359,103.739319
600022,1803,3746,5549,1.322463,103.739777
600023,451,6403,6854,1.322852,103.739239
600024,301,87,388,1.32352,103.737697
600025,342,198,540,1.323183,103.737554
600030,444,258,702,1.320877,103.738797
600031,494,1334,1828,1.320409,103.73872
600032,785,3001,3786,1.321924,103.739622
600033,491,368,859,1.320278,103.742038
600034,768,153,921,1.319864,103.741957
600035,278,273,551,1.319638,103.742451
600036,364,387,751,1.320056,103.742544
600037,219,399,618,1.320589,103.742501
600038,71,1581,1652,1.321156,103.742848
600039,129,2931,3060,1.321378,103.742867
600040,997,2120,3117,1.321386,103.74203
600041,514,1289,1803,1.321638,103.740934
600043,195,96,291,1.321087,103.741764
600044,558,184,742,1.320726,103.741756
600045,74,42,116,1.320476,103.741175
600046,204,70,274,1.320203,103.740522
600047,756,512,1268,1.320202,103.739746
600048,575,230,805,1.320536,103.739773
600049,176,6278,6454,1.321066,103.738168
600050,219,2145,2364,1.320664,103.737628
600051,567,2786,3353,1.320759,103.737173
600052,222,152,374,1.320982,103.737732
600053,246,99,345,1.3213,103.737794
600054,81,752,833,1.321533,103.73686
600055,628,116,744,1.321836,103.737378
600056,652,225,877,1.322231,103.737235
600057,700,314,1014,1.322607,103.737331
600058,3,244,247,1.322499,103.737866
600059,4,124,128,1.322066,103.737788
600060,487,169,656,1.322702,103.738469
600061,384,15705,16089,1.322074,103.738573
600062,540,1305,1845,1.321536,103.738874
600063,742,64,806,1.321191,103.739445
600064,331,65,396,1.321548,103.739808
600065,171,3239,3410,1.321931,103.73909
600101,1387,712,2099,1.336717,103.7385
600102,712,926,1638,1.336173,103.738608
600103,406,228,634,1.336694,103.737967
600104,449,2494,2943,1.336586,103.737616
600105,574,427,1001,1.337284,103.738025
600106,893,2237,3130,1.337226,103.737674
600107,650,102,752,1.337694,103.737894
600108,750,645,1395,1.338307,103.736721
600109,559,2830,3389,1.338341,103.73586
600110,1070,634,1704,1.33884,103.736096
600111,531,434,965,1.338778,103.735505
600112,771,153,924,1.339234,103.735417
600113,600,884,1484,1.338874,103.735008
600114,254,945,1199,1.339154,103.734525
600115,313,214,527,1.339748,103.735135
600116,901,790,1691,1.339686,103.734506
600117,1285,865,2150,1.33782,103.735278
600118,129,134,263,1.338128,103.735442
600119,279,254,533,1.338128,103.735442
600120,52,226,278,1.338128,103.735442
600121,186,133,319,1.338128,103.735442
600122,1325,397,1722,1.335572,103.737277
600123,131,984,1115,1.338128,103.735442
600124,1226,1364,2590,1.334982,103.737871
600130,221,2357,2578,1.334713,103.739339
600131,152,2272,2424,1.334749,103.740062
600132,11,186,197,1.334295,103.739637
600133,63,139,202,1.334178,103.739343
600134,340,2566,2906,1.334023,103.738849
600135,119,71,190,1.333788,103.739684
600201,119,1967,2086,1.336466,103.743104
600202,378,1121,1499,1.336786,103.742965
600203,307,726,1033,1.336834,103.742567
600204,697,378,1075,1.337177,103.741959
600205,227,3314,3541,1.337372,103.743346
600206,299,723,1022,1.337812,103.742
600207,458,99,557,1.337954,103.742418
600208,415,1552,1967,1.338446,103.742658
600209,405,2359,2764,1.337947,103.739687
600210,680,1018,1698,1.33858,103.738942
600211,433,224,657,1.338641,103.73963
600212,142,1793,1935,1.339155,103.740306
600213,309,3305,3614,1.339058,103.739706
600214,170,3594,3764,1.339269,103.738902
600215,92,2108,2200,1.340075,103.738419
600216,736,312,1048,1.339578,103.737696
600217,212,484,696,1.339996,103.737778
600218,481,326,807,1.340332,103.73779
600219,265,120,385,1.340867,103.737733
600220,339,290,629,1.340993,103.737377
600221,86,102,188,1.340865,103.736935
600222,146,560,706,1.340828,103.735641
600223,92,139,231,1.341044,103.736014
600224,526,141,667,1.341672,103.736536
600225,33,115,148,1.341813,103.737249
600226,407,318,725,1.341384,103.735866
600227,507,1438,1945,1.341714,103.73607
600228,474,2194,2668,1.342554,103.736293
600229,740,8812,9552,1.341936,103.737722
600230,188,205,393,1.341493,103.737352
600231,610,171,781,1.341272,103.737809
600232,136,2520,2656,1.339832,103.740803
600233,237,290,527,1.340309,103.740798
600234,457,954,1411,1.339953,103.74151
600235,117,1836,1953,1.339963,103.742123
600236,692,349,1041,1.340469,103.741954
600237,85,176,261,1.340714,103.741248
600238,263,135,398,1.340628,103.740462
600239,72,2167,2239,1.340901,103.740895
600240,503,3666,4169,1.341012,103.741525
600241,758,1380,2138,1.341551,103.742653
600242,60,392,452,1.341782,103.742659
600243,704,1674,2378,1.34201,103.743094
600244,558,702,1260,1.34211,103.742276
600245,329,1120,1449,1.341753,103.742049
600246,341,2216,2557,1.341788,103.739758
600247,623,1962,2585,1.341909,103.739125
600248,553,59,612,1.342154,103.740303
600249,525,2200,2725,1.342524,103.739203
600250,516,352,868,1.342678,103.739739
600251,588,1438,2026,1.3431,103.739795
600252,292,222,514,1.343415,103.738456
600253,312,10441,10753,1.343772,103.737137
600254,489,22,511,1.343434,103.73778
600255,90,738,828,1.344288,103.737778
600256,137,249,386,1.344076,103.738188
600257,1539,518,2057,1.344532,103.738922
600258,655,1841,2496,1.343698,103.739091
600259,144,222,366,1.344045,103.739737
600260,689,1792,2481,1.343734,103.74017
600261,1121,189,1310,1.344447,103.740231
600262,61,362,423,1.34401,103.740985
600263,630,316,946,1.344341,103.741468
600264,1059,158,1217,1.343716,103.741116
600265,790,5592,6382,1.340599,103.744559
600266,247,1219,1466,1.341318,103.744336
600267,456,510,966,1.341121,103.744664
600268,691,114,805,1.341818,103.745065
600269,574,528,1102,1.341419,103.745551
600270,362,325,687,1.341157,103.745825
600271,412,383,795,1.341793,103.746236
600272,590,253,843,1.342122,103.745388
600273,672,183,855,1.342492,103.74523
600274,742,301,1043,1.341988,103.746838
600275,454,213,667,1.340918,103.747904
600276,391,93,484,1.340837,103.747499
600277,1064,328,1392,1.341378,103.746876
600278,434,667,1101,1.340764,103.746399
600279,635,209,844,1.340665,103.746722
600280,479,297,776,1.340391,103.74734
600281,333,2045,2378,1.339898,103.746494
600282,127,463,590,1.339813,103.746817
600283,120,3660,3780,1.339208,103.746783
600284,526,9018,9544,1.339458,103.746213
600301,881,5267,6148,1.344187,103.735007
600302,1249,8390,9639,1.344483,103.734731
600303,274,898,1172,1.344476,103.735176
600304,352,209,561,1.344949,103.734967
600305,840,305,1145,1.345544,103.734988
600306,1151,217,1368,1.345832,103.734846
600307,566,434,1000,1.346686,103.734372
600308,779,192,971,1.346994,103.734238
600309,590,357,947,1.347746,103.733604
600310,728,230,958,1.348015,103.733471
600311,258,705,963,1.347696,103.732871
600312,518,3120,3638,1.347009,103.732554
600313,204,1266,1470,1.347326,103.73325
600314,578,207,785,1.346891,103.733022
600315,263,191,454,1.346154,103.732856
600316,473,9089,9562,1.346482,103.732575
600317,793,631,1424,1.347063,103.730897
600318,204,377,581,1.347326,103.73059
600319,736,221,957,1.347997,103.73043
600320,522,1806,2328,1.348652,103.730826
600321,397,252,649,1.348354,103.730171
600322,1020,249,1269,1.347998,103.72948
600323,384,195,579,1.348349,103.729147
600324,412,32,444,1.348987,103.73015
600325,391,186,577,1.348672,103.729103
600326,546,633,1179,1.349161,103.729651
600327,717,143,860,1.349092,103.729121
600328,639,2345,2984,1.349445,103.72981
600329,284,5046,5330,1.350096,103.730186
600330,361,287,648,1.350507,103.730222
600331,527,338,865,1.350825,103.730451
600332,815,266,1081,1.35126,103.729854
600333,63,50,113,1.351182,103.731067
600334,148,70,218,1.349214,103.730596
600335,39,92,131,1.350229,103.732081
600336,582,119,701,1.350436,103.731475
600337,545,102,647,1.349753,103.731808
600338,173,617,790,1.350148,103.731281
600339,268,488,756,1.349636,103.731368
600340,362,246,608,1.349963,103.730982
600341,597,7099,7696,1.349299,103.731214
600342,28,4691,4719,1.346045,103.731441
600343,75,593,668,1.345814,103.731164
600344,37,2595,2632,1.345653,103.730733
600345,212,38,250,1.345526,103.731146
600346,53,1158,1211,1.345313,103.730565
600347,24,49,73,1.345236,103.731466
600348,66,60,126,1.344546,103.731096
600349,56,115,171,1.344528,103.731423
600350,132,5063,5195,1.344093,103.731233
600351,161,75,236,1.344919,103.730762
600352,269,1814,2083,1.345029,103.730398
600353,184,1011,1195,1.344416,103.730542
600354,5,271,276,1.344557,103.731881
600371,798,2240,3038,1.34838,103.731826
600372,356,2596,2952,1.348332,103.731928
600373,588,131,719,1.349357,103.732292
600374,531,373,904,1.349677,103.732654
600401,560,328,888,1.320487,103.750195
600402,760,312,1072,1.320854,103.749323
600403,243,325,568,1.320345,103.749265
600404,205,2366,2571,1.319878,103.749145
600405,324,251,575,1.31928,103.749512
600406,356,235,591,1.318887,103.748871
600407,523,6409,6932,1.318644,103.748443
600408,400,1085,1485,1.318285,103.748563
600409,204,761,965,1.318532,103.747474
600410,489,350,839,1.319006,103.747505
600411,286,487,773,1.318972,103.746548
600412,755,264,1019,1.319743,103.746637
600413,150,3087,3237,1.319612,103.747852
600414,515,4107,4622,1.320164,103.746779
600415,199,1142,1341,1.320827,103.748049
600416,18,156,174,1.321093,103.748254
601020,11,81,92,1.323956,103.737988
601021,18,127,145,1.323657,103.739755
601022,20,109,129,1.323316,103.739389
601037,831,1427,2258,1.32087,103.742765
601055,11,259,270,1.322128,103.737491
601057,155,548,703,1.322724,103.737384
601062,22,146,168,1.321553,103.739332
601063,25,473,498,1.32129,103.738585
601204,11,108,119,1.337177,103.741959
601215,38,69,107,1.339571,103.738244
601217,94,4676,4770,1.340417,103.738385
601219,306,137,443,1.340695,103.737432
601221,336,603,939,1.340736,103.736352
601223,350,186,536,1.341348,103.736379
601225,199,340,539,1.342032,103.736458
601240,2,177,179,1.299509,103.837
601254,38,584,622,1.343625,103.737936
601267,7,144,151,1.341576,103.744959
601271,8,98,106,1.299509,103.837
601273,4,136,140,1.342437,103.745998
601274,7,129,136,1.341583,103.747462
601282,57,275,332,1.340109,103.747087
601285,391,1682,2073,1.338515,103.746278
601286,276,2866,3142,1.338922,103.745594
601287,482,1224,1706,1.338399,103.743864
601288,549,2170,2719,1.338934,103.743434
601317,9,437,446,1.299509,103.837
601318,451,3058,3509,1.347553,103.730955
601320,20,4707,4727,1.34905,103.730515
601322,812,154,966,1.347617,103.729673
601324,31,318,349,1.348523,103.72981
601335,2,40,42,1.299509,103.837
601354,4,73,77,1.299509,103.837
601372,8,270,278,1.299509,103.837
602057,17,399,416,1.299509,103.837
602240,3,964,967,1.299509,103.837
602285,342,2151,2493,1.338428,103.746951
602286,851,96,947,1.338672,103.745183
602287,551,154,705,1.338389,103.744268
602288,159,1852,2011,1.339238,103.742782
602318,3,26,29,1.347693,103.730893
602320,2,204,206,1.299509,103.837
603240,0,209,209,1.299509,103.837
603285,126,92,218,1.337933,103.746388
603286,515,209,724,1.338906,103.744608
603287,887,57,944,1.338039,103.744869
603288,484,193,677,1.339547,103.743465
604240,3,3051,3054,1.299509,103.837
604285,633,119,752,1.337987,103.745961
604286,466,5657,6123,1.339656,103.744701
604287,346,382,728,1.337921,103.744092
604288,259,716,975,1.339768,103.744045
605285,16,858,874,1.337602,103.746858
605286,35,1436,1471,1.339312,103.745175
605287,12,100,112,1.337581,103.744113
605288,218,3214,3432,1.340319,103.743744
606287,10,16,26,1.3376,103.744566
606288,18,155,173,1.339742,103.743203
608511,20,1706,1726,1.299509,103.837
608516,9784,7881,17665,1.331365,103.739439
608521,2749,25161,27910,1.331863,103.744751
608526,54,1024,1078,1.329744,103.744482
608531,5022,11127,16149,1.334171,103.742851
608532,2640,168,2808,1.334519,103.742793
608533,1137,47005,48142,1.335449,103.742424
608534,94,858,952,1.299509,103.837
608535,256,169,425,1.299509,103.837
608536,146,19,165,1.317864,103.73295
608537,517,11,528,1.299509,103.837
608538,165,4,169,1.317987,103.732993
608541,954,108,1062,1.299509,103.837
608542,18,0,18,1.299509,103.837
608543,129,0,129,1.299509,103.837
608544,8,0,8,1.299509,103.837
608545,49,1,50,1.299509,103.837
608546,123,1105,1228,1.335095,103.739633
608547,8,101,109,1.334308,103.741958
608548,143,4233,4376,1.33285,103.742051
608549,16091,100076,116167,1.333067,103.74366
608550,148,3237,3385,1.33319,103.743333
608551,66,218,284,1.316071,103.733488
608552,45,242,287,1.299509,103.837
608556,64,50,114,1.316268,103.732884
608557,27,86,113,1.316186,103.732534
608558,61,0,61,1.316762,103.73263
608559,9,89,98,1.316514,103.731686
608560,930,28,958,1.316245,103.732232
608561,8,32,40,1.315902,103.73152
608562,597,1,598,1.316282,103.731092
608563,10,0,10,1.316226,103.730801
608564,2,17,19,1.316587,103.731128
608565,14,1,15,1.317055,103.731303
608566,29,62,91,1.316323,103.731413
608567,26,131,157,1.338053,103.753123
608568,24,358,382,1.338024,103.75341
608569,3,7,10,1.338529,103.753143
608570,0,83,83,1.338566,103.752859
608571,6,0,6,1.338281,103.75299
608572,12,81,93,1.33814,103.752468
608574,24,33,57,1.313335,103.729254
608575,158,197,355,1.335143,103.757475
608576,266,103,369,1.334465,103.757717
608577,38,8,46,1.335679,103.752315
608578,45,8,53,1.335923,103.752577
608579,102,9,111,1.336149,103.752803
608580,68,12,80,1.336758,103.752531
608581,46,10,56,1.335971,103.753968
608582,54,28,82,1.336308,103.753963
608583,73,44,117,1.336601,103.753219
608584,10,228,238,1.337448,103.75281
608585,21,827,848,1.337768,103.753166
608586,1048,2919,3967,1.337078,103.754725
608587,12,441,453,1.336174,103.755965
608588,55,2324,2379,1.336393,103.751566
608589,0,1,1,1.337389,103.773954
608590,1,0,1,1.336211,103.751601
608591,65,0,65,1.335832,103.751472
608592,1,2,3,1.337379,103.773964
608593,0,1,1,1.335972,103.751582
608594,0,1,1,1.335839,103.751931
608595,0,12,12,1.336429,103.751756
608596,75,1103,1178,1.336506,103.751747
608597,381,587,968,1.336013,103.750994
608598,86,836,922,1.335373,103.757927
608599,349,146,495,1.33709,103.751582
608600,359,40,399,1.313124,103.730298
608601,152,138,290,1.336195,103.757222
608602,3,102,105,1.336477,103.756783
608603,854,485,1339,1.337784,103.752232
608604,151,971,1122,1.337376,103.752037
608605,43,120,163,1.336659,103.756428
608606,619,450,1069,1.334808,103.758588
608607,11,187,198,1.33588,103.757644
608608,162,758,920,1.336928,103.755971
608609,597,2082,2679,1.337651,103.754693
608610,387,13,400,1.312056,103.732138
608611,94,12,106,1.312802,103.728624
608612,267,66,333,1.312247,103.732602
608613,143,46,189,1.312704,103.730438
608614,580,41,621,1.313308,103.729387
608615,21,10,31,1.312422,103.731492
608616,81,23,104,1.312171,103.733365
608617,81,89,170,1.313303,103.72943
608618,11,24,35,1.312573,103.730935
608619,55,201,256,1.313598,103.731427
608627,47,3,50,1.313243,103.729719
608779,778,567,1345,1.314198,103.73023
608780,133,8,141,1.316556,103.734037
608781,71,19,90,1.315985,103.734297
608782,124,145,269,1.315903,103.734567
608783,119,664,783,1.315822,103.735
608784,515,308,823,1.3192,103.745652
608785,71,190,261,1.319364,103.743467
608826,72,1,73,1.335243,103.749762
608827,2,70,72,1.336644,103.750105
608828,2306,59,2365,1.338182,103.750754
608829,411,89,500,1.33861,103.751933
608830,1788,55,1843,1.3394,103.751122
608831,260,262,522,1.340354,103.749805
608832,850,68,918,1.339271,103.749441
608833,115,18,133,1.338451,103.749499
608834,124,311,435,1.337441,103.749491
608835,38,1176,1214,1.336782,103.74955
608837,200,4041,4241,1.336203,103.74822
608838,1673,696,2369,1.332345,103.748224
608839,299,9888,10187,1.333139,103.748525
608840,257,2255,2512,1.33536,103.74807
608878,274,4113,4387,1.3212,103.738397
608879,8,1619,1627,1.32255,103.741482
608919,27,119,146,1.323442,103.744098
608920,174,12,186,1.323284,103.742946
608921,0,37,37,1.323255,103.742463
608922,27,79,106,1.323935,103.741889
608923,307,50,357,1.32426,103.741615
608924,928,139,1067,1.32448,103.740993
608925,1478,124,1602,1.325256,103.740267
608926,1252,264,1516,1.325732,103.738597
608927,1149,267,1416,1.326121,103.737901
608928,734,261,995,1.325028,103.73943
608968,379,1,380,1.303903,103.738345
608969,25,80,105,1.304139,103.738949
608970,126,0,126,1.304056,103.739394
608971,57,25,82,1.303715,103.739255
608972,146,0,146,1.303958,103.740096
608973,392,32,424,1.30302,103.740749
608974,22,31,53,1.303701,103.740874
608975,96,12,108,1.302298,103.740596
608976,475,85,560,1.300959,103.740122
609017,41,14,55,1.306217,103.740066
609018,17,1,18,1.305934,103.739651
609019,898,40,938,1.305004,103.739657
609021,134,23,157,1.306503,103.736992
609022,81,1,82,1.30739,103.736689
609023,6,34,40,1.30678,103.736206
609024,416,35,451,1.306313,103.735857
609025,797,16,813,1.306451,103.735231
609026,37,0,37,1.305324,103.736271
609027,15,38,53,1.304939,103.73663
609028,244,0,244,1.302537,103.738544
609029,19,42,61,1.304694,103.737135
609030,202,0,202,1.30177,103.738638
609031,28,79,107,1.301073,103.738702
609032,1032,11,1043,1.300616,103.736084
609033,6,17,23,1.302246,103.736794
609034,559,4,563,1.304103,103.736589
609035,51,57,108,1.304118,103.738075
609036,74,27,101,1.305107,103.738237
609037,91,28,119,1.30451,103.738613
609038,7,74,81,1.302885,103.737353
609039,1885,49,1934,1.29983,103.738966
609040,621,30,651,1.301696,103.737249
609041,44,25,69,1.306095,103.73706
609077,9,709,718,1.331121,103.739979
609078,646,224,870,1.328981,103.737353
609079,1556,1077,2633,1.330884,103.738185
609080,31,332,363,1.332452,103.737734
609081,3378,3240,6618,1.333194,103.736132
609082,672,30,702,1.331205,103.737465
609122,1,10,11,1.32435,103.735829
609123,8,22,30,1.323618,103.735456
609124,108,576,684,1.321471,103.734827
609125,18,1,19,1.319616,103.73503
609126,3,2039,2042,1.31752,103.735373
609128,2567,7,2574,1.314586,103.733639
609129,145,297,442,1.313445,103.732189
609130,39,49,88,1.313217,103.733065
609131,104,2,106,1.313033,103.733995
609132,24,100,124,1.312589,103.733901
609133,14,10,24,1.31277,103.732973
609134,259,14,273,1.313079,103.731731
609135,74,1221,1295,1.313545,103.733125
609136,60,185,245,1.310837,103.733717
609138,4,7,11,1.307987,103.733512
609139,4,148,152,1.309475,103.734485
609140,971,631,1602,1.308448,103.734578
609141,64,49,113,1.307108,103.734092
609142,429,0,429,1.302199,103.732902
609143,1295,213,1508,1.310383,103.735078
609144,8,1,9,1.301296,103.730934
609145,41,24,65,1.303382,103.731565
609147,49,37,86,1.303655,103.732457
609148,9,41,50,1.303299,103.732381
609149,6,20,26,1.306229,103.731517
609150,6,89,95,1.317561,103.734813
609151,1083,6,1089,1.302776,103.729701
609152,418,37,455,1.302117,103.731942
609153,0,137,137,1.319304,103.735915
609154,3,0,3,1.335638,103.75168
609155,0,1,1,1.336015,103.751885
609156,0,1,1,1.319284,103.734834
609157,6,276,282,1.318654,103.735383
609158,862,295,1157,1.302413,103.730312
609159,5,188,193,1.299509,103.837
609161,301,84,385,1.382785,103.97205
609162,687,11,698,1.305965,103.730147
609163,234,0,234,1.305015,103.731165
609164,16,57,73,1.299509,103.837
609183,163,145,308,1.306735,103.738974
609184,93,21,114,1.307961,103.736858
609185,1,12,13,1.307043,103.738714
609186,64,42,106,1.307448,103.736278
609187,93,66,159,1.30766,103.738195
609188,1,0,1,1.319364,103.732961
609189,754,283,1037,1.308482,103.738461
609190,21,78,99,1.308929,103.737884
609191,6,0,6,1.307992,103.735477
609192,50,11,61,1.308454,103.736627
609193,534,14,548,1.309888,103.735807
609194,14,100,114,1.308714,103.732967
609195,492,13,505,1.309309,103.732467
609196,8,79,87,1.309522,103.730282
609197,93,0,93,1.309921,103.733276
609198,96,1,97,1.308613,103.730382
609199,41,65,106,1.310172,103.732921
609200,390,0,390,1.308081,103.729865
609201,731,273,1004,1.310555,103.732388
609202,60,48,108,1.307351,103.730108
609203,34,113,147,1.31044,103.731395
609204,186,33,219,1.311482,103.730935
609205,25,10,35,1.307022,103.728846
609206,2309,167,2476,1.31089,103.72881
609207,1,9,10,1.307876,103.728333
609208,54,0,54,1.307281,103.728393
609209,673,2,675,1.30683,103.728442
609213,452,211,663,1.308509,103.728522
609214,438,27,465,1.307611,103.728676
609215,243,0,243,1.306805,103.72952
609216,2741,258,2999,1.310001,103.729342
609217,109,7,116,1.306567,103.738211
609218,121,22,143,1.309314,103.734593
609253,482,216,698,1.305227,103.751901
609254,918,194,1112,1.303784,103.75108
609255,612,119,731,1.304435,103.75195
609256,298,1,299,1.303565,103.752755
609257,659,43,702,1.302232,103.752589
609258,165,233,398,1.302942,103.752266
609259,375,0,375,1.301995,103.753362
609260,1,0,1,1.307716,103.735841
609261,35,135,170,1.30127,103.753688
609262,771,71,842,1.30155,103.752007
609263,2097,4,2101,1.299959,103.753559
609264,472,18,490,1.299216,103.754603
609265,49,45,94,1.298804,103.754438
609266,232,1,233,1.298365,103.7543
609267,97,0,97,1.30102,103.752302
609268,202,13,215,1.299159,103.752855
609269,5,0,5,1.298117,103.753248
609270,91,199,290,1.300259,103.752916
609271,2414,2,2416,1.297122,103.752164
609272,302,296,598,1.300051,103.752322
609273,981,166,1147,1.298086,103.749771
609274,159,1,160,1.299809,103.751761
609275,26,143,169,1.299609,103.751159
609276,393,0,393,1.300732,103.75108
609277,47,11,58,1.301585,103.750503
609278,891,0,891,1.299597,103.745582
609279,110,9,119,1.302128,103.750294
609280,36,26,62,1.300232,103.745909
609281,47,74,121,1.299935,103.746393
609282,347,4,351,1.300523,103.749791
609283,62,12,74,1.30026,103.746504
609284,1354,234,1588,1.29941,103.750154
609285,28,45,73,1.30063,103.747055
609286,96,419,515,1.301014,103.746526
609287,35,191,226,1.301402,103.747181
609288,74,58,132,1.301918,103.746355
609289,1073,63,1136,1.299548,103.748384
609290,195,118,313,1.302883,103.746992
609291,214,26,240,1.299585,103.747378
609292,8,49,57,1.299929,103.74746
609293,8,1097,1105,1.300503,103.747571
609294,453,231,684,1.302898,103.747714
609295,3,0,3,1.319195,103.735183
609296,238,0,238,1.297515,103.754409
609297,18,1,19,1.298626,103.753368
609298,4,41,45,1.299617,103.753416
609299,279,0,279,1.303491,103.752235
609335,218,1703,1921,1.320905,103.747513
609336,481,3925,4406,1.321188,103.746592
609337,346,1028,1374,1.320844,103.74641
609338,113,477,590,1.32161,103.746559
609339,336,187,523,1.321694,103.747494
609340,86,1546,1632,1.321894,103.74959
609341,98,125,223,1.320932,103.750688
609342,12,203,215,1.321474,103.747643
609382,12,78,90,1.303433,103.751342
609383,895,50,945,1.303915,103.750193
609384,1862,90,1952,1.303299,103.749364
609385,9,61,70,1.303065,103.748896
609386,62,59,121,1.301359,103.749353
609387,439,264,703,1.302237,103.747906
609388,455,10,465,1.300924,103.748443
609389,38,228,266,1.301475,103.747414
609431,285,112,397,1.328692,103.742239
609432,12,28,40,1.328287,103.741553
609433,920,635,1555,1.335403,103.735459
609434,7181,4047,11228,1.331037,103.741504
609474,16,850,866,1.345685,103.73413
609476,188,95,283,1.348679,103.732992
609477,821,2858,3679,1.345062,103.733418
609478,655,44,699,1.345644,103.733118
609479,571,709,1280,1.346107,103.733614
609480,684,45,729,1.346141,103.73361
609481,157,1459,1616,1.34543,103.733921
609517,713,736,1449,1.346852,103.729195
609558,292,1406,1698,1.343263,103.740763
609559,19,750,769,1.341759,103.741337
609560,11,163,174,1.343448,103.744005
609561,262,84,346,1.343466,103.742462
609601,4431,28476,32907,1.334938,103.746872
609602,210,6276,6486,1.335944,103.743933
609603,83,4012,4095,1.339551,103.741311
609604,131,146,277,1.340338,103.739469
609605,111,7220,7331,1.340989,103.73872
609606,3615,92607,96222,1.333401,103.74556
609607,1028,10340,11368,1.335584,103.744483
609647,370,902,1272,1.336524,103.736118
609648,139,5114,5253,1.335496,103.737996
609649,29,144,173,1.334308,103.742004
609650,787,1661,2448,1.337682,103.736715
609651,91,11,102,1.337854,103.736905
609652,623,28,651,1.337736,103.736609
609653,861,1143,2004,1.337547,103.736041
609654,21,3643,3664,1.335488,103.739008
609690,2691,13899,16590,1.333511,103.742022
609731,5426,103727,109153,1.33352,103.740277
609732,352,1652,2004,1.332892,103.73951
609773,7,347,354,1.343582,103.73513
609774,2592,658,3250,1.343793,103.733997
609775,1162,2087,3249,1.343433,103.734866
609776,1058,212,1270,1.342966,103.734085
609777,1232,373,1605,1.342523,103.734561
609778,2143,469,2612,1.342216,103.735154
609779,264,623,887,1.341849,103.734807
609780,490,454,944,1.342156,103.734263
609781,1487,2654,4141,1.343702,103.732868
609782,1091,427,1518,1.34437,103.732662
609783,1759,861,2620,1.344069,103.733352
609784,63,15,78,1.343327,103.733218
609786,269,12131,12400,1.342382,103.737369
609787,151,4472,4623,1.345188,103.73259
609788,599,6949,7548,1.349792,103.730619
609789,290,436,726,1.350415,103.729003
609790,250,181,431,1.351493,103.729161
609791,5,780,785,1.349741,103.729229
609792,91,4573,4664,1.341535,103.740764
609831,882,218,1100,1.302866,103.743854
609832,65,14,79,1.30776,103.750291
609874,2,100,102,1.325861,103.735579
609914,668,585,1253,1.326211,103.749545
609915,2000,5640,7640,1.324817,103.750273
609916,6068,1657,7725,1.324738,103.746782
609917,3641,1438,5079,1.329042,103.748706
609918,14,1107,1121,1.326851,103.747773
609919,388,1674,2062,1.325543,103.749849
609920,1287,503,1790,1.324226,103.749154
609921,4486,1149,5635,1.328684,103.745812
609922,1547,341,1888,1.325107,103.747907
609923,3304,2257,5561,1.327229,103.746618
609924,513,1758,2271,1.325937,103.746759
609925,257,546,803,1.326369,103.748673
609926,234,1072,1306,1.324264,103.750208
609927,4975,2605,7580,1.32681,103.748282
609928,2102,788,2890,1.325497,103.74904
609929,791,985,1776,1.325878,103.747729
609930,9754,25262,35016,1.32954,103.747567
609932,423,243,666,1.323931,103.750588
609933,2007,1509,3516,1.328041,103.74795
609934,776,1204,1980,1.327732,103.745974
609935,5680,1251,6931,1.3276,103.749234
609957,740,612,1352,1.330073,103.75028
609958,96,1032,1128,1.339876,103.737082
609959,946,3342,4288,1.34235,103.732342
609960,22,1215,1237,1.330385,103.749033
609961,786,8633,9419,1.330888,103.748645
609962,14,50,64,1.340147,103.737225
609963,15,344,359,1.343916,103.730493
609964,1523,6769,8292,1.327445,103.753555
609965,430,24,454,1.328092,103.754847
609966,4524,1160,5684,1.328234,103.753597
609967,142,3517,3659,1.328006,103.754482
609968,138,21,159,1.328582,103.754183
609969,73,49,122,1.329099,103.752746
609970,339,133,472,1.329136,103.751908
609971,410,10634,11044,1.328173,103.751848
610000,186,37,223,1.303514,103.628363
610005,0,54,54,1.33009,103.721897
610006,0,1,1,1.302516,103.752448
610007,0,15,15,1.330572,103.72237
610008,0,3,3,1.29851,103.749562
610009,1,3,4,1.33736,103.773918
610010,3,331,334,1.33141,103.721945
610063,110,322,432,1.331996,103.722517
610064,139,217,356,1.332381,103.722449
610065,240,4164,4404,1.332373,103.722887
610066,43,1883,1926,1.332007,103.722848
610103,4,7,11,1.332489,103.724528
610105,1,0,1,1.33027,103.721903
610108,83,0,83,1.334317,103.72499
610111,219,2365,2584,1.333895,103.723317
610112,300,202,502,1.333898,103.723636
610113,108,192,300,1.333226,103.724287
610114,434,81,515,1.333859,103.724129
610115,534,1991,2525,1.333645,103.724652
610116,235,2466,2701,1.334754,103.723215
610117,195,109,304,1.335113,103.723063
610118,170,21,191,1.335327,103.722881
610119,440,980,1420,1.334777,103.724397
610120,474,550,1024,1.335232,103.723978
610121,957,7,964,1.335732,103.724159
610122,328,174,502,1.335917,103.723786
610138,285,120,405,1.299509,103.837
610139,206,2175,2381,1.299509,103.837
610140,0,279,279,1.299509,103.837
610141,0,12,12,1.299509,103.837
610150,0,8,8,1.299509,103.837
610151,722,12435,13157,1.326809,103.721061
610152,218,2513,2731,1.327113,103.720614
610153,150,207,357,1.327439,103.720987
610154,179,35,214,1.327557,103.721584
610155,375,2657,3032,1.327784,103.722535
610156,244,121,365,1.327843,103.721853
610157,568,87,655,1.328326,103.72181
610158,232,1474,1706,1.328933,103.722251
610159,266,3242,3508,1.329459,103.722565
610160,190,110,300,1.329196,103.721403
610161,557,62,619,1.32973,103.721603
610162,440,237,677,1.329744,103.721861
610163,383,2141,2524,1.329899,103.722565
610164,0,19,19,1.299509,103.837
610165,1,27,28,1.299509,103.837
610166,5,111,116,1.299509,103.837
610175,26,107,133,1.299509,103.837
610176,12,293,305,1.299509,103.837
610177,616,36,652,1.333208,103.721223
610178,564,334,898,1.333363,103.72068
610179,458,961,1419,1.333846,103.720821
610180,931,695,1626,1.333844,103.721203
610181,593,244,837,1.333847,103.721936
610182,367,3351,3718,1.333861,103.722383
610183,216,1501,1717,1.333203,103.722615
610184,353,84,437,1.333203,103.722293
610321,508,383,891,1.33734,103.724414
610322,327,2263,2590,1.336924,103.724646
610323,279,186,465,1.336766,103.72395
610324,402,170,572,1.33635,103.723367
610325,426,76,502,1.335973,103.72305
610326,245,3468,3713,1.335636,103.722564
610327,228,196,424,1.336097,103.722405
610328,845,218,1063,1.336693,103.722484
610329,604,459,1063,1.337491,103.723655
610330,326,1051,1377,1.337705,103.724238
610331,3,216,219,1.338606,103.72289
610332,578,3016,3594,1.338524,103.723797
610333,487,1323,1810,1.339289,103.72331
610334,164,629,793,1.339019,103.722558
610335,463,218,681,1.338974,103.723177
610336,594,479,1073,1.338606,103.723406
610337,13,73,86,1.337648,103.723342
610338,16,50,66,1.337648,103.723342
610339,54,4931,4985,1.339288,103.722309
610345,1047,308,1355,1.339796,103.721313
610346,540,353,893,1.340296,103.720809
610347,607,276,883,1.340313,103.719949
610348,749,250,999,1.340105,103.719582
610349,404,123,527,1.339429,103.718934
610350,388,2299,2687,1.338706,103.719135
610351,323,2157,2480,1.339002,103.71993
610352,330,245,575,1.339397,103.720142
610353,883,451,1334,1.33967,103.720781
610354,570,1382,1952,1.338733,103.721115
610355,427,1460,1887,1.338604,103.720835
610357,233,1279,1512,1.336689,103.721047
610358,560,210,770,1.33638,103.720674
610359,494,3024,3518,1.336414,103.72128
610360,224,442,666,1.335756,103.72098
610361,490,829,1319,1.335818,103.720312
610362,265,136,401,1.336149,103.719825
610363,362,174,536,1.336464,103.720063
610364,7,175,182,1.337164,103.720495
610365,372,775,1147,1.337678,103.720119
610366,401,190,591,1.338297,103.719746
610367,476,682,1158,1.3381,103.719078
610368,264,102,366,1.337318,103.71948
610369,366,189,555,1.337021,103.719876
610399,703,256,959,1.334774,103.721053
611115,92,912,1004,1.33403,103.724574
611117,11,68,79,1.335362,103.723473
611118,8,59,67,1.335402,103.722861
611120,18,1948,1966,1.335599,103.724529
611121,61,2928,2989,1.335873,103.724954
611138,392,44,436,1.328303,103.723733
611140,1,556,557,1.299509,103.837
611150,9,1065,1074,1.299509,103.837
611155,13,746,759,1.328183,103.722065
611163,18,80,98,1.32993,103.722082
611164,0,14,14,1.299509,103.837
611165,0,2,2,1.337021,103.773501
611166,0,23,23,1.299509,103.837
611175,448,460,908,1.332176,103.721736
611182,23,2231,2254,1.333501,103.722607
611183,2,100,102,1.332904,103.723044
611184,5,114,119,1.332888,103.721866
611328,9,245,254,1.337321,103.72316
611331,246,496,742,1.338032,103.723469
611337,769,613,1382,1.337648,103.723342
611338,262,68,330,1.337648,103.723342
611339,201,180,381,1.339288,103.722309
611346,34,116,150,1.340069,103.72017
612138,550,1176,1726,1.328303,103.723733
612140,0,5,5,1.299509,103.837
612165,0,28,28,1.299509,103.837
612166,1,96,97,1.299509,103.837
612175,1198,271,1469,1.332005,103.721753
612337,372,458,830,1.337648,103.723342
612338,70,122,192,1.339288,103.722309
612339,293,2190,2483,1.339288,103.722309
613138,926,116,1042,1.328303,103.723733
613140,1,39,40,1.299509,103.837
613175,394,26,420,1.332005,103.721753
613337,285,1402,1687,1.337648,103.723342
613339,435,946,1381,1.339288,103.722309
614138,813,4425,5238,1.328303,103.723733
614140,2,233,235,1.299509,103.837
614337,210,2921,3131,1.337648,103.723342
614339,426,1974,2400,1.339288,103.722309
615337,5,96,101,1.339288,103.722309
618289,792,16,808,1.316123,103.722613
618290,1,0,1,1.331867,103.723934
618291,1460,66,1526,1.315539,103.723165
618292,1319,329,1648,1.314317,103.72441
618293,77,77,154,1.315719,103.723389
618294,1,2,3,1.33082,103.722387
618295,1,2,3,1.299509,103.837
618296,1,0,1,1.299509,103.837
618297,3,10,13,1.302502,103.714104
618299,1053,112,1165,1.323166,103.714604
618300,579,73,652,1.32283,103.714491
618301,312,5,317,1.322626,103.711889
618302,1135,4,1139,1.325368,103.714294
618304,375,0,375,1.324094,103.712373
618305,158,10,168,1.325276,103.710423
618309,66,21,87,1.315175,103.725594
618310,557,191,748,1.338216,103.717603
618311,4,17,21,1.301186,103.71763
618312,1,0,1,1.302012,103.718496
618313,9,0,9,1.315026,103.726358
618314,30,0,30,1.302405,103.718004
618315,6,47,53,1.339446,103.718246
618316,118,1,119,1.339466,103.718244
618317,0,10,10,1.339428,103.718218
618318,50,1,51,1.339446,103.718215
618319,0,1,1,1.302012,103.718496
618321,3,32,35,1.339354,103.718105
618322,1,0,1,1.339391,103.718161
618323,3,4,7,1.339316,103.718048
618325,0,118,118,1.339279,103.717992
618326,7,2,9,1.33929,103.717978
618327,0,1,1,1.339368,103.718097
618329,9,19,28,1.339205,103.717879
618330,3,1,4,1.331207,103.721979
618331,46,1,47,1.339168,103.717822
618332,11,0,11,1.339174,103.717801
618334,1,14,15,1.339135,103.717742
618335,1,3,4,1.339213,103.71786
618336,123,0,123,1.339096,103.717683
618337,29,0,29,1.339056,103.717653
618338,36,7,43,1.339057,103.717623
618339,44,5,49,1.339019,103.717597
618340,1,1,2,1.299509,103.837
618341,4,1,5,1.338982,103.71754
618342,7,1,8,1.338979,103.717505
618343,0,1,1,1.339242,103.717935
618344,6,0,6,1.33894,103.717446
618345,4,1,5,1.338908,103.717427
618346,8,2,10,1.338901,103.717387
618347,8,0,8,1.338871,103.717371
618349,142,4,146,1.338834,103.717314
618350,1,2,3,1.299509,103.837
618351,6,0,6,1.338797,103.717258
618352,3,0,3,1.338824,103.717269
618353,1,9,10,1.338759,103.717201
618354,49,5,54,1.338746,103.71715
618355,2,1,3,1.338785,103.717209
618357,2,6,8,1.338685,103.717088
618358,0,152,152,1.338668,103.717032
618359,1,51,52,1.338658,103.717042
618360,9,106,115,1.339112,103.716901
618361,8,492,500,1.339271,103.716847
618362,2,2,4,1.339094,103.717709
618363,1,121,122,1.339294,103.716888
618365,9,2,11,1.339329,103.716943
618366,1,3,4,1.339141,103.716928
618367,11,7,18,1.33935,103.716978
618368,2,0,2,1.339018,103.717564
618369,1,1,2,1.339223,103.717058
618370,0,1,1,1.338945,103.717484
618371,0,2,2,1.339382,103.717035
618373,49,1,50,1.339438,103.717127
618374,15,3,18,1.339311,103.717187
618375,0,2,2,1.339405,103.717072
618377,26,3,29,1.339495,103.717208
618378,3,4,7,1.339378,103.717281
618379,5,0,5,1.339526,103.717244
618380,2,0,2,1.339467,103.717158
618381,11,7,18,1.339578,103.717338
618382,3,8,11,1.339453,103.717409
618383,2,0,2,1.339401,103.717327
618384,39,2,41,1.339482,103.717452
618385,4,6,10,1.339637,103.717427
618386,3,10,13,1.339511,103.717494
618387,1,0,1,1.33926,103.717112
618388,1,1,2,1.339595,103.717375
618389,14,3,17,1.339689,103.717519
618390,24,9,33,1.339572,103.71759
618391,1,0,1,1.339658,103.717459
618393,216,1,217,1.339758,103.717603
618394,4,4,8,1.339632,103.71768
618397,5,1,6,1.339821,103.717701
618398,5,2,7,1.339674,103.717753
618399,0,1,1,1.33971,103.717548
618400,8,0,8,1.339695,103.717783
618401,3,0,3,1.338722,103.717145
618403,4,3,7,1.301304,103.71946
618404,4,14,18,1.339612,103.718422
618405,0,3,3,1.339856,103.717768
618406,14,0,14,1.339647,103.718399
618409,6,2,8,1.339722,103.718362
618410,31,1,32,1.339786,103.718307
618411,0,1,1,1.339835,103.717741
618413,2,3,5,1.339847,103.718279
618414,12,3,15,1.339925,103.718214
618415,4,1,5,1.33991,103.718238
618417,0,1,1,1.339785,103.71832
618418,0,4,4,1.339192,103.717007
618420,0,1,1,1.339973,103.718196
618421,0,2,2,1.339538,103.71754
618422,0,9,9,1.340203,103.71803
618423,0,1,1,1.340133,103.718076
618424,8,3,11,1.340125,103.718082
618425,7,19,26,1.340213,103.71804
618426,0,1,1,1.34016,103.718072
618427,2,0,2,1.340098,103.718113
618428,16,0,16,1.33989,103.718238
618429,45,16,61,1.340481,103.718341
618430,14,1,15,1.340334,103.717873
618431,5,0,5,1.340563,103.718586
618433,0,5,5,1.340572,103.718918
618434,0,12,12,1.340213,103.71802
618435,7,5,12,1.340547,103.718913
618436,8,0,8,1.34023,103.718039
618437,2,1,3,1.339628,103.718424
618439,2,1,3,1.340513,103.718918
618441,1,2,3,1.340444,103.718929
618442,3,11,14,1.340331,103.718152
618443,19,1,20,1.340306,103.71895
618444,2,0,2,1.340365,103.71821
618445,5,1,6,1.340236,103.71896
618446,55,13,68,1.340398,103.718227
618447,3,1,4,1.340064,103.718122
618448,1,0,1,1.340047,103.718134
618449,89,3,92,1.340098,103.718981
618450,0,2,2,1.340365,103.71819
618451,1,0,1,1.340431,103.718265
618452,8,2,10,1.340493,103.718342
618453,1,10,11,1.33996,103.719002
618454,3,0,3,1.340375,103.718939
618455,10,17,27,1.340537,103.718439
618457,3,3,6,1.340553,103.718515
618458,0,2,2,1.340464,103.718302
618459,0,1,1,1.340029,103.718992
618460,5,0,5,1.340571,103.718673
618461,2,0,2,1.340563,103.718566
618462,2,1,3,1.340518,103.718385
618463,1,2,3,1.340577,103.71877
618464,4,0,4,1.340167,103.718971
618465,3,3,6,1.340592,103.718918
618466,0,4,4,1.34058,103.718851
618467,7,4,11,1.340513,103.718938
618468,0,4,4,1.340547,103.718933
618469,0,3,3,1.340578,103.718794
618470,2,0,2,1.340574,103.718721
618471,2,1,3,1.340375,103.718959
618472,3,1,4,1.340444,103.718949
618473,1,1,2,1.340306,103.71897
618474,0,2,2,1.340098,103.719001
618475,0,11,11,1.33997,103.719012
618476,0,92,92,1.339934,103.718988
618477,0,7,7,1.339919,103.718965
618478,7,3,10,1.339888,103.718918
618479,1,1,2,1.340029,103.719012
618480,0,4,4,1.340167,103.718991
618482,5,1,6,1.339764,103.718728
618483,1,2,3,1.340236,103.71898
618484,6,27,33,1.339701,103.718634
618485,43,1,44,1.33967,103.718587
618486,0,43,43,1.339639,103.71854
618487,2,2,4,1.339826,103.718823
618488,3,19,22,1.339587,103.718455
618489,6,2,8,1.339577,103.718445
618490,3,32,35,1.339571,103.718436
618491,0,9,9,1.301352,103.717925
618492,548,255,803,1.314061,103.725306
618494,4080,732,4812,1.325076,103.719871
618495,203,398,601,1.335243,103.721422
618497,33,1470,1503,1.33413,103.721968
618499,601,834,1435,1.334463,103.721391
618590,110,293,403,1.324966,103.72185
618591,131,372,503,1.326291,103.723988
618592,52,2467,2519,1.326847,103.724141
618593,217,12718,12935,1.326983,103.724765
618594,9948,1477,11425,1.326168,103.720679
618616,22,4063,4085,1.335581,103.721784
618617,231,855,1086,1.335638,103.719882
618640,843,992,1835,1.325641,103.72498
618641,37,9258,9295,1.326773,103.7255
618642,664,942,1606,1.3259,103.724955
618643,253,466,719,1.332803,103.72513
618644,118,751,869,1.33363,103.725478
618645,163,1282,1445,1.334451,103.725428
618646,384,541,925,1.334861,103.725512
618647,177,477,654,1.335544,103.725618
618648,280,640,920,1.33618,103.725581
618649,613,850,1463,1.337254,103.725583
618650,395,204,599,1.338005,103.724831
618652,335,687,1022,1.330365,103.724282
618653,12,838,850,1.341207,103.720933
618654,180,15,195,1.341917,103.720994
618656,126,3088,3214,1.340922,103.721797
618657,2,0,2,1.339857,103.71887
618658,2,1,3,1.339732,103.718681
618659,0,19,19,1.329665,103.725305
618679,377,63,440,1.331258,103.716021
618680,0,26,26,1.330649,103.716573
618681,7,0,7,1.331318,103.717062
618682,15,42,57,1.331384,103.716371
618683,36,3,39,1.33158,103.716297
618684,665,4,669,1.331874,103.716236
618685,15,3,18,1.331972,103.716189
618686,4,5,9,1.332364,103.716101
618687,1,13,14,1.332364,103.71608
618688,13,8,21,1.332854,103.715965
618689,20,0,20,1.332756,103.715972
618690,25,0,25,1.333487,103.716634
618691,55,2,57,1.333834,103.715695
618692,55,0,55,1.334166,103.716239
618693,11,4,15,1.334688,103.716318
618694,24,10,34,1.333041,103.715497
618695,1,4,5,1.335003,103.715348
618696,0,2,2,1.329665,103.725656
618697,1,48,49,1.336028,103.715588
618720,143,2111,2254,1.332943,103.723712
618721,10,1880,1890,1.333229,103.723549
618722,5,78,83,1.299509,103.837
618723,36,51,87,1.332987,103.723622
618724,40,113,153,1.33316,103.723445
618725,17,173,190,1.333176,103.723498
618726,60,79,139,1.333084,103.723707
618744,93,979,1072,1.336815,103.722226
618768,80,94,174,1.330072,103.714897
618769,67,19,86,1.330592,103.715418
618770,6,24,30,1.330269,103.714842
618771,79,58,137,1.332089,103.71487
618772,45,37,82,1.33089,103.713846
618773,38,0,38,1.332509,103.714238
618774,72,0,72,1.33124,103.713784
618775,289,32,321,1.333027,103.715002
618776,167,31,198,1.331708,103.713869
618777,42,1,43,1.332082,103.713749
618778,2,0,2,1.335373,103.715761
618779,0,14,14,1.333036,103.714071
618780,59,20,79,1.333187,103.713716
618781,310,4,314,1.331287,103.71473
618802,955,5,960,1.330025,103.710788
618803,91,68,159,1.3295,103.710298
618804,37,146,183,1.330024,103.708908
618805,5,183,188,1.330435,103.710119
618806,231,24,255,1.331016,103.709455
618807,16,0,16,1.332411,103.709113
618808,118,81,199,1.33136,103.710566
618809,613,229,842,1.335232,103.709991
618810,240,601,841,1.331932,103.710552
618811,17,88,105,1.333564,103.710745
618812,14,3,17,1.33373,103.710786
618813,60,0,60,1.333925,103.710826
618814,73,0,73,1.33405,103.710831
618815,90,82,172,1.334224,103.710956
618816,2,1,3,1.329671,103.726021
618817,10,0,10,1.334477,103.710476
618818,8,20,28,1.334736,103.710541
618819,3,9,12,1.334995,103.710606
618820,4,113,117,1.335254,103.710672
618821,16,595,611,1.335513,103.710737
618822,5,18,23,1.335772,103.710802
618823,13,374,387,1.336021,103.710857
618824,61,108,169,1.333245,103.710491
618825,18,142,160,1.3295,103.710297
618826,54,187,241,1.329085,103.709038
618827,2,1,3,1.334218,103.710411
618828,1273,122,1395,1.327562,103.709855
618846,0,35,35,1.325983,103.713566
618847,1,0,1,1.340567,103.718619
618848,0,2,2,1.332641,103.714181
618850,12,3,15,1.32493,103.713814
618852,1,0,1,1.325866,103.713574
618854,0,15,15,1.323537,103.714136
618877,3,113,116,1.325525,103.710508
618878,12,224,236,1.3254,103.710517
618879,0,7,7,1.325369,103.710544
618880,0,7,7,1.325057,103.710615
618881,0,6,6,1.324557,103.710708
618882,0,3,3,1.330205,103.709753
618883,4,156,160,1.323996,103.710836
618884,0,4,4,1.33508,103.723056
618885,1,75,76,1.323434,103.710963
618887,1,16,17,1.323184,103.71104
618911,3,9,12,1.32658,103.717878
618912,0,9,9,1.326616,103.718008
618913,0,22,22,1.326658,103.718175
618914,0,20,20,1.326723,103.718374
618915,2,4,6,1.326795,103.718834
618916,0,11,11,1.327335,103.718643
618917,0,6,6,1.327029,103.717543
618918,1,9,10,1.326553,103.717888
618921,0,1,1,1.324229,103.71398
618923,5,829,834,1.326682,103.718984
618924,0,5,5,1.32649,103.717639
618925,0,27,27,1.325561,103.718093
618927,0,64,64,1.324833,103.718241
618951,1,11,12,1.326773,103.716209
618952,0,1,1,1.326695,103.718385
618953,2,0,2,1.325632,103.713649
618961,1,0,1,1.326666,103.715958
618963,1,0,1,1.325122,103.71651
618986,3,58,61,1.325672,103.711804
618987,3,13,16,1.325719,103.711772
618988,0,3,3,1.324745,103.710686
618989,2,0,2,1.326638,103.716239
618990,1,3,4,1.324433,103.710757
618991,0,3,3,1.325718,103.711771
618993,0,3,3,1.325484,103.71183
618995,0,2,2,1.325391,103.711874
618997,0,1,1,1.324677,103.716674
618999,0,69,69,1.323606,103.712297
619000,2,56,58,1.323137,103.712414
619023,6,4,10,1.328103,103.712997
619024,32,68,100,1.328679,103.712599
619025,5,0,5,1.328079,103.7129
619026,3,79,82,1.327958,103.712314
619027,1,7,8,1.328032,103.712704
619028,11,0,11,1.328512,103.711564
619029,140,10,150,1.327985,103.712509
619030,67,139,206,1.327583,103.710751
619031,5,0,5,1.327938,103.712314
619032,2,2,4,1.325484,103.711831
619033,21,0,21,1.327798,103.711728
619034,2,0,2,1.324546,103.712064
619035,8,7,15,1.327704,103.711337
619036,7,8,15,1.327657,103.711142
619037,58,8,66,1.32761,103.710946
619038,6,47,53,1.327563,103.710751
619061,11,580,591,1.338889,103.721554
619062,144,395,539,1.339343,103.722239
619063,88,213,301,1.340108,103.722544
619064,108,27,135,1.340255,103.722154
619065,25,1041,1066,1.340498,103.722477
619088,746,229,975,1.322029,103.718272
619089,7,524,531,1.320858,103.719456
619090,11,0,11,1.320248,103.720095
619091,262,0,262,1.31957,103.719195
619092,321,339,660,1.319469,103.721282
619093,892,0,892,1.318436,103.721593
619094,655,4,659,1.31828,103.720015
619095,32,443,475,1.317742,103.721738
619096,127,19,146,1.317512,103.721081
619097,438,9,447,1.317329,103.719003
619098,41,201,242,1.316751,103.721172
619099,102,28,130,1.316453,103.718184
619100,2,216,218,1.316538,103.720129
619101,206,1316,1522,1.31569,103.720303
619102,309,25,334,1.314804,103.721022
619103,162,21,183,1.3133,103.717946
619104,567,5,572,1.312604,103.718301
619105,43,1039,1082,1.313494,103.719379
619107,635,81,716,1.312026,103.717963
619108,22,339,361,1.313259,103.719278
619109,7,4,11,1.313258,103.719258
619110,2575,340,2915,1.30975,103.717192
619111,2,111,113,1.304527,103.723065
619112,29,73,102,1.315364,103.719741
619113,377,167,544,1.315015,103.718429
619114,157,2,159,1.31809,103.719138
619115,2753,1716,4469,1.313258,103.719863
619116,6,2,8,1.322047,103.720008
619117,24,363,387,1.322226,103.720745
619119,305,74,379,1.323594,103.722994
619120,1,0,1,1.324076,103.712181
619135,22,22,44,1.309589,103.711976
619157,38,20,58,1.319916,103.710848
619158,614,205,819,1.317625,103.710968
619159,303,115,418,1.315375,103.709295
619160,3078,53,3131,1.316933,103.710796
619161,327,0,327,1.310534,103.708129
619162,8,121,129,1.31061,103.70983
619163,339,18,357,1.311423,103.709384
619164,18,629,647,1.315379,103.710257
619165,3,4,7,1.308693,103.707495
619166,29,1594,1623,1.309912,103.709691
619167,135,903,1038,1.308263,103.710351
619168,1064,519,1583,1.309017,103.710642
619169,33,15,48,1.308788,103.710295
619174,11,27,38,1.308788,103.710295
619175,53,69,122,1.310932,103.710395
619176,1,33,34,1.312305,103.709421
619177,119,49,168,1.317431,103.710232
619197,40,45,85,1.329527,103.715657
619198,42,1,43,1.329351,103.716466
619199,21,0,21,1.328899,103.715828
619201,76,50,126,1.329519,103.715384
619202,62,8,70,1.329053,103.715479
619203,6,1,7,1.328697,103.715555
619229,0,20,20,1.331891,103.725309
619230,46,98,144,1.333893,103.727557
619252,7,11,18,1.326324,103.713473
619254,3,28,31,1.326937,103.716073
619255,1,7,8,1.326916,103.715309
619257,4,22,26,1.326723,103.714547
619258,23,0,23,1.326415,103.713019
619259,177,127,304,1.326328,103.712645
619260,1,29,30,1.326811,103.71159
619261,3,280,283,1.325878,103.710774
619262,6,11,17,1.326185,103.712032
619263,0,2,2,1.327751,103.711532
619264,2115,0,2115,1.32577,103.712026
619265,270,5,275,1.325947,103.71428
619266,497,5,502,1.325941,103.710016
619284,8,248,256,1.320509,103.720736
619285,444,209,653,1.319696,103.722446
619286,7,0,7,1.320514,103.721267
619287,3,1,4,1.327891,103.712118
619289,0,29,29,1.320409,103.723488
619290,2,0,2,1.327679,103.717205
619291,0,5,5,1.32206,103.725114
619292,272,0,272,1.322652,103.724761
619295,1,17,18,1.321737,103.725383
619298,2,3,5,1.320675,103.725274
619299,549,82,631,1.32001,103.726386
619300,17,56,73,1.320049,103.725299
619301,14,6,20,1.318325,103.72825
619302,368,16,384,1.320551,103.722268
619303,0,120,120,1.320494,103.723061
619305,3,0,3,1.325015,103.711947
619306,1,0,1,1.321949,103.723177
619325,109,220,329,1.309768,103.721885
619326,2,124,126,1.31139,103.720676
619327,43,15,58,1.310664,103.721428
619328,211,32,243,1.310091,103.720144
619329,1,4,5,1.308504,103.720363
619330,0,1,1,1.318948,103.728593
619331,46,29,75,1.307904,103.721446
619336,922,18,940,1.308133,103.722354
619337,1,0,1,1.307441,103.720476
619339,0,5,5,1.308126,103.722364
619341,4,0,4,1.320435,103.722971
619342,0,9,9,1.308106,103.72236
619343,3,0,3,1.319058,103.72772
619344,2,7,9,1.308306,103.721708
619345,0,1,1,1.30811,103.722386
619346,0,14,14,1.308306,103.721708
619347,1,4,5,1.308306,103.721708
619348,7,0,7,1.308306,103.721708
619358,122,20,142,1.318807,103.712361
619359,72,85,157,1.319009,103.710757
619360,30,191,221,1.319891,103.713
619361,117,3,120,1.320691,103.711908
619362,743,11,754,1.319068,103.713948
619363,1846,7,1853,1.320927,103.712835
619364,3,83,86,1.319675,103.714605
619365,380,72,452,1.321119,103.713515
619366,0,4,4,1.308128,103.722363
619367,531,41,572,1.3213,103.714171
619368,5,31,36,1.319971,103.715723
619369,2,0,2,1.321414,103.72389
619391,18,633,651,1.299509,103.837
619392,436,10,446,1.320584,103.727508
619393,27,0,27,1.322708,103.730297
619394,10,110,120,1.321789,103.727356
619395,5,21,26,1.322056,103.728926
619396,888,0,888,1.323243,103.725134
619397,9,16,25,1.323977,103.728262
619398,0,6,6,1.323828,103.72941
619399,2,13,15,1.324755,103.729954
619400,8,1,9,1.323814,103.731125
619401,0,7,7,1.324744,103.729963
619402,25,4,29,1.324238,103.73034
619403,52,0,52,1.323397,103.730464
619404,8,0,8,1.322055,103.729552
619405,2,0,2,1.319837,103.715964
619406,128,0,128,1.323049,103.727377
619407,44,22,66,1.323595,103.726864
619408,17,22,39,1.323821,103.727459
619409,0,6,6,1.324274,103.726952
619412,25,0,25,1.322289,103.730903
619413,25,2,27,1.322267,103.73123
619414,1,65,66,1.324547,103.728132
619415,819,202,1021,1.320429,103.730124
619416,10,70,80,1.321687,103.72831
619417,12,0,12,1.32335,103.731723
619418,16,169,185,1.3253,103.73166
619419,56,105,161,1.324853,103.729823
619420,739,1140,1879,1.299509,103.837
619421,283,441,724,1.322237,103.728153
619422,5,6,11,1.324423,103.717918
619423,4,36,40,1.324403,103.717918
619424,0,5,5,1.324145,103.716646
619425,12,2,14,1.324125,103.716646
619426,9,324,333,1.323834,103.715384
619427,2,29,31,1.324125,103.716646
619429,6,20,26,1.323537,103.714136
619430,6,70,76,1.323814,103.715384
619431,2,125,127,1.323814,103.715384
619432,0,1,1,1.308306,103.721708
619435,4,35,39,1.323452,103.713851
619436,4,11,15,1.323147,103.712424
619437,178,10,188,1.323387,103.713565
619439,0,7,7,1.323015,103.711762
619440,0,26,26,1.323257,103.712995
619441,3,39,42,1.322882,103.711101
619442,0,12,12,1.323127,103.712424
619443,2,38,40,1.323127,103.712424
619444,5,14,19,1.322862,103.711101
619445,3,5,8,1.323147,103.712424
619468,4,0,4,1.319915,103.71546
619469,9,1,10,1.312326,103.700205
619470,3,10,13,1.312465,103.700475
619471,6,2,8,1.311765,103.701865
619472,1,6,7,1.31267,103.700876
619473,1,3,4,1.31416,103.714258
619474,6,103,109,1.313007,103.701539
619475,1188,32,1220,1.312002,103.70376
619476,46,85,131,1.313834,103.702684
619477,104,146,250,1.312834,103.704545
619478,1674,250,1924,1.31499,103.70419
619479,70,14,84,1.314781,103.705614
619480,194,53,247,1.312785,103.705395
619481,32,111,143,1.31471,103.706275
619482,79,11,90,1.313287,103.706377
619483,50,96,146,1.31487,103.706884
619484,657,26,683,1.312654,103.70715
619485,7,10,17,1.314262,103.707733
619486,36,72,108,1.31276,103.708121
619487,173,259,432,1.314745,103.714772
619488,249,73,322,1.317029,103.714246
619489,62,12,74,1.312692,103.713943
619490,23,36,59,1.317909,103.71448
619491,406,34,440,1.317238,103.716629
619492,487,15,502,1.318338,103.716671
619493,5,6,11,1.319646,103.717913
619494,4,90,94,1.313837,103.716946
619495,165,364,529,1.314615,103.72196
619496,27,242,269,1.314268,103.71998
619497,12,286,298,1.31436,103.715392
619498,1,51,52,1.314267,103.72424
619500,8,5,13,1.311981,103.699698
619501,2,0,2,1.322283,103.730489
619502,7,37,44,1.31208,103.699919
619503,1,20,21,1.311899,103.699461
619521,5,799,804,1.343857,103.707319
619522,375,566,941,1.341733,103.710177
619523,4973,2290,7263,1.339471,103.712539
619524,4,0,4,1.312683,103.702855
619525,14,164,178,1.334718,103.708908
619526,31,288,319,1.336658,103.709402
619527,622,65,687,1.331861,103.707195
619528,963,414,1377,1.329988,103.706958
619529,397,0,397,1.328971,103.706982
619530,412,94,506,1.32697,103.707759
619531,103,105,208,1.326311,103.708365
619554,29,22,51,1.318353,103.724921
619555,5,20,25,1.319875,103.72427
619556,201,0,201,1.317854,103.725318
619557,106,13,119,1.318328,103.723483
619559,15,172,187,1.317884,103.725722
619560,194,17,211,1.317639,103.723103
619561,55,10,65,1.317767,103.726237
619562,1,0,1,1.323537,103.714136
619563,32,143,175,1.31734,103.726378
619564,1,0,1,1.317191,103.723776
619565,0,1,1,1.316691,103.724813
619566,53,0,53,1.316068,103.725294
619568,134,5,139,1.31607,103.726291
619569,2,0,2,1.319963,103.717849
619570,87,4,91,1.316374,103.727221
619571,376,77,453,1.315623,103.727043
619572,0,4,4,1.337109,103.710389
619573,0,4,4,1.317272,103.724563
619594,39,446,485,1.325017,103.724768
619595,170,169,339,1.323751,103.721846
619596,1,88,89,1.321382,103.71143
619618,42,242,284,1.331683,103.719984
619619,12,0,12,1.331056,103.719335
619622,1,0,1,1.317192,103.726889
619623,1,30,31,1.329004,103.714186
619624,3,71,74,1.326812,103.710622
619625,904,6,910,1.331153,103.711746
619626,123,280,403,1.329627,103.711111
619628,69,256,325,1.326607,103.69483
619651,247,50,297,1.329083,103.72371
619652,1,191,192,1.299509,103.837
619697,19,2,21,1.33142,103.717858
619698,118,3,121,1.332086,103.718443
619699,0,1,1,1.327762,103.714774
619700,9,19,28,1.332843,103.717463
619701,2,0,2,1.31571,103.726601
619702,347,87,434,1.333722,103.717373
619703,62,18,80,1.333964,103.717685
619704,1,0,1,1.332413,103.717546
619705,8,15,23,1.334938,103.717405
619706,309,0,309,1.335322,103.717632
619707,27,19,46,1.333176,103.718911
619708,17,193,210,1.331025,103.718686
619729,326,15,341,1.312836,103.723967
619730,156,96,252,1.312635,103.725444
619732,37,130,167,1.31077,103.722289
619733,28,5,33,1.312024,103.725375
619734,41,23,64,1.310526,103.72128
619735,377,30,407,1.311256,103.724984
619736,211,39,250,1.312011,103.724428
619737,7,12,19,1.311554,103.723691
619738,2,99,101,1.311973,103.723355
619739,297,618,915,1.311451,103.72328
619740,20,700,720,1.310318,103.722735
619741,247,26,273,1.310366,103.724203
619742,722,11,733,1.309235,103.723282
619743,70,8,78,1.308735,103.72313
619744,71,0,71,1.308106,103.722927
619746,488,215,703,1.312697,103.722635
619747,2675,91,2766,1.312226,103.722348
619767,0,138,138,1.326894,103.722586
619768,2,270,272,1.326932,103.722715
619771,351,1395,1746,1.331049,103.723
619773,34,17138,17172,1.334925,103.722167
619795,112,4,116,1.336189,103.73096
619818,6,9,15,1.326837,103.714035
619819,14,0,14,1.327235,103.713294
619820,26,14,40,1.327943,103.713774
619821,1,8,9,1.328506,103.713642
619824,406,54,460,1.330251,103.713604
619826,128,85,213,1.330415,103.712556
619827,25,5,30,1.330978,103.712417
619828,146,14,160,1.331499,103.712968
619829,142,40,182,1.33195,103.712886
619830,122,5,127,1.332374,103.712782
619831,52,39,91,1.332169,103.711406
619832,202,0,202,1.332678,103.712438
619833,384,139,523,1.32988,103.712034
619855,694,208,902,1.335089,103.712161
619856,24,4,28,1.335103,103.712975
619857,94,74,168,1.336151,103.712447
619858,636,20,656,1.336088,103.713434
619859,6,41,47,1.335341,103.713304
619860,14,62,76,1.336161,103.714131
619861,38,54,92,1.335967,103.713497
619862,367,14,381,1.337182,103.715212
619863,1071,203,1274,1.338169,103.716136
619864,217,39,256,1.335591,103.714754
619865,8,278,286,1.336465,103.715286
619867,1,3,4,1.299509,103.837
619868,243,4,247,1.335493,103.714172
619869,148,389,537,1.336812,103.71741
619870,206,38,244,1.336165,103.717097
619890,96,9,105,1.335868,103.711587
619891,1,0,1,1.334492,103.716996
619892,10,4,14,1.337049,103.711912
619893,227,2,229,1.336591,103.712694
619894,20,28,48,1.337059,103.711922
619895,67,0,67,1.33705,103.712044
619896,12,2,14,1.336737,103.713703
619897,1,0,1,1.336425,103.711575
619898,1,13,14,1.337017,103.712534
619900,1,3,4,1.337061,103.717028
619901,10,6,16,1.337435,103.714238
619902,17,50,67,1.337018,103.714479
619903,146,38,184,1.336584,103.71459
619926,33,2,35,1.334278,103.715429
619927,17,77,94,1.334798,103.715019
619928,142,0,142,1.334243,103.715309
619929,2,1,3,1.308306,103.721708
619930,196,3,199,1.334628,103.71437
619931,101,26,127,1.334101,103.714826
619932,4,49,53,1.33376,103.713602
619933,21,0,21,1.33403,103.714585
619934,38,1,39,1.334437,103.713171
619935,2,61,63,1.333959,103.714344
619937,68,0,68,1.333376,103.71231
619938,71,1,72,1.333827,103.713871
619939,41,1,42,1.333908,103.711953
619940,5,21,26,1.333167,103.711035
619941,14,0,14,1.333254,103.713183
619942,1,17,18,1.333212,103.711803
619943,1,8,9,1.332693,103.711383
619944,220,46,266,1.332664,103.71002
619945,146,0,146,1.333742,103.711439
619967,0,1,1,1.337028,103.712371
619968,196,34,230,1.328056,103.718716
619969,4,46,50,1.32827,103.719015
619970,2,8,10,1.329255,103.71725
619971,1,43,44,1.328541,103.719709
619972,12,50,62,1.330062,103.717261
619973,4,14,18,1.330322,103.720523
619974,15,2,17,1.329846,103.71977
619975,16,7,23,1.328986,103.719713
619976,462,13,475,1.329315,103.718821
619977,28,3,31,1.330212,103.718136
619978,47,187,234,1.329468,103.72049
619979,17,17,34,1.33022,103.718664
620000,4,12,16,1.259936,103.703978
627485,645,48,693,1.316702,103.701688
627495,778,25,803,1.281979,103.719925
627510,15,2125,2140,1.299509,103.837
627515,44,5,49,1.324649,103.673741
627521,116,18,134,1.299509,103.837
627525,12,3,15,1.299509,103.837
627526,198,24,222,1.299509,103.837
627528,224,78,302,1.299509,103.837
627531,108,0,108,1.299509,103.837
627532,658,16,674,1.312286,103.701558
627535,120,53,173,1.273453,103.675196
627536,86,8,94,1.299509,103.837
627540,1119,3,1122,1.299509,103.837
627541,771,119,890,1.299509,103.837
627542,1943,355,2298,1.299509,103.837
627545,3979,185,4164,1.312515,103.697473
627546,19,92,111,1.310586,103.69857
627550,3,9,12,1.312669,103.70088
627551,2,2,4,1.336995,103.71286
627552,2,0,2,1.333208,103.717155
627553,17,2,19,1.299509,103.837
627555,2,0,2,1.299509,103.837
627556,37,11,48,1.314768,103.705621
627557,2,0,2,1.299509,103.837
627558,0,2,2,1.299509,103.837
627559,17,1,18,1.313262,103.700833
627560,2,4,6,1.299509,103.837
627561,0,36,36,1.314745,103.714772
627562,41,57,98,1.313479,103.701189
627563,710,101,811,1.311535,103.699673
627564,269,5,274,1.312179,103.702386
627565,168,108,276,1.31325,103.700982
627567,34,3,37,1.330322,103.720523
627568,3,2,5,1.299509,103.837
627569,0,10,10,1.299509,103.837
627570,152,9,161,1.261433,103.676349
627571,1066,28,1094,1.299509,103.837
627575,4996,521,5517,1.375446,104.003223
627576,2694,243,2937,1.321107,103.702245
627577,560,145,705,1.321203,103.701262
627580,476,4,480,1.299509,103.837
627585,1,9,10,1.299509,103.837
627586,636,69,705,1.270662,103.662507
627590,33,258,291,1.299509,103.837
627591,125,46,171,1.280865,103.679083
627595,935,56,991,1.263961,103.668644
627596,1501,0,1501,1.263878,103.668583
627597,56,13,69,1.299509,103.837
627600,713,139,852,1.299509,103.837
627605,837,1913,2750,1.333255,103.697697
627606,717,516,1233,1.333768,103.697502
627607,574,1227,1801,1.334285,103.698768
627608,898,176,1074,1.333792,103.700088
627610,647,119,766,1.275007,103.667496
627611,359,53,412,1.273312,103.664602
627612,4,4,8,1.299509,103.837
627614,615,1,616,1.272553,103.665068
627615,1658,112,1770,1.315616,103.697418
627616,1595,40,1635,1.315998,103.698001
627620,76,2,78,1.270269,103.670645
627621,27,32,59,1.299509,103.837
627625,320,29,349,1.274061,103.709862
627626,93,12,105,1.273676,103.801522
627627,2,10,12,1.37958,103.940668
627630,0,3,3,1.334172,103.715067
627635,487,352,839,1.317134,103.694718
627640,3,0,3,1.24278,103.689996
627641,2,0,2,1.299509,103.837
627642,49,11,60,1.254123,103.674668
627643,1,1,2,1.247243,103.675729
627644,120,1,121,1.299509,103.837
627645,25,31,56,1.264601,103.701451
627646,188,2,190,1.299509,103.837
627647,2,1,3,1.248252,103.675879
627650,12,4,16,1.333332,103.702492
627651,3,3,6,1.333814,103.702936
627652,0,1,1,1.328166,103.717777
627653,10,0,10,1.333972,103.70293
627654,5,0,5,1.33404,103.70294
627655,7,11,18,1.334119,103.702941
627656,1,13,14,1.334203,103.702937
627657,2,59,61,1.334305,103.702616
627658,5,1,6,1.334221,103.702607
627659,5,2,7,1.334127,103.702614
627661,5,2,7,1.333972,103.702611
627662,0,2,2,1.299509,103.837
627663,4,2,6,1.333332,103.702492
627664,17,7,24,1.333332,103.702492
627665,20,4,24,1.333332,103.702492
627666,1,6,7,1.333332,103.702492
627667,2,37,39,1.333332,103.702492
627675,125,3,128,1.333312,103.703658
627678,15,0,15,1.333312,103.703658
627679,24,31,55,1.333312,103.703658
627680,15,49,64,1.333313,103.703659
627681,17,0,17,1.333312,103.703658
627682,16,1,17,1.333312,103.703658
627683,1,0,1,1.333883,103.702928
627684,2,0,2,1.333332,103.702492
627685,0,1,1,1.333312,103.703658
627686,2,1,3,1.299509,103.837
627687,7,0,7,1.334042,103.703536
627688,1,0,1,1.333312,103.703658
627689,0,29,29,1.334204,103.70351
627690,2,19,21,1.334201,103.703177
627691,8,0,8,1.334129,103.703188
627693,3,1,4,1.312659,103.701515
627694,8,0,8,1.333912,103.70321
627695,2,1,3,1.333988,103.703499
627696,1,0,1,1.334147,103.703534
627697,27,4,31,1.333312,103.703658
627698,44,12,56,1.33332,103.70327
627699,15,11,26,1.333333,103.702494
627700,6,2,8,1.258578,103.678953
627705,269,24,293,1.306993,103.672856
627710,123,8,131,1.224884,103.673955
627711,8,14,22,1.229578,103.682152
627712,8,12,20,1.226482,103.679035
627713,7,24,31,1.223082,103.672273
627715,16,15,31,1.275985,103.714478
627716,55,0,55,1.2664,103.725025
627717,640,152,792,1.273333,103.720257
627718,192,113,305,1.271132,103.720947
627719,45,46,91,1.275763,103.713775
627720,83,18,101,1.270278,103.682502
627721,8,33,41,1.299509,103.837
627722,537,97,634,1.256401,103.664744
627723,10,2,12,1.257979,103.666395
627725,198,256,454,1.311106,103.677315
627730,174,0,174,1.27569,103.720557
627731,16,98,114,1.299509,103.837
627735,493,0,493,1.301481,103.684628
627736,111,45,156,1.303391,103.678877
627740,201,123,324,1.285833,103.7212
627745,395,0,395,1.261416,103.709568
627748,130,0,130,1.299509,103.837
627749,182,0,182,1.299509,103.837
627750,1006,1,1007,1.317095,103.693747
627751,88,5,93,1.31896,103.695558
627752,195,29,224,1.319623,103.694989
627753,2762,463,3225,1.321231,103.695034
627754,23,8,31,1.318467,103.694049
627755,19,3,22,1.262115,103.675415
627756,3,0,3,1.33384,103.703213
627757,141,0,141,1.261784,103.674775
627758,4,0,4,1.333996,103.703206
627759,20,0,20,1.261698,103.674631
627760,1,0,1,1.333731,103.703205
627761,3,0,3,1.261777,103.674792
627762,81,20,101,1.261571,103.674466
627764,21,0,21,1.261143,103.674698
627770,9,0,9,1.261395,103.674993
627772,9,1,10,1.261466,103.675105
627773,0,123,123,1.261513,103.67517
627774,14,2,16,1.318836,103.694425
627775,24,0,24,1.308193,103.674516
627776,0,1,1,1.261645,103.674611
627777,19,4,23,1.30818,103.674389
627778,25,7,32,1.308186,103.674224
627779,0,4,4,1.261719,103.674726
627780,10,0,10,1.30813,103.67406
627781,0,2,2,1.333312,103.703658
627782,1,13,14,1.30812,103.673897
627783,0,47,47,1.308104,103.6738
627784,87,63,150,1.308676,103.673786
627785,8,5,13,1.30869,103.673874
627787,5,3,8,1.308707,103.674086
627788,7,15,22,1.308712,103.674145
627789,1,10,11,1.308715,103.674308
627790,8,0,8,1.308719,103.674416
627791,1,1,2,1.308126,103.673978
627792,19,3,22,1.308745,103.674605
627793,11,2,13,1.308767,103.67476
627794,94,17,111,1.30877,103.674854
627795,29,14,43,1.30882,103.674939
627796,10,38,48,1.308832,103.675
627797,20,69,89,1.308812,103.675117
627798,11,175,186,1.308816,103.675181
627799,409,37,446,1.27031,103.681088
627800,122,33,155,1.304433,103.673757
627801,479,96,575,1.257582,103.702854
627802,0,2,2,1.308729,103.674514
627803,150,9,159,1.289547,103.723075
627804,169,144,313,1.308097,103.671998
627805,154,1,155,1.282326,103.675224
627806,481,37,518,1.249383,103.686254
627807,224,8,232,1.238895,103.685621
627808,39,1,40,1.273232,103.675269
627809,15,60,75,1.302264,103.686207
627810,205,33,238,1.305882,103.674211
627811,3,0,3,1.261607,103.674546
627812,578,18,596,1.265848,103.678661
627813,7,1,8,1.305833,103.675253
627814,17,11,28,1.30297,103.684493
627815,79,68,147,1.263555,103.668119
627816,14,73,87,1.290012,103.709711
627817,425,21,446,1.304419,103.673333
627818,4,13,17,1.276506,103.721621
627819,1,2,3,1.252003,103.696733
627820,1,5,6,1.282948,103.675426
627821,3,16,19,1.259186,103.714048
627822,0,5,5,1.273256,103.739804
627823,7,2,9,1.289408,103.724536
627824,50,59,109,1.307971,103.67122
627825,160,280,440,1.275499,103.71514
627826,24,144,168,1.320152,103.694997
627827,22,0,22,1.26117,103.675159
627828,55,24,79,1.29681,103.668557
627829,29,4,33,1.254346,103.697769
627830,93,32,125,1.283714,103.719286
627831,100,53,153,1.275745,103.676312
627832,31,3,34,1.273031,103.73172
627833,1005,62,1067,1.28156,103.678582
627834,0,8,8,1.273432,103.738371
627835,80,0,80,1.255066,103.697402
627836,51,0,51,1.304552,103.674212
627837,17,1,18,1.268918,103.707313
627838,2,0,2,1.259643,103.700477
627839,62,366,428,1.277735,103.713133
627840,451,48,499,1.279176,103.712483
627841,969,42,1011,1.263574,103.676014
627842,438,53,491,1.303434,103.684841
627843,298,7,305,1.285531,103.723565
627844,240,31,271,1.33282,103.695299
627845,3,1,4,1.307885,103.675763
627846,1,0,1,1.308218,103.67446
627848,4,0,4,1.332826,103.694949
627849,7,2,9,1.333417,103.694809
627850,2,7,9,1.333506,103.695343
627851,4,42,46,1.333019,103.695522
627852,5,7,12,1.333164,103.694781
627853,12,1,13,1.266367,103.728091
627854,483,1053,1536,1.332905,103.695585
627855,0,3,3,1.290524,103.695377
627856,478,198,676,1.320164,103.695606
627857,424,153,577,1.285501,103.721268
627858,549,0,549,1.274397,103.715311
627859,91,121,212,1.254263,103.702935
627860,249,171,420,1.277294,103.717588
627861,320,86,406,1.270285,103.706505
627862,327,12,339,1.277678,103.712872
627863,177,27,204,1.253308,103.699099
627864,93,4,97,1.307309,103.67165
627865,11,117,128,1.280244,103.719178
627866,108,185,293,1.30807,103.672336
627867,18419,1577,19996,1.267965,103.693351
627868,2,0,2,1.258791,103.694669
627869,66,3,69,1.267472,103.691414
627870,37,1,38,1.27339,103.697025
627871,3831,440,4271,1.280203,103.701167
627872,48,78,126,1.256326,103.698043
627873,230,64,294,1.272918,103.723228
627875,56,6,62,1.258929,103.702645
627876,225,42,267,1.259495,103.701509
627877,649,1,650,1.282351,103.715583
627878,653,312,965,1.267534,103.704528
627879,2410,205,2615,1.275107,103.731018
627880,87,15,102,1.271868,103.708793
627881,42,11,53,1.263529,103.694648
627882,167,38,205,1.261093,103.698397
627883,726,0,726,1.255997,103.704233
627884,297,90,387,1.274264,103.722474
627885,473,19,492,1.308581,103.673398
627886,1977,11,1988,1.261057,103.703716
627887,400,42,442,1.258942,103.705801
627888,326,19,345,1.262775,103.696953
627889,603,1,604,1.259579,103.695889
627890,1280,31,1311,1.255494,103.69989
627891,387,80,467,1.263932,103.697581
627892,23,437,460,1.265932,103.702173
627893,165,1,166,1.307477,103.672838
627894,489,7,496,1.25449,103.704168
627895,67,17,84,1.29598,103.6687
627896,731,71,802,1.294815,103.667219
627897,104,51,155,1.296045,103.667795
627901,3,25,28,1.315507,103.69938
627902,6,323,329,1.315769,103.699173
627904,0,14,14,1.315507,103.6994
627905,0,7,7,1.316816,103.698346
627907,0,2,2,1.261299,103.695303
627908,1,5,6,1.316292,103.69878
627909,0,5,5,1.317936,103.698239
627910,1,75,76,1.316816,103.698366
627911,5,86,91,1.319298,103.698372
627912,0,3,3,1.26031,103.699799
627913,22,63,85,1.319308,103.698382
627914,0,1,1,1.332929,103.694541
627915,0,186,186,1.320226,103.698495
627916,0,5,5,1.319288,103.698382
627917,0,30,30,1.321154,103.698619
627934,29,15,44,1.329937,103.704113
627935,14,28,42,1.330441,103.705103
627936,28,2,30,1.329968,103.704513
627937,310,47,357,1.329937,103.705143
627938,5,13,18,1.33112,103.705711
627939,2,0,2,1.317297,103.698217
627940,359,8,367,1.331673,103.705711
627941,15,2,17,1.331238,103.705047
627942,2,3,5,1.33133,103.705808
627943,32,44,76,1.331902,103.705092
627944,9,34,43,1.331912,103.705872
627945,91,0,91,1.331838,103.705468
627946,55,4,59,1.332902,103.705772
627947,5,1,6,1.332411,103.705468
627948,60,9,69,1.332985,103.705467
627949,69,34,103,1.333262,103.705477
627966,256,11369,11625,1.32249,103.706712
627968,823,38,861,1.323448,103.705094
627969,1596,158,1754,1.323361,103.706447
627970,211,27,238,1.324644,103.705538
627971,139,224,363,1.323231,103.708209
627972,23,36,59,1.32545,103.705543
627973,927,17,944,1.324992,103.70777
627974,8,16,24,1.325376,103.70644
627975,102,34,136,1.325944,103.705401
627976,545,0,545,1.32578,103.706929
627977,47,14,61,1.327351,103.705433
627978,0,7,7,1.326556,103.706584
627979,16,31,47,1.326896,103.706446
627996,4,39,43,1.32479,103.689767
627997,37,50,87,1.324687,103.689786
627998,16,15,31,1.325014,103.689767
627999,2,13,15,1.324807,103.689787
628000,3,0,3,1.317936,103.698259
628001,9,0,9,1.325049,103.689787
628002,201,4,205,1.325911,103.68977
628003,18,0,18,1.32529,103.689788
628004,22,0,22,1.32636,103.689771
628005,21,0,21,1.325532,103.689789
628006,34,0,34,1.326808,103.689772
628007,12,13,25,1.325773,103.689789
628008,89,0,89,1.326015,103.68979
628009,2,35,37,1.327705,103.689775
628010,1,17,18,1.326256,103.689791
628011,3,13,16,1.326498,103.689792
628012,18,0,18,1.326739,103.689792
628013,62,0,62,1.326981,103.689793
628014,132,20,152,1.327222,103.689794
628015,48,17,65,1.327464,103.689794
628016,43,20,63,1.327695,103.689785
628033,5,88,93,1.306673,103.699826
628034,1,3,4,1.333381,103.694518
628035,1,1,2,1.331236,103.70505
628036,0,18,18,1.306673,103.699826
628037,3,64,67,1.306673,103.699826
628038,0,11,11,1.306673,103.699826
628039,2,48,50,1.306673,103.699826
628040,8,0,8,1.306673,103.699826
628041,0,55,55,1.306673,103.699826
628042,3,26,29,1.306673,103.699826
628043,3,3,6,1.310112,103.694233
628044,0,5,5,1.306673,103.699826
628045,17,180,197,1.313782,103.695784
628046,0,4,4,1.306673,103.699826
628047,193,279,472,1.308202,103.698511
628048,1910,98,2008,1.308971,103.700708
628049,389,36,425,1.306171,103.699604
628050,1604,289,1893,1.304816,103.701263
628051,379,0,379,1.307256,103.703383
628052,480,40,520,1.303923,103.703061
628053,255,398,653,1.304887,103.703579
628054,3772,13,3785,1.303632,103.705467
628070,81,59,140,1.329156,103.703413
628071,67,36,103,1.328322,103.70278
628072,55,12,67,1.32832,103.702216
628073,10,24,34,1.328352,103.701799
628074,101,8,109,1.32917,103.701299
628075,25,84,109,1.329292,103.700451
628076,40,18,58,1.328365,103.700643
628077,12,19,31,1.328327,103.700039
628078,61,59,120,1.329277,103.699716
628079,9,18,27,1.328345,103.699484
628080,116,159,275,1.32927,103.699081
628081,17,417,434,1.329164,103.698671
628082,144,84,228,1.328621,103.697579
628083,139,30,169,1.331282,103.69836
628084,22,28,50,1.330103,103.69997
628085,141,3408,3549,1.331126,103.699385
628086,18,90,108,1.329865,103.697764
628087,188,661,849,1.330634,103.699844
628088,526,2909,3435,1.332606,103.699137
628099,174,40,214,1.323803,103.684801
628100,41,115,156,1.323361,103.68343
628101,58,9,67,1.324278,103.683525
628102,90,0,90,1.325643,103.68449
628103,62,11,73,1.32488,103.684086
628104,16,7,23,1.326046,103.684775
628105,120,48,168,1.325492,103.683388
628106,164,0,164,1.326494,103.684518
628107,4,15,19,1.326186,103.683341
628108,73,0,73,1.326972,103.68493
628109,459,197,656,1.326446,103.684058
628110,6,49,55,1.327407,103.684704
628111,7,77,84,1.327339,103.683536
628128,852,76,928,1.308483,103.697096
628129,462,23,485,1.306892,103.693297
628130,553,235,788,1.303556,103.692698
628131,107,254,361,1.303318,103.691599
628132,1293,1,1294,1.30084,103.691304
628133,501,149,650,1.302651,103.689118
628134,1530,13,1543,1.302036,103.688309
628135,265,37,302,1.300503,103.687899
628136,14,1,15,1.303654,103.68793
628137,54,45,99,1.303723,103.687228
628139,1069,49,1118,1.304664,103.684155
628140,21,158,179,1.305388,103.683701
628141,136,1,137,1.305798,103.684091
628142,41,14,55,1.306345,103.684153
628143,334,46,380,1.308531,103.683642
628144,607,142,749,1.306892,103.693297
628160,34,5,39,1.327175,103.691624
628161,5,11,16,1.327544,103.691648
628162,731,1,732,1.326752,103.690758
628163,7,0,7,1.327386,103.691647
628164,784,537,1321,1.326149,103.691232
628165,50,1,51,1.32707,103.691643
628166,3,0,3,1.325463,103.689769
628167,6,0,6,1.326753,103.69164
628168,5,0,5,1.326437,103.691636
628169,1,0,1,1.318617,103.698326
628170,3,0,3,1.325608,103.691173
628171,82,0,82,1.326001,103.692044
628172,39,5,44,1.325832,103.692009
628173,11,8,19,1.325666,103.692007
628174,8,1,9,1.325475,103.692097
628191,17,0,17,1.30845,103.692702
628192,7,0,7,1.299509,103.837
628193,2,2,4,1.306673,103.699826
628208,1450,133,1583,1.275886,103.726902
628209,450,92,542,1.277892,103.729677
628225,121,0,121,1.257411,103.710276
628226,209,1,210,1.256509,103.70763
628227,52,65771,65823,1.262933,103.702657
628243,0,1,1,1.326121,103.691633
628260,2811,425,3236,1.281595,103.714012
628277,3419,1014,4433,1.264568,103.724163
628279,35,0,35,1.272184,103.712186
628281,17,0,17,1.269013,103.715005
628282,7,0,7,1.272635,103.71461
628283,4,0,4,1.309598,103.696094
628284,9,420,429,1.272635,103.71461
628285,82,0,82,1.266393,103.720348
628286,23,0,23,1.2716,103.71627
628287,12,0,12,1.271379,103.71676
628288,19,7,26,1.273595,103.710401
628289,6,0,6,1.266814,103.722517
628321,346,17,363,1.298547,103.666579
628322,12,0,12,1.296225,103.667303
628323,4,62,66,1.297755,103.66677
628324,72,1931,2003,1.296235,103.666149
628340,189,76,265,1.301699,103.665213
628341,776,357,1133,1.307163,103.664277
628342,903,110,1013,1.304875,103.663274
628343,38,25,63,1.306206,103.663059
628344,361,125,486,1.304843,103.661766
628345,1,8,9,1.306058,103.660579
628346,1,0,1,1.287245,103.689044
628347,22,0,22,1.307842,103.660098
628348,19,89,108,1.307714,103.659273
628365,10,3,13,1.302862,103.665724
628366,11,5,16,1.302767,103.665528
628367,18,3,21,1.301783,103.665326
628369,10,25,35,1.302385,103.664745
628370,1,2,3,1.325805,103.69163
628371,68,4,72,1.30134,103.664495
628372,4,4,8,1.301137,103.663075
628374,15,0,15,1.3017,103.663824
628375,193,3,196,1.302593,103.662736
628376,4,4,8,1.301408,103.66345
628377,11,46,57,1.303188,103.662107
628378,4,4,8,1.301127,103.663085
628379,12,8,20,1.300866,103.663271
628380,93,5,98,1.303595,103.661143
628381,2,43,45,1.305268,103.658913
628382,2,5,7,1.299092,103.664804
628383,79,13,92,1.305816,103.659187
628384,4,32,36,1.30654,103.65884
628385,156,0,156,1.298613,103.664568
628386,720,1,721,1.305781,103.658049
628387,27,19,46,1.298737,103.665524
628388,72,199,271,1.306294,103.657443
628389,476,31,507,1.303928,103.658633
628390,81,126,207,1.296958,103.665381
628391,42,3,45,1.303352,103.658831
628392,7,23,30,1.295794,103.666545
628393,128,43,171,1.302884,103.659216
628394,23,38,61,1.295569,103.666745
628395,1,15,16,1.302727,103.659834
628396,38,2,40,1.302235,103.659955
628397,9,0,9,1.295114,103.664035
628398,67,0,67,1.295082,103.664036
628399,2,0,2,1.306673,103.699826
628400,1,0,1,1.307008,103.660404
628401,3104,0,3104,1.294943,103.663718
628404,82,0,82,1.295108,103.664057
628406,7,16,23,1.303831,103.659548
628407,55,9,64,1.306512,103.657598
628413,2111,52,2163,1.309062,103.660897
628414,206,3651,3857,1.308741,103.659168
628415,15,26,41,1.30878,103.658309
628416,9,0,9,1.308438,103.658045
628417,1,2,3,1.301803,103.663295
628418,45,92,137,1.308272,103.657549
628419,4,23,27,1.306639,103.658524
628420,210,163,373,1.307065,103.657551
628421,13,56,69,1.30558,103.656857
628422,45,22,67,1.305375,103.656586
628423,162,7,169,1.306456,103.655233
628424,190,64,254,1.304584,103.656318
628425,131,114,245,1.304931,103.654839
628426,35,0,35,1.304956,103.655614
628427,623,0,623,1.304777,103.654524
628428,58,0,58,1.303889,103.65461
628429,13,103,116,1.303993,103.655734
628430,115,2,117,1.303822,103.655312
628431,59,16,75,1.302971,103.655991
628432,120,24,144,1.303382,103.657447
628433,106,156,262,1.302286,103.657218
628434,127,118,245,1.301997,103.657672
628435,4,3,7,1.301647,103.658045
628436,33,0,33,1.301554,103.658715
628437,9258,5,9263,1.300548,103.655761
628438,1381,1731,3112,1.302664,103.655094
628442,2,1,3,1.307767,103.658739
628443,46,101,147,1.299951,103.655841
628444,249,20,269,1.306739,103.656361
628445,9,27,36,1.304033,103.653647
628446,4,12,16,1.30593,103.657286
628455,123,657,780,1.324754,103.696492
628456,101,501,602,1.326044,103.696129
628457,63,24,87,1.325408,103.695453
628458,19,2,21,1.325203,103.695448
628459,41,62,103,1.324857,103.695458
628460,68,154,222,1.329877,103.697019
628461,60,59,119,1.325249,103.694674
628462,6,4,10,1.326131,103.695247
628463,25,1,26,1.326772,103.695258
628464,30,84,114,1.327449,103.695473
628465,7,3,10,1.32682,103.69561
628466,14,5,19,1.325784,103.695778
628467,36,6,42,1.325783,103.695736
628468,17,6,23,1.326845,103.695781
628469,44,205,249,1.326858,103.696177
628471,31,215,246,1.330566,103.696544
628472,3,333,336,1.328299,103.695764
628473,23,437,460,1.331163,103.697002
628474,128,1,129,1.328672,103.695863
628475,438,530,968,1.329215,103.695871
628493,3,27,30,1.317522,103.696286
628494,4,179,183,1.317522,103.696286
628495,16,69,85,1.315864,103.693671
628496,10,146,156,1.315034,103.692109
628498,10798,1447,12245,1.307661,103.687188
628499,99,70,169,1.313157,103.68757
628500,102,56,158,1.309875,103.68093
628502,851,228,1079,1.309711,103.677076
628503,175,0,175,1.307199,103.669991
628504,435,86,521,1.309242,103.674286
628505,33,53,86,1.311326,103.657849
628506,11,2,13,1.310834,103.657478
628507,315,162,477,1.314455,103.685043
628508,338,0,338,1.311936,103.657095
628521,11,154,165,1.316705,103.696336
628522,0,7,7,1.316706,103.696071
628523,1,0,1,1.295117,103.66406
628524,1,0,1,1.316605,103.696498
628525,0,4,4,1.271225,103.711908
628526,0,4,4,1.316419,103.696647
628528,1,26,27,1.316605,103.696478
628529,1,3,4,1.316653,103.696427
628531,0,4,4,1.316466,103.69659
628532,2,16,18,1.316048,103.696925
628550,1,20,21,1.313075,103.69171
628551,14,0,14,1.310659,103.6921
628552,2,0,2,1.295084,103.664029
628553,1697,49,1746,1.312509,103.692438
628554,379,386,765,1.311968,103.695752
628555,1827,316,2143,1.312914,103.695349
628556,427,6,433,1.313482,103.694809
628557,471,8,479,1.314104,103.694236
628558,311,27,338,1.314736,103.693707
628559,599,18,617,1.314912,103.694671
628560,1301,170,1471,1.314752,103.69505
628561,214,496,710,1.314112,103.695171
628562,136,389,525,1.311779,103.694642
628563,24,0,24,1.299509,103.837
628564,3,94,97,1.299509,103.837
628565,1,0,1,1.316705,103.696193
628566,3358,310,3668,1.312218,103.693321
628567,616,69,685,1.312035,103.694422
628569,133,58,191,1.326513,103.703085
628570,1551,0,1551,1.326278,103.703955
628571,148,130,278,1.326503,103.703075
628572,15,2,17,1.325848,103.703088
628573,256,13,269,1.32523,103.702669
628574,55,1,56,1.324972,103.703569
628575,105,19,124,1.325049,103.702273
628576,33,29,62,1.324938,103.701875
628577,142,21,163,1.324048,103.701884
628578,139,10,149,1.324958,103.70145
628579,114,1,115,1.324112,103.700885
628580,13,0,13,1.324234,103.70052
628581,26,12,38,1.324644,103.700929
628582,968,25,993,1.324073,103.700129
628583,2,38,40,1.324712,103.700102
628584,34,0,34,1.324178,103.699594
628585,229,29,258,1.324779,103.699274
628586,6,58,64,1.323193,103.698665
628587,2,13,15,1.324292,103.698545
628588,359,87,446,1.324983,103.697978
628589,37,130,167,1.326983,103.702594
628590,80,0,80,1.326492,103.702709
628591,14,3,17,1.326877,103.702112
628592,4,2,6,1.325617,103.70184
628593,16,8,24,1.327289,103.701648
628594,174,6,180,1.325649,103.701423
628595,163,21,184,1.326865,103.701284
628596,0,6,6,1.326488,103.700831
628597,63,0,63,1.325632,103.7006
628598,518,7,525,1.327143,103.700407
628599,19,1,20,1.325566,103.699933
628600,11,8,19,1.326506,103.699954
628601,21,7,28,1.326064,103.698912
628602,73,28,101,1.327064,103.699652
628603,141,69,210,1.325428,103.698716
628604,36,30,66,1.327102,103.698738
628605,59,17,76,1.32731,103.698134
628606,6,68,74,1.32668,103.697112
628607,4,34,38,1.326509,103.701206
628608,0,20,20,1.324712,103.700102
628612,0,2,2,1.312987,103.690561
628614,48,28,76,1.324173,103.701736
628623,18,213,231,1.323622,103.694904
628625,570,34,604,1.3251,103.694011
628626,15,24,39,1.323417,103.691446
628627,15,70,85,1.323378,103.690645
628628,47,2,49,1.323922,103.6911
628629,26,5,31,1.323411,103.69067
628631,1368,118,1486,1.325073,103.692764
628632,55,9,64,1.323807,103.689858
628633,244,6,250,1.325089,103.69051
628634,1,11,12,1.323632,103.689201
628635,468,46,514,1.323735,103.687521
628636,17,15,32,1.323348,103.686673
628637,17,33,50,1.324086,103.686808
628638,0,2,2,1.324538,103.70369
628639,10,4,14,1.324603,103.685963
628640,5,0,5,1.324602,103.685839
628641,22,3,25,1.324598,103.685591
628642,9,5,14,1.324595,103.685343
628643,20,0,20,1.324591,103.685094
628644,2,2,4,1.316187,103.696813
628645,2,3,5,1.324584,103.684598
628646,34,4,38,1.324581,103.68435
628647,14,11,25,1.324577,103.684102
628704,181,35,216,1.329517,103.701654
628705,52,5,57,1.32957,103.701675
628706,8,5,13,1.329807,103.701656
628707,11,1,12,1.329913,103.701676
628708,190,30,220,1.330388,103.701658
628709,174,6,180,1.330409,103.702305
628710,98,36,134,1.330968,103.701661
628711,2,1,3,1.29886,103.657465
628712,222,1,223,1.331155,103.702274
628713,67,0,67,1.331561,103.701244
628714,54,3,57,1.33163,103.702135
628715,31,7,38,1.332062,103.702273
628716,101,31,132,1.331549,103.701663
628717,127,106,233,1.331991,103.701253
628718,372,68,440,1.332738,103.701257
628731,23,1191,1214,1.332137,103.696283
628732,11,59,70,1.332137,103.696176
628733,11,43,54,1.332139,103.695962
628734,36,4,40,1.33214,103.695747
628735,13,0,13,1.332131,103.695543
628736,11,0,11,1.332142,103.695415
628737,56,22,78,1.332108,103.692151
628738,5,32,37,1.332143,103.695061
628739,22,0,22,1.332144,103.694826
628740,135,16,151,1.332145,103.69459
628741,5,0,5,1.332146,103.694354
628742,2,10,12,1.332147,103.694118
628743,13,0,13,1.332148,103.693883
628744,4,34,38,1.332149,103.693647
628745,16,12,28,1.33214,103.693421
628746,121,16,137,1.332108,103.692131
628747,137,31,168,1.33216,103.693421
628748,6,0,6,1.332594,103.692404
628749,29,7,36,1.332674,103.69102
628750,4,7,11,1.332146,103.694492
628751,86,0,86,1.331647,103.69234
628752,11,1,12,1.331828,103.691259
628753,38,1822,1860,1.332146,103.6964
628754,169,55,224,1.332481,103.69502
628763,48,4,52,1.328325,103.692566
628764,93,7,100,1.328306,103.692164
628765,3,0,3,1.330809,103.702488
628766,39,0,39,1.328732,103.691342
628767,2,52,54,1.328331,103.690926
628768,156,1,157,1.328303,103.690529
628770,248,9,257,1.328323,103.69013
628771,5,16,21,1.328325,103.689714
628772,43,29,72,1.329071,103.688952
628773,450,6,456,1.328325,103.688907
628774,267,29,296,1.328416,103.688345
628775,39,58,97,1.329002,103.693351
628776,18,1,19,1.329623,103.693023
628777,3,0,3,1.328338,103.691773
628778,76,26,102,1.32901,103.692803
628779,104,0,104,1.329014,103.692583
628780,13,26,39,1.329608,103.692204
628781,84,31,115,1.329021,103.692144
628782,3,2,5,1.329024,103.691925
628783,97,18,115,1.32958,103.691425
628785,1,0,1,1.329013,103.878267
628786,1,22,23,1.329038,103.691047
628787,2,0,2,1.324002,103.685801
628788,89,1,90,1.329045,103.690608
628789,6,30,36,1.329049,103.690388
628790,5,3,8,1.329052,103.690169
628791,5,1,6,1.329056,103.689949
628792,3,6,9,1.329059,103.68973
628793,115,8,123,1.329063,103.68951
628794,5,1,6,1.329066,103.689291
628795,11,43,54,1.32907,103.689071
628796,19,0,19,1.329073,103.688852
628797,16,8,24,1.329077,103.688632
628798,1,1,2,1.329042,103.690827
628799,7,147,154,1.329084,103.688193
628800,12,269,281,1.329097,103.687964
628801,1,11,12,1.328426,103.687187
628818,117,112,229,1.329802,103.695927
628819,6,135,141,1.330577,103.696325
628820,3,0,3,1.329007,103.693022
628821,0,27,27,1.330577,103.696209
628822,58,15,73,1.329807,103.694809
628823,2,14,16,1.330577,103.695978
628824,21,11,32,1.329743,103.694354
628825,3,0,3,1.330004,103.695304
628826,15,39,54,1.329752,103.693891
628827,80,0,80,1.330578,103.695517
628828,49,7,56,1.330581,103.693306
628829,4,5,9,1.330578,103.695286
628830,6,1,7,1.330204,103.692458
628831,5,9,14,1.330578,103.695055
628832,80,33,113,1.330203,103.692295
628833,4,1,5,1.330578,103.694825
628834,15,0,15,1.330225,103.692142
628836,3,0,3,1.330577,103.695748
628837,7,0,7,1.330578,103.694363
628838,155,11,166,1.330598,103.692284
628839,7,16,23,1.330579,103.694132
628840,11,1,12,1.330601,103.692057
628842,7,0,7,1.330605,103.69183
628843,43,9,52,1.330579,103.693671
628844,62,9,71,1.330609,103.691602
628845,2,16,18,1.330589,103.69343
628847,10,0,10,1.331159,103.692397
628848,30,0,30,1.330616,103.691148
628849,31,15,46,1.331117,103.691898
628850,10,0,10,1.33062,103.690921
628851,4,10,14,1.330624,103.690694
628852,6,1,7,1.330621,103.690884
628853,2,4,6,1.330628,103.690466
628854,11,0,11,1.330631,103.690239
628855,2,0,2,1.32908,103.688413
628856,7,4,11,1.330625,103.690022
628857,38,2,40,1.33119,103.691394
628858,109,8,117,1.331133,103.690509
628859,76,254,330,1.329984,103.689398
628873,2,0,2,1.330625,103.690022
628874,63,44,107,1.332518,103.690375
628875,114,1103,1217,1.332926,103.691216
628876,25,6,31,1.333171,103.691906
628877,52,139,191,1.333178,103.691431
628878,236,195,431,1.33344,103.691657
628879,272,43,315,1.333149,103.692329
628880,102,63,165,1.331078,103.689459
628881,20,12,32,1.331343,103.690106
628882,15,195,210,1.332047,103.69003
628883,37,36,73,1.334065,103.692687
628884,59,53,112,1.334193,103.69192
628885,93,268,361,1.333566,103.693385
628896,6,179,185,1.329424,103.694096
628897,31,8,39,1.33065,103.69342
628898,13,0,13,1.330722,103.693419
628900,0,1,1,1.329035,103.691266
628901,2,0,2,1.331925,103.690887
628902,108,4,112,1.331828,103.693036
628903,20,15,35,1.332484,103.693056
628904,25,20,45,1.332625,103.693064
628905,13,0,13,1.332788,103.693057
628906,1,0,1,1.331007,103.693418
628907,8,56,64,1.333102,103.693023
628908,324,0,324,1.333298,103.693032
628909,176,355,531,1.328754,103.69351
628910,26,4,30,1.328344,103.694809
628912,1,0,1,1.332976,103.693059
628913,1,0,1,1.32811,103.694803
628915,1,0,1,1.328343,103.694841
628918,9,0,9,1.32954,103.694434
628920,479,0,479,1.328713,103.695225
628921,199,12,211,1.332903,103.693899
628922,11,0,11,1.333175,103.694128
628923,32,1,33,1.333473,103.694009
628924,110,0,110,1.333781,103.693949
628925,2457,0,2457,1.32108,103.705209
628926,17,45,62,1.317359,103.707974
628942,90,27,117,1.323128,103.669769
628943,136,65,201,1.323089,103.67017
628944,99,23,122,1.324073,103.669788
628945,231,0,231,1.324665,103.669673
628946,15,71,86,1.326089,103.669606
628947,122,5,127,1.326348,103.668569
628948,3,2,5,1.326843,103.66955
628965,9,2,11,1.326034,103.676448
628966,46,39,85,1.326327,103.676438
628967,4,0,4,1.324588,103.684846
628968,28,3,31,1.326258,103.675233
628969,14,8,22,1.325981,103.675662
628970,70,0,70,1.326146,103.674699
628971,7,0,7,1.325933,103.67524
628972,0,11,11,1.326108,103.674183
628973,1,0,1,1.328343,103.694809
628975,119,18,137,1.326083,103.673737
628976,21,0,21,1.325814,103.674012
628977,13,11,24,1.325799,103.673619
628978,33,14,47,1.325756,103.673192
628979,44,6,50,1.325713,103.672808
628980,19,21,40,1.32568,103.672382
628981,10,7,17,1.325641,103.671974
628982,4,1,5,1.325646,103.671561
628983,6,1,7,1.325605,103.671048
628984,731,128,859,1.325907,103.671804
628985,147,0,147,1.325898,103.671345
628986,2,2,4,1.325986,103.676103
628987,13,24,37,1.325549,103.670559
628988,86,3,89,1.325821,103.670256
628989,30,21,51,1.325468,103.670132
628990,6,5,11,1.325821,103.668428
628991,207,88,295,1.325319,103.66898
629008,80,26,106,1.328592,103.670237
629009,869,45,914,1.328954,103.670772
629010,16,5,21,1.328782,103.671068
629011,243,27,270,1.328897,103.671489
629012,6,0,6,1.328954,103.671947
629013,465,80,545,1.328993,103.672444
629014,124,50,174,1.329002,103.672874
629015,16,13,29,1.329499,103.674699
629016,50,141,191,1.329451,103.675157
629017,180,32,212,1.329393,103.675501
629018,649,60,709,1.329031,103.673333
629019,155,20,175,1.329069,103.673801
629020,50,6,56,1.329088,103.674278
629021,124,344,468,1.329384,103.674078
629022,158,663,821,1.329355,103.673638
629023,33,220,253,1.329288,103.673094
629024,68,30,98,1.329298,103.672186
629025,28,203,231,1.329543,103.672335
629026,85,17,102,1.32925,103.675425
629027,56,20,76,1.327817,103.669596
629028,15,6,21,1.329069,103.674823
629031,34,13,47,1.324653,103.676398
629032,94,374,468,1.327136,103.676924
629033,55,38,93,1.326417,103.676976
629034,136,35,171,1.325549,103.677087
629035,58,95,153,1.324526,103.677199
629036,58,0,58,1.324554,103.675771
629037,205,61,266,1.324791,103.675849
629038,6,9,15,1.324765,103.675648
629039,113,3,116,1.324084,103.676334
629040,20,12,32,1.324777,103.675145
629041,45,81,126,1.323417,103.675307
629042,51,6,57,1.324412,103.674305
629043,1255,58,1313,1.324037,103.674394
629044,15,1,16,1.324386,103.673859
629045,99,0,99,1.324374,103.673627
629046,916,134,1050,1.32315,103.673861
629047,8,38,46,1.324339,103.673156
629048,70,125,195,1.324327,103.672813
629049,4,4,8,1.323258,103.673203
629050,306,0,306,1.324159,103.672435
629051,7,360,367,1.323046,103.672487
629052,15,5,20,1.324153,103.671866
629053,442,6,448,1.323003,103.671538
629054,146,16,162,1.324107,103.671628
629055,2,15,17,1.324119,103.671215
629056,4,81,85,1.324119,103.670948
629057,331,0,331,1.324101,103.67053
629058,151,16,167,1.323586,103.668655
629059,10,132,142,1.324106,103.670273
629060,60,24,84,1.32392,103.668746
629061,136,51,187,1.324689,103.667137
629062,368,187,555,1.324094,103.665533
629063,338,0,338,1.325014,103.667433
629064,34,167,201,1.325506,103.66761
629065,550,55,605,1.325437,103.667196
629066,27,18,45,1.32589,103.667463
629067,121,13,134,1.327033,103.66832
629068,50,17,67,1.32719,103.668487
629069,962,452,1414,1.327466,103.669955
629070,65,18,83,1.327523,103.670893
629071,18,6,24,1.327564,103.671375
629072,21,135,156,1.327613,103.67183
629073,71,16,87,1.327135,103.66998
629074,11,4,15,1.32763,103.672128
629075,6,30,36,1.32715,103.670582
629076,18,0,18,1.327667,103.67272
629077,10,4,14,1.327205,103.671127
629078,50,0,50,1.327647,103.67321
629079,11,1,12,1.327233,103.671734
629080,3,5,8,1.327696,103.673583
629081,1,0,1,1.325895,103.674837
629082,70,0,70,1.327715,103.673913
629083,64,0,64,1.326657,103.672456
629084,3,2,5,1.327725,103.674175
629086,6,2,8,1.327734,103.674466
629087,3,2,5,1.327316,103.672817
629088,14,0,14,1.327761,103.674666
629089,8,12,20,1.327767,103.674795
629090,6,15,21,1.327412,103.673314
629091,5,18,23,1.32784,103.675347
629093,11,18,29,1.327426,103.673941
629094,6,1,7,1.327862,103.675704
629095,3,0,3,1.330219,103.691996
629096,57,18,75,1.326862,103.674529
629097,140,0,140,1.327878,103.6761
629098,30,184,214,1.32789,103.676249
629099,19,117,136,1.327475,103.675085
629100,6,106,112,1.327496,103.67553
629102,113,449,562,1.328768,103.678577
629103,45,0,45,1.327488,103.670458
629104,1,3,4,1.32585,103.670868
629105,618,87,705,1.325015,103.666096
629106,3,17,20,1.326679,103.668005
629107,171,380,551,1.327923,103.677183
629108,388,38,426,1.322834,103.667672
629109,126,0,126,1.32974,103.677761
629110,269,50,319,1.32396,103.666704
629111,1786,158,1944,1.322805,103.666144
629112,29,126,155,1.327531,103.676495
629115,38,0,38,1.324399,103.674122
629116,6116,63991,70107,1.327589,103.678432
629117,595,39,634,1.327351,103.678836
629118,202,515,717,1.327751,103.67833
629119,77,0,77,1.304936,103.695755
629120,11,7,18,1.306528,103.696255
629121,58,54,112,1.306091,103.696787
629122,11,0,11,1.301858,103.698625
629123,34,0,34,1.305694,103.697048
629124,128,3,131,1.305315,103.697153
629125,8,40,48,1.304873,103.697325
629126,0,2,2,1.331655,103.693019
629127,161,0,161,1.303615,103.69621
629129,4,3,7,1.30307,103.697563
629130,1,1,2,1.304689,103.697053
629131,6,0,6,1.304387,103.69716
629132,3,2,5,1.303907,103.697559
629143,467,1202,1669,1.320906,103.708515
629144,64,26,90,1.32191,103.700568
629145,2,71,73,1.322161,103.698756
629146,1262,40,1302,1.321558,103.692975
629147,2,94,96,1.322175,103.688177
629148,771,9,780,1.320146,103.679897
629149,13,2,15,1.321625,103.68464
629150,983,75,1058,1.320684,103.667624
629151,16,429,445,1.322466,103.7026
629152,3,4,7,1.32205,103.711326
629153,68,148,216,1.323189,103.691727
629156,10,0,10,1.322727,103.699874
629157,0,14,14,1.322727,103.699877
629158,18,622,640,1.299509,103.837
629170,73,7,80,1.32785,103.693466
629171,3,11,14,1.327368,103.692017
629172,70,227,297,1.3288,103.685482
629173,111,4274,4385,1.328375,103.681974
629174,1122,735,1857,1.328518,103.680095
629175,50,925,975,1.328539,103.683413
629176,95,103,198,1.328764,103.686366
629177,71,24,95,1.328683,103.685923
629178,3,1314,1317,1.32878,103.685041
629191,84,23,107,1.320493,103.670279
629192,152,92,244,1.321201,103.669209
629193,408,17,425,1.315554,103.67143
629194,68,43,111,1.314131,103.671218
629195,102,94,196,1.312581,103.670811
629196,2090,74,2164,1.31298,103.669342
629197,463,1,464,1.309921,103.672374
629198,304,153,457,1.309328,103.669248
629199,157,127,284,1.311261,103.670404
629215,7,16,23,1.316815,103.663586
629216,1061,142,1203,1.317177,103.663378
629233,103,6,109,1.319402,103.665207
629234,85,27,112,1.318938,103.665196
629236,2,3,5,1.318949,103.665254
629237,3,0,3,1.327857,103.675784
629238,8,20,28,1.318345,103.665316
629239,53,91,144,1.318184,103.664667
629240,1,0,1,1.327749,103.673754
629241,4,91,95,1.318098,103.665681
629242,285,22,307,1.317652,103.665769
629243,10,18,28,1.316844,103.66546
629261,89,23,112,1.319564,103.666749
629263,2,1,3,1.318647,103.665285
629264,35,7,42,1.319152,103.666776
629265,2,0,2,1.303898,103.698046
629266,13,19,32,1.318601,103.666812
629267,6,0,6,1.318326,103.66683
629268,124,81,205,1.318316,103.66684
629269,4,1,5,1.317652,103.666876
629286,4,2,6,1.318023,103.667901
629287,21,1,22,1.318462,103.667899
629288,39,0,39,1.318019,103.667733
629289,22,5,27,1.31844,103.667662
629290,9,0,9,1.318396,103.667941
629291,2,0,2,1.318876,103.666794
629292,1,0,1,1.318042,103.665346
629293,2,2,4,1.326679,103.668005
629294,4,2,6,1.318343,103.667207
629296,31,1,32,1.318316,103.66684
629297,6,5,11,1.318399,103.667011
629314,28,70,98,1.319549,103.669072
629315,24,18,42,1.318449,103.668675
629316,44,39,83,1.319053,103.669178
629317,170,17,187,1.317782,103.668737
629318,135,143,278,1.318233,103.668709
629320,0,5,5,1.318008,103.668733
629321,53,4,57,1.317556,103.668781
629322,0,16,16,1.317115,103.668819
629339,2,5,7,1.307562,103.66601
629340,71,213,284,1.30493,103.664627
629341,265,70,335,1.303509,103.665145
629342,3,18,21,1.302078,103.66596
629343,30,10,40,1.300832,103.665136
629344,71,0,71,1.299888,103.665419
629345,336,74,410,1.298947,103.665999
629346,118,144,262,1.297743,103.667475
629347,1,106,107,1.297291,103.669066
629348,18,37,55,1.297281,103.669076
629349,35,1255,1290,1.29637,103.669651
629350,1833,457,2290,1.302104,103.667751
629351,5014,13,5027,1.292822,103.668578
629352,402,60,462,1.298049,103.669195
629353,1448,465,1913,1.295814,103.672441
629354,177,7,184,1.300744,103.667915
629355,176,8,184,1.303736,103.666475
629356,2283,120,2403,1.303931,103.668068
629357,20,2,22,1.297724,103.67038
629358,18,16,34,1.303202,103.66687
629359,3,143,146,1.302434,103.66736
629360,189,92,281,1.299003,103.66929
629361,1762,124,1886,1.306835,103.667095
629362,334,229,563,1.307429,103.665657
629363,18,22,40,1.307638,103.666359
629364,31,29,60,1.307739,103.666929
629371,21,36,57,1.314601,103.661404
629372,10,61,71,1.314601,103.661424
629373,41,1,42,1.314689,103.661487
629374,19,6,25,1.314689,103.661507
629375,1,19,20,1.314867,103.661653
629376,44,2,46,1.314867,103.661673
629377,109,0,109,1.315044,103.661819
629378,1,0,1,1.318369,103.667574
629379,0,7,7,1.315222,103.661985
629380,33,0,33,1.315222,103.662005
629381,3,0,3,1.319427,103.666758
629383,230,2,232,1.315577,103.662317
629384,3,0,3,1.315399,103.662151
629385,7,52,59,1.315754,103.662483
629386,45,5,50,1.315744,103.662493
629403,14,41,55,1.308451,103.665368
629404,51,3,54,1.310966,103.664314
629405,2,6,8,1.309669,103.665532
629406,9,1,10,1.311084,103.663715
629407,16,23,39,1.310235,103.665348
629408,0,17,17,1.311872,103.663413
629409,3,0,3,1.315577,103.662337
629410,3,7,10,1.312289,103.663014
629411,17,1,18,1.310754,103.664922
629412,65,12,77,1.311129,103.664784
629413,34,247,281,1.310184,103.661398
629414,7637,495,8132,1.311711,103.659803
629415,16,0,16,1.312198,103.66377
629416,1370,8,1378,1.313076,103.662821
629417,28,8,36,1.312534,103.663412
629418,314,2,316,1.312871,103.663055
629419,57,142,199,1.313692,103.662178
629420,7,23,30,1.312919,103.663005
629421,16,13,29,1.314102,103.66175
629422,1,0,1,1.315044,103.661839
629423,33,0,33,1.314502,103.661331
629424,31,20,51,1.313064,103.662853
629425,648,17,665,1.314548,103.661283
629426,33,39,72,1.313161,103.662753
629427,95,13,108,1.314608,103.660304
629428,30,0,30,1.313257,103.662652
629429,2,38,40,1.315108,103.660062
629430,26,2,28,1.313979,103.662543
629437,155,7,162,1.314093,103.662253
629454,3,30,33,1.316988,103.675757
629455,42,1,43,1.316985,103.675322
629456,11,37,48,1.318293,103.675521
629457,21,0,21,1.316667,103.675055
629458,12,0,12,1.318684,103.6748
629459,16,0,16,1.31813,103.674128
629460,375,0,375,1.316533,103.674047
629461,7,0,7,1.318187,103.67353
629462,27,7,34,1.31695,103.673661
629463,71,12,83,1.318295,103.673061
629465,48,1,49,1.317415,103.672737
629466,687,23,710,1.316816,103.672964
629467,191,78,269,1.318207,103.672095
629468,667,9,676,1.318033,103.671601
629469,1,13,14,1.317967,103.671046
629470,33,0,33,1.316417,103.672264
629471,139,49,188,1.31662,103.671565
629472,94,26,120,1.317649,103.669963
629473,2,0,2,1.318433,103.667534
629474,14,5,19,1.317106,103.668684
629475,18,60,78,1.316317,103.670858
629476,4,33,37,1.317097,103.66855
629478,255,15,270,1.317079,103.66828
629479,7,2,9,1.31625,103.669445
629480,16,60,76,1.317061,103.668011
629481,23,1,24,1.316513,103.669209
629482,1,14,15,1.317043,103.667741
629483,56,4,60,1.317095,103.668819
629484,16,0,16,1.317025,103.667472
629485,11,0,11,1.316134,103.668582
629486,0,1,1,1.312968,103.662954
629488,7,73,80,1.316989,103.666933
629489,92,0,92,1.317032,103.667876
629490,75,22,97,1.317,103.667404
629491,28,3,31,1.317276,103.664938
629492,377,4,381,1.316969,103.666933
629493,5,18,23,1.316818,103.664268
629494,40,2,42,1.316951,103.666749
629495,5,0,5,1.316933,103.666565
629496,16,49,65,1.316896,103.666196
629497,28,7,35,1.31686,103.665828
629498,15,7,22,1.316824,103.66546
629499,65,0,65,1.316194,103.664378
629500,9,16,25,1.315019,103.66331
629501,70,30,100,1.316897,103.67456
629502,14,9,23,1.317365,103.672316
629517,162,65,227,1.31165,103.66753
629518,82,117,199,1.312051,103.666517
629519,108,3,111,1.310638,103.667479
629520,146,0,146,1.311356,103.666152
629521,15,6,21,1.309997,103.667752
629522,2,45,47,1.310773,103.666318
629523,232,41,273,1.310096,103.666286
629524,5,16,21,1.308882,103.667111
629525,9,24,33,1.308821,103.665598
629526,6,134,140,1.310029,103.664661
629527,146,47,193,1.310208,103.663982
629528,34,43,77,1.308698,103.664791
629529,25,0,25,1.310558,103.663158
629530,1,16,17,1.31098,103.662101
629531,116,31,147,1.311421,103.661646
629532,74,210,284,1.311711,103.66134
629533,56,6,62,1.312001,103.661034
629534,996,21,1017,1.30912,103.66387
629535,68,10,78,1.312578,103.660423
629536,103,8,111,1.309417,103.662431
629537,2,19,21,1.312895,103.66065
629538,7,11,18,1.313324,103.660313
629539,14,0,14,1.313638,103.660029
629540,218,153,371,1.314488,103.659517
629541,3,23,26,1.315617,103.660154
629542,7,6,13,1.316047,103.660556
629543,63,52,115,1.316466,103.660948
629544,22,0,22,1.310065,103.661984
629545,269,17,286,1.313534,103.65853
629560,1603,80,1683,1.31414,103.676786
629561,28,70,98,1.311584,103.67613
629562,46,925,971,1.313079,103.674423
629563,2084,1,2085,1.312295,103.674625
629564,55,36,91,1.31362,103.673106
629565,299,258,557,1.311224,103.672439
629566,1401,0,1401,1.313065,103.672457
629567,436,158,594,1.31099,103.669306
629568,2,52,54,1.312197,103.667023
629569,62,25,87,1.312374,103.665489
629570,488,1,489,1.312357,103.664733
629572,14,131,145,1.313439,103.664961
629573,68,5,73,1.314179,103.665
629574,11,11,22,1.313404,103.663965
629575,109,31,140,1.314234,103.66414
629576,7,1,8,1.313747,103.663955
629578,38,24,62,1.313988,103.663666
629579,8,0,8,1.314234,103.66412
629580,1,0,1,1.317007,103.667202
629581,19,16,35,1.315029,103.6633
629583,3,41,44,1.315009,103.6633
629584,4,0,4,1.318434,103.667384
629585,2096,102,2198,1.316088,103.660083
629586,89,22,111,1.317019,103.662385
629587,91,23,114,1.318637,103.660791
629588,168,73,241,1.318009,103.662403
629589,2,26,28,1.317558,103.66152
629590,14,0,14,1.318406,103.66344
629591,21,0,21,1.318019,103.662393
629592,43,7,50,1.318769,103.663842
629593,235,96,331,1.318986,103.66221
629594,60,34,94,1.3197,103.666883
629595,1,0,1,1.314496,103.663844
629597,28,13,41,1.319742,103.667548
629598,23,0,23,1.319759,103.667815
629599,346,197,543,1.319776,103.668081
629600,5,0,5,1.319792,103.668347
629601,3,9,12,1.319809,103.668613
629602,520,56,576,1.319364,103.669826
629603,62,109,171,1.319099,103.670771
629604,621,63,684,1.318833,103.67174
629605,668,30,698,1.321068,103.672097
629606,28,124,152,1.320932,103.673187
629607,163,1496,1659,1.319245,103.672624
629608,67,8,75,1.321487,103.674714
629609,38,1,39,1.319081,103.67293
629610,16,19,35,1.321377,103.675642
629611,18,58,76,1.319923,103.673361
629612,8,31,39,1.321076,103.676459
629613,675,2,677,1.319562,103.6747
629614,271,3,274,1.319059,103.674162
629615,50,234,284,1.319275,103.675463
629616,430,68,498,1.319793,103.67607
629617,272,318,590,1.320834,103.67741
629618,11,59,70,1.319391,103.677056
629619,85,386,471,1.321935,103.678264
629620,149,132,281,1.319631,103.67747
629621,50,178,228,1.319814,103.678444
629622,496,42,538,1.317691,103.676648
629623,10,38,48,1.315694,103.676799
629624,1,0,1,1.319709,103.667016
629626,13,36,49,1.317113,103.676684
629627,27,12,39,1.317671,103.676648
629628,20,33,53,1.318019,103.676617
629629,14,5,19,1.318358,103.676596
629630,102,55,157,1.319113,103.676089
629631,152,48,200,1.319405,103.676054
629632,11,8,19,1.314114,103.676956
629633,72,30,102,1.312083,103.677564
629635,339,0,339,1.319391,103.677056
629648,2,3,5,1.313452,103.677866
629649,831,126,957,1.316376,103.677781
629650,25,233,258,1.31592,103.675698
629651,397,9,406,1.314284,103.674023
629652,81,101,182,1.315574,103.675115
629653,30,7,37,1.314756,103.673022
629654,649,0,649,1.315319,103.674732
629655,22,10,32,1.314276,103.672675
629656,323,106,429,1.315846,103.673988
629657,447,62,509,1.315573,103.673502
629658,21,5,26,1.314347,103.671994
629659,2,1,3,1.310082,103.665484
629660,7,0,7,1.315621,103.672359
629661,207,11,218,1.314872,103.670233
629662,26,41,67,1.315931,103.670036
629663,1,0,1,1.316369,103.676258
629664,7,3,10,1.31545,103.669497
629665,308,64,372,1.314809,103.669226
629666,291,20,311,1.315448,103.669314
629667,67,30,97,1.314006,103.669134
629668,40,0,40,1.315385,103.66886
629669,1,15,16,1.313989,103.66857
629670,6,9,15,1.315365,103.668639
629671,4,0,4,1.315019,103.66329
629672,6,0,6,1.315385,103.668209
629673,38,1,39,1.314312,103.667964
629674,60,25,85,1.315334,103.668024
629675,6,4,10,1.314264,103.66752
629676,5,1,6,1.315271,103.667573
629677,161,11,172,1.314277,103.667193
629678,15,0,15,1.315288,103.667359
629679,94,16,110,1.313664,103.665933
629680,60,1,61,1.315527,103.666859
629681,110,3,113,1.315446,103.666211
629682,258,35,293,1.314773,103.665306
629699,2,0,2,1.316689,103.671167
629700,20,109,129,1.325264,103.687362
629701,479,41,520,1.324963,103.688836
629702,46,14,60,1.325471,103.687952
629703,11,37,48,1.325679,103.688394
629704,6,0,6,1.325919,103.687951
629705,176,1,177,1.326215,103.688531
629706,97,16,113,1.326367,103.68795
629707,158,0,158,1.326456,103.68797
629708,1,1,2,1.324915,103.687014
629709,6,26,32,1.326973,103.688719
629710,20,106,126,1.32771,103.687966
629711,33,48,81,1.3277,103.687956
629728,687,56,743,1.324139,103.692838
629729,27,0,27,1.325659,103.693947
629730,15,38,53,1.32621,103.69394
629731,99,1,100,1.326741,103.694139
629732,4,798,802,1.327255,103.694018
629733,2,5,7,1.325699,103.693091
629734,115,0,115,1.326142,103.692656
629735,25,27,52,1.326676,103.693459
629736,6,124,130,1.327299,103.692671
629753,53,3,56,1.325661,103.685719
629754,38,3,41,1.326247,103.68552
629756,33,0,33,1.326135,103.686098
629757,3,2,5,1.325622,103.686111
629758,1,1,2,1.326815,103.687949
629759,2,0,2,1.326905,103.686108
629760,18,59,77,1.327369,103.685411
629761,7,0,7,1.326648,103.686125
629762,8,2,10,1.327162,103.686132
629763,60,32,92,1.327665,103.686129
629780,81,116,197,1.328954,103.704264
629781,5,8,13,1.329221,103.703711
629783,91,13,104,1.330193,103.703719
629784,1,9,10,1.330454,103.704065
629785,7,3,10,1.330412,103.702958
629786,30,0,30,1.330513,103.703723
629787,76,56,132,1.330816,103.702962
629788,1,3,4,1.314368,103.668326
629789,1,1,2,1.326135,103.686118
629790,9,7,16,1.331763,103.704466
629791,6,0,6,1.332063,103.703693
629792,11,0,11,1.331974,103.703675
629793,8,3,11,1.332683,103.703681
629794,21,4,25,1.332417,103.703666
629795,72,43,115,1.332977,103.704326
629796,60,1,61,1.332813,103.703107
629813,1609,58,1667,1.332814,103.708018
629814,292,106,398,1.33364,103.707863
629815,90,76,166,1.332814,103.708018
629816,203,19,222,1.333951,103.70644
629817,35,15,50,1.332926,103.707588
629818,7,3,10,1.333973,103.705077
629819,8,0,8,1.333037,103.707157
629820,62,69,131,1.333288,103.704578
629821,5,0,5,1.332574,103.707277
629822,45,32,77,1.333313,103.703659
629823,3,28,31,1.332658,103.707028
629824,408,55,463,1.333888,103.702205
629825,7,13,20,1.332402,103.702289
629826,14,63,77,1.333262,103.705477
629827,0,1,1,1.314113,103.66985
629828,5,0,5,1.333312,103.703658
629829,15,13,28,1.333312,103.703658
629830,1,1,2,1.331089,103.703692
629831,1,16,17,1.333895,103.70407
629832,2,21,23,1.333967,103.704074
629833,0,4,4,1.330823,103.703717
629834,7,1,8,1.334121,103.704081
629836,13,50,63,1.33427,103.704104
629837,14,17,31,1.334203,103.703749
629838,1,2,3,1.316104,103.672848
629839,1,1,2,1.333811,103.704078
629840,19,5,24,1.333996,103.703786
629841,100,10,110,1.333312,103.703658
629842,406,4,410,1.320488,103.68188
629843,101,40,141,1.318857,103.681357
629844,269,10,279,1.320319,103.683046
629845,680,107,787,1.318337,103.682508
629846,39,98,137,1.318957,103.683168
629847,43,0,43,1.317929,103.683729
629848,6,35,41,1.319145,103.684319
629849,13,22,35,1.321602,103.686045
629850,25,16,41,1.318771,103.6848
629851,187,0,187,1.318361,103.685642
629852,1790,0,1790,1.319057,103.686654
629853,1115,52,1167,1.319328,103.68831
629854,157,3,160,1.317999,103.687716
629855,4,0,4,1.334048,103.70411
629856,17,187,204,1.317955,103.689642
629857,180,5,185,1.316936,103.687784
629858,777,23,800,1.31607,103.689728
629859,978,201,1179,1.315974,103.69206
629860,579,73,652,1.320208,103.686593
629861,20,982,1002,1.320152,103.685407
629862,89,1,90,1.320279,103.684057
629863,1,0,1,1.333312,103.703658
629875,434,215,649,1.309221,103.679484
629876,4014,85,4099,1.307104,103.677875
629877,367,308,675,1.305818,103.679938
629878,46,188,234,1.306564,103.678185
629879,69,2,71,1.304035,103.680304
629880,17,25,42,1.30491,103.678521
629881,314,243,557,1.305785,103.678517
629882,1353,1,1354,1.303063,103.680431
629883,19,0,19,1.304528,103.678287
629884,2,3,5,1.303998,103.678262
629885,61,66,127,1.303378,103.679333
629886,11,397,408,1.302893,103.678483
629887,405,160,565,1.302346,103.678769
629888,12031,1690,13721,1.29814,103.677844
629889,1318,1844,3162,1.301279,103.679112
629890,32,10,42,1.302568,103.677374
629891,20,0,20,1.303476,103.67712
629892,67,19,86,1.304064,103.676893
629893,99,18,117,1.304944,103.676997
629895,787,30,817,1.307608,103.674944
629896,1,0,1,1.319815,103.684192
629897,6,14,20,1.305988,103.676606
629898,3,55,58,1.306323,103.676629
629899,5,34,39,1.306733,103.676648
629900,191,82,273,1.307673,103.676628
629901,139,69,208,1.308949,103.676385
629902,6,7,13,1.318859,103.678695
629903,462,124,586,1.317371,103.67972
629904,119,75,194,1.319008,103.680276
629905,17,135,152,1.325541,103.678455
629906,329,249,578,1.326343,103.681076
629907,38,2723,2761,1.326113,103.678479
629908,391,142,533,1.323261,103.677672
629909,321,56,377,1.304828,103.675149
629910,60,349,409,1.31885,103.678813
629911,274,6,280,1.305712,103.676056
629914,384,90,474,1.308417,103.675451
629915,9,3,12,1.308325,103.675287
629916,8,4,12,1.308276,103.675177
629917,11,3,14,1.3083,103.675085
629918,0,7,7,1.308257,103.675035
629919,1,14,15,1.308242,103.674942
629920,0,2,2,1.334045,103.703751
629921,32,1,33,1.308261,103.674753
629922,10,0,10,1.308239,103.674601
629923,19,65,84,1.314385,103.679424
629924,75,404,479,1.313203,103.679241
629925,2,21,23,1.312752,103.67944
629926,106,24,130,1.314857,103.679345
629927,12,12,24,1.31239,103.679199
629928,5,59,64,1.3119,103.679301
629929,1,1,2,1.308241,103.674866
629930,5,52,57,1.311535,103.67934
629931,37,13,50,1.315267,103.679352
629932,43,250,293,1.310532,103.679285
629933,8,70,78,1.316208,103.679397
629934,16,76,92,1.311443,103.680421
629935,3,1,4,1.317245,103.687138
629936,4,0,4,1.312047,103.679907
629937,15,0,15,1.312306,103.680491
629938,0,1,1,1.30565,103.676742
629939,41,0,41,1.312598,103.680449
629940,79,13,92,1.312839,103.680535
629941,14,1,15,1.315975,103.680818
629942,14,0,14,1.313231,103.680373
629943,0,1,1,1.31607,103.680404
629944,42,0,42,1.315234,103.680789
629945,12,6,18,1.313576,103.679993
629946,260,33,293,1.31503,103.680043
629947,1,0,1,1.313671,103.680274
629948,2,4,6,1.315278,103.680299
629949,12,0,12,1.314121,103.680728
629950,6,4,10,1.31442,103.680304
629951,0,3,3,1.33412,103.70378
629952,6,0,6,1.314393,103.680621
629953,195,100,295,1.310938,103.680231
629969,78,4,82,1.320072,103.688381
629970,836,97,933,1.320334,103.690016
629971,814,17,831,1.321763,103.690118
629972,415,15,430,1.320658,103.693412
629973,99,111,210,1.320794,103.691827
629974,58,1,59,1.319962,103.693615
629975,20,36,56,1.320597,103.692749
629976,154,40,194,1.318822,103.693461
629977,206,2,208,1.319879,103.69179
629978,255,0,255,1.31828,103.692549
629979,127,0,127,1.319321,103.692136
629980,17,14,31,1.317617,103.691408
629981,60,71,131,1.319171,103.690966
629982,91,24,115,1.317301,103.690832
629983,2,11,13,1.319029,103.690275
629984,11,7,18,1.320867,103.689728
629985,324,27,351,1.321677,103.689229
629986,1119,133,1252,1.322222,103.687656
630000,12,57,69,1.31842,103.659745
636849,246,57,303,1.299509,103.837
636893,25,3,28,1.299509,103.837
636906,87,12,99,1.271579,103.637241
636907,764,132,896,1.27547,103.637731
636908,1,3,4,1.316057,103.679967
636911,0,1,1,1.314432,103.680075
636913,34,10,44,1.299509,103.837
636916,9,46,55,1.299509,103.837
636921,1364,933,2297,1.345086,103.678362
636926,9,8,17,1.299509,103.837
636931,15,0,15,1.277488,103.63314
636936,58,3,61,1.299509,103.837
636937,238,14,252,1.269386,103.634021
636941,1,0,1,1.299509,103.837
636942,5,1,6,1.330388,103.646528
636946,244,23,267,1.271841,103.633646
636947,15,86,101,1.271973,103.633463
636948,5,5,10,1.299509,103.837
636949,22,13,35,1.299509,103.837
636950,14,0,14,1.299509,103.837
636951,6,4,10,1.299509,103.837
636952,40,4,44,1.299509,103.837
636957,10,3,13,1.299509,103.837
636958,138,0,138,1.354245,103.687705
636959,44,234,278,1.354142,103.688079
636960,81,0,81,1.354223,103.688458
636961,2,0,2,1.315352,103.6798
636962,216,335,551,1.278897,103.634673
636963,4,1,5,1.299509,103.837
636964,13,3,16,1.299509,103.837
636965,12,0,12,1.278578,103.632276
636966,1,216,217,1.299509,103.837
636967,0,3,3,1.314411,103.680458
636971,0,16,16,1.299509,103.837
636976,1234,103,1337,1.299509,103.837
636986,1630,2052,3682,1.296667,103.635857
636991,1898,457,2355,1.271605,103.618618
636996,15,30,45,1.313441,103.633195
637001,0,1,1,1.299509,103.837
637002,1,0,1,1.299509,103.837
637003,13,0,13,1.277028,103.632314
637004,21,2,23,1.299509,103.837
637005,14,0,14,1.327841,103.647436
637006,1,20,21,1.299509,103.837
637007,0,6,6,1.299509,103.837
637008,0,17,17,1.284535,103.635193
637009,2,5,7,1.299509,103.837
637010,0,4,4,1.299509,103.837
637011,4,6,10,1.299509,103.837
637012,1,6,7,1.299509,103.837
637013,0,40,40,1.299509,103.837
637014,158,81,239,1.286909,103.623726
637015,64,27,91,1.299509,103.837
637016,1624,357,1981,1.335831,103.641398
637021,461,132,593,1.303457,103.625978
637022,3506,501,4007,1.301612,103.63302
637026,2453,3967,6420,1.285921,103.626587
637031,24,135,159,1.299509,103.837
637032,82,161,243,1.299509,103.837
637033,2,15,17,1.299509,103.837
637034,213,165,378,1.299509,103.837
637035,20,329,349,1.299509,103.837
637036,165,16,181,1.299509,103.837
637037,632,28,660,1.295096,103.643689
637041,702,228,930,1.299509,103.837
637046,185,99,284,1.299509,103.837
637047,3,25,28,1.299509,103.837
637051,8093,2014,10107,1.263712,103.613993
637052,237,758,995,1.299509,103.837
637053,13,15,28,1.299509,103.837
637054,68,22,90,1.299509,103.837
637055,137,24,161,1.299509,103.837
637056,120,2,122,1.299509,103.837
637057,59,8,67,1.299509,103.837
637058,27,11,38,1.299509,103.837
637059,51,235,286,1.299509,103.837
637060,124,309,433,1.299509,103.837
637066,43,0,43,1.308544,103.649772
637068,454,3,457,1.310058,103.648434
637069,207,13,220,1.316475,103.65247
637071,23,158,181,1.299509,103.837
637076,305,25,330,1.271336,103.638551
637077,319,31,350,1.277604,103.636447
637078,526,83,609,1.276546,103.636488
637079,4,23,27,1.299556,103.624786
637080,14,79,93,1.299509,103.837
637081,37,36,73,1.299509,103.837
637082,3,2,5,1.299509,103.837
637083,95,2,97,1.271572,103.634698
637084,30,27,57,1.299509,103.837
637085,18,2,20,1.27096,103.633975
637087,6,23,29,1.299509,103.837
637088,55,6,61,1.271588,103.632832
637089,62,27,89,1.273349,103.630342
637090,14,7,21,1.272384,103.63295
637091,197,5,202,1.27096,103.631626
637092,6,3,9,1.299509,103.837
637093,2,0,2,1.299509,103.837
637094,28,0,28,1.299509,103.837
637095,2,1,3,1.299509,103.837
637096,0,1,1,1.299509,103.837
637097,3,29,32,1.275248,103.635397
637098,16,0,16,1.299509,103.837
637099,68,2,70,1.299509,103.837
637100,19,13,32,1.299509,103.837
637101,11,44,55,1.277608,103.634673
637106,4,0,4,1.299509,103.837
637107,7,2,9,1.2776,103.631657
637108,6,0,6,1.299509,103.837
637109,29,0,29,1.299509,103.837
637110,3,1,4,1.299509,103.837
637111,6,15,21,1.275021,103.631609
637112,30,3,33,1.299509,103.837
637113,46,7,53,1.30912,103.627219
637114,58,3,61,1.277714,103.631097
637115,31,8,39,1.323207,103.794438
637117,9,0,9,1.299509,103.837
637118,43,3,46,1.278599,103.63207
637119,2,0,2,1.299509,103.837
637120,1,0,1,1.299509,103.837
637121,396,82,478,1.355972,103.685896
637122,196,71,267,1.346256,103.688191
637123,9,0,9,1.299509,103.837
637124,48,35,83,1.299509,103.837
637125,163,487,650,1.346371,103.689206
637126,89,82,171,1.312733,103.632576
637127,123,21,144,1.312521,103.632016
637131,719,1341,2060,1.279459,103.626083
637132,13,23,36,1.299509,103.837
637133,333,61,394,1.299509,103.837
637136,178,54,232,1.296613,103.626579
637141,3649,821,4470,1.355533,103.692533
637142,575,697,1272,1.354713,103.692178
637143,1377,330,1707,1.355186,103.693498
637156,1,20,21,1.316926,103.63413
637157,6,0,6,1.31673,103.634179
637158,33,5,38,1.316704,103.634297
637159,20,18,38,1.316653,103.634365
637160,206,11,217,1.316643,103.634446
637161,6,0,6,1.316555,103.634498
637162,14,4,18,1.316552,103.634607
637163,178,2,180,1.316701,103.634087
637164,3,2,5,1.316758,103.633971
637165,1,0,1,1.299509,103.837
637166,6,5,11,1.316825,103.63383
637167,25,1,26,1.316914,103.633526
637168,1,0,1,1.316769,103.633908
637169,1,0,1,1.316851,103.633512
637170,7,0,7,1.316689,103.633464
637171,2,1,3,1.299509,103.837
637172,11,0,11,1.316474,103.633362
637173,1,0,1,1.31677,103.633464
637175,8,0,8,1.316234,103.633286
637176,6,0,6,1.316156,103.633249
637177,0,1,1,1.316399,103.63337
637178,1,3,4,1.299509,103.837
637180,1,0,1,1.316078,103.63322
637185,2,0,2,1.315833,103.634161
637187,1,0,1,1.315995,103.633691
637188,8,0,8,1.315746,103.634392
637190,12,0,12,1.315677,103.634561
637191,1,2,3,1.316603,103.633435
637192,12,21,33,1.315629,103.63471
637193,2,3,5,1.315919,103.634759
637195,0,1,1,1.315771,103.634303
637196,0,1,1,1.315959,103.634591
637197,7,0,7,1.31602,103.63443
637198,1,0,1,1.315993,103.63448
637199,1,0,1,1.316072,103.634342
637200,1,0,1,1.316108,103.63426
637204,7,0,7,1.316249,103.633815
637205,6,0,6,1.316274,103.633714
637206,0,4,4,1.316056,103.633557
637207,0,2,2,1.315833,103.634161
637208,8,0,8,1.316519,103.633787
637209,92,1,93,1.316467,103.633895
637210,29,6,35,1.316457,103.633982
637211,1,2,3,1.315624,103.634666
637212,1,0,1,1.316137,103.634168
637213,1,0,1,1.316398,103.634172
637216,2,0,2,1.316551,103.633723
637219,1,0,1,1.316335,103.634251
637220,7,0,7,1.316138,103.634862
637221,8,13,21,1.316081,103.63494
637222,35,16,51,1.316367,103.634984
637223,141,26,167,1.316441,103.634801
637224,32,9,41,1.299509,103.837
637225,221,31,252,1.316661,103.635461
637226,53,0,53,1.316703,103.635109
637227,42,5,47,1.299509,103.837
637236,370,68,438,1.29156,103.627018
637237,4,6,10,1.299509,103.837
637244,1,0,1,1.316165,103.634752
637245,3,0,3,1.316408,103.634047
637246,2,0,2,1.316267,103.634479
637247,1,0,1,1.318622,103.629556
637248,16,0,16,1.318527,103.629844
637249,27,33,60,1.318487,103.629947
637250,5,5,10,1.31822,103.628733
637251,0,1,1,1.318548,103.629806
637252,22,0,22,1.31822,103.628733
637253,10,0,10,1.31822,103.628733
637254,0,1,1,1.31822,103.628733
637255,8,2,10,1.318262,103.629471
637256,3,0,3,1.318573,103.629628
637257,11,1,12,1.318175,103.629684
637258,9,14,23,1.318141,103.629808
637259,4,13,17,1.31767,103.628538
637260,0,2,2,1.318545,103.629735
637261,0,1,1,1.318288,103.629397
637262,0,2,2,1.318187,103.628901
637264,1,0,1,1.318178,103.629004
637265,10,1,11,1.317997,103.629379
637266,1,0,1,1.318069,103.629313
637267,1,0,1,1.317963,103.629515
637268,8,12,20,1.317885,103.629717
637269,5,1,6,1.3179,103.62873
637271,35,0,35,1.317848,103.628863
637275,4,1,5,1.317732,103.629185
637276,41,0,41,1.317707,103.629222
637277,1,1,2,1.318114,103.629074
637278,2,0,2,1.317677,103.629324
637281,3,100,103,1.317556,103.6296
637282,642,16,658,1.315518,103.628175
637283,43,3,46,1.299509,103.837
637284,60,0,60,1.299509,103.837
637285,587,38,625,1.313954,103.625745
637286,23,331,354,1.308794,103.648739
637287,22,40,62,1.308402,103.64918
637288,67,220,287,1.299509,103.837
637291,164,52,216,1.287412,103.635531
637292,0,7,7,1.299509,103.837
637296,279,268,547,1.347797,103.687146
637301,363,11,374,1.284771,103.639076
637302,655,5,660,1.279821,103.640166
637306,7,10,17,1.316181,103.630868
637307,69,16,85,1.319589,103.631547
637308,142,118,260,1.319514,103.631603
637310,238,17,255,1.316182,103.631011
637311,370,40,410,1.270473,103.624616
637312,1376,27,1403,1.273638,103.622792
637313,1156,882,2038,1.276065,103.622431
637321,1576,9,1585,1.335979,103.642495
637322,22,22,44,1.335921,103.638612
637323,260,32,292,1.299509,103.837
637324,29,91,120,1.33998,103.637937
637325,7,1,8,1.299509,103.837
637326,19,14,33,1.316061,103.628327
637327,130,0,130,1.317125,103.629315
637328,47,39,86,1.318711,103.628885
637329,1,1,2,1.317629,103.629387
637330,4,0,4,1.3163,103.633648
637331,2935,619,3554,1.34715,103.680099
637332,1792,751,2543,1.343736,103.683432
637333,27,142,169,1.299509,103.837
637334,5,7,12,1.299509,103.837
637335,12,0,12,1.299509,103.837
637336,7,28,35,1.319562,103.637377
637337,253,56,309,1.31927,103.637094
637338,382,113,495,1.319044,103.636877
637339,3,27,30,1.318704,103.636538
637340,44,35,79,1.318469,103.636302
637341,87,5,92,1.319741,103.63717
637342,269,34,303,1.319505,103.636934
637343,28,0,28,1.319232,103.636679
637344,245,29,274,1.318949,103.636396
637345,752,143,895,1.318685,103.636132
637346,42,42,84,1.319204,103.635501
637347,0,1,1,1.317922,103.629585
637348,107,2,109,1.319666,103.63601
637349,333,12,345,1.319864,103.636208
637350,18,32,50,1.32009,103.636444
637356,96,18,114,1.295162,103.63272
637357,195,15,210,1.293545,103.633555
637358,769,5,774,1.290265,103.634724
637359,39,26,65,1.290402,103.634773
637360,140,0,140,1.299509,103.837
637361,70,12,82,1.315998,103.636037
637362,10,33,43,1.312106,103.633833
637363,981,201,1182,1.27389,103.620378
637364,190,722,912,1.299509,103.837
637366,414,0,414,1.297714,103.620985
637367,219,143,362,1.288901,103.627518
637368,1316,4,1320,1.299509,103.837
637369,230,102,332,1.289933,103.624288
637370,38,129,167,1.299509,103.837
637371,1015,223,1238,1.342009,103.681731
637372,24,102,126,1.299509,103.837
637377,1229,9,1238,1.299008,103.639971
637378,11,7,18,1.30065,103.632643
637379,801,147,948,1.299476,103.631748
637380,1626,261,1887,1.298098,103.637959
637381,159,188,347,1.292845,103.625
637382,427,118,545,1.29632,103.624197
637383,30,4,34,1.296761,103.624425
637384,264,64,328,1.293507,103.625912
637385,1,15,16,1.297217,103.627256
637388,295,329,624,1.299509,103.837
637389,25,29,54,1.299509,103.837
637391,17,25,42,1.295124,103.642955
637392,7,32,39,1.297393,103.640789
637393,73,0,73,1.295834,103.639738
637394,1671,2,1673,1.297294,103.641422
637396,23,331,354,1.289091,103.637148
637397,707,212,919,1.280269,103.638838
637398,3,131,134,1.289889,103.737919
637399,14,34,48,1.299509,103.837
637401,7,47,54,1.317534,103.628323
637402,0,53,53,1.317533,103.628322
637403,1,7,8,1.31693,103.628559
637404,1,8,9,1.316916,103.628663
637405,3,0,3,1.318249,103.629605
637407,1,0,1,1.319468,103.635774
637409,0,1,1,1.31678,103.628933
637410,3,39,42,1.316693,103.629259
637411,1,5,6,1.31629,103.628876
637412,4,0,4,1.318711,103.628885
637415,1,0,1,1.316736,103.629161
637416,3,3,6,1.316519,103.628368
637417,4,134,138,1.31653,103.628302
637418,87,110,197,1.316595,103.628195
637419,16,10,26,1.30794,103.625626
637420,72,7,79,1.31054,103.62572
637421,474,0,474,1.296133,103.629492
637423,271,116,387,1.299509,103.837
637424,492,680,1172,1.292465,103.644515
637425,2,0,2,1.318711,103.628885
637426,49,17,66,1.322519,103.632787
637427,56,8,64,1.319465,103.632818
637428,9,14,23,1.317532,103.630794
637429,735,160,895,1.314791,103.629791
637430,203,28,231,1.317983,103.631539
637431,346,63,409,1.297553,103.630437
637432,1050,127,1177,1.298907,103.629691
637433,84,218,302,1.299019,103.629851
637434,178,40,218,1.298036,103.631995
637436,181,68,249,1.283153,103.634871
637437,2537,261,2798,1.282891,103.629289
637438,961,519,1480,1.284456,103.634968
637439,19,36,55,1.299509,103.837
637440,79,163,242,1.299509,103.837
637441,26,149,175,1.331714,103.634532
637442,9,0,9,1.331378,103.634769
637443,8,6,14,1.331131,103.63497
637444,317,34,351,1.332746,103.634395
637446,1173,0,1173,1.33258,103.634569
637447,79,0,79,1.33225,103.634918
637448,9,0,9,1.331919,103.635266
637449,53,10,63,1.331598,103.635604
637450,260,251,511,1.3319,103.634372
637451,0,1,1,1.316446,103.628504
637452,17,87,104,1.317489,103.63382
637453,2,3,5,1.317047,103.633927
637454,207,4,211,1.317013,103.633979
637455,5,0,5,1.316948,103.634052
637456,221,65,286,1.344246,103.674253
637457,21,3,24,1.345419,103.680087
637458,861,495,1356,1.348996,103.684005
637459,416,233,649,1.345418,103.679045
637460,177,14,191,1.347542,103.682347
637461,1358,277,1635,1.296667,103.635857
637462,283,3,286,1.317236,103.628753
637463,7,35,42,1.304327,103.626226
637464,18,4,22,1.305887,103.626759
637465,29,1,30,1.30701,103.627215
637466,51,4,55,1.308143,103.627585
637467,2,23,25,1.308492,103.649844
637468,46,6,52,1.292077,103.632797
637469,23,3,26,1.29993,103.625143
637470,163,35,198,1.291564,103.633834
637471,1,1,2,1.299509,103.837
637472,86,62,148,1.351818,103.679026
637473,201,37,238,1.302127,103.625382
637474,19,9,28,1.299798,103.625108
637475,2,1,3,1.317533,103.628322
637476,1,2,3,1.300194,103.625247
637477,5,4,9,1.300803,103.62547
637478,14,1,15,1.301016,103.625535
637479,3,0,3,1.3006,103.625396
637480,41,1,42,1.300651,103.624831
637481,20,3,23,1.300951,103.624978
637482,8,53,61,1.301334,103.624703
637483,72,39,111,1.301344,103.624693
637484,40,11,51,1.300954,103.62455
637485,35,3,38,1.300563,103.624407
637486,1,11,12,1.300172,103.624264
637487,12,17,29,1.299977,103.624192
637488,4,14,18,1.299772,103.624131
637489,14,8,22,1.299706,103.624333
637490,58,14,72,1.29963,103.624545
637491,10,2,12,1.299553,103.624757
637492,12,4,16,1.299515,103.624863
637493,80,32,112,1.307312,103.62336
637495,15,252,267,1.313343,103.627904
637496,0,6,6,1.314287,103.627871
637498,85,2,87,1.314027,103.627745
637500,5,1,6,1.313767,103.627659
637501,0,2,2,1.287629,103.632542
637502,1,4,5,1.313505,103.627549
637503,3,129,132,1.313552,103.628001
637504,1,124,125,1.313714,103.62808
637505,3,93,96,1.313823,103.628111
637506,51,130,181,1.313962,103.628156
637507,9,423,432,1.314095,103.628232
637508,4,24,28,1.314254,103.628291
637509,0,6,6,1.314398,103.627911
637510,16,246,262,1.313486,103.627153
637511,2,58,60,1.313637,103.627202
637512,1,5,6,1.314355,103.627137
637513,6,20,26,1.314355,103.627137
637514,4,16,20,1.314355,103.627137
637515,0,62,62,1.314355,103.627137
637516,11,19,30,1.314355,103.627137
637517,0,20,20,1.314355,103.627137
637518,2,40,42,1.314355,103.627137
637519,11,2,13,1.318479,103.632953
637520,12,2,14,1.31838,103.633061
637521,61,8,69,1.318281,103.633168
637522,4,12,16,1.317986,103.632622
637523,3,1,4,1.31636,103.6288
637524,1,1,2,1.31365,103.627587
637525,7,0,7,1.318087,103.632445
637526,8,0,8,1.318095,103.632357
637527,4,0,4,1.318003,103.632557
637529,6,0,6,1.318194,103.632152
637530,2,0,2,1.318072,103.632507
637531,0,6,6,1.318242,103.632
637532,6,8,14,1.318529,103.632083
637533,20,1,21,1.31851,103.632185
637535,0,2,2,1.318197,103.632069
637536,2,1,3,1.300782,103.625456
637537,4,0,4,1.318129,103.632274
637538,0,1,1,1.317961,103.632223
637539,6,1,7,1.318376,103.632619
637540,1,21,22,1.318341,103.632664
637541,2,13,15,1.318297,103.632728
637542,56,60,116,1.318237,103.632807
637543,50,51,101,1.298004,103.632012
637544,1,116,117,1.298065,103.631853
637545,1,1002,1003,1.298127,103.631693
637546,4,2,6,1.298234,103.631434
637547,0,1,1,1.31836,103.63252
637548,272,104,376,1.315787,103.631742
637550,1031,68,1099,1.289209,103.628092
637551,1929,6,1935,1.345034,103.679736
637552,18,3,21,1.299176,103.626263
637553,1216,322,1538,1.342867,103.679399
637554,49,147,196,1.31674,103.628026
637555,80,14,94,1.294938,103.626665
637556,27,3,30,1.299197,103.626451
637557,1873,341,2214,1.31311,103.629095
637558,1039,7,1046,1.294004,103.642409
637559,158,0,158,1.333874,103.671339
637560,9,2,11,1.300102,103.626516
637561,7,1,8,1.300002,103.62677
637562,3,0,3,1.318424,103.6324
637564,5,3,8,1.298981,103.627007
637565,22,0,22,1.29903,103.626872
637566,181,16,197,1.287076,103.631588
637567,35,0,35,1.317414,103.63262
637568,194,1,195,1.316924,103.632191
637569,176,139,315,1.287403,103.635221
637570,17,249,266,1.294808,103.626457
637571,21,116,137,1.290572,103.636301
637573,3,202,205,1.291025,103.624963
637574,93,2,95,1.299211,103.626173
637575,128,17,145,1.291041,103.636308
637576,56,27,83,1.300026,103.626345
637577,1,7,8,1.299636,103.626214
637578,2575,86,2661,1.299756,103.636375
637579,605,51,656,1.314935,103.627728
637580,8,6,14,1.314901,103.62789
637581,8,0,8,1.314783,103.62811
637582,1,0,1,1.298273,103.631335
637583,8,136,144,1.314661,103.62848
637584,7,651,658,1.31459,103.628448
637585,1,0,1,1.314734,103.628309
637586,1,0,1,1.314662,103.628248
637587,6,0,6,1.314845,103.627841
637588,41,12,53,1.314911,103.627667
637589,90,64,154,1.313352,103.627425
637590,22,4,26,1.295134,103.626115
637591,0,18,18,1.2994,103.624768
637592,6,33,39,1.299782,103.62382
637593,13,181,194,1.319267,103.659961
637594,1,2,3,1.299903,103.627025
637595,2,3,5,1.301723,103.627659
637596,3,13,16,1.302296,103.62699
637597,7,126,133,1.318914,103.659868
637598,347,140,487,1.355319,103.687075
637599,152,15,167,1.294451,103.632472
637600,63,102,165,1.311235,103.626804
637601,310,57,367,1.318994,103.629678
637602,4,1,5,1.292616,103.639295
637603,4,6,10,1.298747,103.627343
637604,2,3,5,1.297481,103.624694
637606,23,9,32,1.317923,103.628656
637607,992,0,992,1.287199,103.640587
637608,7,5,12,1.290816,103.626629
637609,698,269,967,1.30756,103.635584
637610,350,16,366,1.30878,103.634326
637611,2,1,3,1.30211,103.627431
637612,128,22,150,1.290578,103.630624
637613,8,532,540,1.299505,103.628042
637614,0,1,1,1.314735,103.628113
637615,3,0,3,1.298819,103.627163
637616,4202,1206,5408,1.349219,103.677587
637618,5,0,5,1.300835,103.627289
637619,0,3,3,1.300627,103.627821
637620,110,0,110,1.301043,103.626756
637621,40,1,41,1.299844,103.627901
637622,3,9,12,1.300353,103.625876
637623,35,4,39,1.300205,103.626315
637624,13,0,13,1.300195,103.626325
637626,0,1,1,1.300523,103.628088
637627,4,2,6,1.299973,103.626898
637628,3,0,3,1.300437,103.627377
637629,2,1,3,1.299898,103.627088
637631,3,1,4,1.3184,103.632442
637634,239,230,469,1.352874,103.682271
637635,338,109,447,1.35301,103.682771
637636,5,22,27,1.299555,103.627915
637637,0,1,1,1.300047,103.626707
637639,3,5,8,1.299257,103.626093
637640,16,5,21,1.298749,103.627525
637641,4,101,105,1.28826,103.635166
637642,66,115,181,1.294213,103.635771
637643,303,307,610,1.289582,103.630451
637644,1235,253,1488,1.294517,103.623515
637645,76,21,97,1.294675,103.634575
637646,24,12,36,1.294964,103.626048
637647,10,31,41,1.291549,103.625141
637648,201,98,299,1.294306,103.636918
637649,54,10,64,1.301967,103.626987
637650,26,26,52,1.294169,103.625511
637651,89,7,96,1.298573,103.624083
637652,11,15,26,1.320464,103.62957
637653,41,65,106,1.293318,103.637644
637654,168,33,201,1.290108,103.626396
637655,6,5,11,1.289575,103.646884
637657,16,69,85,1.287614,103.633442
637658,141,79,220,1.351308,103.681545
637659,415,355,770,1.350722,103.681012
637660,32,2,34,1.292599,103.63479
637661,375,118,493,1.362284,103.684664
637662,292,436,728,1.349369,103.682965
637663,39,36,75,1.350174,103.686935
637664,1119,90,1209,1.351856,103.688841
637665,1631,199,1830,1.351616,103.689591
637666,0,3,3,1.299824,103.627279
637667,1,4,5,1.292199,103.623809
637668,4,0,4,1.299674,103.62766
637669,3,0,3,1.300031,103.628138
637670,2,0,2,1.318453,103.632329
637671,3,1,4,1.292179,103.623809
637672,24,2,26,1.292109,103.623979
637673,4,1,5,1.292068,103.624137
637674,2,0,2,1.292139,103.6239
637675,16,4,20,1.292007,103.624295
637676,4,1,5,1.291987,103.624295
637677,17,1,18,1.291947,103.624453
637678,12,2,14,1.291927,103.624453
637679,0,1,1,1.299604,103.627788
637681,0,2,2,1.292048,103.624137
637683,128,13,141,1.291765,103.624927
637684,38,5,43,1.291745,103.624927
637685,0,4,4,1.292129,103.623979
637686,2,1,3,1.292159,103.6239
637687,2,2,4,1.291694,103.625043
637690,1,6,7,1.291035,103.624808
637691,6,2,8,1.2911,103.624487
637693,0,1,1,1.291886,103.624611
637695,1,0,1,1.291281,103.624
637696,1,2,3,1.291684,103.625033
637697,33,6,39,1.290935,103.624768
637698,22,6,28,1.290951,103.624657
637699,0,5,5,1.291017,103.624517
637700,6,4,10,1.29106,103.624385
637701,0,6,6,1.291112,103.624253
637702,1,6,7,1.29118,103.624118
637703,44,7,51,1.291218,103.623991
637704,11,1,12,1.291273,103.623851
637705,1,7,8,1.291327,103.623705
637706,1,19,20,1.291379,103.623527
637707,1,18,19,1.291774,103.623408
637708,1,0,1,1.291462,103.623513
637709,1,1,2,1.291826,103.624769
637710,36,2,38,1.292185,103.623533
637711,1,0,1,1.291774,103.623408
637713,2,0,2,1.29198,103.62347
637714,7,7,14,1.292776,103.623719
637715,206,0,206,1.349355,103.687986
637717,134,159,293,1.340625,103.680288
637718,914,606,1520,1.342137,103.679822
637719,123,206,329,1.344492,103.68727
637720,68,432,500,1.344005,103.686409
637721,418,535,953,1.343794,103.683977
637722,869,810,1679,1.34175,103.683095
637723,89,59,148,1.340764,103.683209
637724,24,12,36,1.299509,103.837
637725,17,158,175,1.320551,103.630035
637726,6,2,8,1.301469,103.628341
637727,4,2,6,1.301553,103.628113
637728,3,0,3,1.291583,103.623358
637729,0,1,1,1.292284,103.623564
637730,0,1,1,1.300981,103.626936
637732,2,0,2,1.292579,103.623657
637736,30,0,30,1.300544,103.628054
637737,1,0,1,1.300918,103.627096
637738,7,3,10,1.300429,103.628364
637739,358,5,363,1.301311,103.628647
637740,23,0,23,1.301364,103.628568
637742,2,0,2,1.300793,103.627415
637743,53,0,53,1.301562,103.628038
637744,2,0,2,1.301496,103.628214
637748,5,0,5,1.301891,103.627154
637749,4,1,5,1.301957,103.626977
637750,50,16,66,1.28788,103.632113
637751,19,35,54,1.312032,103.631587
637752,1150,16,1166,1.312145,103.631192
637753,40,17,57,1.313118,103.630015
637754,195,17,212,1.313087,103.630107
637755,31,0,31,1.313025,103.63029
637756,17,19,36,1.312963,103.630472
637758,1,12,13,1.312839,103.630838
637759,30,0,30,1.312778,103.631021
637760,0,2,2,1.301628,103.627861
637761,7,0,7,1.312654,103.631387
637762,28,0,28,1.312592,103.63157
637764,18,4,22,1.312468,103.631935
637765,5,13,18,1.312416,103.632108
637766,1422,262,1684,1.303045,103.631752
637767,157,18,175,1.312317,103.630817
637768,87,6,93,1.2896,103.633658
637769,10,85,95,1.30123,103.628678
637770,15,30,45,1.300409,103.628364
637773,3,16,19,1.300819,103.628521
637774,1,1,2,1.312716,103.631204
637775,17,7,24,1.301384,103.628568
637776,6,43,49,1.29555,103.633639
637777,16,6,22,1.293633,103.632401
637778,152,74,226,1.299126,103.627911
637779,4,28,32,1.300419,103.628374
637780,35,32,67,1.312406,103.632098
637781,24,7,31,1.333843,103.671363
637782,249,28,277,1.312387,103.627188
637783,10,5,15,1.308955,103.625964
637784,11,23,34,1.32032,103.629842
637785,1,53,54,1.309517,103.627998
637786,76,14,90,1.30912,103.627219
637787,76,0,76,1.310146,103.627798
637788,26,16,42,1.297906,103.626693
637789,23,5,28,1.297655,103.626609
637790,7,7,14,1.297155,103.626442
637792,161,8,169,1.296153,103.626106
637793,64,1,65,1.295653,103.625939
637795,3,0,3,1.301012,103.626856
637796,50,0,50,1.294685,103.625041
637797,39,0,39,1.294274,103.624887
637798,23,5,28,1.294268,103.624153
637799,2,3,5,1.294518,103.624194
637800,5,1,6,1.294928,103.624353
637801,66,0,66,1.295115,103.624425
637802,1,31,32,1.295531,103.624618
637803,26,9,35,1.295731,103.624655
637804,0,5,5,1.296182,103.624835
637805,0,1,1,1.300481,103.628214
637806,34,3,37,1.296806,103.625069
637807,7,3,10,1.296987,103.6251
637808,73,5,78,1.29738,103.62538
637809,0,1,1,1.296389,103.624869
637810,81,8,89,1.298189,103.625705
637811,5,0,5,1.309354,103.629676
637812,1,0,1,1.297801,103.625547
637814,16,0,16,1.309293,103.626753
637816,1,3,4,1.291581,103.625047
637817,18,73,91,1.313462,103.655688
637819,2303,393,2696,1.351081,103.689197
637820,1613,747,2360,1.35105,103.689208
637821,259,7,266,1.295913,103.620613
637822,29,0,29,1.293759,103.624681
637823,1,0,1,1.312664,103.656738
637825,0,1,1,1.293748,103.624687
637826,0,7,7,1.293378,103.624297
637829,4,0,4,1.313371,103.655757
637832,0,2,2,1.301331,103.628647
637833,45,0,45,1.292982,103.62408
637838,61,2,63,1.311267,103.630222
637839,21,156,177,1.311059,103.630595
637840,15,7,22,1.311004,103.630803
637841,3,101,104,1.310949,103.631005
637842,13,1,14,1.310758,103.631225
637843,52,3,55,1.310402,103.632009
637844,2,21,23,1.310743,103.632215
637845,1,8,9,1.310572,103.632122
637846,2,0,2,1.292981,103.624106
637847,0,12,12,1.310392,103.632019
637848,551,17,568,1.309573,103.632102
637849,1,0,1,1.293751,103.624692
637858,5,84,89,1.298916,103.629631
637860,1,6,7,1.298895,103.629701
637861,0,3,3,1.295152,103.625771
637862,3,4,7,1.298803,103.62994
637863,4,158,162,1.298888,103.629741
637864,0,8,8,1.298742,103.630099
637865,1,3,4,1.293379,103.624269
637866,0,17,17,1.29868,103.630259
637867,3,0,3,1.298865,103.62978
637868,0,72,72,1.298619,103.630418
637870,0,9,9,1.298557,103.630577
637871,0,1,1,1.309354,103.631355
637872,2,15,17,1.298496,103.630737
637873,5,0,5,1.298696,103.630239
637874,3,6,9,1.298434,103.630896
637875,5,2,7,1.298657,103.630338
637876,37,14,51,1.298373,103.631056
637877,0,2,2,1.310392,103.632019
637878,5,16,21,1.298311,103.631215
637879,2,0,2,1.298619,103.630438
637880,78,39,117,1.29825,103.631374
637881,16,2,18,1.298542,103.630637
637882,274,235,509,1.298188,103.631534
637883,4,1,5,1.298503,103.630737
637884,15,7,22,1.298465,103.630837
637885,119,3,122,1.298427,103.630936
637886,1,1,2,1.29858,103.630538
637887,2,1,3,1.298811,103.62994
637889,4,0,4,1.298849,103.62984
637890,9,5,14,1.298158,103.631634
637895,102,145,247,1.3081,103.63154
637896,15,12,27,1.308581,103.629665
637898,1807,217,2024,1.33458,103.641394
637899,2837,1504,4341,1.33388,103.671343
637900,23,0,23,1.333842,103.671365
637901,26,1,27,1.333852,103.671344
637902,31,13,44,1.291746,103.619088
637903,2,9,11,1.33727,103.69071
637904,2,1,3,1.29835,103.631135
637905,5,3,8,1.337235,103.690736
637906,4,0,4,1.298196,103.631534
637908,0,1,1,1.298734,103.630139
637909,1,2,3,1.337304,103.690665
637910,1,0,1,1.337239,103.690713
637911,4,0,4,1.337272,103.690689
637912,2,2,4,1.337029,103.690888
637913,4,1,5,1.336961,103.690939
637914,1,0,1,1.337174,103.690761
637915,49,0,49,1.336892,103.69099
637916,8,0,8,1.33698,103.690905
637917,0,4,4,1.33711,103.690809
637918,245,28,273,1.336915,103.690953
637919,12,0,12,1.336755,103.691091
637920,3,0,3,1.337098,103.690837
637921,6,10,16,1.336686,103.691142
637922,15,0,15,1.336785,103.691049
637923,2,0,2,1.298388,103.631036
637924,0,2,2,1.336618,103.691193
637925,0,1,1,1.337045,103.690857
637926,1,0,1,1.336549,103.691243
637927,20,0,20,1.33648,103.691294
637928,5,2,7,1.336591,103.691192
637929,1,1,2,1.33672,103.691096
637930,5,0,5,1.336526,103.69124
637932,15,1,16,1.336461,103.691288
637933,26,11,37,1.336274,103.691446
637934,1,0,1,1.336656,103.691144
637935,3,0,3,1.33685,103.691001
637936,2,2,4,1.336823,103.69104
637937,1,16,17,1.336147,103.691538
637938,8,0,8,1.336267,103.691432
637939,28,1,29,1.336202,103.69148
637940,4,0,4,1.336332,103.691384
637941,0,1,1,1.336396,103.691336
637945,0,2,2,1.336412,103.691345
637946,0,2,2,1.338177,103.691739
637949,1,1,2,1.337707,103.691238
637951,6,4,10,1.337379,103.691496
637952,2,0,2,1.337525,103.691381
637953,1,1,2,1.337306,103.691553
637954,1,0,1,1.337909,103.691943
637955,0,3,3,1.336206,103.691497
637956,1,1,2,1.337234,103.69161
637957,3,0,3,1.337088,103.691725
637958,4,0,4,1.336137,103.691528
637959,79,9,88,1.336797,103.691955
637960,0,6,6,1.336734,103.692002
637961,0,10,10,1.336756,103.691967
637962,0,2,2,1.337015,103.691783
637963,0,7,7,1.336851,103.691892
637964,2,0,2,1.336788,103.691942
637965,4,11,15,1.336979,103.691791
637966,16,0,16,1.337042,103.691741
637967,9,12,21,1.337106,103.691691
637968,1,0,1,1.337161,103.691668
637969,3,3,6,1.337234,103.69159
637970,17,0,17,1.337297,103.69154
637971,1,3,4,1.33687,103.691897
637972,4,0,4,1.337361,103.69149
637973,1,1,2,1.336915,103.691841
637974,20,0,20,1.337552,103.69134
637975,0,2,2,1.337488,103.69139
637979,0,12,12,1.337646,103.692585
637980,3,0,3,1.336942,103.69184
637981,3,2,5,1.337777,103.692538
637982,1,1,2,1.337616,103.691289
637983,0,4,4,1.337425,103.69144
637984,2,302,304,1.339877,103.691302
637985,0,2,2,1.33719,103.692373
637986,2,63,65,1.339804,103.691207
637987,6,1,7,1.339755,103.691145
637988,0,65,65,1.339706,103.691082
637989,2,0,2,1.339853,103.69127
637990,2,144,146,1.339607,103.690956
637991,6,0,6,1.339558,103.690894
637992,6,89,95,1.339509,103.690831
637993,1,0,1,1.33717,103.691641
637994,14,14,28,1.339434,103.690735
637997,6,775,781,1.339306,103.690571
637998,24,0,24,1.339254,103.690506
637999,4,2,6,1.339202,103.69044
638000,0,81,81,1.339151,103.690374
638001,0,3,3,1.337097,103.692301
638002,0,59,59,1.339048,103.690243
638003,1,2,3,1.3391,103.690309
638004,0,145,145,1.338999,103.690182
638005,1,0,1,1.33946,103.690768
638006,0,225,225,1.3389,103.690059
638007,1,1,2,1.339656,103.691019
638008,9,756,765,1.338801,103.689936
638010,2,82,84,1.338703,103.689813
638011,6,6,12,1.338653,103.689751
638012,1,61,62,1.338604,103.68969
638014,0,111,111,1.338555,103.68962
638016,1,46,47,1.338458,103.68948
638017,154,85,239,1.305297,103.63024
638018,22,15,37,1.30482,103.630072
638019,131,11,142,1.304321,103.629907
638020,41,21,62,1.303823,103.629695
638021,0,10,10,1.303335,103.629506
638022,5,134,139,1.302868,103.629345
638023,926,20,946,1.30236,103.629136
638024,205,27,232,1.305679,103.629179
638025,184,27,211,1.305208,103.629022
638026,15,14,29,1.304773,103.628832
638027,20,0,20,1.304354,103.628701
638028,10,14,24,1.303969,103.628552
638029,17,10,27,1.303514,103.628363
638030,29,16,45,1.302539,103.628443
638031,240,238,478,1.302215,103.628328
638032,62,8,70,1.305836,103.628466
638033,39,2,41,1.305374,103.628284
638034,655,72,727,1.304889,103.628137
638035,84,4,88,1.304401,103.627927
638036,10,8,18,1.303938,103.627778
638037,11,0,11,1.303434,103.627569
638038,240,298,538,1.302787,103.62684
638039,106,3,109,1.308511,103.628893
638041,38,0,38,1.307652,103.631099
638042,18,19,37,1.307876,103.630457
638043,812,105,917,1.307266,103.631007
638044,48,10,58,1.307709,103.630375
638045,8,20,28,1.3068,103.63079
638046,6,2,8,1.307542,103.630312
638047,4,36,40,1.306286,103.630603
638048,1,0,1,1.338949,103.69012
638049,477,148,625,1.305821,103.63045
638050,1,0,1,1.307209,103.630188
638051,10,1,11,1.306542,103.629938
638052,22,0,22,1.306962,103.62966
638053,11,0,11,1.306586,103.629503
638054,8,0,8,1.306415,103.629412
638055,2,0,2,1.338851,103.689997
638056,2,0,2,1.306261,103.629373
638057,19,7,26,1.308322,103.628839
638058,18,0,18,1.308144,103.628774
638059,31,45,76,1.307787,103.628645
638060,17,0,17,1.30743,103.628516
638062,6,72,78,1.307192,103.628933
638063,2,0,2,1.306083,103.629286
638064,10,2,12,1.306679,103.628755
638065,0,1,1,1.306875,103.630063
638066,20,2,22,1.30632,103.628635
638067,31,69,100,1.311443,103.629231
638068,52,19,71,1.311683,103.628562
638069,18,108,126,1.312071,103.628693
638070,85,13,98,1.311693,103.628552
638071,3,13,16,1.311683,103.628542
638072,34,29,63,1.311454,103.628475
638073,18,3,21,1.310997,103.628341
638074,5,8,13,1.31067,103.628263
638075,355,770,1125,1.348324,103.681525
638076,39,13,52,1.310558,103.62831
638077,2,9,11,1.31048,103.62838
638079,9,0,9,1.310414,103.628556
638081,2,4,6,1.310348,103.628732
638082,122,13,135,1.31033,103.628759
638083,12,0,12,1.310281,103.628909
638085,0,9,9,1.310215,103.629085
638087,1,0,1,1.306492,103.628676
638091,0,3,3,1.339023,103.690212
638093,15,4,19,1.30995,103.629789
638094,16,9,25,1.309884,103.629966
638095,23,0,23,1.309818,103.630142
638096,1,0,1,1.310149,103.629261
638097,1,0,1,1.309751,103.630318
638098,15,1,16,1.309619,103.63067
638099,4,0,4,1.337273,103.692435
638100,1,0,1,1.309685,103.630494
638101,3,0,3,1.310016,103.629613
638102,1,0,1,1.309486,103.631023
638103,40,103,143,1.309324,103.631586
638104,3,0,3,1.30942,103.631199
638105,0,5,5,1.30963,103.631742
638106,1,0,1,1.309354,103.631375
638107,6,2,8,1.309936,103.631854
638108,32,1,33,1.310576,103.631603
638109,8,7,15,1.31024,103.631964
638110,0,2,2,1.306849,103.628788
638111,1,0,1,1.310393,103.632
638112,1,1,2,1.310749,103.631216
638113,0,1,1,1.310393,103.63202
638114,3,1,4,1.309553,103.630846
638115,4,21,25,1.310573,103.632123
638116,1,0,1,1.310393,103.63202
638117,153,188,341,1.310744,103.632216
638118,20,0,20,1.311048,103.630355
638119,25,2,27,1.310403,103.63201
638120,20,1,21,1.311144,103.630072
638121,25,3,28,1.310759,103.631226
638122,5,0,5,1.31124,103.629788
638123,1,2,3,1.309328,103.63147
638124,85,0,85,1.311337,103.629505
638125,3,4,7,1.310928,103.63073
638126,3,12,15,1.311385,103.629363
638127,15,14,29,1.311096,103.630234
638128,11,0,11,1.311673,103.628552
638129,9,9,18,1.311264,103.629737
638130,4,7,11,1.311433,103.629221
638131,73,4,77,1.311349,103.629489
638132,2,1,3,1.311296,103.630876
638133,9,8,17,1.339167,103.691828
638134,2,0,2,1.310759,103.631206
638135,1,0,1,1.310952,103.630639
638136,2,1,3,1.339122,103.691794
638137,1,18,19,1.338758,103.691307
638139,25,45,70,1.33877,103.6913
638140,0,2,2,1.339087,103.69175
638141,1,1,2,1.338878,103.691484
638142,4,3,7,1.338808,103.691396
638143,12,2,14,1.338836,103.69125
638145,4,0,4,1.310855,103.630922
638146,12,5,17,1.338714,103.691277
638147,3,2,5,1.338924,103.691182
638148,1,0,1,1.338968,103.691572
638149,33,1,34,1.338967,103.691149
638151,2,2,4,1.33888,103.691216
638152,11,6,17,1.338594,103.691126
638153,3,11,14,1.339055,103.691081
638154,0,4,4,1.339011,103.691115
638155,1,0,1,1.33869,103.691247
638156,2,0,2,1.338792,103.691283
638157,4,2,6,1.339143,103.691014
638158,1,0,1,1.339099,103.691048
638159,4,0,4,1.338546,103.691065
638160,10,0,10,1.338401,103.690884
638161,3,1,4,1.339187,103.69098
638162,1,2,3,1.339017,103.691661
638163,23,0,23,1.339275,103.690913
638164,4,0,4,1.339231,103.690946
638165,17,13,30,1.339318,103.690879
638166,14,0,14,1.338271,103.690717
638168,2,0,2,1.338497,103.691005
638169,2,13,15,1.33876,103.691104
638170,2,0,2,1.338236,103.690672
638171,2,1,3,1.338353,103.690823
638172,12,0,12,1.338098,103.690489
638173,60,1,61,1.338334,103.690759
638174,1,0,1,1.338449,103.690944
638175,0,11,11,1.338353,103.690746
638176,16,4,20,1.337961,103.690306
638177,0,2,2,1.338167,103.69058
638179,55,0,55,1.338429,103.690691
638180,0,3,3,1.338722,103.691126
638181,1,1,2,1.338391,103.690718
638182,0,1,1,1.33803,103.690398
638183,5,4,9,1.338581,103.690581
638184,4,3,7,1.338619,103.690554
638185,3,7,10,1.338657,103.690527
638186,2,6,8,1.338696,103.690499
638188,10,4,14,1.338772,103.690445
638189,24,0,24,1.33881,103.690417
638190,5,2,7,1.338848,103.69039
638191,6,0,6,1.338886,103.690362
638192,0,2,2,1.338505,103.690636
638193,2,0,2,1.338924,103.690335
638194,2,1,3,1.338467,103.690664
638195,5,5,10,1.338292,103.690543
638216,2,7,9,1.338556,103.689729
638217,1,1,2,1.338962,103.690308
638220,24,0,24,1.338286,103.689933
638221,4,0,4,1.338315,103.690773
638223,8,2,10,1.338056,103.690108
638224,0,1,1,1.338543,103.690609
638225,0,5,5,1.337912,103.690215
638226,0,4,4,1.33821,103.689992
638227,1,1,2,1.338517,103.689758
638228,0,8,8,1.338456,103.689785
638230,8,0,8,1.338317,103.68989
638232,0,2,2,1.338525,103.689732
638234,2,5,7,1.33804,103.6901
638235,2,0,2,1.338179,103.689995
638236,0,3,3,1.338326,103.690522
638238,0,1,1,1.337979,103.690167
638240,3,1,4,1.338559,103.689706
638241,3,0,3,1.337902,103.690205
638244,7,0,7,1.337437,103.690563
638245,4,1,5,1.33737,103.690614
638246,13,10,23,1.338518,103.692139
638247,7,20,27,1.338489,103.692102
638248,19,0,19,1.33843,103.69203
638249,1,11,12,1.338372,103.691957
638251,9,16,25,1.338255,103.691812
638252,39,0,39,1.338197,103.691739
638253,2,0,2,1.337971,103.690152
638256,16,0,16,1.338031,103.691536
638257,2,1,3,1.337636,103.690409
638259,7,0,7,1.337864,103.691334
638263,3,1,4,1.337703,103.690358
638264,2,0,2,1.338169,103.691705
638266,1,0,1,1.337836,103.690256
638268,1,0,1,1.337534,103.690937
638270,16,2,18,1.337314,103.690675
638271,44,8,52,1.338483,103.69212
638272,2,14,16,1.33844,103.692066
638273,1,0,1,1.337424,103.690806
638274,10,2,12,1.338264,103.691848
638275,15,1,16,1.338187,103.691749
638276,8,0,8,1.338097,103.691819
638277,0,1,1,1.338352,103.691957
638280,0,1,1,1.338006,103.691888
638281,2,6,8,1.337293,103.692435
638282,1,2,3,1.337975,103.691469
638287,6,3,9,1.337631,103.692157
638288,55,0,55,1.3377,103.692104
638289,0,2,2,1.337643,103.691068
638291,10,746,756,1.338098,103.692431
638292,56,19,75,1.338138,103.692408
638293,5,0,5,1.338218,103.692364
638294,4,268,272,1.338298,103.692319
638295,7,0,7,1.338377,103.692274
638296,0,6,6,1.338457,103.69223
638297,11,2,13,1.338537,103.692185
638298,0,17,17,1.338576,103.692164
638299,1,2,3,1.337318,103.692398
638301,0,1,1,1.337464,103.692306
638303,0,1,1,1.338773,103.692059
638304,7,0,7,1.33901,103.691932
638305,2,2,4,1.337698,103.691133
638306,5,2,7,1.339167,103.691848
638308,1,0,1,1.338931,103.691974
638309,0,2,2,1.33777,103.69205
638310,26,0,26,1.339404,103.69172
638311,1,0,1,1.339247,103.691808
638313,5,0,5,1.339554,103.691604
638314,9,2,11,1.3393,103.691762
638315,0,1,1,1.339479,103.691662
638316,3,0,3,1.338616,103.692143
638318,0,4,4,1.339088,103.69189
638319,6,0,6,1.339779,103.69143
638320,5,0,5,1.339695,103.691475
638321,2,1,3,1.339432,103.691678
638322,0,4,4,1.339563,103.691577
638323,23,0,23,1.339892,103.691343
638324,4,11,15,1.339882,103.691333
638325,0,3,3,1.339854,103.691372
638326,0,12,12,1.339943,103.691297
638328,17,0,17,1.340045,103.691206
638329,1,0,1,1.339629,103.691546
638330,3,535,538,1.340147,103.691114
638331,5,49,54,1.335953,103.691422
638332,2,1,3,1.339918,103.69132
638333,1,2,3,1.335974,103.691436
638334,0,4,4,1.339826,103.691374
638335,4,0,4,1.336055,103.691492
638336,1,2,3,1.336015,103.691464
638337,7,0,7,1.33617,103.691574
638338,0,1,1,1.340096,103.69116
638340,111,0,111,1.336333,103.691703
638341,0,1,1,1.336202,103.6916
638342,161,0,161,1.336463,103.691806
638343,1,0,1,1.336398,103.691754
638344,25,1,26,1.336594,103.691909
638345,8,1,9,1.336659,103.69196
638346,2,6,8,1.336714,103.692002
638347,2,1,3,1.336127,103.691538
638348,0,3,3,1.336771,103.692048
638349,3,0,3,1.336817,103.692084
638350,19,220,239,1.337488,103.692522
638352,1,132,133,1.330121,103.676536
638354,4,23,27,1.330086,103.677112
638355,4,0,4,1.336096,103.69152
638356,33,1,34,1.328916,103.676613
638357,534,0,534,1.332377,103.687362
638358,68,0,68,1.332368,103.687411
638361,262,0,262,1.332373,103.687379
638364,824,3,827,1.332772,103.683902
638365,344,130,474,1.332714,103.678929
638366,1899,856,2755,1.329444,103.68286
638367,12,105,117,1.332018,103.676725
638368,12,10,22,1.328917,103.677151
638377,1783,549,2332,1.335544,103.644612
638378,1,1,2,1.339326,103.691769
638379,216,184,400,1.333768,103.642868
638380,125,23,148,1.333375,103.642483
638381,1909,0,1909,1.332953,103.642054
638382,599,711,1310,1.332484,103.641674
638383,637,120,757,1.332054,103.641255
638384,5,43,48,1.329007,103.638274
638385,109,10,119,1.328146,103.637568
638386,96,3,99,1.331148,103.640664
638387,3,0,3,1.33691,103.692156
638388,434,3,437,1.332489,103.640276
638389,7,12,19,1.325965,103.636794
638390,9,44,53,1.299509,103.837
638391,930,37,967,1.299509,103.837
638404,3779,764,4543,1.341276,103.635989
638405,4,28,32,1.325991,103.632367
638406,1,125,126,1.326736,103.632523
638408,1919,3,1922,1.331353,103.632671
638410,190,87,277,1.345011,103.639114
638411,326,0,326,1.339347,103.63674
638412,4,25,29,1.334816,103.635186
638413,2003,145,2148,1.329636,103.631884
638414,354,26,380,1.327206,103.631014
638415,13,8,21,1.331364,103.633923
638416,12,127,139,1.344353,103.638682
638417,728,42,770,1.324487,103.632197
638418,50,36,86,1.299509,103.837
638419,38,0,38,1.299509,103.837
638427,71,186,257,1.332084,103.63798
638428,209,16,225,1.329439,103.636615
638429,166,0,166,1.335276,103.63998
638430,4,0,4,1.329314,103.676803
638431,31,201,232,1.334448,103.639261
638432,261,24,285,1.330458,103.635772
638433,577,0,577,1.330264,103.637645
638434,41,123,164,1.331421,103.636314
638435,25,64,89,1.33244,103.638317
638436,236,20,256,1.333172,103.639445
638437,14,4,18,1.330623,103.634491
638438,10,6,16,1.330823,103.634303
638439,8,12,20,1.331058,103.63398
638440,724,105,829,1.333583,103.640304
638441,25,12,37,1.331752,103.63707
638442,94,2,96,1.299509,103.837
638452,3,13,16,1.31909,103.651687
638453,182,59,241,1.319167,103.651782
638454,400,95,495,1.319322,103.651912
638455,68,62,130,1.318967,103.65287
638457,80,0,80,1.320098,103.652679
638458,3,3,6,1.320254,103.652808
638459,340,27,367,1.320048,103.653482
638481,8613,222,8835,1.32093,103.664431
638482,9,8,17,1.319795,103.661885
638483,38,87,125,1.319508,103.661473
638485,19,0,19,1.320558,103.661092
638486,1295,65,1360,1.319955,103.660479
638487,8,0,8,1.313004,103.6561
638488,89,6,95,1.312707,103.655672
638489,465,290,755,1.312006,103.654424
638490,8,79,87,1.311174,103.653758
638492,13,47,60,1.316119,103.655245
638493,36,0,36,1.310005,103.652676
638495,170,6,176,1.309626,103.652416
638496,241,0,241,1.308939,103.651792
638497,29,377,406,1.307336,103.651109
638498,1613,214,1827,1.306904,103.650892
638499,321,0,321,1.310679,103.651758
638500,384,301,685,1.310728,103.650313
638501,2687,1239,3926,1.307425,103.648594
638502,23,1,24,1.309758,103.650295
638503,2337,424,2761,1.308525,103.651685
638505,153,142,295,1.312511,103.652186
638506,58,66,124,1.313876,103.655816
638507,40,8,48,1.313722,103.655949
638508,39,15,54,1.313641,103.656029
638509,1,11,12,1.313518,103.656139
638510,0,18,18,1.313405,103.656262
638511,3,6,9,1.313284,103.656385
638512,22,35,57,1.313093,103.656552
638513,48,4,52,1.312944,103.656657
638514,9,0,9,1.312826,103.656795
638515,0,1,1,1.336528,103.691857
638516,35,1,36,1.312423,103.656663
638519,0,2,2,1.335392,103.643508
638520,113,4,117,1.312885,103.656214
638521,39,2,41,1.31311,103.656016
638522,207,10,217,1.338278,103.638606
638523,1,0,1,1.312701,103.6569
638524,30,0,30,1.337989,103.638335
638525,15,0,15,1.337797,103.638154
638526,9,0,9,1.337605,103.637973
638527,8,9,17,1.337413,103.637792
638528,76,0,76,1.33722,103.637612
638529,41,8,49,1.337028,103.637431
638550,373,49,422,1.33722,103.639847
638551,0,18,18,1.337136,103.639749
638552,22,6,28,1.33657,103.63924
638553,2,0,2,1.312783,103.65636
638554,0,5,5,1.335905,103.63928
638555,1,0,1,1.338182,103.638515
638556,2,2,4,1.33491,103.639615
638557,9,1,10,1.336665,103.639308
638558,1,2,3,1.331141,103.640689
638559,39,13,52,1.335911,103.638602
638560,3,0,3,1.336476,103.639131
638562,28,16,44,1.335921,103.638612
638563,19,0,19,1.335578,103.638335
638564,8,9,17,1.337287,103.636477
638565,78,4,82,1.33647,103.638006
638566,11,2,13,1.337018,103.637421
638567,126,3,129,1.337028,103.637411
638568,52,56,108,1.337525,103.636582
638583,5,16,21,1.333288,103.638586
638584,511,19,530,1.333519,103.638349
638585,1,0,1,1.336853,103.639484
638586,101,8,109,1.334443,103.637404
638587,39,2,41,1.334905,103.636931
638588,261,9,270,1.334736,103.636636
638589,32,9,41,1.335041,103.636237
638590,29,15,44,1.333259,103.638635
638591,107,3,110,1.333461,103.638428
638593,95,1,96,1.33427,103.637601
638594,1,4,5,1.334674,103.637188
638595,102,6,108,1.335223,103.637374
638596,198,0,198,1.335511,103.637105
638597,3,8,11,1.335777,103.636787
638598,116,5,121,1.335524,103.635817
638599,2,3,5,1.336393,103.636235
638610,40,24,64,1.329125,103.64148
638611,477,6,483,1.328257,103.642354
638612,556,1,557,1.329102,103.642233
638613,322,218,540,1.329102,103.642253
638614,37,40,77,1.329974,103.642233
638615,262,71,333,1.329209,103.643103
638636,10,1235,1245,1.322953,103.65532
638637,7,15,22,1.322781,103.655209
638638,11,1,12,1.322964,103.655994
638639,4511,16,4527,1.32381,103.6561
638640,2,0,2,1.337042,103.639661
638641,6,0,6,1.324826,103.656214
638642,1,300,301,1.323743,103.656304
638643,124,0,124,1.323589,103.656592
638644,248,60,308,1.325274,103.656643
638645,37,0,37,1.323914,103.656862
638646,66,26,92,1.324223,103.657177
638647,595,64,659,1.324332,103.657499
638669,86,32,118,1.321382,103.657025
638670,41,0,41,1.322276,103.656667
638671,7,46,53,1.321578,103.657205
638672,16,39,55,1.322459,103.657238
638673,329,0,329,1.321968,103.657565
638674,182,0,182,1.322697,103.65758
638675,207,71,278,1.322359,103.657925
638676,230,17,247,1.323113,103.657789
638677,75,5,80,1.32275,103.658285
638678,394,5,399,1.32275,103.658265
638679,16,39,55,1.32314,103.658645
638680,154,12,166,1.323521,103.658995
638681,15,7,22,1.323531,103.658985
638702,17,13,30,1.32038,103.648997
638703,20,69,89,1.319544,103.649023
638704,8,0,8,1.318534,103.64728
638705,113,3,116,1.318067,103.648132
638706,26,25,51,1.31819,103.646949
638707,1343,0,1343,1.317466,103.647769
638708,11,0,11,1.317474,103.646996
638709,196,47,243,1.316621,103.646457
638710,12,116,128,1.316777,103.646342
638711,13,0,13,1.316367,103.646231
638712,38,44,82,1.316446,103.646025
638713,51,16,67,1.315989,103.645872
638714,46,0,46,1.316524,103.645182
638715,12,4,16,1.314695,103.646113
638716,43,15,58,1.315452,103.645075
638717,254,13,267,1.313919,103.645342
638718,3,198,201,1.313823,103.64272
638719,797,114,911,1.316086,103.64282
638720,437,326,763,1.315141,103.642327
638721,85,479,564,1.316576,103.642132
638722,4574,1,4575,1.315234,103.640419
638723,12,79,91,1.317098,103.641817
638724,1,16,17,1.317489,103.641321
638725,5,13,18,1.317697,103.640548
638726,975,66,1041,1.318295,103.638218
638727,13,56,69,1.319063,103.639195
638728,8,55,63,1.319144,103.638725
638729,8,1,9,1.320103,103.63788
638730,4,0,4,1.335901,103.638612
638731,5,23,28,1.32142,103.636444
638732,464,14,478,1.320627,103.634415
638735,56,23,79,1.319952,103.638157
638736,8,49,57,1.316395,103.642564
638737,9,46,55,1.323057,103.633329
638738,9,122,131,1.315859,103.644595
638739,34,0,34,1.318752,103.639475
638740,55,39,94,1.322851,103.635143
638741,248,7,255,1.314198,103.64393
638743,302,24,326,1.322194,103.634441
638755,6,5,11,1.31942,103.649241
638756,169,35,204,1.318803,103.649723
638757,99,57,156,1.319124,103.649679
638758,16,33,49,1.318234,103.649206
638759,62,13,75,1.318813,103.649962
638760,70,43,113,1.318369,103.648497
638761,84,11,95,1.318493,103.650311
638762,43,0,43,1.317743,103.648906
638763,4,12,16,1.318191,103.650612
638764,11,2,13,1.318793,103.649733
638765,14,22,36,1.315797,103.653234
638766,28,15,43,1.315382,103.653573
638767,21,35,56,1.316391,103.651694
638768,76,23,99,1.315099,103.653894
638769,438,41,479,1.314845,103.654224
638770,99,7,106,1.316599,103.652063
638771,8,106,114,1.314496,103.65462
638772,41,241,282,1.314166,103.65494
638773,26,0,26,1.315091,103.652792
638774,32,61,93,1.31436,103.653553
638775,11,16,27,1.314076,103.654154
638776,62,54,116,1.313129,103.654053
638778,123,22,145,1.315467,103.652671
638779,170,3,173,1.318234,103.649226
638780,1,0,1,1.333981,103.637877
638781,37,35,72,1.31471,103.653172
638782,22,59,81,1.316475,103.65247
638783,443,190,633,1.316174,103.65279
638784,1067,68,1135,1.317753,103.650313
638785,39,153,192,1.317823,103.65099
638786,318,195,513,1.31726,103.651361
638787,1,2,3,1.336288,103.638955
638789,0,8,8,1.299509,103.837
638790,1,0,1,1.317966,103.650068
638797,38,13,51,1.312925,103.653279
638798,60,0,60,1.312733,103.652689
638799,98,138,236,1.313489,103.653219
638800,16,0,16,1.313808,103.652274
638801,12,8,20,1.313334,103.652751
638802,16,0,16,1.313316,103.652136
638803,961,302,1263,1.312082,103.65316
638804,24,2,26,1.312841,103.652435
638805,56,18,74,1.313821,103.65139
638806,108,0,108,1.313092,103.650749
638818,12,5,17,1.328898,103.639673
638819,232,49,281,1.328503,103.639668
638820,69,0,69,1.327775,103.638989
638821,22,72,94,1.327507,103.638733
638822,38,0,38,1.32725,103.638488
638823,71,40,111,1.325651,103.638748
638824,1495,49,1544,1.326734,103.637996
638825,253,3,256,1.325324,103.637788
638826,186,63,249,1.326218,103.637504
638827,158,106,264,1.325713,103.637023
638828,744,112,856,1.324047,103.636782
638829,377,18,395,1.325507,103.636544
638830,140,47,187,1.323137,103.635698
638831,191,14,205,1.325074,103.635206
638832,141,23,164,1.328377,103.64026
638852,39,2,41,1.323361,103.638373
638853,8,0,8,1.323839,103.637625
638854,128,0,128,1.323133,103.638202
638855,8,6,14,1.323558,103.637426
638856,8,1,9,1.322929,103.638002
638858,13,0,13,1.323331,103.637757
638859,1,0,1,1.299509,103.837
638860,12,0,12,1.323046,103.637497
638861,12,25,37,1.322604,103.637113
638862,5,2,7,1.322762,103.637238
638863,26,0,26,1.322288,103.636824
638865,13,3,16,1.322133,103.637221
638866,175,11,186,1.321619,103.636787
638868,11,9,20,1.322004,103.636084
638888,16,24,40,1.323923,103.642686
638889,12,13,25,1.323741,103.64252
638890,6,0,6,1.323297,103.64154
638891,6,0,6,1.323014,103.641859
638892,0,5,5,1.320965,103.639415
638893,616,327,943,1.32265,103.641528
638894,277,0,277,1.320679,103.638966
638895,1,8,9,1.322268,103.641867
638896,47,0,47,1.320106,103.639114
638897,12,4,16,1.322046,103.64149
638898,3,18,21,1.319208,103.638257
638899,13,13,26,1.321582,103.640542
638900,9,0,9,1.320165,103.639958
638901,9,60,69,1.319741,103.639597
638902,37,1,38,1.319403,103.638934
638904,106,0,106,1.322962,103.641186
638905,318,24,342,1.32113,103.640345
638924,13,0,13,1.320329,103.642024
638926,18,5,23,1.319448,103.641852
638927,3,5,8,1.319479,103.641246
638928,240,41,281,1.320006,103.641064
638929,198,41,239,1.317787,103.639701
638930,31,3,34,1.320395,103.641384
638931,312,22,334,1.318931,103.640728
638932,18,79,97,1.317797,103.639691
638933,4,1,5,1.319499,103.641246
638934,366,8,374,1.318911,103.640728
638935,6,0,6,1.319155,103.639645
638950,1,3,4,1.321041,103.63754
638951,10,1,11,1.319893,103.646465
638952,31,13,44,1.318832,103.646319
638953,4,3,7,1.318717,103.645866
638954,172,5,177,1.319447,103.645245
638955,5,0,5,1.319862,103.645696
638974,52,18,70,1.317619,103.646148
638975,234,75,309,1.317091,103.645447
638976,44,1,45,1.318234,103.645881
638977,97,0,97,1.317017,103.644411
638978,4,16,20,1.318167,103.644908
638979,211,31,242,1.317988,103.642942
638980,6,2,8,1.318942,103.644215
638981,732,0,732,1.319716,103.64442
638982,133,3,136,1.319739,103.642506
638983,39,22,61,1.321158,103.643631
638984,1,27,28,1.320739,103.641899
638985,328,7,335,1.320919,103.641506
638986,7,3,10,1.321175,103.641166
638987,131,2,133,1.321778,103.642564
638988,75,54,129,1.322286,103.640189
638989,81,4,85,1.321657,103.641537
638990,13,12,25,1.321741,103.640426
638991,1,9,10,1.321256,103.639963
638992,79,28,107,1.322581,103.640758
638993,26,2,28,1.321623,103.639794
638994,236,73,309,1.323469,103.640612
638995,901,39,940,1.322116,103.638944
638996,649,70,719,1.32456,103.639497
638997,5,9,14,1.323606,103.638632
638998,1,2,3,1.315658,103.652273
638999,1,0,1,1.32292,103.637402
639000,17,0,17,1.325286,103.637458
639001,27,9,36,1.325643,103.637109
639022,43,22,65,1.331135,103.642175
639023,135,54,189,1.330058,103.64065
639024,265,86,351,1.331431,103.642451
639025,5,6,11,1.332022,103.643004
639026,9,9,18,1.331124,103.642085
639027,0,8,8,1.331515,103.64244
639028,8,1,9,1.332614,103.643558
639029,54,29,83,1.331845,103.642761
639030,13,14,27,1.332225,103.643118
639031,9,22,31,1.333195,103.644101
639032,22,7,29,1.332616,103.643478
639033,54,22,76,1.332996,103.643835
639034,4,46,50,1.333439,103.644336
639035,35,14,49,1.333657,103.645363
639036,8,0,8,1.334141,103.645009
639037,213,25,238,1.334162,103.646085
639038,39,6,45,1.334571,103.646279
639039,9,15,24,1.335535,103.646347
639040,254,32,286,1.3334,103.644278
639041,263,25,288,1.333595,103.644465
639042,340,3,343,1.333985,103.64484
639043,36,22,58,1.334375,103.645214
639044,23,0,23,1.334765,103.645588
639045,28,5,33,1.335155,103.645963
639046,2,8,10,1.335545,103.646337
639047,12,4,16,1.330905,103.641876
639048,3,9,12,1.330506,103.641516
639067,137,25,162,1.318888,103.648323
639068,19,81,100,1.318898,103.648333
639069,22,8,30,1.319606,103.647578
639070,151,7,158,1.319606,103.647598
639071,19,3,22,1.320315,103.646844
639072,42,27,69,1.32051,103.647499
639073,129,2,131,1.320595,103.646548
639074,225,0,225,1.320528,103.64688
639075,2,12,14,1.320865,103.646262
639076,216,20,236,1.320933,103.646456
639077,41,27,68,1.320753,103.645436
639078,17,1,18,1.321225,103.646135
639079,726,19,745,1.320932,103.64487
639081,11,0,11,1.322485,103.644547
639082,215,18,233,1.321697,103.645645
639083,185,53,238,1.321934,103.643513
639084,55,7,62,1.322667,103.64336
639085,18,4,22,1.323375,103.643224
639086,833,6,839,1.324471,103.642446
639088,886,281,1167,1.324132,103.642053
639089,143,7,150,1.325062,103.641034
639090,211,6,217,1.326822,103.638917
639091,7,0,7,1.326258,103.640655
639092,17,0,17,1.326366,103.640542
639093,10,8,18,1.326473,103.640429
639094,17,0,17,1.326581,103.640315
639095,43,0,43,1.326689,103.640202
639096,1,0,1,1.324918,103.637818
639097,13,24,37,1.326904,103.639975
639098,3,18,21,1.327011,103.639862
639099,5,0,5,1.327119,103.639749
639101,23,2,25,1.327334,103.639522
639102,1,0,1,1.326796,103.640089
639103,8,0,8,1.32755,103.639296
639104,9,37,46,1.327657,103.639182
639105,71,6,77,1.326,103.640138
639106,494,86,580,1.326091,103.64229
639107,681,269,950,1.325304,103.642923
639108,116,7,123,1.324096,103.643441
639125,38,76,114,1.32823,103.645239
639126,6,72,78,1.327615,103.645829
639127,235,12,247,1.328534,103.645516
639128,114,8,122,1.328331,103.645351
639129,4,8,12,1.329144,103.646072
639130,3,24,27,1.328738,103.645722
639131,6,145,151,1.329754,103.646628
639132,21,103,124,1.329144,103.646092
639133,12,1,13,1.330388,103.646528
639134,838,0,838,1.32955,103.646462
639135,65,41,106,1.330657,103.647459
639136,1299,0,1299,1.329957,103.646833
639137,107,326,433,1.33095,103.647734
639138,708,124,832,1.330353,103.647193
639139,0,49,49,1.331538,103.648286
639140,66,199,265,1.330531,103.647361
639141,173,8,181,1.332126,103.648838
639142,518,0,518,1.330699,103.647518
639143,0,2,2,1.322999,103.656654
639144,70,0,70,1.331034,103.647833
639145,21,2,23,1.33137,103.648148
639146,1,0,1,1.327442,103.639409
639147,36,17,53,1.332042,103.648779
639148,12,54,66,1.332377,103.649094
639149,96,138,234,1.3338,103.649601
639150,1095,29,1124,1.332937,103.650253
639169,9,8,17,1.323486,103.649643
639170,12,8,20,1.323567,103.649559
639171,2,10,12,1.323729,103.649391
639172,0,6,6,1.323891,103.649222
639173,8,0,8,1.324053,103.649054
639174,11,10,21,1.324214,103.648886
639175,164,0,164,1.324376,103.648718
639176,9,0,9,1.324538,103.648549
639177,3,0,3,1.324551,103.638178
639178,0,2,2,1.332713,103.649389
639179,16,1,17,1.324943,103.648127
639180,3,2,5,1.325024,103.648041
639182,1,0,1,1.331372,103.649047
639183,10,0,10,1.325509,103.647525
639184,0,17,17,1.325671,103.647353
639185,10,32,42,1.325833,103.647181
639186,6,0,6,1.325994,103.647009
639187,4,0,4,1.320109,103.646659
639188,7,4,11,1.326318,103.646665
639189,458,27,485,1.327739,103.644345
639190,77,4,81,1.328196,103.643894
639191,14,31,45,1.3295,103.644143
639192,179,0,179,1.329937,103.643692
639193,278,0,278,1.329867,103.642943
639195,686,205,891,1.326716,103.644532
639196,88,1,89,1.324122,103.647134
639197,101,25,126,1.323792,103.647899
639198,39,6,45,1.323724,103.648704
639215,153,6,159,1.325138,103.645347
639216,7,71,78,1.324427,103.646017
639217,4,19,23,1.325592,103.645815
639218,85,138,223,1.326634,103.645826
639219,7,35,42,1.325568,103.645914
639220,3,8,11,1.326988,103.646419
639221,946,7,953,1.326308,103.646655
639222,3,0,3,1.3247,103.648381
639224,148,287,435,1.327299,103.647551
639225,49,0,49,1.326992,103.648177
639226,16,0,16,1.32779,103.648003
639227,265,0,265,1.327496,103.648302
639228,15,30,45,1.328273,103.647666
639229,62,30,92,1.327709,103.648692
639230,249,122,371,1.328465,103.64805
639231,2,0,2,1.324862,103.648213
639232,225,110,335,1.32889,103.64822
639233,65,0,65,1.328761,103.648919
639234,21,55,76,1.329468,103.648529
639235,43,0,43,1.329061,103.6492
639236,138,26,164,1.329158,103.649271
639237,21,8,29,1.329352,103.649472
639238,19,10,29,1.329545,103.649632
639239,2,0,2,1.32828,103.648476
639240,48,1,49,1.329932,103.649994
639241,28,77,105,1.329748,103.650393
639242,49,0,49,1.330656,103.649822
639243,173,9,182,1.330006,103.650711
639244,4,0,4,1.326156,103.646837
639245,110,26,136,1.331246,103.650441
639246,212,17,229,1.330966,103.651806
639247,19,0,19,1.331329,103.652164
639248,72,51,123,1.331702,103.652517
639249,272,2,274,1.332964,103.651962
639250,23,133,156,1.332052,103.652931
639251,152,197,349,1.331882,103.651179
639266,433,45,478,1.331083,103.645605
639267,170,12,182,1.331808,103.646405
639268,1,0,1,1.325347,103.647697
639269,0,13,13,1.332244,103.645942
639270,504,111,615,1.331905,103.644723
639271,224,0,224,1.333187,103.645949
639272,59,114,173,1.333209,103.644618
639273,357,92,449,1.334765,103.643377
639274,150,184,334,1.334387,103.643688
639293,334,0,334,1.325398,103.649407
639294,69,256,325,1.32595,103.648614
639295,483,6,489,1.326272,103.648953
639296,49,10,59,1.326788,103.649048
639297,13,3,16,1.326281,103.649515
639298,15,10,25,1.326754,103.649976
639299,23,5,28,1.326754,103.649956
639300,4,13,17,1.327227,103.650416
639301,119,0,119,1.327227,103.650396
639302,14,0,14,1.3277,103.650837
639303,3,8,11,1.327518,103.651269
639304,52,0,52,1.32846,103.650441
639305,40,15,55,1.327706,103.651691
639306,19,3,22,1.328637,103.650872
639307,29,0,29,1.328006,103.651971
639308,2,0,2,1.329271,103.650177
639309,34,8,42,1.328539,103.652162
639310,14,0,14,1.329142,103.651627
639311,72,3,75,1.325723,103.650085
639331,12,65,77,1.318049,103.656833
639332,101,41,142,1.318209,103.655866
639333,144,45,189,1.318351,103.65492
639334,188,1,189,1.319636,103.655627
639335,542,22,564,1.318787,103.654455
639336,14,0,14,1.320367,103.655072
639337,45,11,56,1.319209,103.654019
639338,34,27,61,1.320695,103.65445
639339,163,22,185,1.320719,103.653277
639340,587,0,587,1.321429,103.65335
639342,5,172,177,1.32151,103.652427
639343,25,4,29,1.32256,103.652374
639364,12,14,26,1.322924,103.648729
639365,14,0,14,1.324687,103.650176
639366,95,3,98,1.325017,103.650454
639367,1,0,1,1.331462,103.644637
639368,29,35,64,1.325318,103.651513
639369,33,0,33,1.325796,103.651964
639370,49,8,57,1.325988,103.652168
639371,47,0,47,1.32651,103.651723
639372,4,26,30,1.325924,103.652937
639373,18,13,31,1.326373,103.652517
639374,0,51,51,1.326565,103.652722
639375,140,0,140,1.32695,103.65307
639376,212,4,216,1.32695,103.65309
639377,0,8,8,1.32759,103.652491
639378,2,0,2,1.328955,103.65115
639379,59,28,87,1.327605,103.6531
639380,95,38,133,1.327718,103.653828
639381,62,24,86,1.328093,103.654187
639382,9,1,10,1.322416,103.648512
639402,15,52,67,1.317046,103.657473
639403,2,0,2,1.327334,103.653459
639404,28,77,105,1.319391,103.65942
639405,198,24,222,1.31867,103.656412
639406,22,0,22,1.320343,103.656902
639408,66,37,103,1.321404,103.656066
639409,173,165,338,1.321553,103.656587
639410,51,8,59,1.321564,103.655238
639411,1,3,4,1.331167,103.649945
639412,0,15,15,1.322701,103.655132
639413,27,5,32,1.323735,103.654984
639414,27,11,38,1.32266,103.654443
639415,0,35,35,1.323528,103.654288
639416,4,2,6,1.325627,103.652628
639417,36,0,36,1.323208,103.65328
639418,6,12,18,1.32445,103.652652
639419,270,0,270,1.32507,103.652708
639420,109,21,130,1.325159,103.651899
639441,131,63,194,1.32153,103.64951
639442,25,7,32,1.320272,103.65099
639443,395,18,413,1.322176,103.650242
639445,175,55,230,1.322647,103.650838
639446,80,93,173,1.321668,103.650994
639447,169,314,483,1.323075,103.651489
639448,103,16,119,1.321377,103.651834
639449,151,0,151,1.324104,103.651921
639450,32,88,120,1.324164,103.652866
639451,497,162,659,1.324075,103.654252
639452,37,82,119,1.3253,103.653148
639453,15,18,33,1.324452,103.654794
639454,304,36,340,1.325624,103.653691
639456,360,0,360,1.325531,103.654574
639457,320,74,394,1.325082,103.655508
639458,105,4,109,1.326281,103.654462
639459,293,329,622,1.325835,103.655975
639460,557,128,685,1.326717,103.655694
639461,2442,15,2457,1.326593,103.65764
639462,48,99,147,1.327004,103.655964
639463,26,0,26,1.327815,103.655786
639464,81,2520,2601,1.328489,103.656252
639465,56,285,341,1.328441,103.657312
639466,9,2,11,1.317119,103.633521
639486,9,13,22,1.320111,103.658447
639487,33,83,116,1.320196,103.658544
639488,28,0,28,1.320368,103.658677
639489,14,0,14,1.320539,103.65885
639490,41,40,81,1.320882,103.659136
639491,81,5,86,1.32035,103.659462
639492,25,21,46,1.321395,103.659596
639493,76,1,77,1.320677,103.659703
639494,14,1,15,1.321631,103.659304
639495,4,2,6,1.321063,103.659976
639496,2,5,7,1.321928,103.659623
639497,125,33,158,1.321337,103.660256
639498,3,21,24,1.322462,103.660124
639499,144,119,263,1.323438,103.660574
639500,22,111,133,1.323521,103.658995
639501,102,0,102,1.328186,103.654089
639502,3,11,14,1.328268,103.654002
639503,35,3,38,1.328434,103.653827
639504,30,0,30,1.328599,103.653651
639505,250,0,250,1.328765,103.653476
639506,37,151,188,1.32893,103.653301
639507,83,22,105,1.329096,103.653126
639508,5,14,19,1.329261,103.65295
639509,7,0,7,1.329427,103.652775
639510,26,7,33,1.328978,103.652475
639511,30,25,55,1.329686,103.652505
639512,310,84,394,1.32978,103.65241
639513,15,0,15,1.329968,103.65222
639514,7,0,7,1.330155,103.65203
639515,3,26,29,1.330343,103.65184
639516,15,1,16,1.330531,103.651649
639517,1,1,2,1.318692,103.657904
639518,13,13,26,1.330906,103.651269
639519,3,184,187,1.331084,103.651089
639520,1,92,93,1.332925,103.647411
639521,455,0,455,1.333422,103.647049
639522,1,99,100,1.334245,103.646864
639523,67,6,73,1.33607,103.645192
639524,9,97,106,1.336926,103.644836
639525,177,56,233,1.333121,103.649242
639526,301,36,337,1.330177,103.653973
639527,169,7,176,1.328315,103.655134
639528,1,12,13,1.32854,103.653969
639529,52,13,65,1.299509,103.837
639530,142,8,150,1.326717,103.655694
639531,40,71,111,1.321346,103.66024
639546,4,21,25,1.346918,103.685753
639548,165,782,947,1.348251,103.685797
639549,133,281,414,1.347791,103.685831
639574,7,121,128,1.312853,103.657252
639577,137,2,139,1.317388,103.653143
639578,68,0,68,1.32118,103.648065
639579,23,39,62,1.321562,103.647628
639580,314,20,334,1.321984,103.647151
639581,47,16,63,1.32241,103.646717
639582,353,43,396,1.323071,103.645367
639583,135,16,151,1.332123,103.637428
639584,1,4,5,1.332371,103.637164
639585,51,37,88,1.332866,103.636637
639586,238,34,272,1.33336,103.636109
639587,24,0,24,1.333744,103.636341
639588,1,0,1,1.32484,103.651061
639589,3,19,22,1.329901,103.63877
639591,653,416,1069,1.316869,103.651887
639592,34,9,43,1.327378,103.641179
639593,221,74,295,1.32729,103.643555
639594,89,89,178,1.327911,103.640752
639595,11,1,12,1.32074,103.648238
639596,35,1,36,1.326987,103.641718
639597,342,45,387,1.331893,103.639038
639598,5,19,24,1.330708,103.640086
639599,5,0,5,1.332343,103.636163
639600,5,7,12,1.332545,103.635975
639601,0,4,4,1.322721,103.655132
639602,0,3,3,1.327488,103.646584
639603,19,9,28,1.333284,103.635127
639604,14,18,32,1.333436,103.634945
639605,0,64,64,1.325059,103.644403
639606,117,0,117,1.299509,103.837
639607,67,16,83,1.32241,103.646717
639608,60,102,162,1.299509,103.837
639609,94,35,129,1.299509,103.837
639619,219,19,238,1.351622,103.687344
639620,27,1,28,1.351629,103.687344
639621,52,11,63,1.351645,103.687345
639622,30,1,31,1.35166,103.687345
639623,36,2,38,1.351675,103.687345
639624,98,3,101,1.351691,103.687346
639625,34,20,54,1.351706,103.687346
639626,7,3,10,1.352309,103.687056
639627,174,0,174,1.352263,103.686931
639628,31,0,31,1.35231,103.686842
639629,5,5,10,1.352577,103.687044
639630,115,15,130,1.352605,103.687151
639631,137,55,192,1.352699,103.687181
639632,19,12,31,1.352737,103.687206
639633,62,0,62,1.352882,103.687204
639634,35,4,39,1.352974,103.687239
639635,27,3,30,1.353109,103.687181
639636,8,1,9,1.353152,103.687218
639637,102,0,102,1.353194,103.687493
639638,12,1,13,1.353117,103.687544
639639,39,5,44,1.35295,103.687513
639640,189,4,193,1.352909,103.68752
639641,32,31,63,1.352648,103.68762
639642,97,3,100,1.352623,103.687661
639643,27,0,27,1.352648,103.687788
639644,35,4,39,1.352597,103.687867
639645,29,4,33,1.352647,103.687987
639646,5,5,10,1.352621,103.688094
639647,167,1,168,1.352644,103.688195
639648,74,4,78,1.352583,103.688299
639649,28,1,29,1.352638,103.688407
639650,50,7,57,1.352591,103.688511
639651,57,0,57,1.352291,103.688476
639652,140,2,142,1.352274,103.688394
639653,36,8,44,1.35233,103.688298
639654,23,5,28,1.352273,103.688201
639655,18,9,27,1.352312,103.68811
639656,33,4,37,1.352311,103.688008
639657,25,17,42,1.352198,103.687356
639658,32,3,35,1.352213,103.687356
639659,49,16,65,1.352228,103.687357
639660,33,13,46,1.352244,103.687357
639661,180,0,180,1.352259,103.687357
639662,9,14,23,1.352275,103.687358
639663,70,1,71,1.35229,103.687358
639664,63,11,74,1.352305,103.687358
639665,101,1,102,1.351609,103.687527
639666,58,25,83,1.351551,103.687512
639667,202,14,216,1.350488,103.687939
639668,150,72,222,1.350654,103.68738
639669,212,85,297,1.35103,103.687029
639670,178,316,494,1.350719,103.686627
639671,257,19,276,1.351129,103.687045
639672,129,41,170,1.351129,103.687045
639673,2617,88,2705,1.351195,103.687829
639687,1,1,2,1.330719,103.651459
639690,3,0,3,1.333024,103.635474
639691,87,1,88,1.345334,103.684328
639692,9,0,9,1.345532,103.684299
639693,69,8,77,1.34573,103.68427
639694,11,0,11,1.345947,103.684247
639695,4,0,4,1.332795,103.635659
639696,0,2,2,1.345206,103.684306
639699,1,0,1,1.334039,103.635997
639701,3,0,3,1.345234,103.684317
639703,15,0,15,1.346572,103.685344
639704,26,6,32,1.346647,103.685505
639705,19,0,19,1.346673,103.685601
639706,67,5,72,1.346637,103.685146
639727,28,17,45,1.346948,103.684107
639728,12,2,14,1.347187,103.684292
639729,12,0,12,1.346989,103.684203
639730,7,0,7,1.34719,103.684322
639731,1,0,1,1.346288,103.684783
639732,5,0,5,1.347215,103.684295
639733,27,37,64,1.34708,103.684468
639734,23,0,23,1.347207,103.684319
639735,7,11,18,1.347131,103.684636
639736,9,0,9,1.347186,103.684292
639737,37,0,37,1.347181,103.684805
639738,6,0,6,1.347216,103.684299
639739,28,1,29,1.347231,103.684974
639740,30,0,30,1.347186,103.684296
639741,11,6,17,1.346895,103.684594
639742,3,0,3,1.34643,103.685063
639743,19,1,20,1.347337,103.68533
639744,8,0,8,1.347403,103.684729
639745,3,2,5,1.347007,103.68493
639746,35,0,35,1.347409,103.684709
639747,0,2,2,1.346056,103.684351
639748,34,0,34,1.347295,103.685659
639749,6,0,6,1.34723,103.685787
639750,13,0,13,1.347532,103.685096
639751,146,1,147,1.347251,103.685769
639752,19,1,20,1.34724,103.685797
639753,7,14,21,1.346938,103.684037
639754,107,10,117,1.299509,103.837
639755,67,40,107,1.299509,103.837
639757,1,0,1,1.34703,103.684299
639758,119,530,649,1.299509,103.837
639773,26,5,31,1.345652,103.686388
639774,36,3,39,1.345652,103.686388
639775,15,0,15,1.345652,103.686388
639776,24,4,28,1.345652,103.686388
639778,84,468,552,1.345377,103.687792
639798,7541,4423,11964,1.344233,103.680142
639799,29,0,29,1.353453,103.687306
639801,329,304,633,1.345568,103.682602
639803,2,29,31,1.299509,103.837
639804,432,106,538,1.351937,103.685784
639805,444,66,510,1.351209,103.686266
639807,133,154,287,1.350549,103.685725
639808,306,83,389,1.350724,103.686207
639809,354,864,1218,1.354702,103.686435
639810,137,63,200,1.354297,103.685623
639811,201,37,238,1.351952,103.685702
639812,208,746,954,1.350801,103.685113
639815,1605,241,1846,1.345247,103.683377
639816,653,1459,2112,1.343212,103.682586
639823,274,15,289,1.354741,103.695929
639925,13,5,18,1.303445,103.626631
639926,90,857,947,1.313313,103.627669
639927,1,115,116,1.30926,103.648769
639928,492,150,642,1.350554,103.682001
639929,212,113,325,1.350254,103.680806
639930,64,3,67,1.289742,103.631943
639931,1506,312,1818,1.328832,103.655434
639932,1772,295,2067,1.335269,103.65192
639933,1150,251,1401,1.335062,103.648866
639934,4673,846,5519,1.336175,103.647081
639936,168,49,217,1.333542,103.651107
639937,2574,1188,3762,1.347023,103.636207
639938,19,134,153,1.325491,103.658741
639939,1288,804,2092,1.334647,103.650257
639940,2971,27,2998,1.330694,103.653195
639956,60,130,190,1.330978,103.662479
639977,118,24,142,1.347598,103.683515
639978,16,0,16,1.34786,103.683515
639979,5,2,7,1.34806,103.683526
640167,40,35,75,1.346651,103.70617
640168,5,173,178,1.346953,103.706174
640169,9,35,44,1.347538,103.707379
640170,56,11,67,1.347266,103.707325
640171,41,21,62,1.346658,103.707519
640172,32,83,115,1.346401,103.707488
640174,263,9514,9777,1.346441,103.709107
640175,390,2563,2953,1.346718,103.709417
640176,451,11095,11546,1.347208,103.70982
640177,339,195,534,1.347681,103.70932
640178,167,215,382,1.347272,103.708728
640179,576,859,1435,1.347003,103.708898
640180,63,193,256,1.345693,103.709196
640181,9,43,52,1.345693,103.709196
640182,17,201,218,1.345693,103.709196
640183,31,243,274,1.345693,103.709216
640184,7,315,322,1.345693,103.709196
640185,1841,3241,5082,1.346391,103.710765
640186,1573,1082,2655,1.345864,103.711161
640187,1716,763,2479,1.345206,103.71068
640188,452,2971,3423,1.343719,103.711099
640189,524,309,833,1.344423,103.711385
640190,206,168,374,1.345082,103.71178
640191,700,3443,4143,1.343842,103.711819
640196,12,313,325,1.299509,103.837
640198,318,225,543,1.344383,103.714327
640199,189,140,329,1.343675,103.714393
640200,823,391,1214,1.342977,103.714672
640201,313,363,676,1.343214,103.715342
640202,367,260,627,1.34369,103.714978
640203,296,630,926,1.344244,103.715702
640204,428,216,644,1.344377,103.715103
640205,456,1186,1642,1.344755,103.715598
640206,544,994,1538,1.344949,103.715032
640207,480,7609,8089,1.346188,103.713846
640208,724,137,861,1.347141,103.714435
640209,1029,3787,4816,1.346057,103.7144
640210,1002,5872,6874,1.348048,103.712804
640211,1117,20,1137,1.348454,103.713599
640212,65,121,186,1.349227,103.713176
640213,133,1188,1321,1.349388,103.712769
640214,105,852,957,1.348861,103.711917
640215,185,527,712,1.348578,103.712134
640216,12,270,282,1.349811,103.711361
640217,5,21,26,1.350027,103.710957
640218,9,115,124,1.350606,103.711224
640220,11,1292,1303,1.350212,103.711962
640221,1243,38703,39946,1.346517,103.712422
640257,255,258,513,1.345926,103.708119
640258,169,1702,1871,1.346151,103.708441
640259,191,2088,2279,1.345535,103.708588
640260,187,3947,4134,1.345221,103.708073
640261,294,74,368,1.345713,103.707933
640262,486,411,897,1.345423,103.707193
640263,520,1310,1830,1.345446,103.706814
640264,306,140,446,1.346054,103.706887
640265,234,1127,1361,1.345706,103.706635
640266,446,428,874,1.346104,103.706345
640267,283,210,493,1.346534,103.70691
640268,13,65,78,1.347885,103.707744
640271,57,1893,1950,1.350118,103.704074
640272,20,2,22,1.350282,103.704642
640273,18,227,245,1.351981,103.702847
640274,5,37,42,1.352533,103.703821
640275,13,61,74,1.353086,103.703068
640276,121,571,692,1.35363,103.703748
640279,0,6,6,1.350689,103.70528
640280,18,5,23,1.350932,103.705297
640281,19,1,20,1.351188,103.70553
640401,347,3697,4044,1.353411,103.721628
640402,765,4491,5256,1.353354,103.722633
640403,322,74,396,1.35374,103.721671
640404,414,280,694,1.353872,103.722454
640405,678,256,934,1.354386,103.721583
640406,442,449,891,1.354315,103.722638
640407,529,382,911,1.354714,103.7218
640408,315,210,525,1.354728,103.722769
640409,715,217,932,1.354093,103.725206
640410,815,224,1039,1.35373,103.726157
640411,465,505,970,1.353728,103.725046
640412,384,262,646,1.353279,103.726071
640413,326,484,810,1.353288,103.724938
640414,231,155,386,1.352773,103.725966
640415,236,3974,4210,1.352812,103.724842
640416,437,3396,3833,1.35241,103.725846
640417,343,100,443,1.351215,103.726838
640418,77,1717,1794,1.351002,103.726475
640419,279,350,629,1.350907,103.726859
640420,531,216,747,1.350572,103.72692
640421,274,6516,6790,1.350218,103.726938
640422,361,5747,6108,1.350349,103.726318
640423,542,327,869,1.350931,103.725205
640424,67,728,795,1.351083,103.724857
640425,451,7900,8351,1.351154,103.724401
640426,344,232,576,1.351619,103.724494
640427,290,61,351,1.351347,103.725341
640428,287,499,786,1.351574,103.725358
640429,117,90,207,1.351884,103.7245
640430,331,1092,1423,1.352033,103.725337
640431,316,730,1046,1.35229,103.724616
640432,244,1087,1331,1.352517,103.723527
640433,331,2435,2766,1.352674,103.722989
640434,228,78,306,1.352401,103.722756
640435,132,269,401,1.352178,103.723479
640436,118,197,315,1.352092,103.722924
640437,335,54,389,1.351815,103.72356
640438,108,59,167,1.351377,103.723684
640439,33,151,184,1.351568,103.723179
640440,255,2298,2553,1.351309,103.722771
640441,572,6009,6581,1.351323,103.720094
640442,145,1264,1409,1.351513,103.71959
640443,313,174,487,1.351557,103.720045
640444,490,159,649,1.35199,103.719709
640445,160,36,196,1.352025,103.720355
640446,60,210,270,1.352401,103.719683
640447,543,195,738,1.35226,103.720014
640448,576,1537,2113,1.352626,103.71963
640449,433,3369,3802,1.35214,103.71807
640450,551,370,921,1.352056,103.717765
640451,96,228,324,1.351827,103.718207
640452,603,225,828,1.351592,103.718326
640453,349,235,584,1.351389,103.717685
640454,367,7278,7645,1.351072,103.717848
640455,270,7063,7333,1.351283,103.718162
640456,433,5452,5885,1.35068,103.720274
640457,385,2234,2619,1.350727,103.721056
640458,194,949,1143,1.350315,103.72023
640459,285,419,704,1.350324,103.721143
640460,483,132,615,1.349932,103.720969
640461,696,923,1619,1.349659,103.721052
640462,220,2055,2275,1.350697,103.722121
640463,490,4080,4570,1.350593,103.723121
640464,550,395,945,1.350345,103.722427
640465,661,412,1073,1.350198,103.722934
640466,946,202,1148,1.349846,103.722913
640467,780,472,1252,1.349609,103.722166
640468,547,4076,4623,1.348927,103.72069
640469,628,257,885,1.348496,103.721086
640470,391,123,514,1.348161,103.721143
640471,792,102,894,1.348461,103.722004
640472,652,192,844,1.34817,103.722007
640473,293,1195,1488,1.348527,103.722868
640474,460,201,661,1.348085,103.724297
640475,570,457,1027,1.348067,103.725281
640476,374,370,744,1.347748,103.724322
640477,471,376,847,1.347766,103.725314
640478,836,140,976,1.347304,103.724078
640479,126,291,417,1.347104,103.724496
640480,1053,926,1979,1.346887,103.72439
640481,1169,1618,2787,1.346888,103.724813
640482,85,261,346,1.347116,103.724741
640483,409,569,978,1.347307,103.725185
640484,767,153,920,1.348222,103.726612
640485,414,64,478,1.348361,103.726986
640486,310,209,519,1.348664,103.726577
640487,496,196,692,1.348689,103.726969
640488,356,1001,1357,1.349102,103.726376
640489,771,387,1158,1.34914,103.726974
640490,615,2069,2684,1.349542,103.72697
640491,511,2252,2763,1.349534,103.72649
640492,357,3263,3620,1.350203,103.724268
640493,3,632,635,1.348998,103.724975
640494,47,288,335,1.349595,103.724924
640495,178,257,435,1.34976,103.724232
640496,39,301,340,1.350072,103.723863
640497,23,45,68,1.349397,103.724262
640498,339,326,665,1.348325,103.724256
640499,1067,532,1599,1.348384,103.7251
640501,859,10556,11415,1.350092,103.719126
640502,398,8075,8473,1.350353,103.718008
640503,140,1090,1230,1.350079,103.717994
640504,181,168,349,1.349915,103.718834
640505,36,70,106,1.349774,103.718212
640506,176,25,201,1.349142,103.718715
640507,158,383,541,1.348987,103.718414
640508,98,266,364,1.348757,103.718649
640509,29,1,30,1.348703,103.719325
640510,714,547,1261,1.348459,103.719656
640511,860,321,1181,1.347969,103.719944
640513,477,276,753,1.347407,103.719661
640514,1116,1361,2477,1.346709,103.719864
640515,776,2200,2976,1.346037,103.720123
640516,1125,162,1287,1.345444,103.720171
640517,238,2028,2266,1.345807,103.719694
640518,1247,432,1679,1.345216,103.718014
640519,145,161,306,1.345587,103.717603
640520,931,1651,2582,1.34596,103.718169
640521,833,281,1114,1.346813,103.71746
640522,567,238,805,1.346565,103.716586
640523,670,1431,2101,1.346777,103.716226
640524,712,2322,3034,1.347157,103.717356
640525,853,471,1324,1.347357,103.716163
640526,130,236,366,1.347625,103.717001
640527,1039,86,1125,1.347859,103.716237
640528,864,23,887,1.348356,103.717098
640529,431,156,587,1.3485,103.71621
640530,377,444,821,1.348566,103.715665
640531,409,1800,2209,1.349082,103.715565
640532,566,339,905,1.349229,103.715923
640533,624,468,1092,1.348864,103.71646
640534,883,590,1473,1.348967,103.717245
640535,391,917,1308,1.349317,103.716862
640536,1711,3745,5456,1.349844,103.716567
640537,295,3653,3948,1.350444,103.716213
640538,699,3937,4636,1.350125,103.715762
640539,221,180,401,1.350779,103.71616
640540,423,240,663,1.350572,103.715634
640541,334,228,562,1.351014,103.715882
640542,260,99,359,1.351579,103.715599
640543,278,108,386,1.351986,103.716085
640544,104,656,760,1.352264,103.715749
640545,456,161,617,1.352344,103.715373
640546,793,357,1150,1.352794,103.715365
640547,589,115,704,1.353095,103.715161
640548,576,302,878,1.353192,103.715541
640549,373,149,522,1.352918,103.715745
640550,520,118,638,1.352595,103.716249
640551,647,7631,8278,1.352299,103.716456
640552,582,4049,4631,1.352836,103.717986
640553,333,1480,1813,1.353168,103.719046
640554,572,349,921,1.353247,103.718092
640555,658,455,1113,1.353747,103.719046
640556,635,88,723,1.353623,103.717751
640557,452,389,841,1.354047,103.718839
640558,298,238,536,1.35414,103.717773
640559,846,109,955,1.354564,103.718799
640560,2,224,226,1.395696,103.745264
640561,6,65,71,1.299509,103.837
640562,1,6,7,1.299509,103.837
640601,609,617,1226,1.339848,103.700082
640602,249,136,385,1.339278,103.70017
640603,288,125,413,1.338849,103.700258
640604,171,75,246,1.338707,103.699863
640605,222,108,330,1.338615,103.699531
640606,181,1481,1662,1.337928,103.699142
640607,138,1243,1381,1.337947,103.69958
640608,233,1372,1605,1.337947,103.700024
640609,378,1262,1640,1.337942,103.700482
640610,380,1472,1852,1.338001,103.700964
640611,467,1462,1929,1.338966,103.700843
640612,664,831,1495,1.33936,103.700774
640613,601,591,1192,1.339994,103.700565
640617,516,2177,2693,1.340735,103.700514
640618,847,1494,2341,1.341451,103.700431
640619,458,125,583,1.341442,103.699792
640620,132,6,138,1.341388,103.699354
640621,478,136,614,1.340964,103.699592
640622,519,1454,1973,1.340433,103.698925
640623,632,1927,2559,1.340282,103.698077
640624,352,2724,3076,1.340769,103.69774
640625,799,98,897,1.341545,103.698656
640626,583,226,809,1.34184,103.698313
640627,443,82,525,1.342001,103.698805
640628,1305,120,1425,1.34223,103.699254
640629,648,132,780,1.342581,103.69959
640630,675,720,1395,1.342766,103.700185
640631,616,494,1110,1.343073,103.700111
640632,549,1089,1638,1.34395,103.6998
640633,393,447,840,1.343482,103.699215
640634,311,714,1025,1.343127,103.698761
640635,539,1774,2313,1.342746,103.698342
640636,506,249,755,1.34203,103.697977
640637,412,188,600,1.341456,103.697886
640638,122,2647,2769,1.34152,103.696988
640639,471,5225,5696,1.340752,103.69679
640640,472,193,665,1.34008,103.696507
640641,515,497,1012,1.340733,103.696171
640642,408,1140,1548,1.340431,103.695873
640643,506,750,1256,1.339329,103.695586
640644,483,238,721,1.339558,103.696263
640645,348,129,477,1.339003,103.696419
640646,510,198,708,1.339407,103.69697
640647,412,2572,2984,1.340094,103.697316
640648,13,39,52,1.339014,103.697349
640649,19,105,124,1.338962,103.696985
640650,18,80,98,1.338685,103.696837
640651,139,7630,7769,1.337112,103.697111
640652,22,45,67,1.336395,103.69699
640655,49,2353,2402,1.335344,103.697946
640656,45,78,123,1.33594,103.700282
640657,22,686,708,1.335369,103.700824
640658,27,850,877,1.337281,103.701094
640659,153,167,320,1.337231,103.70216
640660,11,295,306,1.335345,103.704147
640661,44,367,411,1.335361,103.704893
640662,16,2,18,1.336788,103.70314
640663,12,220,232,1.338954,103.701291
640664,22,243,265,1.339508,103.703183
640667,22,72,94,1.341386,103.701532
640669,16,53,69,1.342497,103.703082
640670,7,77,84,1.344356,103.702472
640672,11,250,261,1.343968,103.70061
640673,53,336,389,1.344321,103.70063
640674,27,1353,1380,1.344761,103.702595
640675,32,730,762,1.345483,103.703187
640676,27,713,740,1.346352,103.704672
640677,26,197,223,1.345417,103.705216
640678,46,3,49,1.345314,103.70414
640679,145,770,915,1.344585,103.70608
640680,4,10,14,1.344546,103.705815
640681,8,17,25,1.344121,103.705159
640682,16,88,104,1.34397,103.704978
640683,48,2613,2661,1.342258,103.704927
640684,35,105,140,1.34444,103.704113
640685,30,12,42,1.343203,103.704349
640686,39,2080,2119,1.341544,103.704381
640687,502,351,853,1.341733,103.705551
640688,568,130,698,1.340924,103.705336
640689,532,25969,26501,1.340885,103.706111
640690,324,903,1227,1.341328,103.706779
640691,145,384,529,1.342084,103.706146
640692,925,139,1064,1.34205,103.706701
640693,362,202,564,1.342629,103.706311
640694,581,563,1144,1.343136,103.707101
640695,939,726,1665,1.342615,103.707427
640696,373,375,748,1.342045,103.707457
640697,15,103,118,1.299509,103.837
640698,29,340,369,1.299509,103.837
640701,170,532,702,1.342392,103.69518
640702,260,513,773,1.341978,103.695263
640703,431,1144,1575,1.341759,103.695804
640704,249,1876,2125,1.341077,103.69537
640705,632,1114,1746,1.34078,103.694741
640706,387,1130,1517,1.34171,103.694464
640707,249,1273,1522,1.341735,103.693971
640708,658,460,1118,1.342018,103.694303
640709,210,1104,1314,1.342495,103.694361
640710,254,1187,1441,1.342855,103.69481
640711,191,1881,2072,1.342694,103.695875
640712,235,7008,7243,1.342477,103.696041
640713,117,1388,1505,1.343352,103.696319
640714,657,315,972,1.343139,103.696716
640715,438,326,764,1.343526,103.69655
640716,143,1220,1363,1.343783,103.696781
640717,247,2609,2856,1.343413,103.697221
640718,352,240,592,1.34377,103.697195
640719,223,2433,2656,1.344617,103.696942
640720,252,354,606,1.34439,103.697408
640721,283,134,417,1.344044,103.6975
640722,418,4854,5272,1.343785,103.698384
640723,281,293,574,1.344636,103.697839
640724,419,206,625,1.345242,103.698336
640725,257,544,801,1.345407,103.697774
640726,133,3849,3982,1.346004,103.697082
640727,438,167,605,1.345712,103.69787
640728,277,136,413,1.346056,103.697944
640729,218,908,1126,1.346365,103.698035
640730,233,526,759,1.346082,103.698323
640731,433,673,1106,1.345516,103.698697
640732,206,2694,2900,1.345789,103.6997
640733,340,2332,2672,1.34548,103.699929
640734,336,4161,4497,1.345706,103.70051
640735,737,122,859,1.345948,103.700789
640736,253,1029,1282,1.346181,103.701533
640737,341,970,1311,1.346572,103.701268
640738,620,327,947,1.34636,103.700573
640739,693,391,1084,1.3464,103.699966
640743,426,632,1058,1.347322,103.699049
640744,1658,1074,2732,1.34695,103.698697
640745,481,1616,2097,1.346977,103.698246
640746,295,154,449,1.347382,103.69809
640747,158,1012,1170,1.347355,103.697283
640748,177,129,306,1.347787,103.697728
640749,199,1767,1966,1.348036,103.69802
640750,257,1754,2011,1.347916,103.699029
640751,682,450,1132,1.347587,103.699043
640752,183,2380,2563,1.348549,103.699617
640753,203,1319,1522,1.348582,103.699866
640754,294,295,589,1.348867,103.700311
640755,382,3253,3635,1.348588,103.700832
640756,402,53,455,1.349066,103.700504
640757,314,48,362,1.34992,103.700799
640758,537,781,1318,1.350139,103.700314
640759,395,325,720,1.350145,103.69964
640760,393,220,613,1.349372,103.699896
640761,378,119,497,1.348977,103.699554
640762,711,11618,12329,1.349156,103.698195
640763,23,6618,6641,1.348424,103.698452
640764,611,131,742,1.349281,103.698266
640765,424,272,696,1.350157,103.698571
640766,309,1807,2116,1.349875,103.697984
640810,384,345,729,1.346875,103.695356
640811,317,1414,1731,1.346161,103.69652
640812,324,159,483,1.346274,103.695755
640813,179,226,405,1.345967,103.695721
640814,968,165,1133,1.345635,103.695677
640815,320,240,560,1.345333,103.69576
640816,244,4407,4651,1.345411,103.696389
640817,362,5055,5417,1.344958,103.695429
640818,237,203,440,1.345182,103.695122
640819,123,184,307,1.345533,103.695053
640820,116,476,592,1.346347,103.695126
640821,360,3424,3784,1.347,103.694113
640822,146,915,1061,1.346771,103.693567
640823,208,166,374,1.346732,103.693893
640824,210,319,529,1.346425,103.693703
640825,229,663,892,1.346171,103.693489
640826,469,304,773,1.346103,103.694069
640827,633,1459,2092,1.345584,103.693113
640828,124,2490,2614,1.345053,103.693138
640829,118,1359,1477,1.344924,103.694079
640830,169,118,287,1.345294,103.69345
640831,205,180,385,1.34486,103.694624
640832,174,2793,2967,1.344541,103.694873
640833,259,1381,1640,1.343759,103.694303
640834,358,3664,4022,1.343257,103.694293
640835,143,300,443,1.343511,103.693903
640836,708,6737,7445,1.34317,103.693313
640837,298,595,893,1.343058,103.692894
640838,254,253,507,1.343798,103.693732
640839,386,347,733,1.343852,103.692763
640840,317,1972,2289,1.343935,103.692178
640841,111,645,756,1.344514,103.692919
640842,88,536,624,1.344505,103.693308
640843,244,516,760,1.344076,103.693966
640844,179,946,1125,1.345267,103.692275
640845,447,2401,2848,1.3446,103.691914
640846,93,94,187,1.345428,103.691612
640847,275,251,526,1.345389,103.691997
640848,66,210,276,1.345974,103.692066
640849,188,182,370,1.345775,103.69171
640850,273,177,450,1.346196,103.692107
640851,482,3199,3681,1.346735,103.692624
640852,170,181,351,1.347214,103.69258
640853,256,4242,4498,1.346965,103.692836
640854,735,188,923,1.347901,103.695938
640855,269,36,305,1.346902,103.696243
640856,324,2450,2774,1.34742,103.696522
640857,243,1194,1437,1.348031,103.696582
640858,428,3040,3468,1.348134,103.695978
640859,300,1891,2191,1.349046,103.696114
640860,126,2305,2431,1.348837,103.696751
640861,158,2886,3044,1.349325,103.696828
640862,219,414,633,1.350145,103.696559
640863,78,391,469,1.349285,103.695244
640864,591,265,856,1.349359,103.694709
640865,203,334,537,1.34978,103.695426
640866,465,152,617,1.350511,103.695529
640901,14,3053,3067,1.340286,103.686831
640902,248,32,280,1.339107,103.686566
640903,357,68,425,1.339921,103.686119
640904,318,347,665,1.340261,103.685841
640905,145,211,356,1.34056,103.685078
640906,433,327,760,1.34125,103.685111
640907,141,172,313,1.341103,103.685966
640908,207,1262,1469,1.340487,103.686339
640909,185,203,388,1.341183,103.686458
640910,357,131,488,1.342088,103.686237
640911,177,3440,3617,1.341612,103.686798
640912,22,2108,2130,1.341211,103.687188
640913,333,610,943,1.341878,103.687499
640914,249,140,389,1.341505,103.687844
640915,324,97,421,1.341098,103.687731
640916,143,171,314,1.340685,103.687612
640917,118,361,479,1.340368,103.687567
640918,73,7872,7945,1.340821,103.68716
640919,175,1444,1619,1.339915,103.687256
640920,158,1609,1767,1.339785,103.688308
640921,313,518,831,1.339814,103.688902
640922,225,593,818,1.339627,103.689219
640923,105,780,885,1.339593,103.68983
640924,155,2144,2299,1.340425,103.689734
640925,276,163,439,1.340159,103.689236
640926,378,120,498,1.340504,103.689366
640928,304,182,486,1.340928,103.689383
640929,542,143,685,1.341324,103.689265
640930,57,1474,1531,1.340985,103.689887
640931,130,2110,2240,1.341595,103.689661
640932,192,2206,2398,1.341771,103.688523
640933,130,4507,4637,1.34213,103.689778
640934,392,10632,11024,1.34234,103.688633
640935,5,368,373,1.342622,103.688292
640936,201,366,567,1.342549,103.689008
640937,52,733,785,1.342432,103.690051
640938,270,62,332,1.34291,103.689739
640939,135,520,655,1.343036,103.688696
640940,2261,337,2598,1.343407,103.688847
640941,314,96,410,1.343933,103.688779
640942,210,385,595,1.343743,103.689486
640943,248,72,320,1.343865,103.68972
640944,485,349,834,1.344591,103.689613
640945,432,220,652,1.344303,103.690217
640946,348,120,468,1.344352,103.69049
640947,291,99,390,1.34384,103.690934
640948,260,362,622,1.344513,103.690977
640949,471,120,591,1.343304,103.691582
640950,488,165,653,1.343027,103.690597
640952,677,8775,9452,1.342527,103.691382
640953,625,2919,3544,1.342403,103.690807
640959,82,5346,5428,1.341514,103.690502
640960,217,132,349,1.341406,103.691314
640961,131,689,820,1.341236,103.691933
640962,62,3305,3367,1.341727,103.691672
640963,12,78,90,1.341939,103.692135
640964,105,1380,1485,1.341988,103.692617
640965,171,824,995,1.341353,103.692537
640966,185,404,589,1.341728,103.692912
640967,4,34,38,1.299509,103.837
640968,1,174,175,1.299509,103.837
640969,1,144,145,1.299509,103.837
640974,102,2586,2688,1.339969,103.693222
640975,383,172,555,1.340166,103.69331
640976,351,89,440,1.33981,103.693516
640977,356,298,654,1.339516,103.69357
640978,448,750,1198,1.34061,103.694053
640979,527,224,751,1.339567,103.694155
640980,193,87,280,1.339167,103.693607
640986,14,627,641,1.337006,103.69452
640987,13,28,41,1.336891,103.694866
640988,21,1,22,1.336182,103.695445
640990,6,606,612,1.335363,103.695732
641167,3,106,109,1.346866,103.707041
641180,953,525,1478,1.344899,103.70998
641181,1354,192,1546,1.344899,103.70998
641183,638,594,1232,1.348775,103.709741
641196,743,313,1056,1.344079,103.71362
641197,688,460,1148,1.343733,103.713848
641198,1,11,12,1.345221,103.71472
641206,12,83,95,1.345317,103.715443
641207,7,6,13,1.347029,103.713599
641208,185,669,854,1.346595,103.71445
641209,15,728,743,1.346053,103.715357
641210,19,336,355,1.348237,103.713211
641212,81,327,408,1.348873,103.713357
641216,65,20,85,1.350659,103.711433
641217,6,0,6,1.299509,103.837
641218,15,40,55,1.299509,103.837
641257,1,73,74,1.345973,103.707553
641262,5,237,242,1.299509,103.837
641268,812,161,973,1.348041,103.707577
641271,347,2988,3335,1.350841,103.704188
641272,634,84,718,1.350224,103.705165
641273,427,2345,2772,1.351302,103.703307
641274,851,157,1008,1.352392,103.703663
641275,460,353,813,1.352374,103.702189
641276,836,264,1100,1.353236,103.703552
641279,0,2,2,1.34726,103.685696
641280,0,5,5,1.350749,103.705171
641281,0,29,29,1.350971,103.705174
641495,1,8,9,1.349082,103.725469
641497,2,0,2,1.350689,103.70528
641498,3,50,53,1.349082,103.725469
641499,18,1502,1520,1.299509,103.837
641505,19,2007,2026,1.299509,103.837
641517,585,3079,3664,1.345179,103.721259
641518,91,290,381,1.345284,103.718955
641528,3,375,378,1.299509,103.837
641530,436,1332,1768,1.348097,103.715685
641536,17,2733,2750,1.299509,103.837
641547,4,120,124,1.299509,103.837
641560,42,1173,1215,1.299509,103.837
641561,26,2,28,1.299509,103.837
641601,12,124,136,1.339468,103.699837
641606,1,373,374,1.338662,103.701122
641607,5,4,9,1.338662,103.701122
641612,7,192,199,1.338662,103.701122
641613,20,13,33,1.339624,103.700517
641617,21,202,223,1.340711,103.700051
641624,4,105,109,1.341128,103.69846
641627,7,4,11,1.341665,103.698917
641629,14,168,182,1.343024,103.699529
641631,3,41,44,1.343399,103.699741
641635,21,143,164,1.342401,103.698802
641638,859,2002,2861,1.341943,103.697609
641640,18,252,270,1.339794,103.695989
641647,9,142,151,1.339839,103.696796
641648,126,148,274,1.338328,103.697652
641649,700,4597,5297,1.337943,103.697477
641650,431,3588,4019,1.337933,103.696614
641651,508,941,1449,1.337039,103.697659
641652,290,1674,1964,1.336683,103.698334
641653,519,1287,1806,1.336724,103.696732
641654,204,1033,1237,1.336075,103.69836
641655,671,1540,2211,1.335565,103.698412
641656,600,1535,2135,1.335224,103.699386
641657,351,1532,1883,1.335312,103.700127
641658,525,419,944,1.336909,103.700993
641659,259,71,330,1.336957,103.702266
641660,866,32,898,1.335706,103.704595
641661,564,50,614,1.335665,103.704883
641662,224,267,491,1.337055,103.702781
641663,1083,686,1769,1.338828,103.701608
641664,589,466,1055,1.339159,103.703294
641665,767,368,1135,1.339949,103.703265
641666,544,517,1061,1.339603,103.701496
641667,587,176,763,1.341609,103.70114
641668,320,294,614,1.341828,103.70286
641669,278,1209,1487,1.343002,103.703143
641670,258,2167,2425,1.344071,103.702778
641671,615,806,1421,1.343975,103.702327
641672,401,618,1019,1.343712,103.700909
641673,502,158,660,1.344226,103.701016
641674,316,120,436,1.344506,103.7023
641675,444,64,508,1.345386,103.703519
641676,336,25,361,1.345952,103.704426
641677,693,301,994,1.3456,103.70504
641678,413,153,566,1.344959,103.704167
641679,156,31,187,1.344263,103.705804
641680,264,42,306,1.344552,103.705555
641681,298,90,388,1.344413,103.705113
641682,328,52,380,1.343943,103.705379
641683,497,312,809,1.342673,103.70498
641684,402,2522,2924,1.344078,103.703931
641685,522,1610,2132,1.343282,103.703947
641686,223,6010,6233,1.341744,103.704638
641691,11,1096,1107,1.342395,103.705838
641692,28,112,140,1.34172,103.70713
641697,376,138,514,1.299509,103.837
641698,409,192,601,1.341196,103.707855
641702,5,210,215,1.341607,103.695169
641712,12,3555,3567,1.299509,103.837
641734,10,1734,1744,1.345636,103.700899
641739,15,474,489,1.345972,103.700253
641750,2,213,215,1.347452,103.698566
641760,0,112,112,1.349618,103.700219
641762,8,56,64,1.349062,103.697951
641764,7,263,270,1.349652,103.699175
641811,1,4,5,1.346585,103.696121
641821,2,213,215,1.346508,103.694879
641828,7,397,404,1.345019,103.693635
641830,481,104,585,1.345245,103.694088
641831,9,69,78,1.345234,103.694808
641832,23,1149,1172,1.344429,103.694346
641837,8,82,90,1.344158,103.694296
641841,3,357,360,1.344228,103.693144
641844,21,2172,2193,1.345419,103.692653
641854,9,232,241,1.347738,103.69625
641855,2,423,425,1.347166,103.695758
641859,7,215,222,1.349462,103.695903
641865,4,177,181,1.350262,103.695089
641962,19,302,321,1.34249,103.691838
641967,2,476,478,1.299509,103.837
641986,250,199,449,1.337203,103.695017
641987,467,2190,2657,1.33659,103.694403
641988,185,644,829,1.336489,103.695714
641989,367,3146,3513,1.335892,103.694453
641990,111,595,706,1.335191,103.695033
642180,408,314,722,1.344899,103.70998
642181,757,358,1115,1.344899,103.70998
642183,766,174,940,1.348419,103.709676
642196,415,725,1140,1.342928,103.714222
642197,412,72,484,1.299509,103.837
642198,8,516,524,1.345221,103.71472
642216,129,357,486,1.349655,103.711878
642217,33,0,33,1.299509,103.837
642218,29,58,87,1.299509,103.837
642221,208,16058,16266,1.345686,103.713082
642268,363,275,638,1.347536,103.708003
642271,565,103,668,1.350507,103.704383
642272,570,110,680,1.350515,103.704987
642273,202,1523,1725,1.351858,103.703401
642274,454,105,559,1.352641,103.703018
642275,416,184,600,1.352785,103.702211
642276,466,1441,1907,1.35272,103.704252
642278,2,0,2,1.349082,103.725469
642279,0,3,3,1.347208,103.6843
642280,0,8,8,1.350742,103.705146
642281,0,156,156,1.350964,103.705181
642517,24,9236,9260,1.34511,103.720679
642561,21,827,848,1.299509,103.837
642624,4,25,29,1.34075,103.698437
642648,344,708,1052,1.338528,103.698096
642649,324,2087,2411,1.337963,103.697999
642650,528,1432,1960,1.337938,103.696224
642651,242,1391,1633,1.337044,103.698355
642652,664,233,897,1.336673,103.697814
642653,687,746,1433,1.336225,103.696675
642654,503,162,665,1.336142,103.697793
642655,262,1148,1410,1.335679,103.697531
642656,705,292,997,1.335873,103.699246
642657,492,274,766,1.335992,103.700741
642658,273,96,369,1.336445,103.700715
642659,691,253,944,1.336896,103.701663
642660,131,48,179,1.336221,103.704079
642661,701,3481,4182,1.33618,103.705507
642662,554,130,684,1.337205,103.703116
642663,462,3393,3855,1.337961,103.70173
642664,522,1706,2228,1.338336,103.703596
642665,624,189,813,1.339773,103.702773
642666,1044,267,1311,1.339652,103.7021
642667,482,2379,2861,1.341048,103.701691
642668,566,1894,2460,1.341916,103.703211
642669,237,99,336,1.342973,103.702787
642671,501,631,1132,1.343878,103.701869
642673,390,113,503,1.344443,103.701556
642674,824,531,1355,1.345057,103.702108
642675,675,1278,1953,1.345842,103.703486
642676,517,577,1094,1.346081,103.703904
642677,237,10,247,1.345371,103.704482
642678,108,122,230,1.345065,103.703871
642679,980,1186,2166,1.343832,103.706046
642680,643,209,852,1.345033,103.705283
642681,672,188,860,1.344867,103.704872
642682,719,2618,3337,1.343658,103.705558
642683,555,262,817,1.342964,103.704927
642684,629,259,888,1.343916,103.70419
642685,440,2763,3203,1.342927,103.703974
642686,278,241,519,1.341906,103.704439
642697,432,714,1146,1.299509,103.837
642698,240,339,579,1.340751,103.707582
642712,0,22,22,1.299509,103.837
642760,3,223,226,1.299509,103.837
642967,1,451,452,1.299509,103.837
642986,236,92,328,1.337069,103.695357
642987,138,20,158,1.336691,103.694714
642988,140,806,946,1.336203,103.695777
642989,143,15,158,1.335765,103.69477
642990,195,433,628,1.335201,103.694794
643180,263,289,552,1.344899,103.70998
643183,784,209,993,1.348332,103.708916
643197,309,274,583,1.299509,103.837
643218,30,185,215,1.299509,103.837
643268,766,601,1367,1.34729,103.708142
643271,356,105,461,1.350037,103.704361
643272,696,187,883,1.350874,103.704759
643273,529,1882,2411,1.352047,103.703835
643274,256,42,298,1.352987,103.703735
643275,551,159,710,1.353102,103.702751
643276,608,2939,3547,1.353237,103.704319
643277,3,188,191,1.350665,103.705179
643278,0,1,1,1.299509,103.837
643279,0,2,2,1.350689,103.70528
643280,0,5,5,1.350687,103.705167
643281,3,0,3,1.350689,103.70528
643517,612,1039,1651,1.344936,103.719972
643648,334,935,1269,1.338918,103.697755
643650,388,29,417,1.338508,103.696424
643652,392,200,592,1.336663,103.697252
643653,452,1677,2129,1.335467,103.696892
643654,755,144,899,1.335854,103.697134
643656,730,48,778,1.336115,103.699849
643658,484,90,574,1.336878,103.700395
643659,451,102,553,1.336401,103.701781
643660,214,15,229,1.336587,103.70375
643661,544,443,987,1.336339,103.705079
643662,622,3964,4586,1.337483,103.703997
643663,622,625,1247,1.337995,103.702237
643664,701,1557,2258,1.338258,103.703177
643667,287,2133,2420,1.341131,103.70211
643668,215,855,1070,1.341599,103.703275
643669,337,232,569,1.343275,103.7027
643671,350,541,891,1.343805,103.70141
643673,417,990,1407,1.344725,103.701231
643677,598,127,725,1.345234,103.704731
643678,427,135,562,1.344683,103.703602
643679,499,4023,4522,1.343895,103.706348
643680,481,328,809,1.344967,103.705714
643681,661,279,940,1.344434,103.704635
643682,578,4787,5365,1.343219,103.705352
643683,384,225,609,1.343395,103.704734
643684,440,206,646,1.343663,103.704535
643685,343,1435,1778,1.342524,103.70403
643686,163,693,856,1.342218,103.704173
643697,83,625,708,1.299509,103.837
643698,354,1351,1705,1.299509,103.837
643986,126,1419,1545,1.336951,103.695597
643987,566,30,596,1.336733,103.695088
643988,461,1556,2017,1.335846,103.695798
643989,243,58,301,1.335707,103.695084
643990,81,683,764,1.335569,103.694466
644183,643,279,922,1.349047,103.708994
644197,430,23,453,1.344324,103.7137
644218,25,700,725,1.299509,103.837
644271,427,141,568,1.350018,103.704789
644272,427,5737,6164,1.35111,103.704525
644273,635,115,750,1.352279,103.703018
644274,433,1683,2116,1.352197,103.704319
644275,530,924,1454,1.353592,103.703045
644276,645,2268,2913,1.353458,103.704403
644277,0,20,20,1.35083,103.705141
644278,0,6,6,1.350689,103.70528
644279,2,96,98,1.350689,103.70528
644280,0,7,7,1.3508,103.705143
644281,0,19,19,1.350932,103.705174
644517,355,264,619,1.344927,103.719411
644648,470,1028,1498,1.339434,103.697594
644656,408,112,520,1.335543,103.699839
644658,306,428,734,1.337284,103.70071
644659,415,66,481,1.336411,103.702456
644660,422,71,493,1.336391,103.703085
644661,1003,870,1873,1.336587,103.704559
644662,589,2214,2803,1.33706,103.704249
644663,519,65,584,1.338541,103.702339
644664,529,48,577,1.338687,103.702851
644667,532,171,703,1.34174,103.702032
644668,273,383,656,1.341536,103.702943
644669,218,734,952,1.343348,103.703104
644678,805,8802,9607,1.344982,103.70326
644697,8,217,225,1.299509,103.837
644987,256,20,276,1.336716,103.695365
644989,222,60,282,1.335674,103.695416
645277,0,27,27,1.350851,103.705148
645278,0,4,4,1.345957,103.684237
645280,0,21,21,1.350795,103.705175
645281,0,16,16,1.350884,103.705179
645517,492,1946,2438,1.344534,103.718836
645660,15,204,219,1.299509,103.837
645663,24,2484,2508,1.338131,103.702695
645664,12,121,133,1.338982,103.702504
645667,1,96,97,1.342028,103.702441
645668,6,724,730,1.341196,103.702636
646277,1,0,1,1.350689,103.70528
646281,3,6,9,1.351106,103.705403
646517,43,2948,2991,1.344702,103.71972
648125,154,699,853,1.348645,103.705097
648141,165,284,449,1.350419,103.707902
648145,9,37,46,1.352148,103.696692
648146,0,3,3,1.350964,103.705459
648147,1,10,11,1.299509,103.837
648148,0,10,10,1.299509,103.837
648149,0,1,1,1.350947,103.705476
648150,9,0,9,1.299509,103.837
648151,0,2,2,1.350689,103.70528
648152,0,3,3,1.299509,103.837
648153,5,66,71,1.299509,103.837
648155,43,211,254,1.345622,103.725109
648156,62,154,216,1.345622,103.725109
648160,49,138,187,1.299509,103.837
648161,28,566,594,1.299509,103.837
648162,64,9,73,1.299509,103.837
648163,21,5,26,1.299509,103.837
648164,88,3249,3337,1.299509,103.837
648165,1720,409,2129,1.354575,103.708949
648166,1936,67,2003,1.35295,103.709366
648170,466,476,942,1.360617,103.706363
648175,543,135,678,1.3578,103.708284
648180,2,169,171,1.299509,103.837
648195,544,1,545,1.351305,103.709675
648200,273,57,330,1.336843,103.699774
648201,13,732,745,1.338538,103.698878
648205,19,0,19,1.299509,103.837
648206,29,14,43,1.299509,103.837
648207,5,21,26,1.299509,103.837
648208,17,0,17,1.299509,103.837
648209,1,1,2,1.299509,103.837
648210,7,0,7,1.299509,103.837
648211,66,0,66,1.299509,103.837
648212,7,0,7,1.299509,103.837
648213,2,1,3,1.299509,103.837
648214,6,0,6,1.299509,103.837
648215,2,0,2,1.299509,103.837
648216,6,0,6,1.299509,103.837
648218,3,7,10,1.299509,103.837
648219,6,9,15,1.299509,103.837
648226,1,0,1,1.299509,103.837
648228,1,0,1,1.299509,103.837
648232,0,1,1,1.299509,103.837
648238,7,0,7,1.299509,103.837
648241,1,0,1,1.299509,103.837
648242,5,0,5,1.299509,103.837
648243,1,0,1,1.299509,103.837
648245,2,0,2,1.299509,103.837
648249,13,0,13,1.299509,103.837
648250,1,0,1,1.299509,103.837
648251,8,2,10,1.299509,103.837
648252,2,7,9,1.299509,103.837
648253,1,0,1,1.299509,103.837
648254,1,0,1,1.299509,103.837
648255,2,0,2,1.299509,103.837
648256,2,0,2,1.299509,103.837
648257,3,0,3,1.351385,103.699955
648259,1,0,1,1.299509,103.837
648260,4,0,4,1.350689,103.70528
648262,25,0,25,1.299509,103.837
648264,4,0,4,1.299509,103.837
648265,4,0,4,1.299509,103.837
648267,1,0,1,1.299509,103.837
648269,6,0,6,1.299509,103.837
648270,20,0,20,1.299509,103.837
648272,3,0,3,1.299509,103.837
648274,2,0,2,1.299509,103.837
648275,2,0,2,1.299509,103.837
648276,7,0,7,1.299509,103.837
648277,39,0,39,1.299509,103.837
648278,6,0,6,1.299509,103.837
648279,7,0,7,1.299509,103.837
648280,7,0,7,1.299509,103.837
648282,7,0,7,1.299509,103.837
648283,30,11,41,1.299509,103.837
648284,2,26,28,1.299509,103.837
648285,7,59,66,1.299509,103.837
648286,3,18,21,1.299509,103.837
648287,1,16,17,1.299509,103.837
648288,10,9,19,1.299509,103.837
648289,54,10,64,1.299509,103.837
648290,5,5,10,1.299509,103.837
648291,1,17,18,1.299509,103.837
648292,22,26,48,1.299509,103.837
648293,4,13,17,1.299509,103.837
648294,2,9,11,1.299509,103.837
648295,0,7,7,1.299509,103.837
648296,32,6,38,1.299509,103.837
648297,2,1,3,1.299509,103.837
648298,64,66,130,1.299509,103.837
648299,13,0,13,1.299509,103.837
648300,3,0,3,1.299509,103.837
648301,69,0,69,1.299509,103.837
648302,13,1,14,1.299509,103.837
648303,0,2,2,1.299509,103.837
648304,4,0,4,1.299509,103.837
648305,2508,108,2616,1.342993,103.719387
648310,615,1378,1993,1.337443,103.696921
648315,1522,182,1704,1.342682,103.718193
648316,1622,37,1659,1.342454,103.717715
648317,1498,26,1524,1.343078,103.717887
648318,1234,546,1780,1.343084,103.71786
648319,495,0,495,1.343103,103.717857
648320,1804,1110,2914,1.342794,103.718628
648321,40,518,558,1.299444,103.858272
648322,1238,495,1733,1.342518,103.719744
648323,389,1363,1752,1.299509,103.837
648324,2331,548,2879,1.342912,103.719605
648325,65,314,379,1.354831,103.702645
648326,13,96,109,1.355181,103.702735
648330,6,0,6,1.33942,103.705361
648331,71,138,209,1.33942,103.705362
648332,569,4,573,1.339345,103.705984
648333,420,0,420,1.33926,103.705728
648334,160,0,160,1.339151,103.705512
648335,235,2,237,1.339074,103.705248
648336,510,20,530,1.338949,103.705015
648337,652,5233,5885,1.338852,103.704743
648338,222,2434,2656,1.339572,103.704457
648339,416,169,585,1.339678,103.704712
648340,322,482,804,1.339786,103.704979
648341,252,495,747,1.339929,103.705269
648342,435,85,520,1.339991,103.705482
648343,434,408,842,1.340045,103.705742
648345,47,1243,1290,1.337545,103.705704
648346,492,1500,1992,1.340173,103.704606
648347,677,188,865,1.351499,103.707576
648348,485,173,658,1.335276,103.702086
648349,35,33,68,1.34729,103.703553
648350,645,431,1076,1.353569,103.701682
648351,166,96,262,1.351143,103.697241
648352,357,64,421,1.351297,103.6975
648353,449,69,518,1.35101,103.697837
648354,273,112,385,1.342172,103.701945
648355,182,21,203,1.351084,103.69652
648356,388,1,389,1.351063,103.696549
648357,238,27,265,1.351363,103.696174
648358,314,53,367,1.351406,103.695879
648359,353,81,434,1.35104,103.695633
648360,541,31,572,1.350839,103.695836
648361,359,72,431,1.350766,103.696151
648362,198,80,278,1.350587,103.696381
648363,482,27,509,1.350504,103.696795
648364,246,33,279,1.350502,103.6968
648365,425,414,839,1.350524,103.697224
648366,250,1906,2156,1.350605,103.69746
648367,441,4,445,1.351014,103.697821
648368,200,512,712,1.339037,103.698854
648369,51,260,311,1.347557,103.704093
648370,42,810,852,1.347164,103.703366
648371,23,4,27,1.352189,103.699851
648372,0,1,1,1.299509,103.837
648374,1,1,2,1.299509,103.837
648375,12,1,13,1.352227,103.699797
648376,9,0,9,1.352238,103.699782
648377,4,0,4,1.299509,103.837
648379,0,2,2,1.352216,103.699813
648380,120,18,138,1.352163,103.699911
648381,8,5,13,1.352281,103.69972
648382,8,0,8,1.352184,103.699879
648383,2,0,2,1.35227,103.699735
648384,0,12,12,1.352202,103.699853
648385,3,0,3,1.336843,103.699774
648387,1,1,2,1.352525,103.699101
648388,28,3,31,1.352255,103.699776
648390,8,0,8,1.352291,103.699725
648391,1,1,2,1.352607,103.699002
648393,6,8,14,1.352703,103.698843
648394,1,1,2,1.352668,103.698865
648395,10,0,10,1.352744,103.698766
648396,3,0,3,1.352569,103.699089
648397,2,5,7,1.352816,103.698732
648398,5,0,5,1.352434,103.69952
648399,9,1,10,1.352828,103.69865
648400,8,0,8,1.352469,103.699469
648401,3,3,6,1.352896,103.698606
648402,8,0,8,1.352505,103.699418
648403,89,0,89,1.352909,103.698536
648405,1,4,5,1.352953,103.698498
648406,0,3,3,1.352398,103.699571
648407,12,0,12,1.352994,103.698392
648408,6,0,6,1.352612,103.699264
648409,1,7,8,1.353043,103.698376
648410,1,1,2,1.352362,103.699623
648412,5,1,6,1.352684,103.699161
648413,0,1,1,1.352195,103.699844
648414,0,1,1,1.353147,103.698228
648415,4,0,4,1.352249,103.699766
648416,1,0,1,1.352719,103.69911
648417,0,33,33,1.353203,103.698115
648418,7,10,17,1.352791,103.699008
648420,2,3,5,1.352862,103.698905
648422,13,5,18,1.352933,103.698803
648424,0,6,6,1.353005,103.6987
648425,7,1,8,1.35304,103.698649
648426,0,5,5,1.353076,103.698598
648427,5,1,6,1.353112,103.698546
648428,2,9,11,1.353148,103.698495
648429,5,0,5,1.353183,103.698444
648430,0,10,10,1.353219,103.698393
648431,16,0,16,1.353255,103.698341
648432,4,3,7,1.35329,103.69829
648433,3,0,3,1.352577,103.699315
648434,1,3,4,1.353191,103.698173
648435,1,25,26,1.353397,103.698136
648436,73,0,73,1.353433,103.698085
648437,5,2,7,1.353413,103.69805
648438,2,1,3,1.353326,103.698239
648439,4,15,19,1.353353,103.698005
648440,4,0,4,1.353362,103.698188
648441,0,1,1,1.352755,103.699059
648442,1,0,1,1.353272,103.697946
648443,3,0,3,1.353393,103.698035
648444,26,0,26,1.353152,103.697856
648445,11,6,17,1.353112,103.697826
648447,2,0,2,1.352648,103.699213
648448,4,0,4,1.353312,103.697976
648449,11,1,12,1.352991,103.697737
648450,2,15,17,1.351263,103.698473
648451,21,13,34,1.351424,103.698237
648452,2,0,2,1.353031,103.697767
648453,2,3,5,1.351449,103.698313
648455,0,5,5,1.35142,103.698379
648456,6,3,9,1.351191,103.698465
648457,0,5,5,1.351428,103.698462
648458,0,2,2,1.351248,103.698472
648459,0,4,4,1.353001,103.697747
648460,12,2,14,1.351134,103.698458
648461,9,2,11,1.351424,103.698577
648462,2,1,3,1.353192,103.697886
648463,2,0,2,1.351163,103.698461
648464,3,581,584,1.351077,103.698451
648466,4,903,907,1.351049,103.698447
648467,0,1,1,1.353232,103.697916
648468,1,0,1,1.351445,103.698792
648469,2,1,3,1.351106,103.698454
648470,1,1,2,1.351413,103.698658
648471,13,0,13,1.351406,103.698902
648472,1,1,2,1.350992,103.69844
648473,8,4,12,1.351411,103.698933
648474,15,0,15,1.350935,103.698433
648475,13,3,16,1.351259,103.699037
648476,8,1,9,1.350906,103.69843
648477,0,2,2,1.350963,103.698437
648478,5,0,5,1.350878,103.698426
648479,1,20,21,1.350859,103.698433
648480,1,9,10,1.351234,103.699026
648481,0,1,1,1.35102,103.698444
648482,20,2,22,1.35119,103.699023
648483,73,2,75,1.35116,103.699022
648484,1,3,4,1.351428,103.698512
648485,8,6,14,1.3511,103.699018
648486,0,2,2,1.351287,103.698485
648487,3,223,226,1.351041,103.699014
648488,6,246,252,1.351011,103.699013
648489,2,1,3,1.351439,103.69883
648490,5,1,6,1.350952,103.699009
648491,7,3,10,1.350922,103.699007
648492,3,1,4,1.35113,103.69902
648493,5,3,8,1.350863,103.699004
648494,0,5,5,1.350843,103.699012
648495,12,24,36,1.352973,103.700137
648496,3,0,3,1.350982,103.699011
648497,1,14,15,1.353013,103.700079
648498,2,2,4,1.350892,103.699006
648499,8,2,10,1.353006,103.700054
648500,3,0,3,1.352485,103.700151
648501,9,9,18,1.353042,103.700016
648502,4,2,6,1.352603,103.700012
648503,0,1,1,1.351219,103.699025
648505,1,16,17,1.353104,103.699893
648506,28,4,32,1.352696,103.699929
648508,11,0,11,1.352749,103.699849
648509,0,13,13,1.353191,103.699808
648510,1,4,5,1.352785,103.699835
648511,2,1,3,1.352577,103.700047
648513,22,10,32,1.353238,103.699718
648514,5,2,7,1.35282,103.699741
648515,44,2,46,1.353304,103.699643
648517,7,16,23,1.35334,103.699603
648519,0,6,6,1.353338,103.699577
648520,27,0,27,1.352933,103.699602
648521,1,7,8,1.353369,103.699535
648522,1,2,3,1.353224,103.69978
648523,3,4,7,1.353429,103.699453
648524,8,0,8,1.352972,103.699488
648525,1,11,12,1.353434,103.699426
648526,0,2,2,1.351071,103.699016
648527,15,8,23,1.353451,103.699366
648528,42,1,43,1.352834,103.699931
648529,0,18,18,1.353521,103.699363
648530,0,6,6,1.352887,103.699856
648531,3,10,13,1.353543,103.699307
648533,6,15,21,1.353588,103.699237
648534,13,8,21,1.352995,103.699706
648535,4,8,12,1.353618,103.699144
648536,77,0,77,1.353049,103.69963
648537,11,7,18,1.353678,103.699126
648538,1,3,4,1.352528,103.700097
648539,2,27,29,1.353679,103.699082
648541,4,6,10,1.353742,103.699016
648542,4,6,10,1.35321,103.699405
648543,0,5,5,1.353742,103.698988
648545,2,3,5,1.353769,103.698953
648546,1,6,7,1.353318,103.699255
648547,0,6,6,1.353792,103.698911
648548,9,1,10,1.353372,103.699179
648549,3,8,11,1.35387,103.698839
648550,7,8,15,1.353426,103.699104
648551,6,4,10,1.353873,103.698827
648552,3,0,3,1.352938,103.69956
648553,0,6,6,1.353842,103.698489
648554,0,3,3,1.353479,103.699029
648555,0,2,2,1.35278,103.700006
648558,7,1,8,1.353641,103.698804
648559,10,0,10,1.353725,103.698367
648560,2,0,2,1.353819,103.698464
648561,1,2,3,1.353533,103.698954
648562,10,3,13,1.353748,103.698653
648564,1,0,1,1.353074,103.699929
648565,29,0,29,1.353584,103.698221
648566,0,7,7,1.353846,103.698513
648567,2,7,9,1.353537,103.698172
648568,1,0,1,1.353802,103.698578
648570,10,15,25,1.351376,103.699201
648571,7,0,7,1.351309,103.699342
648573,87,0,87,1.351404,103.699368
648574,20,1,21,1.351435,103.69939
648575,11,0,11,1.351497,103.699433
648576,4,4,8,1.351546,103.699463
648577,18,0,18,1.351595,103.699494
648578,0,3,3,1.353678,103.698318
648579,4,0,4,1.353103,103.699555
648580,43,0,43,1.35189,103.699676
648581,36,0,36,1.351988,103.699737
648582,11,0,11,1.352086,103.699798
648583,111,0,111,1.352184,103.699859
648584,126,12,138,1.353846,103.698513
648585,4,10,14,1.353866,103.698513
648587,1,0,1,1.35349,103.698124
648588,22,2,24,1.35396,103.69841
648589,8,0,8,1.353927,103.698458
648590,4,1,5,1.354036,103.698342
648591,2,4,6,1.353968,103.698421
648592,0,5,5,1.354145,103.69819
648593,106,3,109,1.354009,103.698384
648594,2,0,2,1.353695,103.698728
648595,9,12,21,1.35405,103.698347
648596,1,3,4,1.351791,103.699616
648597,0,3,3,1.351693,103.699555
648598,1,0,1,1.353886,103.698495
648599,1,6,7,1.354132,103.698273
648600,0,2,2,1.354145,103.69819
648601,3,2,5,1.354154,103.698218
648602,3,0,3,1.354091,103.69831
648603,3,102,105,1.354165,103.69819
648604,42,6,48,1.353936,103.697814
648605,2,216,218,1.35418,103.698127
648606,22,0,22,1.353866,103.697752
648607,1,2,3,1.354007,103.697875
648608,1,3,4,1.354168,103.698095
648609,0,119,119,1.354149,103.698006
648610,1,0,1,1.354129,103.698006
648611,1,1,2,1.354077,103.697937
648613,2,11,13,1.354087,103.697927
648614,1,0,1,1.353725,103.697629
648615,13,8,21,1.354057,103.697899
648616,1,1,2,1.354128,103.69798
648617,0,8,8,1.354016,103.697864
648618,3,0,3,1.354175,103.698065
648619,3,6,9,1.353975,103.697828
648620,24,2,26,1.353372,103.697321
648621,11,7,18,1.353935,103.697792
648622,0,2,2,1.353513,103.697444
648623,23,2,25,1.353894,103.697757
648624,0,3,3,1.353443,103.697382
648625,1,6,7,1.353853,103.697721
648626,1,2,3,1.353231,103.697198
648627,4,3,7,1.353812,103.697686
648628,1,1,2,1.353302,103.697259
648629,2,2,4,1.353795,103.697691
648630,0,4,4,1.353731,103.697614
648631,0,2,2,1.353772,103.69765
648632,0,6,6,1.353609,103.697508
648633,28,0,28,1.353568,103.697472
648634,0,1,1,1.353584,103.697506
648635,23,1,24,1.353487,103.697401
648636,0,3,3,1.353161,103.697136
648637,3,4,7,1.353405,103.69733
648638,1,1,2,1.35365,103.697543
648639,1,4,5,1.353324,103.697258
648640,1,2,3,1.353446,103.697365
648641,9,0,9,1.353242,103.697187
648642,3,5,8,1.353202,103.697152
648643,1,12,13,1.353171,103.697126
648644,0,8,8,1.352967,103.69779
648645,31,4,35,1.352967,103.69777
648646,15,3,18,1.352943,103.697823
648647,6,2,8,1.352943,103.697803
648648,7,0,7,1.352896,103.697889
648649,0,2,2,1.353365,103.697294
648650,0,1,1,1.353527,103.697436
648651,0,2,2,1.352896,103.697869
648653,320,2,322,1.352801,103.698001
648654,7,0,7,1.352753,103.698087
648655,4,0,4,1.35369,103.697579
648657,1,1,2,1.352848,103.697935
648658,4,1,5,1.352658,103.698219
648659,1,0,1,1.352848,103.697955
648660,1,0,1,1.352658,103.698199
648661,9,3,12,1.35261,103.698265
648662,1,4,5,1.352563,103.698351
648663,2,0,2,1.352706,103.698133
648664,18,0,18,1.352515,103.698417
648665,0,2,2,1.352563,103.698331
648666,19,4,23,1.352468,103.698483
648667,2,1,3,1.353283,103.697223
648668,2,0,2,1.352515,103.698397
648669,18,2,20,1.35242,103.698529
648670,3,3,6,1.352372,103.698615
648671,1,1,2,1.35242,103.698549
648672,66,1,67,1.352325,103.698681
648673,0,4,4,1.352753,103.698067
648674,0,7,7,1.352277,103.698747
648675,32,0,32,1.352277,103.698727
648677,3,3,6,1.35223,103.698793
648678,1,6,7,1.352182,103.698879
648679,36,0,36,1.352182,103.698859
648681,5,4,9,1.352135,103.698925
648682,14,3,17,1.352097,103.699001
648683,23,8,31,1.352087,103.698991
648684,1,0,1,1.35261,103.698285
648685,0,5,5,1.352,103.698948
648686,4,1,5,1.352027,103.699077
648687,0,2,2,1.352372,103.698595
648688,5,0,5,1.351967,103.699142
648689,10,1,11,1.351823,103.698748
648690,6,1,7,1.351917,103.699198
648691,8,2,10,1.351812,103.698649
648692,1,0,1,1.352057,103.699044
648693,1,0,1,1.351907,103.699188
648694,4,0,4,1.352325,103.698661
648696,4,0,4,1.351997,103.699089
648697,0,10,10,1.352052,103.698994
648698,18,0,18,1.352017,103.698977
648699,1,0,1,1.351818,103.698453
648700,43,0,43,1.351902,103.698915
648701,0,1,1,1.351947,103.698942
648702,23,2,25,1.351822,103.698793
648703,1,2,3,1.352468,103.698463
648704,1,2,3,1.351798,103.698698
648705,2,1,3,1.351792,103.698649
648706,9,0,9,1.351796,103.698492
648709,2,1,3,1.351794,103.698571
648710,5,0,5,1.35153,103.700666
648711,1,0,1,1.351822,103.698793
648713,4,0,4,1.352077,103.699001
648714,2,2,4,1.352034,103.700093
648715,63,3,66,1.351883,103.700326
648716,4,0,4,1.351627,103.70063
648717,3,0,3,1.351803,103.698257
648718,8,2,10,1.351742,103.700538
648719,1,8,9,1.351975,103.699898
648721,8,2,10,1.351829,103.700431
648722,1,0,1,1.352109,103.699976
648723,7,0,7,1.351912,103.700301
648724,7,0,7,1.351954,103.700236
648725,131,8,139,1.351996,103.700171
648727,10,5,15,1.35208,103.700041
648728,6,0,6,1.352121,103.699976
648729,48,16,64,1.351496,103.699504
648730,0,14,14,1.351496,103.699467
648731,3,3,6,1.351495,103.699555
648732,0,4,4,1.351671,103.700609
648733,1,3,4,1.351496,103.699501
648734,15,0,15,1.351495,103.699569
648735,0,6,6,1.351492,103.69976
648736,0,2,2,1.351912,103.698905
648737,0,5,5,1.351491,103.699862
648738,3,1,4,1.351494,103.699658
648739,24,0,24,1.351489,103.699964
648740,3,2,5,1.351492,103.699774
648742,2,4,6,1.351491,103.699842
648743,5,2,7,1.351486,103.700169
648744,1,6,7,1.35149,103.69991
648745,2,0,2,1.351494,103.699638
648746,29,1,30,1.351489,103.699978
648747,1,1,2,1.351484,103.700271
648748,15,4,19,1.351488,103.700046
648750,0,1,1,1.351871,103.700366
648751,0,4,4,1.351493,103.699706
648752,0,1,1,1.351486,103.700115
648753,0,5,5,1.351488,103.70067
648754,1,0,1,1.351485,103.700183
648755,0,2,2,1.351483,103.700373
648756,0,3,3,1.351903,103.699953
648757,1,1,2,1.351483,103.700319
648758,2,0,2,1.351481,103.700456
648759,4,1,5,1.351479,103.700592
648760,124,3,127,1.351468,103.70067
648761,0,7,7,1.351474,103.70068
648762,0,2,2,1.35148,103.700524
648763,3,5,8,1.351462,103.70068
648764,4,1,5,1.351455,103.70068
648765,0,6,6,1.351447,103.70068
648766,1,13,14,1.351439,103.70068
648767,6,0,6,1.351431,103.70068
648768,0,4,4,1.35148,103.700578
648769,0,4,4,1.351424,103.70068
648770,6,26,32,1.351291,103.701332
648771,9,33,42,1.351285,103.701389
648772,47,1,48,1.351286,103.701421
648773,7,0,7,1.351308,103.701471
648774,15,6,21,1.351378,103.701548
648775,2,13,15,1.35137,103.701616
648776,1,10,11,1.351583,103.701604
648777,2,5,7,1.351644,103.701581
648778,0,3,3,1.351482,103.700387
648779,0,7,7,1.351735,103.7016
648780,2,8,10,1.351864,103.701615
648781,11,48,59,1.351924,103.701605
648782,12,11,23,1.351962,103.701523
648783,16,390,406,1.352013,103.701484
648784,5,1,6,1.352047,103.701406
648785,1,156,157,1.3521,103.701337
648787,2,61,63,1.352162,103.701249
648788,0,1,1,1.351484,103.700251
648789,5,47,52,1.352245,103.701181
648790,12,1,13,1.352284,103.701083
648791,0,68,68,1.352298,103.701034
648792,9,0,9,1.351489,103.700717
648793,1,3,4,1.351416,103.70068
648794,22,2,24,1.35149,103.700764
648795,3,89,92,1.352395,103.700956
648797,1,3,4,1.352348,103.700987
648798,9,1,10,1.352098,103.700729
648799,0,65,65,1.352454,103.700859
648800,1,0,1,1.352199,103.701192
648801,6,0,6,1.352465,103.700814
648802,0,4,4,1.352382,103.700903
648803,0,37,37,1.352491,103.700769
648805,0,1,1,1.352148,103.700675
648806,23,2,25,1.352255,103.700546
648807,0,22,22,1.352571,103.700656
648809,5,2,7,1.35259,103.700628
648810,0,2,2,1.35147,103.70068
648811,13,15,28,1.352625,103.700563
648813,5,1,6,1.352676,103.700536
648814,4,0,4,1.352162,103.700649
648815,12,8,20,1.352687,103.700496
648817,2,43,45,1.352725,103.700424
648818,0,3,3,1.351697,103.701587
648819,4,32,36,1.35095,103.699403
648820,6,259,265,1.35095,103.699383
648821,0,1,1,1.352549,103.700721
648822,0,6,6,1.350949,103.699418
648824,0,136,136,1.350948,103.699487
648826,7,161,168,1.350946,103.699555
648827,34,1,35,1.350944,103.699644
648828,0,190,190,1.350944,103.699624
648829,0,1,1,1.350949,103.699438
648830,0,97,97,1.350943,103.699693
648832,1,73,74,1.350941,103.699762
648834,1,60,61,1.350939,103.699831
648835,1,0,1,1.350943,103.699713
648836,14,120,134,1.350938,103.699899
648837,43,11,54,1.350936,103.699988
648838,0,86,86,1.350936,103.699968
648840,1,296,297,1.350934,103.700037
648841,0,1,1,1.350938,103.699919
648842,0,16,16,1.350932,103.700106
648844,18,122,140,1.350931,103.700174
648845,0,2,2,1.352305,103.700439
648846,0,127,127,1.350929,103.700243
648847,12,5,17,1.350927,103.700332
648848,0,80,80,1.350927,103.700312
648849,0,3,3,1.352459,103.700256
648850,0,72,72,1.350926,103.700381
648851,5,2,7,1.350924,103.70047
648852,0,50,50,1.350924,103.70045
648853,11,2,13,1.350922,103.700538
648854,0,70,70,1.350922,103.700518
648855,4,0,4,1.352398,103.700318
648856,27,107,134,1.350921,103.700587
648857,2,17,19,1.350929,103.700666
648858,1,273,274,1.350909,103.700666
648859,2,5,7,1.350918,103.700705
648860,8,905,913,1.350918,103.700688
648861,3,1,4,1.350921,103.700607
648862,0,6,6,1.350917,103.700719
648863,0,2,2,1.350929,103.700263
648864,5,124,129,1.350915,103.700782
648865,33,2,35,1.350914,103.70085
648866,109,124,233,1.350913,103.700845
648867,2,1,3,1.350926,103.700401
648868,1,80,81,1.350912,103.700908
648869,2,0,2,1.350916,103.700792
648870,1,52,53,1.35091,103.700971
648871,0,2,2,1.350911,103.700967
648872,0,238,238,1.350908,103.701034
648873,0,1,1,1.350932,103.700126
648874,2,1,3,1.350912,103.700909
648875,0,2,2,1.350909,103.701025
648876,2,55,57,1.350904,103.70116
648877,1,0,1,1.350907,103.701083
648878,1,58,59,1.350903,103.701223
648880,2,61,63,1.350901,103.701286
648881,5,1,6,1.3509,103.701316
648882,2,75,77,1.350899,103.701349
648883,5,3,8,1.350899,103.701374
648884,15,419,434,1.350887,103.701422
648885,1,0,1,1.350904,103.701199
648886,526,1080,1606,1.339874,103.706464
648923,1707,1218,2925,1.340292,103.71654
648924,29,95,124,1.341334,103.717181
648925,655,17,672,1.341283,103.717421
648926,124,27,151,1.341103,103.717859
648927,1637,271,1908,1.341862,103.718377
648964,23,1433,1456,1.338689,103.692795
648965,261,662,923,1.338574,103.694113
648966,0,25,25,1.341202,103.693158
648967,152,695,847,1.340876,103.691618
649000,24,190,214,1.341316,103.69021
649036,270,1718,1988,1.342223,103.688066
649037,249,3046,3295,1.33837,103.688061
649038,281,338,619,1.338205,103.687205
649040,183,537,720,1.342594,103.692257
649041,196,3447,3643,1.342802,103.691852
649075,93,2656,2749,1.347373,103.694576
649076,366,609,975,1.348486,103.694609
649112,159,1177,1336,1.346811,103.701683
649114,26,770,796,1.347093,103.701445
649149,82,438,520,1.348436,103.698774
649151,34,130,164,1.349652,103.699175
649188,490,93,583,1.347628,103.700517
649223,297,462,759,1.34455,103.698987
649295,391,1717,2108,1.346187,103.718911
649296,255,4964,5219,1.348596,103.718015
649297,155,479,634,1.348112,103.717843
649332,470,1559,2029,1.347595,103.721578
649368,16,1786,1802,1.351889,103.716664
649369,27,1643,1670,1.352812,103.724424
649370,184,2313,2497,1.351759,103.726968
649371,210,641,851,1.351473,103.72158
649406,355,1542,1897,1.347026,103.722405
649407,30,8311,8341,1.349214,103.720224
649408,0,511,511,1.349137,103.720244
649409,7,0,7,1.349274,103.720429
649410,502,1005,1507,1.346902,103.726756
649411,2349,2927,5276,1.345828,103.723359
649412,3114,904,4018,1.34524,103.722869
649413,2302,149,2451,1.346268,103.722836
649414,8193,9,8202,1.346012,103.726298
649481,33,441,474,1.350142,103.701308
649482,332,2945,3277,1.350933,103.702261
649483,7,234,241,1.349872,103.702702
649484,3,667,670,1.349885,103.703024
649485,6,67,73,1.349711,103.70307
649486,636,629,1265,1.348808,103.703404
649487,41,181,222,1.349108,103.702869
649488,0,17,17,1.348615,103.702982
649489,9,0,9,1.348414,103.701801
649490,293,6,299,1.348742,103.702013
649491,165,89,254,1.349226,103.701654
649492,67,3,70,1.349934,103.7018
649517,381,8345,8726,1.351056,103.723382
649518,9,582,591,1.350854,103.721501
649519,37,717,754,1.349375,103.714722
649520,182,3798,3980,1.350295,103.725433
649555,7,1,8,1.349759,103.735171
649557,0,4,4,1.350917,103.700734
649561,0,6,6,1.350315,103.734723
649567,1,5,6,1.359709,103.731653
649569,0,17,17,1.351685,103.735979
649606,0,1,1,1.350907,103.701422
649608,1,0,1,1.351435,103.733596
649614,0,85,85,1.354678,103.735435
649616,0,1,1,1.355237,103.733426
649693,0,21,21,1.353087,103.729343
649694,139,384,523,1.349831,103.708419
649695,19,275,294,1.356615,103.718475
649696,988,63,1051,1.348927,103.706898
649697,369,291,660,1.349812,103.707658
649698,8,103,111,1.353431,103.729542
649699,0,82,82,1.353431,103.729542
649730,1,0,1,1.352449,103.732762
649734,711,1230,1941,1.366311,103.692244
649735,75,55,130,1.364808,103.690822
649806,298,52,350,1.341552,103.715052
649808,12,301,313,1.345463,103.716757
649809,544,161,705,1.350886,103.713267
649810,1130,266,1396,1.344241,103.717535
649811,1668,0,1668,1.344241,103.717528
649812,1110,0,1110,1.344266,103.717562
649813,1022,0,1022,1.344239,103.717528
649814,786,0,786,1.344242,103.717524
649815,960,0,960,1.344269,103.71756
649816,802,178,980,1.344267,103.717534
649817,234,422,656,1.344379,103.71712
649818,58,1179,1237,1.349148,103.714306
649819,496,603,1099,1.341577,103.715971
649820,850,126,976,1.342006,103.716687
649821,384,93,477,1.34215,103.717075
649822,986,567,1553,1.34267,103.716948
649823,657,495,1152,1.34261,103.716525
649824,1082,609,1691,1.341577,103.715971
649825,141,1225,1366,1.299509,103.837
649845,2769,21029,23798,1.344394,103.720999
649846,494,1776,2270,1.338717,103.706071
649848,1161,945,2106,1.334908,103.706428
649849,112,653,765,1.33919,103.708676
649882,137,3904,4041,1.348338,103.711314
649883,36,49,85,1.34803,103.711974
649884,24,10235,10259,1.347735,103.711589
649886,648,7131,7779,1.345452,103.714107
649922,39,349,388,1.341913,103.71102
649923,31,1192,1223,1.344802,103.713293
649924,38,663,701,1.344661,103.713041
649925,1122,1426,2548,1.342853,103.711851
649926,52,0,52,1.342853,103.711851
649927,637,693,1330,1.34183,103.711829
649928,1095,573,1668,1.341925,103.712277
649929,519,817,1336,1.342853,103.711851
649930,317,4834,5151,1.34287,103.712983
649934,42,0,42,1.342735,103.710225
649960,31,2884,2915,1.344118,103.707646
649961,630,394,1024,1.343172,103.70949
649962,28,37,65,1.348755,103.710857
649964,205,1979,2184,1.348533,103.710976
649965,14,189,203,1.299509,103.837
650101,253,1647,1900,1.346543,103.746739
650102,291,1358,1649,1.347288,103.7473
650103,1624,2560,4184,1.348105,103.747788
650104,203,314,517,1.348936,103.747297
650105,366,91,457,1.348552,103.747139
650106,566,63,629,1.348196,103.746949
650107,498,152,650,1.347818,103.746573
650108,450,131,581,1.347428,103.746589
650109,513,8177,8690,1.346945,103.74618
650110,584,1124,1708,1.347475,103.745672
650111,347,76,423,1.348312,103.745936
650112,491,472,963,1.348408,103.745298
650113,263,517,780,1.348804,103.745265
650114,663,300,963,1.348825,103.74588
650115,766,145,911,1.349163,103.746569
650116,602,345,947,1.349587,103.746301
650117,591,253,844,1.349947,103.747152
650118,297,111,408,1.349998,103.74652
650119,337,244,581,1.350432,103.74666
650120,521,519,1040,1.350787,103.747332
650121,466,789,1255,1.351387,103.747731
650122,369,1463,1832,1.351879,103.747076
650123,66,74,140,1.35151,103.747468
650124,30,29,59,1.351166,103.747204
650125,606,265,871,1.351439,103.74679
650126,76,1347,1423,1.351829,103.746701
650127,336,747,1083,1.35182,103.745974
650128,35,2176,2211,1.351662,103.745587
650129,236,143,379,1.351419,103.745962
650130,367,246,613,1.351052,103.745939
650131,314,193,507,1.350667,103.746095
650132,162,1959,2121,1.350387,103.74572
650133,21,1312,1333,1.351485,103.744932
650134,355,1212,1567,1.351547,103.744462
650135,679,551,1230,1.351187,103.744688
650136,537,2313,2850,1.350836,103.744777
650137,49,6485,6534,1.350608,103.744956
650138,226,71,297,1.350508,103.744567
650139,310,178,488,1.351061,103.744181
650140,1117,293,1410,1.350733,103.743627
650141,759,253,1012,1.350289,103.743307
650142,360,896,1256,1.349844,103.742937
650143,159,89,248,1.350315,103.743879
650144,30,529,559,1.349969,103.744214
650145,103,117,220,1.349959,103.743615
650146,251,98,349,1.34963,103.743984
650147,86,60,146,1.349475,103.743569
650148,104,405,509,1.349302,103.743855
650149,91,4818,4909,1.349267,103.744319
650150,112,1143,1255,1.348718,103.743734
650151,54,4317,4371,1.348739,103.744243
650152,143,9406,9549,1.348204,103.744198
650153,304,7652,7956,1.347569,103.744289
650154,67,213,280,1.347706,103.743965
650155,14,28,42,1.348013,103.743565
650156,10,72,82,1.348269,103.743837
650157,18,29,47,1.348387,103.743512
650158,53,1563,1616,1.348769,103.743143
650159,218,1312,1530,1.348643,103.742681
650160,372,337,709,1.348843,103.741997
650161,327,331,658,1.348527,103.741979
650162,357,74,431,1.34774,103.741899
650163,691,422,1113,1.348164,103.742552
650164,482,113,595,1.347764,103.742555
650165,1004,246,1250,1.347291,103.74175
650166,31,1279,1310,1.347075,103.742713
650167,501,1117,1618,1.346971,103.742192
650168,409,2764,3173,1.347195,103.7413
650169,529,3565,4094,1.346557,103.740936
650170,706,440,1146,1.346625,103.740159
650171,482,406,888,1.346214,103.740228
650172,1055,128,1183,1.345772,103.740548
650173,244,272,516,1.346041,103.740805
650174,94,62,156,1.345641,103.741066
650175,328,75,403,1.345585,103.741489
650176,284,396,680,1.346,103.741343
650177,587,4595,5182,1.346365,103.74156
650178,661,584,1245,1.346069,103.74257
650179,109,71,180,1.345682,103.742226
650180,295,74,369,1.345573,103.742727
650181,29,137,166,1.345688,103.743341
650182,323,87,410,1.345606,103.743801
650183,461,4170,4631,1.34625,103.743255
650184,163,112,275,1.346211,103.743773
650185,351,4589,4940,1.347056,103.74489
650186,312,86,398,1.346733,103.744155
650187,555,323,878,1.346576,103.74472
650188,220,260,480,1.346058,103.745593
650189,190,966,1156,1.345732,103.746362
650190,265,3084,3349,1.345379,103.74586
650191,672,622,1294,1.345454,103.745383
650192,709,106,815,1.345543,103.744768
650193,251,178,429,1.345969,103.744431
650194,110,179,289,1.299509,103.837
650201,223,1739,1962,1.346213,103.748092
650202,791,291,1082,1.346431,103.748485
650203,1293,556,1849,1.347182,103.748989
650204,392,3040,3432,1.347563,103.749712
650205,663,751,1414,1.347071,103.749885
650206,517,215,732,1.34663,103.749368
650207,882,786,1668,1.346221,103.749347
650208,403,377,780,1.345904,103.748852
650209,594,4071,4665,1.345425,103.74886
650210,487,4700,5187,1.34547,103.74954
650211,808,387,1195,1.346157,103.750564
650212,686,252,938,1.347211,103.752058
650213,547,1476,2023,1.346886,103.752431
650214,142,101,243,1.347389,103.752727
650215,488,1450,1938,1.346822,103.753425
650216,858,228,1086,1.347198,103.75343
650217,812,1609,2421,1.346843,103.754775
650218,191,85,276,1.347199,103.754263
650219,598,207,805,1.347241,103.754754
650220,20,21,41,1.34755,103.754551
650221,1037,60,1097,1.347537,103.753447
650222,110,80,190,1.347846,103.753853
650223,192,143,335,1.348117,103.753197
650224,168,76,244,1.347787,103.752431
650225,800,570,1370,1.348489,103.752481
650226,161,1319,1480,1.348786,103.752926
650227,594,183,777,1.348421,103.753353
650228,631,1774,2405,1.348713,103.753628
650229,492,1983,2475,1.348248,103.754572
650230,587,273,860,1.347768,103.754881
650231,493,1859,2352,1.349161,103.754325
650232,183,181,364,1.349376,103.754768
650233,566,4611,5177,1.34881,103.755078
650234,51,166,217,1.349083,103.75519
650235,714,450,1164,1.348562,103.756416
650236,710,1462,2172,1.349406,103.755786
650237,30,133,163,1.349597,103.755193
650238,899,217,1116,1.34991,103.754591
650239,1007,812,1819,1.350264,103.754959
650240,1102,527,1629,1.350563,103.754097
650241,756,3402,4158,1.350917,103.754458
650242,323,1801,2124,1.35097,103.755929
650243,515,1072,1587,1.349675,103.756327
650244,542,2364,2906,1.34954,103.756979
650245,30,42,72,1.349709,103.75725
650246,72,284,356,1.349637,103.757432
650247,255,338,593,1.349942,103.75672
650248,449,295,744,1.350327,103.756462
650249,507,477,984,1.350716,103.756551
650250,480,1426,1906,1.351055,103.756856
650251,31,40,71,1.350911,103.757393
650252,214,163,377,1.350538,103.757101
650253,31,36,67,1.350192,103.757478
650254,86,636,722,1.349873,103.757973
650255,170,153,323,1.350363,103.758418
650256,44,56,100,1.350846,103.758287
650257,68,1341,1409,1.35118,103.757817
650258,477,2631,3108,1.351282,103.75868
650259,406,1519,1925,1.351197,103.759607
650260,395,164,559,1.351002,103.758879
650261,6,7,13,1.350719,103.758761
650262,114,534,648,1.350672,103.759336
650263,647,305,952,1.350291,103.759036
650264,357,541,898,1.350008,103.75912
650265,736,2864,3600,1.350046,103.759565
650266,483,3395,3878,1.349355,103.759821
650267,326,2461,2787,1.348843,103.759877
650268,411,3957,4368,1.349283,103.759017
650269,207,204,411,1.348737,103.759258
650271,190,142,332,1.348187,103.758691
650272,373,11274,11647,1.348833,103.757788
650273,162,2983,3145,1.348445,103.757527
650274,139,153,292,1.347912,103.757988
650275,27,338,365,1.34817,103.758174
650276,12,183,195,1.34784,103.75831
650277,64,168,232,1.347408,103.75787
650278,197,77,274,1.347836,103.757696
650279,28,4842,4870,1.348166,103.757244
650280,223,2709,2932,1.347743,103.757137
650281,98,50,148,1.347552,103.757523
650283,556,63,619,1.347252,103.757493
650284,115,6269,6384,1.346808,103.75726
650285,303,1282,1585,1.34627,103.757823
650286,486,705,1191,1.346769,103.758339
650287,786,166,952,1.347243,103.758365
650288,1014,746,1760,1.34529,103.760417
650289,765,1125,1890,1.344535,103.760341
650290,634,89,723,1.34422,103.757127
650291,1041,341,1382,1.343683,103.755999
650292,0,117,117,1.299509,103.837
650293,0,10,10,1.299509,103.837
650296,5,39,44,1.299509,103.837
650297,150,555,705,1.345033,103.747171
650298,257,182,439,1.34479,103.746952
650299,639,108,747,1.344344,103.747144
650301,583,831,1414,1.356782,103.74865
650302,92,358,450,1.357064,103.748452
650303,62,700,762,1.356749,103.748202
650304,598,661,1259,1.357485,103.748114
650305,387,209,596,1.35783,103.747992
650306,86,1596,1682,1.358251,103.747541
650307,483,214,697,1.358174,103.748064
650308,577,73,650,1.358519,103.748086
650309,158,2410,2568,1.358299,103.748787
650310,101,1048,1149,1.35972,103.748738
650311,300,1193,1493,1.36007,103.748349
650312,605,424,1029,1.359876,103.747528
650313,746,227,973,1.360194,103.747445
650314,165,127,292,1.360353,103.746959
650315,973,2530,3503,1.360188,103.746446
650316,402,116,518,1.360554,103.746792
650317,28,32,60,1.360722,103.747643
650318,474,113,587,1.360902,103.746911
650319,530,5506,6036,1.361222,103.746364
650320,41,81,122,1.361103,103.746933
650321,646,287,933,1.361281,103.747455
650322,411,2058,2469,1.361629,103.747535
650323,406,471,877,1.361466,103.748201
650324,438,2495,2933,1.362142,103.747535
650325,908,5606,6514,1.36233,103.747058
650326,72,1023,1095,1.362581,103.748167
650327,130,171,301,1.362878,103.747852
650328,131,483,614,1.362883,103.747633
650329,418,1003,1421,1.36328,103.74769
650330,497,877,1374,1.363148,103.748203
650331,773,2522,3295,1.363629,103.747638
650332,106,929,1035,1.36375,103.748204
650333,610,95,705,1.36413,103.747937
650334,83,25,108,1.364344,103.74785
650335,85,238,323,1.364539,103.748104
650336,651,2237,2888,1.364888,103.748368
650337,725,1468,2193,1.363517,103.749448
650338,635,805,1440,1.363515,103.750264
650339,402,309,711,1.363117,103.750357
650340,766,445,1211,1.363104,103.749583
650341,694,241,935,1.36274,103.749213
650342,66,616,682,1.362535,103.748605
650343,573,252,825,1.362451,103.749273
650344,82,524,606,1.362574,103.74987
650345,615,1803,2418,1.362797,103.750685
650346,217,413,630,1.362452,103.750443
650347,352,6067,6419,1.36239,103.751093
650348,405,110,515,1.362125,103.750614
650349,803,182,985,1.36211,103.749488
650350,143,707,850,1.361698,103.749098
650351,8,1,9,1.36179,103.749469
650352,4,0,4,1.350068,103.735612
650353,4,2,6,1.361713,103.749802
650354,889,189,1078,1.361351,103.749661
650355,3,4,7,1.361733,103.750547
650356,11,3,14,1.361867,103.750806
650357,11,1,12,1.36164,103.750815
650358,851,120,971,1.361379,103.750569
650359,101,3406,3507,1.36126,103.751156
650360,337,320,657,1.361044,103.750525
650361,196,2021,2217,1.360707,103.75073
650362,58,419,477,1.360635,103.750081
650363,512,23,535,1.360959,103.749411
650364,727,313,1040,1.360632,103.749305
650365,195,1201,1396,1.360777,103.748652
650366,208,101,309,1.360362,103.748893
650367,320,305,625,1.360317,103.749764
650368,466,279,745,1.360346,103.75048
650369,499,2041,2540,1.360014,103.750558
650370,660,115,775,1.35998,103.749795
650371,98,243,341,1.359581,103.750631
650372,182,910,1092,1.359015,103.751101
650373,4,4,8,1.358959,103.750278
650374,198,779,977,1.358103,103.750591
650375,33,170,203,1.358411,103.750071
650376,36,372,408,1.358394,103.749499
650377,28,4,32,1.299509,103.837
650383,1106,212,1318,1.36242,103.752036
650384,1126,333,1459,1.36287,103.75204
650385,1029,625,1654,1.363564,103.751994
650386,1424,388,1812,1.363902,103.752315
650387,774,154,928,1.364825,103.752444
650388,878,487,1365,1.364791,103.75207
650389,909,1695,2604,1.365462,103.752058
650390,822,213,1035,1.36547,103.752421
650391,1074,152,1226,1.365761,103.752534
650392,937,250,1187,1.365791,103.753044
650393,947,328,1275,1.366428,103.753051
650394,1042,433,1475,1.366334,103.752561
650395,1337,1029,2366,1.36624,103.752021
650402,573,490,1063,1.364575,103.744451
650403,389,254,643,1.365137,103.744816
650404,533,114,647,1.365476,103.745066
650405,454,920,1374,1.365648,103.745623
650406,1003,1253,2256,1.365193,103.745942
650407,249,171,420,1.364767,103.745734
650408,454,172,626,1.36473,103.744958
650409,519,368,887,1.364533,103.745809
650410,1089,330,1419,1.36449,103.74498
650411,839,447,1286,1.364056,103.746155
650412,275,3717,3992,1.36419,103.746356
650413,78,915,993,1.363734,103.746714
650414,613,140,753,1.363591,103.745911
650415,77,1159,1236,1.363224,103.746616
650416,686,210,896,1.363159,103.745958
650417,1019,426,1445,1.3629,103.746187
650419,235,1145,1380,1.361858,103.746099
650420,169,334,503,1.362475,103.745621
650421,608,469,1077,1.362443,103.744968
650422,425,297,722,1.362171,103.745643
650423,411,134,545,1.36215,103.744987
650424,58,638,696,1.361923,103.74553
650425,122,140,262,1.361921,103.7452
650426,1074,765,1839,1.361741,103.744735
650435,0,4,4,1.361569,103.749469
650436,0,92,92,1.299509,103.837
650437,0,117,117,1.299509,103.837
650440,1,8,9,1.347545,103.745038
650442,0,77,77,1.299509,103.837
650443,2,61,63,1.299509,103.837
650445,0,83,83,1.299509,103.837
650446,10,745,755,1.299509,103.837
650447,29,396,425,1.299509,103.837
650448,9,15,24,1.299509,103.837
650449,1,0,1,1.359222,103.694178
650450,0,1,1,1.299509,103.837
650451,0,6,6,1.299509,103.837
650452,1,0,1,1.299509,103.837
650454,2,0,2,1.350905,103.701141
650461,1,5,6,1.299509,103.837
650501,619,1463,2082,1.351564,103.754909
650503,482,1936,2418,1.35151,103.753588
650504,319,1317,1636,1.352003,103.754858
650505,612,215,827,1.351942,103.753581
650506,863,285,1148,1.352272,103.754572
650507,484,207,691,1.352242,103.753799
650508,57,164,221,1.352626,103.754306
650509,61,132,193,1.352613,103.754051
650510,379,2101,2480,1.352763,103.754742
650511,493,233,726,1.35266,103.753618
650512,1191,152,1343,1.354038,103.752678
650513,312,436,748,1.354102,103.752189
650514,577,214,791,1.354502,103.752398
650523,580,783,1363,1.35672,103.752553
650524,425,571,996,1.356851,103.752922
650525,143,204,347,1.357165,103.752095
650526,619,3191,3810,1.357228,103.750937
650527,58,248,306,1.357144,103.751392
650528,558,279,837,1.356678,103.750976
650530,180,213,393,1.356257,103.750937
650531,363,304,667,1.356305,103.750152
650532,498,719,1217,1.356287,103.749578
650533,322,408,730,1.355968,103.749739
650534,415,589,1004,1.355983,103.750208
650535,426,30,456,1.354954,103.750231
650536,673,720,1393,1.355518,103.750804
650537,1185,305,1490,1.355206,103.750684
650539,705,285,990,1.354802,103.750716
650540,585,469,1054,1.354449,103.751112
650541,116,846,962,1.354097,103.75144
650542,530,33,563,1.353993,103.750964
650620,696,1520,2216,1.349597,103.748347
650621,906,301,1207,1.35019,103.748219
650622,558,1291,1849,1.350702,103.748387
650623,468,36230,36698,1.350893,103.749224
650624,227,152,379,1.351312,103.749527
650625,283,1058,1341,1.351194,103.748808
650626,465,3214,3679,1.351658,103.749136
650627,298,1270,1568,1.351805,103.749416
650628,374,2908,3282,1.351529,103.749732
650630,66,3538,3604,1.349812,103.749935
650631,7,185,192,1.350268,103.74973
650632,112,4010,4122,1.349353,103.750512
650633,23,218,241,1.349213,103.751027
650634,325,589,914,1.349733,103.751433
650636,225,1714,1939,1.349636,103.751682
650637,93,2339,2432,1.349636,103.751999
650638,25,804,829,1.349386,103.752164
650639,112,71,183,1.349336,103.751877
650640,39,867,906,1.349365,103.751484
650641,21,554,575,1.349002,103.751226
650642,383,74,457,1.349032,103.751551
650643,5,998,1003,1.349015,103.751881
650644,72,1992,2064,1.348711,103.751665
651105,22,62,84,1.299509,103.837
651154,107,3352,3459,1.347399,103.743673
651188,12,1148,1160,1.346895,103.745439
651194,438,721,1159,1.345814,103.744003
651210,705,1821,2526,1.34694,103.749879
651230,171,1700,1871,1.299509,103.837
651241,30,951,981,1.350963,103.754577
651285,13,158,171,1.346715,103.757784
651288,824,2111,2935,1.346052,103.760405
651289,650,1554,2204,1.344177,103.760384
651290,701,829,1530,1.344646,103.757558
651291,570,487,1057,1.343083,103.755538
651292,0,108,108,1.299509,103.837
651293,0,66,66,1.299509,103.837
651296,12,69,81,1.299509,103.837
651377,4,29,33,1.299509,103.837
651383,178,290,468,1.362573,103.751954
651388,22,253,275,1.364483,103.752266
651391,145,583,728,1.365765,103.752109
651395,80,3461,3541,1.363934,103.751851
651404,12,75,87,1.365151,103.745328
651411,3,156,159,1.299509,103.837
651412,17,484,501,1.299509,103.837
651413,1,110,111,1.299509,103.837
651435,1,337,338,1.363831,103.75149
651436,0,108,108,1.299509,103.837
651437,0,1,1,1.363831,103.75149
651439,0,1,1,1.299509,103.837
651440,0,9,9,1.299509,103.837
651441,0,4,4,1.299509,103.837
651443,1,24,25,1.299509,103.837
651445,22,124,146,1.299509,103.837
651446,4,184,188,1.299509,103.837
651447,28,1015,1043,1.299509,103.837
651448,0,2,2,1.299509,103.837
651450,2,10,12,1.299509,103.837
651451,6,6,12,1.299509,103.837
651622,12,401,413,1.349833,103.748613
651628,29,3730,3759,1.350951,103.749974
651644,16,232,248,1.348639,103.751418
652194,692,92,784,1.34479,103.745149
652230,19,325,344,1.299509,103.837
652288,616,1565,2181,1.346119,103.759651
652289,891,444,1335,1.343687,103.759757
652290,708,556,1264,1.343138,103.756421
652291,720,57,777,1.343003,103.755006
652292,1,145,146,1.299509,103.837
652293,4,800,804,1.299509,103.837
652296,80,76,156,1.299509,103.837
652377,4,1792,1796,1.299509,103.837
652435,2,0,2,1.299509,103.837
652439,2,3,5,1.299509,103.837
652442,0,1,1,1.299509,103.837
652445,11,2,13,1.299509,103.837
652446,0,26,26,1.299509,103.837
652448,2,6,8,1.299509,103.837
652449,2,49,51,1.299509,103.837
652450,1,76,77,1.299509,103.837
652451,1,0,1,1.299509,103.837
652461,0,10,10,1.353863,103.737206
652622,16,1649,1665,1.350516,103.748326
653288,945,1074,2019,1.345891,103.759097
653289,525,2612,3137,1.343517,103.758911
653290,1231,48,1279,1.343632,103.75651
653291,370,94,464,1.343561,103.755027
653292,2,116,118,1.299509,103.837
653296,53,73,126,1.299509,103.837
653435,2,0,2,1.299509,103.837
653439,0,3,3,1.350906,103.701097
653440,1,0,1,1.299509,103.837
653442,0,24,24,1.299509,103.837
653443,2,0,2,1.299509,103.837
653448,1,0,1,1.299509,103.837
653450,3,1194,1197,1.299509,103.837
653461,2,9,11,1.299509,103.837
654288,568,238,806,1.345542,103.758805
654289,1062,1556,2618,1.344264,103.759165
654290,374,1802,2176,1.344004,103.7576
654291,587,5396,5983,1.343611,103.754735
654440,5,127,132,1.299509,103.837
654443,3,127,130,1.347416,103.740268
654450,1,1,2,1.299509,103.837
654461,0,2,2,1.299509,103.837
655288,192,1899,2091,1.345299,103.758179
655289,427,840,1267,1.344649,103.75905
655290,569,169,738,1.343383,103.757309
655291,14,367,381,1.342752,103.755573
656288,522,217,739,1.345057,103.759381
656289,535,406,941,1.345051,103.758864
656290,682,331,1013,1.3434,103.756899
657288,6,176,182,1.345585,103.760153
657289,16,229,245,1.344549,103.759919
657290,41,153,194,1.343065,103.757696
658005,0,3,3,1.299509,103.837
658007,1,0,1,1.337794,103.757088
658009,2,4,6,1.369063,103.753043
658010,20,0,20,1.369067,103.753065
658011,2,1,3,1.299509,103.837
658012,2,1,3,1.369097,103.75313
658013,0,4,4,1.299509,103.837
658015,0,2,2,1.299509,103.837
658016,1,1,2,1.299509,103.837
658017,0,1,1,1.337794,103.757088
658029,5,0,5,1.359121,103.740892
658034,2,1,3,1.369099,103.753209
658035,1,0,1,1.299509,103.837
658036,11,0,11,1.370141,103.752988
658037,5,0,5,1.369799,103.753058
658038,2,0,2,1.299509,103.837
658039,4,1,5,1.369804,103.753113
658040,14,0,14,1.370146,103.753087
658041,3,1,4,1.369072,103.753236
658042,6,0,6,1.370126,103.753117
658043,1,7,8,1.369831,103.753249
658044,3,1,4,1.369804,103.753163
658045,1,12,13,1.370136,103.753225
658049,22,1,23,1.369593,103.75299
658050,0,1,1,1.369797,103.753007
658051,3,0,3,1.369795,103.752942
658052,1,0,1,1.369576,103.753017
658053,1,0,1,1.369569,103.753118
658054,5,6,11,1.369603,103.753231
658055,1,0,1,1.369572,103.753173
658056,21,1,22,1.3693,103.753139
658057,0,2,2,1.370149,103.753039
658058,1,3,4,1.370158,103.753179
658059,5,0,5,1.37048,103.753176
658060,15,1,16,1.370483,103.753248
658061,5,4,9,1.370485,103.753319
658062,1,9,10,1.370478,103.753381
658064,2039,1486,3525,1.338942,103.758733
658065,3379,1479,4858,1.337164,103.759705
658066,834,805,1639,1.337881,103.758674
658069,23,97,120,1.299509,103.837
658070,638,408,1046,1.336758,103.758667
658071,237,61,298,1.338724,103.755811
658072,218,350,568,1.372964,103.752336
658073,4,586,590,1.372988,103.752737
658074,2421,2661,5082,1.349274,103.749061
658075,113,2390,2503,1.338931,103.758064
658076,7,89,96,1.338521,103.755673
658077,1463,650,2113,1.338065,103.757031
658078,430,594,1024,1.338462,103.756269
658079,816,958,1774,1.338462,103.758284
658080,607,1281,1888,1.338524,103.757082
658115,77,271,348,1.340653,103.752433
658198,1,0,1,1.369281,103.753084
658200,1,0,1,1.370571,103.753388
658203,9,0,9,1.370387,103.753395
658204,165,0,165,1.370336,103.753398
658206,3,2,5,1.370235,103.753402
658208,11,0,11,1.370134,103.753406
658209,6,0,6,1.370083,103.753408
658210,0,2,2,1.369286,103.753196
658211,0,2,2,1.370032,103.75341
658212,1,0,1,1.370498,103.753381
658213,3,1,4,1.369282,103.75322
658214,5,1,6,1.36983,103.753419
658215,34,1,35,1.369779,103.753421
658216,8,2,10,1.369729,103.753424
658217,1,0,1,1.369931,103.753415
658219,8,0,8,1.369577,103.75343
658220,0,2,2,1.369982,103.753413
658221,6,0,6,1.369476,103.753434
658223,2,1,3,1.369574,103.753061
658224,4,0,4,1.36988,103.753417
658225,1,0,1,1.369678,103.753426
658228,0,2,2,1.369526,103.753432
658230,2,1,3,1.369374,103.753439
658232,0,1,1,1.369283,103.753433
658234,8,1,9,1.368595,103.753529
658235,6,1,7,1.368534,103.753557
658236,0,1,1,1.369235,103.753354
658238,9,2,11,1.368326,103.753564
658239,3,2,5,1.368266,103.753572
658240,1,0,1,1.368422,103.753586
658242,1,3,4,1.369324,103.753441
658243,61,0,61,1.36814,103.753299
658244,3,0,3,1.369249,103.753393
658246,5,1,6,1.368136,103.753134
658248,0,1,1,1.368197,103.753491
658249,8,0,8,1.368156,103.752959
658251,6,1,7,1.368175,103.752844
658252,3,0,3,1.368155,103.753243
658254,25,1,26,1.368153,103.752607
658258,0,1,1,1.368133,103.752975
658260,1,0,1,1.368161,103.752316
658263,7,2,9,1.368732,103.751896
658264,1,1,2,1.369256,103.753413
658268,2,0,2,1.368109,103.751845
658269,1,0,1,1.368114,103.752116
658272,0,1,1,1.368254,103.751414
658276,20,0,20,1.368673,103.751232
658278,6,2,8,1.368757,103.751183
658279,0,5,5,1.36881,103.751184
658280,1,1,2,1.368219,103.751471
658281,1,5,6,1.368947,103.751102
658282,17,1,18,1.368969,103.751088
658283,0,1,1,1.368443,103.751317
658286,0,3,3,1.368167,103.752783
658287,0,12,12,1.299729,103.857084
658289,0,1,1,1.369054,103.751083
658290,15,2,17,1.369007,103.751522
658291,0,3,3,1.369016,103.751389
658292,2,1,3,1.299729,103.857084
658293,0,5,5,1.299729,103.857084
658294,1,0,1,1.299729,103.857084
658295,0,1,1,1.368988,103.751722
658297,2,6,8,1.299729,103.857084
658298,2,2,4,1.368144,103.753379
658299,1,8,9,1.299729,103.857084
658300,2,0,2,1.36889,103.751137
658301,24,28,52,1.299729,103.857084
658302,25,2,27,1.369024,103.751897
658303,0,1,1,1.299729,103.857084
658304,0,2,2,1.369009,103.751922
658305,2,2,4,1.36903,103.75183
658306,3,0,3,1.36901,103.751578
658307,2,1,3,1.369005,103.751979
658308,9,0,9,1.369016,103.752214
658309,4,2,6,1.299729,103.857084
658310,1,6,7,1.369047,103.752284
658311,0,3,3,1.299729,103.857084
658312,0,3,3,1.299729,103.857084
658314,10,0,10,1.369043,103.752453
658315,1,7,8,1.299729,103.857084
658316,14,1,15,1.369037,103.752514
658318,132,3,135,1.369024,103.752397
658319,1,0,1,1.299729,103.857084
658320,0,4,4,1.299729,103.857084
658321,1,0,1,1.299729,103.857084
658322,6,0,6,1.369051,103.752744
658326,2,0,2,1.369006,103.751959
658328,0,1,1,1.368688,103.752536
658330,6,1,7,1.369062,103.753016
658331,0,2,2,1.369091,103.752864
658332,0,1,1,1.369076,103.752636
658334,1,0,1,1.369086,103.753071
658336,0,1,1,1.369075,103.752885
658337,8,12,20,1.370022,103.751088
658338,20,6,26,1.369738,103.751187
658339,2,1,3,1.369031,103.75233
658340,8,0,8,1.369702,103.751263
658341,4,0,4,1.369028,103.752426
658343,18,0,18,1.37006,103.751242
658344,3,1,4,1.370034,103.751191
658346,2,0,2,1.299729,103.857084
658347,0,1,1,1.369084,103.752986
658349,4,1,5,1.370069,103.751407
658350,6,2,8,1.369748,103.751582
658351,4,0,4,1.369739,103.751376
658353,0,1,1,1.370042,103.751354
658354,3,2,5,1.369725,103.751661
658355,5,2,7,1.370049,103.751636
658356,0,3,3,1.370054,103.751167
658357,0,1,1,1.370082,103.751589
658358,1,2,3,1.369753,103.75172
658359,19,0,19,1.370087,103.751756
658360,1,0,1,1.37008,103.751691
658361,0,1,1,1.369766,103.751824
658362,11,2,13,1.369765,103.751882
658363,6,0,6,1.370062,103.751854
658364,0,3,3,1.369735,103.751776
658365,0,5,5,1.370065,103.751907
658366,19,1,20,1.36974,103.752019
658367,12,5,17,1.370101,103.751965
658368,18,1,19,1.36977,103.752041
658370,0,2,2,1.369714,103.751421
658371,10,1,11,1.370077,103.752077
658372,3,1,4,1.370074,103.751463
658373,3,1,4,1.369776,103.752221
658374,1,1,2,1.369784,103.752167
658375,0,1,1,1.370059,103.751803
658376,17,0,17,1.369765,103.752307
658378,0,1,1,1.370112,103.752195
658379,48,1,49,1.37011,103.752334
658380,3,0,3,1.369764,103.751935
658381,8,4,12,1.370123,103.752396
658382,0,1,1,1.369766,103.752367
658383,7,1,8,1.370115,103.752439
658384,4,3,7,1.36979,103.752553
658385,6,1,7,1.370094,103.752494
658386,1,0,1,1.369766,103.752495
658388,0,3,3,1.369796,103.752441
658389,1,0,1,1.369768,103.7526
658390,4,9,13,1.36978,103.752754
658391,2,2,4,1.370075,103.752145
658392,1,13,14,1.369815,103.752787
658393,111,13,124,1.370139,103.752741
658394,42,6,48,1.369782,103.752838
658395,2,7,9,1.370138,103.752797
658396,1,6,7,1.369819,103.752895
658397,16,4,20,1.370112,103.752877
658398,0,1,1,1.370124,103.752586
658399,4,1,5,1.370437,103.752028
658400,2,0,2,1.369761,103.752279
658401,5,1,6,1.370442,103.752171
658402,5,1,6,1.370445,103.752243
658403,2,5,7,1.370448,103.752315
658404,1,2,3,1.369772,103.752628
658405,0,1,1,1.370113,103.752933
658406,0,5,5,1.370456,103.75253
658407,1,3,4,1.370107,103.752631
658408,0,3,3,1.37045,103.752387
658409,1,1,2,1.370439,103.7521
658411,17,2,19,1.370469,103.752889
658412,3,2,5,1.370472,103.752961
658413,0,1,1,1.370453,103.752458
658414,14,0,14,1.370477,103.753104
658415,0,2,2,1.370464,103.752745
658416,0,5,5,1.36919,103.751347
658417,21,4,25,1.36952,103.751442
658418,1,6,7,1.369223,103.751399
658419,2,1,3,1.370461,103.752674
658420,19,1,20,1.369218,103.751421
658421,3,1,4,1.370458,103.752602
658422,3,3,6,1.369193,103.751586
658424,0,3,3,1.369523,103.751524
658425,1,0,1,1.370475,103.753032
658426,1,0,1,1.369507,103.751727
658427,6,1,7,1.369533,103.751775
658428,1,0,1,1.369204,103.751755
658429,4,2,6,1.369545,103.751815
658430,3,1,4,1.369502,103.751598
658431,2,0,2,1.369492,103.751409
658432,3,0,3,1.369186,103.751566
658433,3,2,5,1.369547,103.751918
658435,1,1,2,1.369542,103.751856
658436,0,1,1,1.369206,103.751729
658437,2,4,6,1.369523,103.752019
658438,13,0,13,1.369253,103.752205
658439,7,3,10,1.369519,103.752085
658440,0,1,1,1.369246,103.751941
658441,0,1,1,1.369245,103.752052
658442,1,0,1,1.369526,103.752192
658443,0,1,1,1.369262,103.752162
658444,13,0,13,1.369235,103.75219
658445,1,0,1,1.369536,103.752249
658446,36,1,37,1.369244,103.752476
658447,57,3,60,1.369542,103.75235
658448,19,1,20,1.369239,103.752325
658449,0,3,3,1.369218,103.751998
658450,8,4,12,1.369275,103.752375
658451,0,4,4,1.369238,103.751877
658452,1,4,5,1.369271,103.752434
658453,2,3,5,1.369543,103.752495
658454,6,0,6,1.369266,103.752765
658455,3,0,3,1.369538,103.752387
658456,11,3,14,1.369255,103.752519
658457,27,1,28,1.369576,103.752628
658458,38,3,41,1.369248,103.752572
658459,7,1,8,1.369557,103.75268
658460,1,5,6,1.3693,103.752995
658461,1,2,3,1.369552,103.752577
658462,0,1,1,1.369531,103.752305
658463,24,1,25,1.369591,103.752796
658464,4,2,6,1.369309,103.753143
658465,14,1,15,1.36956,103.752847
658466,13,4,17,1.369309,103.753221
658467,9,1,10,1.369593,103.752907
658468,0,2,2,1.369542,103.751966
658469,0,1,1,1.369258,103.75276
658470,3,6,9,1.369303,103.753033
658471,21,31,52,1.370789,103.751176
658472,15,1,16,1.370755,103.751158
658473,4,44,48,1.370813,103.751205
658474,2,3,5,1.371081,103.751544
658475,2,1,3,1.36956,103.752763
658476,0,10,10,1.371091,103.751554
658477,1,55,56,1.370909,103.751318
658478,2,0,2,1.369302,103.752891
658479,3,0,3,1.370861,103.751261
658480,3,4,7,1.371625,103.752034
658481,2,14,16,1.371005,103.751431
658482,48,2,50,1.371713,103.752095
658483,1,0,1,1.369275,103.752976
658484,5,4,9,1.37181,103.752142
658485,2,13,15,1.371091,103.751534
658486,1,0,1,1.371053,103.751487
658487,1,1,2,1.371313,103.751761
658488,4,28,32,1.372243,103.752394
658489,0,5,5,1.371167,103.751601
658490,5,32,37,1.37229,103.752463
658491,24,1,25,1.371243,103.751669
658492,8,0,8,1.372291,103.752667
658493,0,3,3,1.370957,103.751374
658494,6,6,12,1.372296,103.752739
658495,2,0,2,1.371129,103.751568
658497,1,4,5,1.371407,103.751828
658498,5,3,8,1.372286,103.752902
658499,5,1,6,1.37147,103.751887
658500,4,0,4,1.369563,103.752434
658501,0,3,3,1.371288,103.751715
658502,29,1,30,1.372116,103.753194
658503,6,0,6,1.371567,103.751971
658504,0,3,3,1.371533,103.751945
658505,1,2,3,1.371986,103.753326
658506,17,1,18,1.371661,103.752041
658507,2,7,9,1.371687,103.752058
658508,1,0,1,1.372026,103.752268
658509,14,9,23,1.37181,103.752122
658510,1,0,1,1.371745,103.752091
658511,0,9,9,1.371891,103.752169
658512,1,1,2,1.371344,103.75177
658513,8,7,15,1.371999,103.752232
658514,24,0,24,1.372054,103.752264
658515,2,4,6,1.372108,103.752295
658516,8,3,11,1.372162,103.752327
658517,5,7,12,1.372216,103.752358
658518,0,4,4,1.372201,103.753048
658519,65,1,66,1.372291,103.752437
658520,21,0,21,1.37231,103.752497
658521,57,28,85,1.372311,103.752565
658522,15,0,15,1.372311,103.752633
658523,2,9,11,1.372311,103.752667
658524,2,0,2,1.371945,103.752201
658525,11,3,14,1.372311,103.752565
658527,0,1,1,1.371837,103.752138
658528,5,1,6,1.37248,103.752999
658530,3,1,4,1.372253,103.752384
658532,1,0,1,1.372282,103.752424
658533,9,0,9,1.372351,103.753229
658534,2,3,5,1.372285,103.753273
658535,1,0,1,1.372326,103.75321
658536,3,0,3,1.371635,103.752024
658537,0,1,1,1.372265,103.753337
658538,2,0,2,1.372311,103.752616
658539,1,2,3,1.371942,103.753347
658540,1,1,2,1.37181,103.753352
658542,4,0,4,1.372386,103.753085
658543,12,1,13,1.371532,103.753359
658544,4,0,4,1.371583,103.753358
658545,3,1,4,1.37148,103.75336
658546,11,0,11,1.371376,103.753362
658547,4,0,4,1.371428,103.753361
658548,7,0,7,1.371273,103.753364
658549,11,3,14,1.371221,103.753365
658550,149,1,150,1.371169,103.753366
658551,1,0,1,1.371898,103.753349
658552,0,2,2,1.371645,103.753347
658553,2,1,3,1.371723,103.753354
658554,1,2,3,1.371045,103.753369
658555,5,2,7,1.370983,103.753371
658556,1,0,1,1.371118,103.753367
658557,1,0,1,1.370942,103.753373
658558,4,1,5,1.37086,103.753376
658561,3,1,4,1.371325,103.753363
658562,13,3,16,1.370694,103.753383
658563,4,1,5,1.370653,103.753384
658564,20,1,21,1.370612,103.753386
658565,0,3,3,1.371025,103.75337
658566,5,6,11,1.36927,103.751026
658567,6,2,8,1.369329,103.750988
658568,6,3,9,1.36938,103.750964
658569,4,2,6,1.369435,103.75095
658570,25,0,25,1.369457,103.750966
658571,0,2,2,1.371076,103.753358
658572,9,1,10,1.369565,103.750936
658573,101,0,101,1.369612,103.750919
658574,3,1,4,1.370736,103.753381
658575,1,3,4,1.369663,103.75088
658576,0,19,19,1.369836,103.750865
658577,11,3,14,1.369877,103.750786
658578,19,1,20,1.369892,103.750779
658579,10,7,17,1.369576,103.751175
658580,5,1,6,1.369691,103.751105
658581,1,24,25,1.369807,103.751035
658582,0,133,133,1.369922,103.750965
658583,8,33,41,1.370139,103.750908
658584,5,304,309,1.370159,103.750908
658585,0,5,5,1.370306,103.750937
658586,4,1,5,1.370442,103.750956
658587,7,7,14,1.370478,103.75097
658588,9,38,47,1.370514,103.750985
658589,18,35,53,1.370584,103.751022
658590,17,5,22,1.370652,103.751068
658591,6,366,372,1.370721,103.751115
658592,22,242,264,1.370755,103.751138
658594,3,9,12,1.371064,103.753301
658595,1,5,6,1.371061,103.753279
658597,16,0,16,1.371057,103.753189
658598,3,1,4,1.369755,103.75087
658599,3,3,6,1.371052,103.7531
658601,3,0,3,1.369194,103.751032
658602,1,2,3,1.371047,103.75301
658603,3,3,6,1.371042,103.752921
658604,1,0,1,1.370901,103.753375
658605,5,0,5,1.371038,103.752831
658606,7,5,12,1.371036,103.752781
658607,3,3,6,1.371033,103.752742
658608,3,0,3,1.371046,103.75297
658609,34,0,34,1.371028,103.752652
658610,1,0,1,1.371041,103.752875
658611,17,7,24,1.371024,103.752563
658613,32,0,32,1.371019,103.752473
658614,89,1,90,1.371016,103.752402
658615,0,7,7,1.371014,103.752384
658616,1,0,1,1.371026,103.752591
658618,4,3,7,1.371006,103.752213
658619,0,10,10,1.371005,103.752205
658621,7,0,7,1.371,103.752116
658622,10,6,16,1.370996,103.752024
658623,0,2,2,1.369529,103.750921
658624,2,0,2,1.370995,103.752026
658625,2,0,2,1.370991,103.751929
658626,6,1,7,1.370986,103.751835
658627,1,20,21,1.370986,103.751847
658628,24,0,24,1.370981,103.75174
658630,2,0,2,1.370991,103.751937
658631,2,2,4,1.371056,103.753159
658632,6,1,7,1.371049,103.751603
658633,1,0,1,1.371011,103.752308
658634,1,3,4,1.370979,103.751693
658635,1,1,2,1.370979,103.751713
658636,3,22,25,1.370442,103.750976
658637,0,10,10,1.370432,103.750995
658638,31,0,31,1.370429,103.751028
658639,25,18,43,1.370422,103.751034
658640,5,0,5,1.370403,103.751111
658641,7,0,7,1.370403,103.751111
658642,2,3,5,1.370406,103.751195
658643,4,5,9,1.370404,103.751167
658644,2,0,2,1.371081,103.751544
658645,2,0,2,1.370409,103.751278
658646,1,1,2,1.370407,103.751239
658647,8,4,12,1.37041,103.75131
658648,3,0,3,1.371031,103.752686
658649,1,0,1,1.371049,103.751583
658650,23,1,24,1.370419,103.75153
658651,2,7,9,1.370415,103.751454
658652,30,0,30,1.370422,103.751613
658653,6,1,7,1.370418,103.751526
658654,1,5,6,1.370425,103.751697
658655,5,5,10,1.370421,103.751597
658656,4,0,4,1.371091,103.751554
658657,4,0,4,1.370428,103.751781
658658,1,3,4,1.370423,103.751669
658659,2,4,6,1.370426,103.751741
658660,11,0,11,1.370434,103.751948
658661,1,0,1,1.370412,103.751382
658662,6,1,7,1.370438,103.752032
658663,5,4,9,1.370431,103.751884
658664,4,0,4,1.370431,103.751864
658665,88,0,88,1.370434,103.751956
658666,1,3,4,1.370441,103.752115
658667,4,0,4,1.370444,103.752199
658668,2,1,3,1.370416,103.751446
658669,15,0,15,1.370453,103.75245
658670,15,5,20,1.370457,103.752534
658671,5,0,5,1.37046,103.752618
658672,4,1,5,1.370463,103.752701
658673,3,0,3,1.37045,103.752367
658674,1,3,4,1.370447,103.752283
658676,3,2,5,1.370475,103.753036
658678,1,4,5,1.370482,103.753204
658680,1,8,9,1.370498,103.753381
658681,0,4,4,1.370469,103.752869
658682,0,1,1,1.370429,103.751813
658683,2,1,3,1.370466,103.752785
658685,5,0,5,1.371581,103.75224
658686,3,3,6,1.371586,103.752153
658688,50,0,50,1.371583,103.752285
658690,5,1,6,1.371587,103.752374
658692,3,0,3,1.37161,103.752108
658693,0,1,1,1.371619,103.752067
658698,6,0,6,1.371605,103.752731
658699,11,0,11,1.371612,103.752851
658701,3,1,4,1.371635,103.752044
658702,5,0,5,1.371613,103.75291
658703,38,0,38,1.371621,103.753046
658704,1,0,1,1.371597,103.75256
658705,0,1,1,1.371618,103.753
658706,7,1,8,1.371622,103.753089
658707,1,0,1,1.371626,103.753143
658708,4,0,4,1.371616,103.752948
658709,0,8,8,1.371645,103.753347
658711,2,11,13,1.371625,103.753347
658712,453,1078,1531,1.342423,103.760309
658713,3024,9566,12590,1.349649,103.749107
658714,3,1,4,1.371626,103.753178
658715,35,0,35,1.339508,103.761808
658716,5,0,5,1.339392,103.7615
658718,8,0,8,1.339361,103.761409
658719,247,0,247,1.339468,103.761678
658720,2,0,2,1.370412,103.751362
658721,28,0,28,1.339442,103.761591
658723,2,2,4,1.339407,103.761545
658724,1,0,1,1.37163,103.75324
658725,12,0,12,1.339351,103.761318
658726,4,0,4,1.339396,103.761454
658727,1,0,1,1.33927,103.761135
658728,9,0,9,1.33921,103.760953
658729,1,2,3,1.371592,103.752463
658730,5,0,5,1.339179,103.760862
658731,3,10,13,1.33922,103.760757
658732,0,1,1,1.33926,103.761044
658733,3,1,4,1.33924,103.761044
658734,2,0,2,1.339331,103.761318
658735,1,1,2,1.339138,103.760738
658736,28,5,33,1.339127,103.760704
658737,2,1,3,1.339543,103.76126
658738,2,0,2,1.339404,103.760684
658739,2,0,2,1.339106,103.760637
658740,29,1381,1410,1.339094,103.76058
658741,2,4,6,1.339773,103.760539
658742,7,477,484,1.339188,103.760749
658743,1,9,10,1.339834,103.760515
658744,3,134,137,1.339218,103.760738
658745,10,1,11,1.340025,103.760507
658746,64,282,346,1.339276,103.760715
658747,1,2,3,1.339527,103.760636
658748,14,64,78,1.339335,103.760692
658749,28,3,31,1.340157,103.760635
658750,23,128,151,1.339394,103.760668
658751,0,2,2,1.33965,103.760588
658752,11,21,32,1.339452,103.760645
658753,3,0,3,1.340105,103.760567
658754,18,103,121,1.339511,103.760622
658755,6,0,6,1.340385,103.761031
658756,0,23,23,1.33957,103.760599
658757,22,8,30,1.340453,103.761156
658758,38,87,125,1.339629,103.760576
658759,3,5,8,1.340462,103.761251
658760,1,25,26,1.339687,103.760553
658761,3,0,3,1.340316,103.760905
658762,7,179,186,1.339746,103.76053
658763,3,0,3,1.340383,103.761305
658764,6,153,159,1.339805,103.760507
658765,7,1,8,1.340119,103.76138
658766,16,447,463,1.339834,103.760495
658767,7,0,7,1.340063,103.761373
658768,8,186,194,1.339899,103.760482
658769,4,6,10,1.340012,103.761399
658770,0,178,178,1.339962,103.760479
658771,6,0,6,1.339871,103.761259
658772,1,88,89,1.340025,103.760487
658773,1,0,1,1.339159,103.760781
658774,3,9,12,1.340078,103.760527
658775,1,0,1,1.339862,103.761287
658776,0,120,120,1.340136,103.760583
658777,4,0,4,1.339282,103.760733
658778,2,18,20,1.340177,103.760635
658779,1,0,1,1.339893,103.761369
658780,10,526,536,1.340196,103.760662
658782,2,19,21,1.340234,103.760717
658784,3,279,282,1.340264,103.760772
658785,2,0,2,1.340248,103.76078
658786,0,11,11,1.340294,103.760827
658787,5,40,45,1.340324,103.760882
658788,0,1,1,1.339933,103.76149
658789,0,3,3,1.340251,103.761342
658790,1,24,25,1.340413,103.761046
658791,0,42,42,1.340443,103.761101
658792,0,11,11,1.340473,103.761156
658793,5,0,5,1.340479,103.761219
658794,1,0,1,1.340354,103.760936
658795,2,1,3,1.340383,103.760991
658796,4,0,4,1.339906,103.761406
658798,5,1,6,1.340218,103.761357
658799,1,0,1,1.340456,103.761269
658801,0,2,2,1.339946,103.761543
658802,21,1,22,1.339972,103.761427
658803,2,2,4,1.340341,103.761322
658804,21,910,931,1.337974,103.760679
658805,11,523,534,1.338006,103.760715
658806,61,1,62,1.337984,103.760711
658807,0,3,3,1.340403,103.761305
658808,0,2,2,1.340033,103.76141
658809,19,0,19,1.338074,103.76092
658810,0,5,5,1.338026,103.760838
658811,9,1,10,1.338119,103.761056
658812,0,1,1,1.340157,103.761375
658814,1,3,4,1.339941,103.761436
658815,114,3,117,1.338163,103.761156
658816,0,4,4,1.338069,103.760965
658818,2,2,4,1.33809,103.761029
658819,0,3,3,1.338028,103.760783
658820,5,2,7,1.338132,103.761156
658822,3,2,5,1.338153,103.761219
658823,7,3,10,1.338257,103.761413
658824,1,0,1,1.338048,103.760901
658826,31,3,34,1.338195,103.761347
658827,1,3,4,1.338111,103.761092
658828,2,0,2,1.338005,103.760774
658829,6,0,6,1.338349,103.761674
658830,2,6,8,1.338238,103.761474
658831,20,3,23,1.338335,103.761638
658832,0,1,1,1.338174,103.761283
658833,0,3,3,1.338207,103.761265
658834,0,1,1,1.338259,103.761537
658835,0,1,1,1.338294,103.761631
658836,113,5,118,1.338358,103.761747
658837,7,4,11,1.338423,103.761816
658838,1,5,6,1.338461,103.761846
658839,0,3,3,1.33828,103.761601
658840,8,2,10,1.338592,103.761847
658841,2,2,4,1.338319,103.761589
658842,1,1,2,1.338217,103.76141
658843,1,10,11,1.338784,103.761795
658844,17,1,18,1.338848,103.761774
658845,4,1,5,1.338912,103.761754
658847,50,0,50,1.339016,103.761723
658848,13,2,15,1.33912,103.761693
658849,8,0,8,1.339224,103.761662
658850,4,5,9,1.339328,103.761632
658851,35,3,38,1.339432,103.761601
658852,25,1165,1190,1.338548,103.760575
658853,22,941,963,1.338517,103.760553
658854,6,5,11,1.338553,103.7606
658855,1,0,1,1.338323,103.761691
658856,2,1,3,1.338526,103.761851
658857,3,1,4,1.338657,103.761835
658858,1,0,1,1.338533,103.7606
658859,1,1,2,1.338721,103.761815
658860,1,0,1,1.338614,103.760791
658861,0,4,4,1.338564,103.760696
658862,1,2,3,1.338584,103.760696
658863,1,1,2,1.338594,103.760791
658865,6,5,11,1.338687,103.761077
658866,10,4,14,1.338737,103.761172
658867,46,1,47,1.338717,103.761172
658868,4,0,4,1.338625,103.760886
658869,0,1,1,1.338645,103.760886
658870,11,1,12,1.338799,103.761363
658871,4,0,4,1.338768,103.761267
658872,20,0,20,1.33883,103.761458
658873,2,5,7,1.33881,103.761458
658874,7,4,11,1.33886,103.761553
658875,45,0,45,1.33884,103.761553
658876,14,1,15,1.338891,103.761649
658877,18,1,19,1.338871,103.761649
658878,9,3,12,1.338912,103.761734
658879,5,4,9,1.338878,103.761688
658880,900,635,1535,1.341616,103.760862
658881,1753,1331,3084,1.34127,103.759847
658882,2878,330,3208,1.341098,103.760393
658962,184,361,545,1.348506,103.740867
658963,44,1291,1335,1.347146,103.740653
658964,9,721,730,1.34713,103.740058
658965,296,3590,3886,1.350343,103.741592
658966,8476,210,8686,1.353168,103.738103
659003,1410,438,1848,1.365784,103.748504
659081,43,244,287,1.358174,103.752976
659083,2019,40155,42174,1.359012,103.751888
659084,96,4211,4307,1.366663,103.75054
659085,1271,4628,5899,1.366829,103.750145
659086,48,1393,1441,1.367749,103.749537
659087,7,272,279,1.367374,103.748697
659088,72,3328,3400,1.359667,103.752228
659125,118,2385,2503,1.364453,103.747213
659163,276,87,363,1.349481,103.74102
659164,799,5915,6714,1.351972,103.747924
659165,2,5,7,1.354329,103.742985
659166,146,698,844,1.34991,103.738553
659167,17,223,240,1.355105,103.740104
659168,267,960,1227,1.350877,103.742881
659203,3,100,103,1.363018,103.743733
659204,17,136,153,1.363886,103.74518
659205,208,406,614,1.362261,103.743372
659206,760,2769,3529,1.352618,103.749398
659243,365,450,815,1.354143,103.754202
659244,900,1473,2373,1.356391,103.752428
659245,1522,440,1962,1.355689,103.752432
659246,1187,292,1479,1.355157,103.752423
659247,1731,223,1954,1.354941,103.752664
659248,919,278,1197,1.354865,103.75314
659249,79,34,113,1.355424,103.752758
659250,531,370,901,1.352752,103.753048
659251,271,1011,1282,1.355001,103.751595
659288,6,30,36,1.299509,103.837
659289,18,242,260,1.34552,103.760396
659322,451,3213,3664,1.364045,103.750416
659401,405,2319,2724,1.364488,103.749162
659440,57,1647,1704,1.359288,103.74934
659441,115,6,121,1.359,103.748528
659442,1299,351,1650,1.35739,103.749281
659443,743,50,793,1.357438,103.74999
659444,81,1085,1166,1.357288,103.749291
659445,1164,951,2115,1.356952,103.749499
659480,383,565,948,1.341683,103.754461
659519,112,2057,2169,1.340389,103.754604
659520,3,800,803,1.340092,103.756942
659521,1,0,1,1.338748,103.761267
659523,170,3419,3589,1.340341,103.757328
659524,348,51,399,1.342672,103.751531
659525,12,13,25,1.34212,103.752546
659526,84,616,700,1.342267,103.752616
659527,139,51,190,1.3428,103.751639
659528,175,86,261,1.343372,103.752044
659529,86,1367,1453,1.342879,103.752951
659530,13,0,13,1.34139,103.752764
659531,8,10,18,1.341243,103.752152
659532,15,0,15,1.341754,103.751914
659533,2,2,4,1.338779,103.761363
659534,2,2,4,1.341443,103.751451
659535,2,1,3,1.338676,103.760982
659536,16,12,28,1.342118,103.750574
659537,2,58,60,1.341812,103.750189
659538,6,60,66,1.341701,103.750578
659539,8,4,12,1.341425,103.751005
659540,5,72,77,1.341225,103.751455
659541,8,34,42,1.340682,103.751768
659542,17,42,59,1.340793,103.75219
659543,3,393,396,1.341117,103.753216
659544,248,532,780,1.341376,103.756106
659545,42,2936,2978,1.341754,103.75585
659546,82,13,95,1.340546,103.756639
659547,2,2901,2903,1.340804,103.756069
659548,154,188,342,1.340169,103.755944
659549,7,73,80,1.33935,103.75578
659550,1,17,18,1.338825,103.755504
659551,12,20,32,1.338966,103.755097
659552,2,0,2,1.338656,103.760982
659553,49,237,286,1.339981,103.75572
659554,455,602,1057,1.343944,103.75344
659578,485,614,1099,1.339533,103.757377
659581,243,498,741,1.34432,103.74835
659582,14,73,87,1.344659,103.750318
659583,145,0,145,1.344591,103.750681
659584,14,570,584,1.344687,103.751168
659585,176,1189,1365,1.344587,103.751792
659586,159,119,278,1.344004,103.751295
659587,26,50,76,1.343671,103.750923
659588,5,1,6,1.343608,103.750444
659589,272,1,273,1.343711,103.750056
659590,1,1,2,1.339487,103.755376
659591,106,161,267,1.344085,103.749375
659592,747,253,1000,1.344533,103.749486
659630,0,1249,1249,1.34643,103.751151
659631,4,92,96,1.346319,103.751152
659632,23,1326,1349,1.346095,103.751154
659633,333,258,591,1.34572,103.752298
659634,416,1513,1929,1.346179,103.753862
659635,3,619,622,1.344661,103.754884
659636,1124,664,1788,1.34683,103.755982
659637,911,121,1032,1.346231,103.756204
659638,18,1499,1517,1.346509,103.756104
659673,186,2154,2340,1.34954,103.742675
659674,861,3093,3954,1.349364,103.742359
659714,0,94,94,1.342346,103.748894
659759,75,350,425,1.347411,103.768374
659760,33,169,202,1.347388,103.764873
659761,41,217,258,1.347219,103.764538
659762,660,1134,1794,1.344781,103.756511
659763,279,136,415,1.347037,103.765732
659764,388,59,447,1.346636,103.7663
659765,1603,17,1620,1.346328,103.765807
659766,859,6,865,1.346212,103.765254
659801,2456,1201,3657,1.3521,103.756704
659802,1804,1134,2938,1.35196,103.755596
659803,30,176,206,1.352847,103.756451
659804,2347,585,2932,1.353074,103.756162
659840,91,1765,1856,1.349245,103.758491
659841,408,2488,2896,1.349112,103.758195
659879,111,3068,3179,1.343077,103.758393
659918,927,1608,2535,1.347261,103.759424
659919,88,3543,3631,1.351424,103.756063
659920,2494,2076,4570,1.351859,103.759147
659921,3058,825,3883,1.35153,103.757223
659958,146,270,416,1.349046,103.749569
659959,237,668,905,1.3503,103.74756
667968,137,66,203,1.349718,103.881869
667973,1020,198,1218,1.376239,103.756401
667978,1598,1120,2718,1.363398,103.764373
667979,1996,4173,6169,1.363414,103.764469
667980,1616,614,2230,1.363398,103.764373
667981,221,140,361,1.36464,103.764326
667982,234,180,414,1.299509,103.837
667988,177,18,195,1.367747,103.757493
667989,4,30,34,1.375115,103.761239
668105,0,3,3,1.341781,103.750801
668106,0,3,3,1.375798,103.757802
668107,0,1,1,1.339967,103.757174
668108,4,1,5,1.37579,103.757822
668109,4,8,12,1.376038,103.758217
668110,7,1,8,1.375881,103.75798
668111,56,3,59,1.376199,103.758494
668112,0,8,8,1.375973,103.758138
668114,13,2,15,1.376064,103.758296
668115,4,4,8,1.376809,103.758503
668116,4,1,5,1.376502,103.758688
668118,3,1,4,1.341621,103.751103
668119,9,0,9,1.376349,103.75878
668120,0,4,4,1.376359,103.75877
668121,31,1,32,1.376004,103.758999
668156,10,753,763,1.377665,103.757063
668158,15,2,17,1.377597,103.757083
668159,1,4,5,1.377462,103.757122
668160,2,3,5,1.377327,103.757162
668161,3,3,6,1.377192,103.757201
668162,4,41,45,1.377057,103.757241
668163,0,54,54,1.376923,103.75728
668164,0,12,12,1.376788,103.75732
668165,18,5,23,1.376653,103.757359
668166,2,3,5,1.376518,103.757399
668167,5,5,10,1.376383,103.757438
668168,35,12,47,1.376248,103.757478
668169,1,8,9,1.377192,103.757221
668170,0,4,4,1.376171,103.758894
668171,0,7,7,1.376923,103.7573
668172,40,7,47,1.376788,103.75734
668173,6,22,28,1.376653,103.757379
668174,6,4,10,1.376518,103.757419
668175,13,6,19,1.376383,103.757458
668176,41,3,44,1.376258,103.757488
668177,9,6,15,1.377665,103.757083
668178,1,6,7,1.377597,103.757103
668179,12,2,14,1.377462,103.757142
668180,9,2,11,1.377327,103.757182
668181,8,32,40,1.299509,103.837
668182,36,5,41,1.299509,103.837
668183,7,1,8,1.299509,103.837
668184,0,4,4,1.377057,103.757261
668185,11,2,13,1.299509,103.837
668186,0,7,7,1.299509,103.837
668187,3,28,31,1.299509,103.837
668188,0,4,4,1.299509,103.837
668189,0,1,1,1.375878,103.75794
668190,2,0,2,1.343775,103.749663
668191,7,1,8,1.299509,103.837
668194,1,1,2,1.299509,103.837
668197,1,1,2,1.299509,103.837
668198,5,2,7,1.299509,103.837
668199,1,1,2,1.299509,103.837
668200,120,8,128,1.299509,103.837
668201,897,24,921,1.376239,103.756401
668202,913,535,1448,1.376239,103.756401
668203,5,4,9,1.375242,103.758354
668204,0,4,4,1.375242,103.758334
668206,10,0,10,1.375146,103.758344
668207,0,1,1,1.299509,103.837
668208,1,1,2,1.299509,103.837
668209,13,1,14,1.375102,103.758359
668210,3,6,9,1.374907,103.758317
668211,1,0,1,1.375102,103.758359
668212,2,0,2,1.375066,103.758335
668214,6,5,11,1.374665,103.758273
668215,8,1,9,1.374836,103.758329
668216,1,0,1,1.375013,103.758349
668218,1,1,2,1.374748,103.758299
668219,5,0,5,1.374645,103.758273
668220,2,0,2,1.374506,103.757981
668221,0,1,1,1.374557,103.758115
668222,4,0,4,1.375242,103.758334
668224,0,1,1,1.37458,103.758205
668226,4,3,7,1.3743,103.757447
668227,59,1,60,1.374492,103.757997
668228,0,1,1,1.374351,103.757581
668229,0,1,1,1.374461,103.757919
668230,0,1,1,1.374431,103.75784
668233,0,2,2,1.374454,103.757848
668234,3,3,6,1.37429,103.757457
668269,1,12,13,1.376293,103.757551
668270,6,4,10,1.376308,103.757614
668271,1,1,2,1.37431,103.757526
668273,150,3,153,1.376398,103.757739
668274,0,6,6,1.376518,103.75799
668275,2,6,8,1.376468,103.757865
668276,0,3,3,1.375744,103.757743
668278,6,1,7,1.376799,103.758493
668279,2,1,3,1.376659,103.758242
668280,0,3,3,1.376609,103.758116
668281,24,3,27,1.376985,103.758898
668282,2,0,2,1.376328,103.757614
668283,36,3,39,1.376945,103.758929
668284,3,0,3,1.377006,103.758883
668285,4,3,7,1.376904,103.758961
668286,2,2,4,1.374403,103.757714
668288,1,1,2,1.376749,103.758367
668289,2,0,2,1.376891,103.758621
668290,3,0,3,1.376809,103.758483
668291,3,1,4,1.376855,103.758557
668292,0,2,2,1.376823,103.759023
668293,1,0,1,1.374401,103.757761
668295,3,0,3,1.376964,103.758749
668297,15,0,15,1.37666,103.759148
668298,0,3,3,1.376701,103.759117
668299,1,3,4,1.376345,103.759617
668300,36,1,37,1.37708,103.75895
668301,80,0,80,1.376579,103.75921
668302,27,0,27,1.376539,103.759241
668303,1,0,1,1.376387,103.759582
668304,0,20,20,1.376457,103.759304
668305,10,0,10,1.376417,103.759335
668307,12,0,12,1.376335,103.759397
668308,0,1,1,1.376498,103.759272
668309,2,0,2,1.377026,103.758867
668311,0,12,12,1.377036,103.759141
668312,2,3,5,1.377304,103.759402
668315,4,0,4,1.37662,103.759179
668316,4,3,7,1.377101,103.75955
668317,0,1,1,1.376894,103.759235
668318,3,0,3,1.377065,103.758926
668320,1,0,1,1.377043,103.759592
668322,4,0,4,1.377159,103.759508
668323,34,2,36,1.3762,103.76001
668324,0,1,1,1.376927,103.759677
668325,6,0,6,1.376143,103.759844
668327,13,0,13,1.376094,103.759788
668328,9,0,9,1.376695,103.759846
668329,1,0,1,1.376811,103.759761
668330,0,1,1,1.376133,103.759443
668331,6,2,8,1.376103,103.759354
668332,17,0,17,1.376579,103.75993
668334,2,0,2,1.37695,103.759206
668335,4,0,4,1.376869,103.759719
668336,10,7,17,1.376463,103.760015
668337,9,2,11,1.375917,103.758922
668338,0,7,7,1.375994,103.758989
668339,142,12,154,1.37585,103.758844
668340,1,8,9,1.375568,103.758591
668341,0,9,9,1.375781,103.758795
668342,2,5,7,1.375558,103.758601
668378,14,2,16,1.374901,103.757194
668379,5,0,5,1.374919,103.757245
668380,2,0,2,1.376521,103.759973
668381,1,2,3,1.376985,103.759635
668382,13,11,24,1.375025,103.757554
668383,7,4,11,1.375061,103.757657
668384,2,4,6,1.375096,103.75776
668385,14,0,14,1.375122,103.757853
668386,1,1,2,1.374954,103.757348
668387,16,3,19,1.375301,103.758325
668388,25,0,25,1.375377,103.758408
668389,11,0,11,1.375112,103.757863
668493,2,16,18,1.36059,103.761547
668494,4,1,5,1.360375,103.761332
668599,40,92,132,1.359769,103.762591
668600,0,1,1,1.376637,103.759888
668602,172,10,182,1.359921,103.7624
668604,1,0,1,1.359817,103.762529
668605,0,5,5,1.36003,103.762248
668606,2,4,6,1.360003,103.762437
668607,1,0,1,1.359998,103.762289
668610,37,0,37,1.360108,103.762149
668611,9,16,25,1.360117,103.762285
668612,2,16,18,1.360149,103.762101
668614,0,2,2,1.375132,103.757863
668615,8,0,8,1.360201,103.762177
668617,4,0,4,1.375994,103.759009
668618,5,4,9,1.360239,103.761977
668619,7,0,7,1.360282,103.762072
668620,3,2,5,1.360268,103.761939
668621,0,1,1,1.360038,103.762403
668622,50,1,51,1.360292,103.761899
668623,3,0,3,1.37499,103.757451
668624,0,33,33,1.360363,103.761799
668625,2,0,2,1.36018,103.762054
668626,1,1,2,1.360388,103.761745
668627,6,3,9,1.360477,103.761632
668662,4,63,67,1.357386,103.761442
668663,3,3,6,1.357587,103.761077
668664,9,7,16,1.357586,103.761076
668665,4,0,4,1.360231,103.762118
668666,0,7,7,1.357586,103.761076
668667,25,0,25,1.357586,103.761076
668668,2,6,8,1.357586,103.761076
668670,2,14,16,1.357586,103.761076
668671,340,1200,1540,1.357411,103.762088
668672,3,10,13,1.357654,103.760982
668673,0,12,12,1.35779,103.76079
668674,2,0,2,1.360435,103.761689
668675,3,29,32,1.35806,103.760408
668677,0,1,1,1.360327,103.762007
668678,2,0,2,1.357925,103.760599
668680,0,1,1,1.358104,103.76034
668681,18,0,18,1.35809,103.76034
668682,27,8,35,1.358278,103.760067
668683,9,2,11,1.358121,103.760292
668684,11,0,11,1.358321,103.759999
668685,92,1,93,1.358182,103.760197
668686,1,8,9,1.358364,103.75993
668688,7,0,7,1.358408,103.759862
668691,2,0,2,1.358147,103.760272
668692,0,2,2,1.358364,103.75991
668693,9,0,9,1.358425,103.759815
668694,2,0,2,1.358495,103.759726
668695,4,7,11,1.358486,103.75972
668696,0,2,2,1.358538,103.759658
668698,1,1,2,1.358582,103.759589
668700,9,0,9,1.358669,103.759453
668702,47,0,47,1.358687,103.759424
668703,2,2,4,1.357586,103.761076
668704,0,2,2,1.358625,103.759521
668705,0,1,1,1.358234,103.760135
668706,1,2,3,1.360321,103.761854
668707,18,1,19,1.358846,103.759161
668708,0,6,6,1.358882,103.759103
668709,21,0,21,1.358925,103.758994
668710,0,2,2,1.35874,103.759336
668711,5,2,7,1.358968,103.758904
668713,26,0,26,1.359053,103.758726
668714,1,3,4,1.358704,103.759395
668715,10,0,10,1.359139,103.758547
668716,2,3,5,1.359065,103.75872
668717,10,0,10,1.359224,103.758369
668719,37,7,44,1.3593,103.7582
668720,15,14,29,1.359188,103.758465
668721,14,0,14,1.359249,103.758338
668722,121,0,121,1.35931,103.75821
668723,6,3,9,1.359394,103.758068
668724,28,9,37,1.359477,103.757926
668725,2,0,2,1.358913,103.759039
668726,13,1,14,1.359767,103.757602
668727,6,31,37,1.35755,103.761006
668761,115,18,133,1.359231,103.762234
668762,0,8,8,1.359235,103.762249
668763,36,5,41,1.359253,103.762203
668764,0,3,3,1.358811,103.75922
668765,0,2,2,1.359574,103.757818
668766,0,1,1,1.358776,103.759278
668767,33,0,33,1.359339,103.762082
668768,1,2,3,1.359259,103.762214
668769,10,1,11,1.359381,103.762021
668770,1,0,1,1.359309,103.762144
668771,1,0,1,1.359407,103.762004
668772,11,0,11,1.359444,103.761931
668773,4,4,8,1.359456,103.761934
668775,1,2,3,1.359358,103.762074
668776,3,2,5,1.359555,103.761794
668777,18,2,20,1.359553,103.761777
668778,27,1,28,1.359604,103.761724
668779,13,1,14,1.359596,103.761717
668780,1,2,3,1.35951,103.761838
668781,2,0,2,1.359296,103.762142
668782,5,0,5,1.359703,103.761584
668783,1,0,1,1.359424,103.76196
668785,36,0,36,1.359724,103.761534
668786,30,0,30,1.359802,103.761445
668787,8,0,8,1.359767,103.761473
668788,4,4,8,1.359851,103.761375
668790,1,0,1,1.359682,103.761595
668791,1,0,1,1.3599,103.761305
668792,11,0,11,1.35995,103.761235
668793,1,0,1,1.359853,103.761352
668794,4,0,4,1.359004,103.758848
668795,1,2,3,1.359654,103.761654
668799,1,0,1,1.359896,103.761291
668800,3,0,3,1.359939,103.76123
668801,3,0,3,1.360147,103.760955
668802,20,10,30,1.360196,103.760885
668803,1,0,1,1.360025,103.761108
668804,0,8,8,1.360153,103.760926
668805,8,0,8,1.360186,103.760875
668840,13,10,23,1.358142,103.761457
668841,0,13,13,1.358142,103.761477
668842,1,3,4,1.359999,103.761165
668845,3,0,3,1.360067,103.761047
668846,144,0,144,1.358242,103.761307
668847,75,0,75,1.358242,103.761327
668848,0,4,4,1.358162,103.761427
668850,12,0,12,1.358322,103.761187
668853,3,1,4,1.358282,103.761247
668854,8,0,8,1.358402,103.761066
668856,2,4,6,1.358442,103.761006
668857,0,1,1,1.36011,103.760987
668858,11,0,11,1.358482,103.760946
668859,2,0,2,1.359639,103.761656
668860,13,8,21,1.358522,103.760886
668861,4,6,10,1.358522,103.760906
668863,58,0,58,1.358562,103.760846
668864,24,6,30,1.358602,103.760766
668865,39,1,40,1.358602,103.760786
668866,3,0,3,1.358202,103.761387
668867,28,3,31,1.358642,103.760726
668868,9,1,10,1.358681,103.760646
668870,18,5,23,1.358721,103.760586
668871,1,1,2,1.358482,103.760966
668872,3,0,3,1.358642,103.760706
668873,3,1,4,1.358362,103.761147
668874,6,0,6,1.358801,103.760466
668875,5,0,5,1.358801,103.760486
668876,1,7,8,1.358841,103.760406
668877,1,0,1,1.358442,103.761026
668878,7,0,7,1.358881,103.760346
668879,2,0,2,1.358721,103.760606
668880,33,1,34,1.358921,103.760286
668881,7,0,7,1.358921,103.760306
668882,5,0,5,1.358961,103.760225
668884,14,0,14,1.359001,103.760165
668886,1,0,1,1.358841,103.760426
668887,1,0,1,1.359041,103.760105
668888,3,6,9,1.359081,103.760045
668889,153,0,153,1.359081,103.760065
668890,6,0,6,1.359121,103.759985
668891,13,1,14,1.359121,103.760005
668892,1,0,1,1.359041,103.760125
668893,3,0,3,1.358761,103.760526
668894,52,0,52,1.359201,103.759865
668896,1,0,1,1.359161,103.759925
668897,47,1,48,1.359244,103.759815
668898,0,1,1,1.359244,103.759795
668899,4,0,4,1.358761,103.760546
668901,0,1,1,1.35929,103.759716
668902,2,0,2,1.358881,103.760366
668903,4,0,4,1.35929,103.759736
668904,5,3,8,1.359372,103.759538
668905,2,0,2,1.359339,103.759609
668907,7,0,7,1.359405,103.759486
668908,22,0,22,1.359438,103.759395
668909,131,3,134,1.359438,103.759415
668910,0,3,3,1.359161,103.759945
668911,5,0,5,1.359454,103.759379
668946,1,9,10,1.358655,103.761832
668947,4,15,19,1.358662,103.761842
668948,4,0,4,1.359339,103.759629
668950,1,0,1,1.359306,103.7597
668951,6,0,6,1.358748,103.761721
668952,0,3,3,1.359444,103.759369
668953,0,5,5,1.358804,103.761641
668954,24,0,24,1.358805,103.76162
668956,1,0,1,1.35872,103.761741
668957,1,0,1,1.358848,103.761559
668959,0,1,1,1.358918,103.76148
668960,12,0,12,1.358934,103.761438
668961,4,2,6,1.359032,103.76132
668963,1,8,9,1.359088,103.761239
668964,1,0,1,1.358975,103.7614
668965,20,0,20,1.359145,103.761159
668967,184,0,184,1.359202,103.761079
668968,5,24,29,1.359105,103.761195
668969,11,90,101,1.359259,103.760998
668972,8,2,10,1.359191,103.761074
668974,1,8,9,1.359234,103.761014
668975,0,3,3,1.358763,103.76168
668976,14,0,14,1.359277,103.760953
668977,1,0,1,1.35902,103.761317
668978,3,1,4,1.358677,103.761801
668979,17,5,22,1.359543,103.760597
668981,2,0,2,1.359372,103.759558
668982,1,1,2,1.359599,103.760516
668983,4,4,8,1.359656,103.760436
668984,13,2,15,1.359448,103.760711
668987,1,19,20,1.35977,103.760275
668988,0,1,1,1.359486,103.760677
668989,124,1,125,1.359707,103.760826
668990,6,8,14,1.359577,103.760529
668991,0,5,5,1.359855,103.760155
668992,3,0,3,1.359429,103.760757
668993,6,1,7,1.359902,103.760067
668994,7,1,8,1.359662,103.760408
668995,2,0,2,1.359405,103.760771
668996,97,1,98,1.359705,103.760347
668997,11,5,16,1.359995,103.75989
668998,5,0,5,1.359748,103.760286
668999,1,1,2,1.359948,103.759978
669000,22,0,22,1.359791,103.760226
669001,8,0,8,1.360073,103.75969
669002,1,0,1,1.359534,103.760589
669003,0,2,2,1.360032,103.759797
669005,2,0,2,1.360114,103.759583
669006,2,0,2,1.360134,103.75953
669008,73,0,73,1.360225,103.759556
669009,3,6,9,1.360225,103.759556
669010,3,14,17,1.360225,103.759556
669011,17,0,17,1.359942,103.759969
669012,142,0,142,1.360498,103.760183
669013,8,1,9,1.359978,103.759903
669014,1,6,7,1.36036,103.759594
669015,9,0,9,1.36036,103.759594
669016,54,1,55,1.359995,103.75987
669017,25,9,34,1.360416,103.75961
669018,4,1,5,1.360416,103.75961
669019,10,2,12,1.360032,103.759777
669020,21,3,24,1.360579,103.759644
669021,41,10,51,1.360579,103.759644
669022,20,0,20,1.360061,103.759701
669023,41,3,44,1.360711,103.759663
669025,2,1,3,1.359619,103.760468
669026,3,0,3,1.36081,103.759669
669027,6,1,7,1.36087,103.759667
669028,8,4,12,1.360124,103.75952
669029,5,0,5,1.360992,103.759663
669030,6,1,7,1.360019,103.75949
669031,8,0,8,1.361112,103.759659
669032,9,0,9,1.359904,103.759469
669033,0,2,2,1.359908,103.760036
669035,5,1,6,1.360317,103.758697
669037,26,1,27,1.360369,103.758694
669038,6,0,6,1.359454,103.759359
669039,15,0,15,1.360475,103.75869
669040,14,0,14,1.358892,103.759093
669041,47,9,56,1.36058,103.758685
669042,2,0,2,1.360329,103.759313
669043,7,0,7,1.360686,103.758681
669044,0,1,1,1.359834,103.760165
669045,2,0,2,1.360221,103.758691
669048,7,2,9,1.360007,103.75865
669049,1,0,1,1.360178,103.758683
669050,2,0,2,1.360791,103.758676
669052,25,0,25,1.359835,103.758618
669053,1,2,3,1.360119,103.759548
669055,15,0,15,1.360273,103.758504
669056,3,0,3,1.360273,103.758596
669057,1,0,1,1.361002,103.758667
669058,2,3,5,1.360254,103.758689
669059,4,4,8,1.360264,103.758362
669060,1,1,2,1.359921,103.758634
669061,0,4,4,1.359319,103.760892
669062,2,0,2,1.360253,103.75855
669063,3,1,4,1.360248,103.758263
669065,3,2,5,1.36021,103.758119
669066,0,1,1,1.360272,103.758411
669068,43,0,43,1.359916,103.757755
669070,0,2,2,1.360252,103.758411
669071,0,11,11,1.359754,103.757593
669073,1,1,2,1.359767,103.757602
669074,46,6,52,1.360268,103.757438
669076,64,0,64,1.360268,103.757437
669077,11,0,11,1.359715,103.757568
669078,4,0,4,1.360225,103.758166
669081,9,0,9,1.360063,103.757622
669082,98,1,99,1.360062,103.757621
669083,23,0,23,1.360062,103.757621
669084,2,7,9,1.359984,103.757104
669085,5,17,22,1.359925,103.757744
669086,99,2,101,1.359925,103.757744
669087,18,6,24,1.359926,103.757745
669088,4,5,9,1.359777,103.757592
669089,8,1,9,1.359741,103.757565
669090,6,6,12,1.360489,103.759423
669091,11,0,11,1.360542,103.75925
669092,30,4,34,1.360311,103.759584
669093,11,0,11,1.359558,103.757465
669095,2,7,9,1.359715,103.757548
669096,88,0,88,1.359506,103.757431
669099,4,0,4,1.3602,103.7575
669100,83,0,83,1.359558,103.757445
669101,6,0,6,1.359516,103.757421
669102,4,23,27,1.359584,103.757482
669106,0,1,1,1.360071,103.757938
669107,13,1,14,1.359714,103.757567
669108,10,0,10,1.359714,103.757567
669109,49,0,49,1.359714,103.757567
669110,138,1,139,1.359714,103.757567
669111,80,0,80,1.359054,103.757408
669112,0,1,1,1.359714,103.757567
669113,3,0,3,1.359664,103.758585
669114,2,1,3,1.35897,103.757344
669115,5,2,7,1.359662,103.757533
669116,4,0,4,1.35961,103.757479
669117,2,1,3,1.359663,103.757534
669118,28,5,33,1.359662,103.757533
669126,16,92,108,1.360459,103.763085
669128,1,2,3,1.359662,103.757533
669129,1,1,2,1.359741,103.757585
669130,19,0,19,1.360254,103.762948
669131,1,9,10,1.360197,103.762906
669132,1,0,1,1.359013,103.757376
669133,4,1,5,1.360097,103.762836
669135,0,4,4,1.359662,103.757533
669136,37,4,41,1.359951,103.762725
669137,42,34,76,1.359879,103.762669
669172,1,4,5,1.35396,103.759267
669173,18,4,22,1.35396,103.759259
669174,0,3,3,1.360354,103.763016
669176,0,1,1,1.360143,103.762865
669177,1,2,3,1.353958,103.759309
669178,1,2,3,1.35395,103.759421
669179,0,1,1,1.353953,103.759393
669180,0,1,1,1.353943,103.759529
669182,9,1,10,1.353937,103.759645
669183,3,0,3,1.353948,103.759477
669184,8,0,8,1.353932,103.759729
669185,2,1,3,1.35393,103.759745
669187,22,479,501,1.353907,103.759971
669188,0,42,42,1.353922,103.759897
669189,4,291,295,1.353927,103.759971
669224,1,201,202,1.352828,103.759726
669225,2,27,29,1.352821,103.759595
669226,14,26,40,1.352509,103.758962
669227,1,19,20,1.352807,103.759335
669228,10,5,15,1.352532,103.758854
669229,548,64,612,1.352793,103.759074
669230,0,11,11,1.35278,103.759205
669231,579,20,599,1.352779,103.758814
669232,276,6,282,1.352762,103.758879
669233,322,3,325,1.352765,103.758553
669234,2,8,10,1.352745,103.758553
669235,0,3,3,1.353924,103.759853
669236,2,18,20,1.352696,103.758253
669237,5,1,6,1.353816,103.758118
669239,15,0,15,1.353839,103.757917
669240,2,1,3,1.352768,103.758618
669241,5,2,7,1.352695,103.758252
669242,3,2,5,1.353846,103.757808
669243,0,1,1,1.353943,103.759561
669244,1,0,1,1.353819,103.757709
669245,108,23,131,1.352742,103.757636
669246,91,1,92,1.353815,103.757529
669247,1,0,1,1.353858,103.757606
669248,9,0,9,1.353828,103.757295
669249,10,18,28,1.352789,103.757139
669250,3,1,4,1.360003,103.762761
669251,14,1,15,1.353462,103.757019
669252,0,1,1,1.353843,103.757423
669253,3,9,12,1.352784,103.756956
669254,11,0,11,1.353387,103.757215
669255,9,0,9,1.353349,103.757317
669256,4,0,4,1.353379,103.756886
669257,0,24,24,1.352764,103.75654
669258,2,0,2,1.360305,103.762985
669259,4,3,7,1.353359,103.757739
669260,16,9,25,1.353326,103.757843
669261,1,4,5,1.353319,103.757958
669262,3,0,3,1.352696,103.758253
669263,4,2,6,1.353322,103.758157
669264,2,2,4,1.353374,103.757431
669265,12,3,15,1.353338,103.758337
669266,0,3,3,1.353323,103.758034
669267,0,3,3,1.353079,103.758308
669269,104,21,125,1.353008,103.75778
669270,4,6,10,1.353029,103.757359
669271,2,1,3,1.352971,103.758276
669272,188,1,189,1.353008,103.757157
669273,3,2,5,1.353042,103.757065
669274,2,1,3,1.353036,103.757259
669275,1,1,2,1.353342,103.757618
669276,26,6,32,1.353033,103.75674
669277,55,196,251,1.353012,103.756664
669317,74,2064,2138,1.361991,103.766921
669363,9,69,78,1.354521,103.760427
669364,8,30,38,1.354521,103.760458
669365,0,1,1,1.353381,103.757141
669366,0,1,1,1.354522,103.760373
669367,0,1,1,1.354521,103.760415
669368,3,5,8,1.354523,103.760327
669369,2,1,3,1.353011,103.756968
669370,3,0,3,1.354525,103.760155
669371,31,2,33,1.354526,103.760046
669372,0,1,1,1.354523,103.760264
669373,1,7,8,1.354528,103.759937
669374,3,1,4,1.353342,103.758264
669375,23,3,26,1.35453,103.759828
669376,0,3,3,1.354524,103.76024
669377,5,0,5,1.354531,103.759718
669378,1,2,3,1.354528,103.759978
669379,0,3,3,1.354529,103.759891
669380,0,5,5,1.35453,103.759804
669381,0,1,1,1.354525,103.760153
669382,0,2,2,1.353033,103.756868
669383,3,3,6,1.354536,103.759391
669384,0,5,5,1.354533,103.759629
669385,65,4,69,1.354537,103.759282
669386,0,2,2,1.354531,103.759717
669387,5,12,17,1.354529,103.759183
669388,1,2,3,1.354533,103.759609
669389,8,1,9,1.354536,103.759368
669390,2,5,7,1.354538,103.75928
669391,34,4,38,1.354549,103.759183
669426,4,1696,1700,1.353321,103.759818
669427,4,651,655,1.353322,103.759807
669428,4,12,16,1.353323,103.759746
669429,1,2,3,1.354535,103.759455
669430,8,9,17,1.353327,103.759601
669431,4,0,4,1.354526,103.760066
669432,3,20,23,1.353332,103.759455
669433,0,1,1,1.354534,103.7595
669434,4,2,6,1.353373,103.75913
669436,0,2,2,1.354534,103.759542
669437,4,0,4,1.353331,103.759496
669438,0,3,3,1.353325,103.759704
669439,4,0,4,1.353408,103.759094
669440,1,6,7,1.353953,103.759215
669442,5,2,7,1.353821,103.759172
669443,1,1,2,1.353564,103.759105
669444,1,6,7,1.35403,103.759208
669446,0,2,2,1.353963,103.759205
669447,0,4,4,1.353564,103.759085
669448,1,1,2,1.354129,103.759203
669450,3,0,3,1.35375,103.759176
669451,6,0,6,1.354529,103.759183
669452,51,0,51,1.354582,103.759167
669453,10,0,10,1.354626,103.759161
669456,2,1,3,1.354493,103.759176
669457,2,11,13,1.354914,103.759103
669458,11,3,14,1.354994,103.759105
669459,0,4,4,1.35422,103.759196
669460,7,10,17,1.355153,103.759108
669461,2,4,6,1.355082,103.758586
669462,0,2,2,1.354311,103.75919
669463,1,0,1,1.353337,103.759289
669464,1,0,1,1.355124,103.758644
669465,0,2,2,1.355103,103.758615
669466,1,4,5,1.355176,103.758832
669467,5,7,12,1.355173,103.758896
669468,17,2,19,1.35517,103.758959
669469,0,6,6,1.355167,103.759023
669470,82,8,90,1.355164,103.759086
669471,89,9,98,1.355163,103.759118
669472,4,8,12,1.355152,103.759169
669473,13,12,25,1.355152,103.759149
669474,1,5,6,1.355152,103.759211
669475,144,14,158,1.355152,103.759191
669476,2,15,17,1.35515,103.759294
669477,3,11,14,1.35515,103.759274
669478,1,2,3,1.354838,103.759126
669479,0,1,1,1.355151,103.758705
669480,1,8,9,1.355148,103.759459
669481,3,0,3,1.355149,103.759376
669482,0,7,7,1.355146,103.759542
669483,1,0,1,1.355149,103.759356
669484,7,3,10,1.355145,103.759625
669486,1,4,5,1.355143,103.759708
669487,1,1,2,1.355168,103.758767
669488,2,1,3,1.355148,103.759439
669489,6,1,7,1.355142,103.75977
669490,8,4,12,1.355141,103.759873
669491,2,0,2,1.355143,103.759688
669492,1,11,12,1.355139,103.759956
669493,0,2,2,1.355141,103.759853
669494,2,2,4,1.355073,103.759106
669495,0,1,1,1.355146,103.759522
669496,5,6,11,1.355136,103.760122
669497,0,3,3,1.355142,103.759791
669498,51,2,53,1.355135,103.760205
669499,2,1,3,1.355136,103.760102
669500,5,6,11,1.355134,103.760287
669501,1,1,2,1.355139,103.759936
669502,0,7,7,1.355132,103.76037
669503,0,1,1,1.355138,103.760019
669504,4,3,7,1.355141,103.760443
669505,3,1,4,1.355138,103.760039
669506,4,552,556,1.355178,103.760983
669507,13,3,16,1.355178,103.76094
669508,1,3,4,1.355121,103.760443
669509,2,3,5,1.355181,103.760764
669510,6,1,7,1.355182,103.760677
669511,12,2,14,1.355168,103.760592
669512,0,9,9,1.355152,103.760542
669513,8,2,10,1.355131,103.760453
669514,2,2,4,1.355179,103.760852
669515,3,211,214,1.355128,103.760453
669554,1139,483,1622,1.364159,103.765499
669555,389,7,396,1.364603,103.766041
669556,1056,1710,2766,1.363381,103.765413
669557,1629,152,1781,1.363532,103.766011
669558,952,1901,2853,1.362514,103.765915
669559,1084,734,1818,1.360759,103.765297
669560,372,918,1290,1.361533,103.76509
669561,1338,132,1470,1.361461,103.765801
669562,1970,255,2225,1.360759,103.765297
669565,1087,1771,2858,1.358597,103.765054
669566,1195,495,1690,1.358788,103.764424
669567,29,0,29,1.35963,103.764655
669568,470,1022,1492,1.359897,103.764468
669569,1701,270,1971,1.357084,103.763605
669570,288,937,1225,1.356117,103.762253
669579,99,1256,1355,1.359132,103.763318
669581,1490,175,1665,1.3594,103.76292
669583,779,131,910,1.35455,103.761237
669584,7,7,14,1.353727,103.761636
669587,240,297,537,1.353445,103.760451
669590,971,700,1671,1.358857,103.762767
669592,1258,4533,5791,1.357877,103.762731
669594,136,1198,1334,1.356779,103.761706
669595,142,1,143,1.356758,103.7609
669596,229,194,423,1.356726,103.760429
669597,520,237,757,1.356757,103.759769
669598,1346,254,1600,1.356343,103.7594
669599,733,158,891,1.356307,103.760808
669600,2236,302,2538,1.356458,103.761329
669604,183,10,193,1.356757,103.759769
669605,102,420,522,1.356757,103.759769
669606,920,42,962,1.355727,103.759168
669607,466,27,493,1.355737,103.760037
669608,712,151,863,1.356343,103.7594
669609,242,30,272,1.356726,103.760429
669610,265,19,284,1.358668,103.762217
669611,55,33,88,1.356729,103.761391
669612,507,281,788,1.356722,103.761104
669613,479,417,896,1.360195,103.76509
669614,505,96,601,1.359715,103.764976
669615,980,192,1172,1.359287,103.765043
669616,542,3029,3571,1.360716,103.76498
669617,1118,1640,2758,1.362575,103.765232
669618,55,1,56,1.36298,103.7659
669619,744,37,781,1.356757,103.759168
669620,718,37,755,1.356757,103.759168
669621,938,29,967,1.357165,103.758291
669622,31,106,137,1.356757,103.759168
669623,424,309,733,1.354012,103.760776
669624,671,50,721,1.353696,103.761143
669625,473,61,534,1.353354,103.761503
669626,308,159,467,1.353187,103.761102
669627,571,61,632,1.353445,103.760451
669628,15,0,15,1.353445,103.760451
669629,265,1521,1786,1.356477,103.761325
669630,541,1057,1598,1.356477,103.761325
669638,40,7763,7803,1.372155,103.76087
669640,17,1,18,1.372483,103.761534
669641,4,1,5,1.372683,103.761451
669642,8,4459,4467,1.369533,103.762597
669643,24,0,24,1.372288,103.760714
669644,60,50,110,1.369504,103.762624
669645,1729,2,1731,1.370436,103.758669
669646,78,1,79,1.371912,103.759283
669648,35,0,35,1.369529,103.762594
669676,23,4,27,1.377913,103.759094
669677,10,0,10,1.377903,103.759084
669679,2,1,3,1.355135,103.760185
669682,60,1,61,1.37817,103.759643
669683,9,0,9,1.377903,103.759104
669684,10,0,10,1.377902,103.759103
669686,32,5,37,1.378113,103.759565
669687,1,2,3,1.377832,103.75894
669688,54,6,60,1.378113,103.759565
669689,5,0,5,1.37793,103.759667
669690,7,1,8,1.377736,103.759738
669691,1,12,13,1.377746,103.759748
669692,2,0,2,1.355134,103.760267
669693,3,6,9,1.378133,103.759565
669694,1,0,1,1.355132,103.76035
669695,3,75,78,1.378179,103.759662
669696,5,3,8,1.378067,103.758961
669698,4,20,24,1.378067,103.758961
669699,20,1,21,1.3778,103.758841
669700,0,2,2,1.378112,103.759564
669701,6,1,7,1.3778,103.758841
669726,1,12,13,1.360577,103.762754
669728,0,4,4,1.355131,103.760453
669730,3,8,11,1.360659,103.762466
669731,2,0,2,1.3778,103.758841
669733,0,8,8,1.360679,103.762282
669735,0,13,13,1.360666,103.762181
669737,2,5,7,1.360642,103.762051
669738,0,6,6,1.360658,103.761999
669739,3,0,3,1.378123,103.759575
669740,0,9,9,1.360609,103.761856
669741,0,3,3,1.360612,103.761944
669742,2,30,32,1.360629,103.761738
669743,562,19,581,1.359997,103.763993
669744,363,341,704,1.36002,103.763961
669745,95,20,115,1.360956,103.761204
669812,5,0,5,1.357766,103.759261
669813,2,0,2,1.360608,103.762399
669814,2,4,6,1.3584,103.759208
669815,11,1,12,1.3584,103.759157
669817,1,3,4,1.360617,103.762609
669819,0,5,5,1.358399,103.758754
669820,25,0,25,1.358399,103.758653
669822,12,2,14,1.35842,103.759157
669823,133,0,133,1.358398,103.758452
669825,88,0,88,1.358398,103.758351
669826,1,2,3,1.360586,103.761798
669829,1,1,2,1.3584,103.759258
669830,4,5,9,1.358418,103.758452
669831,12,0,12,1.358397,103.758049
669832,13,0,13,1.358418,103.75825
669833,5,0,5,1.358397,103.757948
669834,1,2,3,1.358419,103.758855
669835,4,5,9,1.358397,103.757847
669836,7,5,12,1.358417,103.757847
669837,7,4,11,1.35931,103.75819
669838,2,2,4,1.358399,103.758956
669840,690,5,695,1.358417,103.757847
669841,10,0,10,1.359158,103.758095
669842,0,7,7,1.359056,103.758032
669843,1,0,1,1.378142,103.759581
669844,5,1,6,1.358853,103.757905
669845,6,0,6,1.358802,103.757873
669847,6,0,6,1.358542,103.757834
669849,70,0,70,1.358304,103.757833
669850,1,1,2,1.358398,103.758149
669852,1,1,2,1.3582,103.757828
669887,9,55,64,1.35776,103.760639
669888,4,5,9,1.358047,103.760393
669889,3,4,7,1.358053,103.760388
669890,39,0,39,1.358026,103.760383
669891,11,13,24,1.358025,103.760382
669892,23,24,47,1.357992,103.760339
669893,7,0,7,1.357957,103.760334
669894,3,12,15,1.357956,103.760333
669895,3,1,4,1.3593,103.7582
669896,6,8,14,1.357889,103.760285
669897,1,0,1,1.358954,103.757968
669898,3,2,5,1.357778,103.760149
669899,10,3,13,1.35782,103.760236
669900,0,6,6,1.357819,103.760235
669902,47,25,72,1.357758,103.760149
669903,0,1,1,1.357888,103.760284
669904,1,1,2,1.357797,103.757821
669907,283,32,315,1.357758,103.760032
669908,12,0,12,1.357757,103.760031
669909,3,9,12,1.357777,103.75955
669910,8,1,9,1.357758,103.759954
669911,2,11,13,1.357757,103.759953
669912,21,0,21,1.357776,103.759401
669913,0,4,4,1.357854,103.76024
669914,1,2,3,1.358417,103.758049
669915,4,16,20,1.357757,103.759798
669916,3,0,3,1.357776,103.759251
669917,1,2,3,1.357777,103.759196
669918,2,1,3,1.357757,103.75972
669919,1,2,3,1.357778,103.759141
669920,24,0,24,1.357779,103.759031
669921,2,2,4,1.357757,103.759876
669922,17,1,18,1.357781,103.758921
669924,4,2,6,1.357782,103.758811
669925,7,1,8,1.357756,103.759407
669926,1,0,1,1.357757,103.760148
669927,11,2,13,1.357756,103.759329
669928,0,2,2,1.357777,103.75985
669929,6,0,6,1.357756,103.759251
669931,1,3,4,1.357757,103.759563
669932,1,0,1,1.357784,103.758701
669933,66,16,82,1.357758,103.759149
669934,4,6,10,1.357791,103.758261
669935,7,24,31,1.357759,103.759047
669936,11,0,11,1.357792,103.758151
669937,77,11,88,1.35776,103.758945
669938,40,0,40,1.357794,103.758041
669939,1,1,2,1.357786,103.758591
669940,0,1,1,1.357789,103.758371
669941,5,20,25,1.357764,103.75874
669942,6,9,15,1.357797,103.757821
669943,1,33,34,1.357765,103.758638
669945,0,41,41,1.357766,103.758536
669946,1,5,6,1.357789,103.757705
669947,1,2,3,1.357757,103.759641
669948,1,0,1,1.357795,103.757931
669949,2,10,12,1.35777,103.758332
669950,2,0,2,1.357762,103.758842
669951,16,59,75,1.357771,103.75823
669952,2,1,3,1.357768,103.758434
669953,1,39,40,1.357772,103.758127
669954,1,7,8,1.357756,103.757243
669955,8,24,32,1.357774,103.758025
669956,2,3,5,1.357776,103.757923
669957,3,0,3,1.357764,103.757359
669958,10,0,10,1.357774,103.75778
669959,12,0,12,1.357771,103.757738
669960,57,1,58,1.357765,103.757656
669962,14,0,14,1.357754,103.757491
669963,1,18,19,1.357748,103.757408
669964,52,11,63,1.357742,103.757326
669965,5,1,6,1.357736,103.757243
670101,406,843,1249,1.379108,103.767363
670102,387,347,734,1.379088,103.768065
670103,53,50,103,1.378629,103.768434
670104,315,198,513,1.378851,103.767855
670105,71,165,236,1.378305,103.767731
670106,292,205,497,1.377909,103.767271
670107,236,343,579,1.378122,103.766644
670108,238,3335,3573,1.377638,103.767061
670109,35,1729,1764,1.377455,103.767731
670110,354,91,445,1.37789,103.768046
670111,530,203,733,1.378146,103.768197
670112,183,328,511,1.378523,103.768643
670113,570,1135,1705,1.378305,103.769304
670114,52,257,309,1.377841,103.769769
670115,583,361,944,1.37801,103.769138
670116,443,236,679,1.377111,103.768568
670117,16,1479,1495,1.377329,103.767907
670118,251,2694,2945,1.376874,103.768348
670119,48,370,418,1.376666,103.769023
670120,277,154,431,1.377053,103.769377
670121,614,291,905,1.377309,103.769591
670122,26,857,883,1.377725,103.769978
670123,443,200,643,1.377541,103.770629
670124,485,2906,3391,1.376831,103.771035
670125,791,772,1563,1.37728,103.770458
670126,459,507,966,1.376275,103.769914
670127,52,2786,2838,1.376536,103.769243
670128,291,2103,2394,1.376086,103.769688
670129,732,2656,3388,1.37598,103.770416
670130,773,303,1076,1.374104,103.771193
670131,310,1672,1982,1.374534,103.770854
670132,231,289,520,1.374278,103.77063
670133,210,158,368,1.374221,103.769783
670134,20,81,101,1.374421,103.769331
670135,769,142,911,1.373998,103.768871
670136,135,146,281,1.37462,103.768753
670137,258,270,528,1.375127,103.769255
670138,74,11,85,1.374842,103.769994
670139,709,3791,4500,1.375373,103.769503
670140,277,395,672,1.375436,103.768849
670141,199,255,454,1.375872,103.768099
670142,339,2096,2435,1.376582,103.767582
670143,459,136,595,1.376311,103.767437
670144,124,61,185,1.375831,103.76754
670145,53,173,226,1.375955,103.766816
670146,600,37,637,1.375683,103.765969
670147,430,207,637,1.376071,103.765608
670148,635,545,1180,1.375936,103.766077
670149,167,217,384,1.376825,103.766616
670150,346,3796,4142,1.377027,103.766828
670151,380,323,703,1.377008,103.766171
670152,570,33,603,1.375202,103.765877
670153,408,181,589,1.374975,103.765451
670154,1120,179,1299,1.37489,103.765038
670155,802,270,1072,1.375366,103.764906
670163,678,225,903,1.376268,103.764401
670164,616,263,879,1.376523,103.764909
670165,902,668,1570,1.376725,103.76516
670166,671,935,1606,1.377614,103.765436
670167,786,198,984,1.377629,103.765
670168,656,3622,4278,1.377561,103.764325
670170,591,1452,2043,1.378572,103.766128
670171,1052,1147,2199,1.378808,103.7663
670172,548,1399,1947,1.379518,103.766646
670173,710,1728,2438,1.379847,103.766734
670174,671,1586,2257,1.380151,103.766203
670175,726,332,1058,1.379808,103.765828
670176,629,158,787,1.379298,103.765677
670177,869,671,1540,1.380238,103.765222
670178,600,149,749,1.380313,103.764549
670179,919,567,1486,1.379801,103.765074
670180,429,1052,1481,1.379079,103.764799
670181,632,163,795,1.379185,103.76297
670182,956,13446,14402,1.379934,103.763274
670183,701,1941,2642,1.380008,103.762942
670184,1061,622,1683,1.379689,103.762284
670185,618,384,1002,1.379346,103.762143
670201,583,1046,1629,1.371902,103.775216
670202,567,289,856,1.372412,103.774973
670203,544,302,846,1.373184,103.775503
670204,686,401,1087,1.373268,103.774919
670205,802,2729,3531,1.373446,103.773873
670206,648,287,935,1.373677,103.774066
670207,395,401,796,1.37369,103.774772
670208,620,199,819,1.373992,103.774898
670209,100,49,149,1.37419,103.775762
670210,909,293,1202,1.374312,103.776159
670211,445,360,805,1.374595,103.775954
670212,188,50,238,1.374477,103.775674
670213,631,149,780,1.374313,103.775414
670214,885,124,1009,1.374993,103.774659
670215,116,165,281,1.375118,103.774277
670216,653,169,822,1.374729,103.774494
670217,624,60,684,1.374784,103.773705
670218,839,276,1115,1.374505,103.773478
670219,815,2479,3294,1.374151,103.772696
670220,308,319,627,1.374441,103.772853
670221,1031,231,1262,1.37545,103.773401
670222,89,129,218,1.375222,103.774061
670223,962,592,1554,1.375711,103.77357
670224,100,906,1006,1.375881,103.773018
670225,363,236,599,1.37552,103.772463
670226,547,202,749,1.375289,103.772335
670227,296,1916,2212,1.374984,103.771404
670228,500,997,1497,1.37542,103.771094
670229,364,526,890,1.375221,103.77162
670230,235,119,354,1.376228,103.772118
670231,7,166,173,1.376043,103.772746
670232,313,295,608,1.37645,103.772378
670233,522,1300,1822,1.376558,103.771852
670234,621,715,1336,1.378542,103.771788
670235,439,601,1040,1.378232,103.771251
670236,644,434,1078,1.379056,103.771087
670237,728,1310,2038,1.37861,103.77064
670238,741,345,1086,1.37968,103.770554
670239,725,331,1056,1.379981,103.771228
670240,643,274,917,1.379316,103.771072
670241,578,156,734,1.379695,103.771819
670242,152,188,340,1.380125,103.771838
670243,297,534,831,1.380651,103.771394
670244,426,587,1013,1.38092,103.771813
670245,41,1691,1732,1.380512,103.772078
670246,545,1046,1591,1.381381,103.773217
670248,1099,311,1410,1.3814,103.774122
670249,644,368,1012,1.381058,103.77378
670250,683,287,970,1.380687,103.773875
670251,913,283,1196,1.380333,103.773912
670252,577,222,799,1.379962,103.773996
670253,440,942,1382,1.37961,103.774588
670254,379,1716,2095,1.379626,103.773823
670255,550,1801,2351,1.379618,103.772988
670256,178,1471,1649,1.379094,103.772851
670257,621,172,793,1.377701,103.774089
670258,46,134,180,1.377788,103.773121
670259,680,829,1509,1.376976,103.773569
670260,53,22,75,1.377701,103.774089
670270,1100,3022,4122,1.376486,103.774518
670271,1062,12159,13221,1.377185,103.774012
670272,429,1054,1483,1.377557,103.774467
670273,495,342,837,1.377558,103.775279
670274,1310,549,1859,1.377135,103.774695
670275,1590,675,2265,1.376866,103.774693
670276,786,507,1293,1.376216,103.775394
670277,322,587,909,1.376095,103.774913
670401,956,356,1312,1.380521,103.768476
670402,556,836,1392,1.380306,103.768067
670403,604,366,970,1.381122,103.767933
670404,497,467,964,1.380734,103.767615
670405,44,316,360,1.381316,103.76718
670406,882,522,1404,1.381845,103.767482
670407,900,297,1197,1.381443,103.767912
670408,908,773,1681,1.381703,103.768634
670409,430,694,1124,1.382642,103.767625
670410,737,323,1060,1.38261,103.767189
670411,109,317,426,1.383087,103.767487
670412,814,377,1191,1.382935,103.768149
670413,148,542,690,1.382353,103.768682
670414,182,1693,1875,1.382804,103.768984
670415,106,203,309,1.383352,103.768871
670416,405,173,578,1.383225,103.768335
670417,444,173,617,1.38401,103.76805
670418,871,233,1104,1.384292,103.768842
670419,729,468,1197,1.38428,103.76943
670420,100,71,171,1.384704,103.769429
670421,440,4238,4678,1.384447,103.769974
670422,326,150,476,1.385016,103.769585
670423,437,82,519,1.385469,103.769138
670424,53,60,113,1.385724,103.769144
670425,231,117,348,1.385808,103.769378
670426,369,39,408,1.386232,103.769453
670427,253,125,378,1.386483,103.769746
670428,25,96,121,1.386714,103.769741
670429,279,1183,1462,1.386803,103.769928
670430,552,1938,2490,1.386678,103.770404
670431,420,288,708,1.386173,103.770519
670432,400,3369,3769,1.386253,103.771091
670433,90,1476,1566,1.385711,103.771086
670434,513,1622,2135,1.385361,103.770816
670435,783,173,956,1.385937,103.770363
670436,492,230,722,1.382293,103.770108
670437,425,805,1230,1.382978,103.769643
670438,293,417,710,1.382844,103.770085
670439,967,439,1406,1.383097,103.770293
670440,579,4386,4965,1.383607,103.770101
670441,454,181,635,1.383213,103.770766
670442,460,54,514,1.382345,103.771244
670443,56,33,89,1.381009,103.770084
670445,1631,3660,5291,1.383802,103.770558
670446,9,109,118,1.384083,103.770281
670447,679,56,735,1.38322,103.771726
670448,465,252,717,1.383424,103.7719
670449,608,138,746,1.383943,103.772222
670450,450,1383,1833,1.384512,103.772294
670451,90,95,185,1.385155,103.772175
670452,94,765,859,1.385524,103.772219
670453,1034,587,1621,1.385384,103.77163
670454,691,227,918,1.385003,103.771761
670455,649,734,1383,1.387357,103.770934
670456,353,1178,1531,1.388237,103.771739
670457,590,1011,1601,1.388237,103.771739
670458,705,1442,2147,1.388237,103.771739
670459,1075,1069,2144,1.387953,103.771151
670460,636,2607,3243,1.387953,103.771151
670461,512,1284,1796,1.387066,103.771205
670462,2,85,87,1.299509,103.837
670463,0,15,15,1.299509,103.837
670464,1,23,24,1.299509,103.837
670465,997,1117,2114,1.387167,103.772677
670466,953,277,1230,1.3869,103.773169
670467,1148,352,1500,1.387046,103.773776
670468,954,70,1024,1.387561,103.773425
670469,869,137,1006,1.387982,103.773344
670470,684,150,834,1.38858,103.773157
670471,828,279,1107,1.388408,103.772752
670472,1147,1053,2200,1.387995,103.772459
670473,971,2619,3590,1.38829,103.772116
670474,555,250,805,1.38872,103.772411
670475,522,26,548,1.388982,103.772614
670476,622,114,736,1.388968,103.772947
670477,522,123,645,1.389249,103.773077
670478,526,21,547,1.389593,103.772958
670479,497,64,561,1.389854,103.772571
670480,1241,80,1321,1.389739,103.77219
670481,344,123,467,1.389355,103.771955
670482,547,57,604,1.389196,103.772316
670483,690,90,780,1.388786,103.771935
670484,680,1699,2379,1.388341,103.771736
670485,1097,2259,3356,1.299509,103.837
670486,785,407,1192,1.388768,103.771358
670487,555,220,775,1.388768,103.771358
670488,541,275,816,1.299509,103.837
670501,1062,263,1325,1.383262,103.766945
670502,1039,423,1462,1.383777,103.766724
670503,419,2520,2939,1.384421,103.766537
670504,452,7092,7544,1.384563,103.766968
670505,1337,517,1854,1.384226,103.767249
670506,911,1550,2461,1.387001,103.768126
670507,537,420,957,1.386572,103.768014
670508,783,104,887,1.386196,103.768375
670509,359,203,562,1.386722,103.76884
670510,706,1609,2315,1.387427,103.769188
670511,485,1384,1869,1.387778,103.768413
670512,363,724,1087,1.387345,103.768196
670513,335,1807,2142,1.388199,103.767739
670514,305,177,482,1.387562,103.767374
670515,286,372,658,1.388345,103.76729
670516,783,384,1167,1.387268,103.767236
670517,323,570,893,1.388301,103.766539
670518,470,171,641,1.387036,103.766864
670519,550,121,671,1.387955,103.766073
670520,575,323,898,1.386332,103.766401
670521,540,718,1258,1.387459,103.765684
670522,403,101,504,1.3861,103.766268
670523,535,1451,1986,1.387121,103.765449
670524,490,61,551,1.385969,103.766039
670525,590,363,953,1.386726,103.765116
670526,452,198,650,1.38547,103.76517
670527,842,158,1000,1.386367,103.76484
670528,807,582,1389,1.385147,103.765475
670529,401,480,881,1.385974,103.764489
670530,653,1154,1807,1.38494,103.765127
670531,201,1304,1505,1.385684,103.764053
670532,1003,2515,3518,1.385085,103.764584
670533,463,421,884,1.384976,103.763712
670534,688,776,1464,1.38461,103.764064
670535,654,106,760,1.384369,103.763184
670536,947,317,1264,1.384104,103.763791
670537,728,507,1235,1.383822,103.763012
670538,582,176,758,1.3838,103.763716
670539,913,387,1300,1.383172,103.763086
670540,341,191,532,1.383371,103.763636
670541,614,198,812,1.382719,103.763248
670542,718,177,895,1.38308,103.763725
670543,523,156,679,1.382348,103.764111
670544,395,67,462,1.382045,103.763873
670545,528,3278,3806,1.381559,103.763421
670546,64,230,294,1.299509,103.837
670547,36,195,231,1.388735,103.77018
670548,9,786,795,1.299509,103.837
670549,66,185,251,1.299509,103.837
670550,80,238,318,1.299509,103.837
670601,291,2346,2637,1.381845,103.762439
670602,540,450,990,1.381476,103.762607
670603,778,505,1283,1.381575,103.762133
670604,997,563,1560,1.381141,103.762325
670605,1061,145,1206,1.380845,103.761881
670606,1148,145,1293,1.381349,103.761581
670607,586,551,1137,1.382323,103.76149
670608,232,253,485,1.382863,103.761218
670609,406,2079,2485,1.383054,103.761721
670610,366,588,954,1.383336,103.761091
670611,571,162,733,1.383851,103.761806
670612,826,410,1236,1.383791,103.761116
670613,426,1179,1605,1.384578,103.762062
670614,883,1008,1891,1.384292,103.760879
670615,706,932,1638,1.384735,103.762218
670616,244,133,377,1.384971,103.760981
670617,490,1910,2400,1.385608,103.762712
670618,657,306,963,1.385461,103.761181
670619,194,55,249,1.385924,103.762255
670620,422,97,519,1.385843,103.761615
670621,637,137,774,1.385985,103.762629
670622,571,289,860,1.385817,103.761259
670623,657,280,937,1.386131,103.762162
670624,704,460,1164,1.386102,103.761668
670625,1265,439,1704,1.385492,103.760355
670626,1098,446,1544,1.3853,103.759791
670627,1322,1676,2998,1.385382,103.759219
670628,1123,3623,4746,1.385118,103.760105
670629,1751,1341,3092,1.386577,103.75911
670630,1236,2211,3447,1.386771,103.759636
670631,1494,572,2066,1.386707,103.760164
670632,24,95,119,1.384937,103.759229
670633,31,765,796,1.384937,103.759229
670634,77,125,202,1.299509,103.837
670635,73,359,432,1.386277,103.758497
670636,28,223,251,1.386926,103.758383
670650,650,956,1606,1.386865,103.763205
670651,838,275,1113,1.386502,103.763449
670652,856,124,980,1.387322,103.763508
670653,265,94,359,1.386791,103.76389
670654,793,164,957,1.387733,103.763908
670655,799,153,952,1.387095,103.764158
670656,380,661,1041,1.387545,103.764634
671133,164,194,358,1.374646,103.770253
671152,36,102,138,1.375742,103.765378
671163,32,180,212,1.376905,103.764347
671170,6,240,246,1.378939,103.765567
671171,4,4,8,1.379263,103.766314
671175,10,1,11,1.299509,103.837
671177,2,409,411,1.380663,103.764924
671180,96,1455,1551,1.378736,103.764997
671181,11,7975,7986,1.379024,103.763263
671183,49,1234,1283,1.379082,103.764017
671185,20,62,82,1.379204,103.762578
671217,28,197,225,1.374179,103.774409
671225,17,221,238,1.375027,103.77307
671234,27,965,992,1.37916,103.771996
671259,188,642,830,1.377432,103.77279
671401,36,2301,2337,1.381284,103.768987
671422,4,232,236,1.299509,103.837
671442,8,351,359,1.382514,103.771138
671443,697,1130,1827,1.380936,103.770225
671446,33,80,113,1.383956,103.77133
671449,31,346,377,1.383822,103.7727
671453,29,210,239,1.385054,103.771511
671455,10,79,89,1.387684,103.771065
671457,25,140,165,1.387991,103.770732
671464,1,57,58,1.299509,103.837
671465,4,506,510,1.299509,103.837
671466,11,30,41,1.387234,103.773378
671468,17,185,202,1.3881,103.773695
671471,5,6,11,1.388182,103.773077
671476,16,462,478,1.389054,103.773448
671478,234,590,824,1.389837,103.772843
671480,122,260,382,1.389826,103.771996
671482,6,0,6,1.388935,103.772278
671487,11,53,64,1.299509,103.837
671488,3,69,72,1.299509,103.837
671505,38,551,589,1.384935,103.767548
671510,11,120,131,1.387045,103.768759
671513,5,26,31,1.387673,103.767611
671517,8,50,58,1.38786,103.766543
671518,35,197,232,1.386679,103.766852
671521,8,24,32,1.387108,103.765932
671524,1623,1044,2667,1.384839,103.766361
671525,8,28,36,1.386319,103.765343
671529,93,248,341,1.385153,103.764426
671533,62,3636,3698,1.385153,103.763469
671537,66,1700,1766,1.383458,103.762921
671541,48,1052,1100,1.38267,103.762989
671544,22,301,323,1.299509,103.837
671546,1024,700,1724,1.388735,103.77018
671547,397,58,455,1.388735,103.77018
671548,1061,1247,2308,1.388893,103.76794
671549,589,79,668,1.388893,103.76794
671550,670,1188,1858,1.388893,103.76794
671603,23,331,354,1.381773,103.761701
671611,17,72,89,1.383219,103.761663
671613,14,60,74,1.384215,103.761749
671615,8,63,71,1.385006,103.762048
671616,2,111,113,1.384865,103.761531
671617,22,17,39,1.383639,103.762065
671625,10,516,526,1.386402,103.761366
671629,21,1157,1178,1.38597,103.758986
671632,378,567,945,1.38497,103.758238
671633,426,1559,1985,1.385499,103.758362
671634,487,191,678,1.386277,103.758497
671635,946,356,1302,1.386167,103.758194
671636,584,1129,1713,1.387052,103.758544
671651,7,62,69,1.386925,103.764324
671654,23,7,30,1.387535,103.764174
672163,4,34,38,1.299509,103.837
672177,1,12,13,1.38007,103.764948
672259,6,37,43,1.299509,103.837
672442,346,969,1315,1.38149,103.771487
672443,821,615,1436,1.380936,103.770225
672488,6,113,119,1.299509,103.837
672546,725,401,1126,1.388735,103.77018
672547,379,508,887,1.388735,103.77018
672548,1526,1221,2747,1.388893,103.76794
672549,339,115,454,1.299509,103.837
672550,790,429,1219,1.389562,103.767218
672613,10,57,67,1.383639,103.762065
672625,38,56,94,1.38685,103.76043
672629,45,18,63,1.38685,103.76043
672632,508,429,937,1.384937,103.759229
672633,962,1406,2368,1.385099,103.758581
672634,531,731,1262,1.386277,103.758497
672635,690,284,974,1.386277,103.758497
672636,785,115,900,1.386962,103.758425
673442,737,91,828,1.381499,103.770879
673443,881,417,1298,1.38149,103.771487
673546,342,204,546,1.388,103.7715
673547,424,1463,1887,1.299509,103.837
673633,1130,355,1485,1.384937,103.759229
673634,4,151,155,1.299509,103.837
673635,542,1913,2455,1.386721,103.757831
673636,1498,1699,3197,1.387306,103.758938
674442,687,882,1569,1.380998,103.770823
674443,1029,781,1810,1.38149,103.771487
674547,592,306,898,1.388735,103.77018
674633,378,2838,3216,1.384937,103.759229
674635,8,82,90,1.299509,103.837
674636,12,466,478,1.299509,103.837
677641,6,611,617,1.299509,103.837
677646,8,808,816,1.299509,103.837
677656,1,344,345,1.299509,103.837
677661,382,68,450,1.299509,103.837
677662,442,814,1256,1.299509,103.837
677666,618,129,747,1.365035,103.771869
677667,770,1,771,1.365287,103.772132
677668,480,20,500,1.365287,103.772132
677669,1345,1,1346,1.365259,103.771446
677670,627,33,660,1.299509,103.837
677671,47,3684,3731,1.378618,103.764171
677672,52,3531,3583,1.299509,103.837
677673,174,993,1167,1.299509,103.837
677676,1,0,1,1.357781,103.75759
677678,3,0,3,1.357777,103.757821
677680,3,0,3,1.299509,103.837
677681,0,1,1,1.299509,103.837
677682,13,3,16,1.299509,103.837
677683,0,7,7,1.299509,103.837
677684,10,5,15,1.299509,103.837
677685,1,0,1,1.299509,103.837
677686,7,1,8,1.299509,103.837
677687,10,4,14,1.299509,103.837
677690,1,0,1,1.299509,103.837
677692,3,1,4,1.357757,103.7592
677693,66,0,66,1.371266,103.77293
677694,1,0,1,1.299509,103.837
677696,0,1,1,1.299509,103.837
677697,1,0,1,1.299509,103.837
677698,1,0,1,1.299509,103.837
677699,30,0,30,1.299509,103.837
677700,104,2,106,1.299509,103.837
677701,29,2,31,1.299509,103.837
677702,0,5,5,1.299509,103.837
677703,4,13,17,1.299509,103.837
677706,67,1,68,1.299509,103.837
677707,23,0,23,1.299509,103.837
677708,9,5,14,1.299509,103.837
677709,11,3,14,1.299509,103.837
677710,5,2,7,1.299509,103.837
677711,5,0,5,1.299509,103.837
677712,4,3,7,1.299509,103.837
677713,17,0,17,1.299509,103.837
677714,24,8,32,1.371502,103.772993
677715,3,0,3,1.299509,103.837
677716,26,2,28,1.299509,103.837
677717,3,3,6,1.299509,103.837
677721,1729,1692,3421,1.389389,103.769691
677722,815,199,1014,1.389389,103.769691
677723,1196,70,1266,1.389389,103.769691
677724,37,61,98,1.299509,103.837
677726,9,217,226,1.386206,103.757122
677727,53,12,65,1.299509,103.837
677728,74,2,76,1.380337,103.760152
677729,20,308,328,1.299509,103.837
677730,876,32,908,1.403271,103.757476
677731,4,2,6,1.371999,103.76904
677732,6,3,9,1.371954,103.76907
677733,10,3,13,1.371892,103.769067
677734,6,4,10,1.371831,103.769079
677735,2,8,10,1.299509,103.837
677736,115,44,159,1.382752,103.760863
677737,290,297,587,1.387707,103.760018
677738,273,972,1245,1.386569,103.771802
677739,112,755,867,1.382303,103.760982
677740,200,1298,1498,1.386243,103.767117
677741,416,1422,1838,1.388271,103.764939
677742,325,675,1000,1.383113,103.760229
677743,3482,32705,36187,1.379962,103.764153
677744,421,2720,3141,1.385851,103.767546
677745,0,1,1,1.299509,103.837
677746,2,2,4,1.299509,103.837
677747,19,17,36,1.372631,103.772851
677748,2,2,4,1.372823,103.7729
677749,96,12,108,1.372438,103.772894
677750,28,1,29,1.372077,103.773122
677751,5,3,8,1.372314,103.772967
677752,18,6,24,1.372086,103.773137
677753,3,0,3,1.299509,103.837
677754,2,1,3,1.372067,103.773112
677755,86,9,95,1.372057,103.773122
677756,19,2,21,1.372113,103.773183
677757,8,2,10,1.37167,103.773338
677758,2,0,2,1.357772,103.757474
677759,0,1,1,1.372936,103.772964
677760,1,3,4,1.373038,103.773039
677761,64,0,64,1.371483,103.773435
677763,2,0,2,1.372132,103.773213
677764,9,0,9,1.372204,103.773335
677765,1,2,3,1.372095,103.773152
677767,2,3,5,1.372259,103.773427
677768,2,11,13,1.372267,103.773447
677769,2,9,11,1.373253,103.770976
677770,4,92,96,1.373334,103.771232
677771,2,53,55,1.373445,103.771393
677772,100,27,127,1.373504,103.771525
677773,36,14,50,1.373579,103.771718
677774,13,25,38,1.37374,103.771836
677775,6,237,243,1.373841,103.771942
677776,2,91,93,1.373314,103.772535
677777,2,59,61,1.373285,103.772594
677778,32,107,139,1.373227,103.772712
677779,5,526,531,1.373168,103.772831
677780,4,484,488,1.37311,103.772949
677781,7,1041,1048,1.373062,103.773057
677782,11,377,388,1.373034,103.773094
677783,0,4,4,1.37215,103.773244
677784,11,6,17,1.372922,103.773151
677785,3,178,181,1.372979,103.773176
677786,2,1,3,1.372222,103.773366
677787,12,3,15,1.372942,103.77323
677788,1,1,2,1.372186,103.773305
677789,4,232,236,1.372906,103.773285
677791,0,2,2,1.372864,103.773219
677792,0,3,3,1.372899,103.77318
677793,8,41,49,1.372832,103.773394
677794,1,0,1,1.37166,103.773348
677795,7,16,23,1.372796,103.773448
677796,1,3,4,1.373015,103.773121
677797,5,285,290,1.372759,103.773503
677798,0,2,2,1.372869,103.773339
677799,0,2,2,1.372716,103.773453
677800,18,12,30,1.37267,103.773498
677801,5,706,711,1.372671,103.7736
677802,2,0,2,1.372718,103.773553
677803,229,6,235,1.372645,103.773621
677804,3,0,3,1.372813,103.773305
677805,1,1136,1137,1.372593,103.773663
677808,1,0,1,1.372784,103.773362
677809,7,331,338,1.372477,103.773725
677810,17,0,17,1.372441,103.773698
677811,0,4,4,1.37275,103.773407
677812,14,5,19,1.372372,103.773738
677813,2,186,188,1.372362,103.773788
677815,4,10,14,1.372304,103.773819
677816,1,8,9,1.371949,103.773957
677817,5,215,220,1.372246,103.77385
677818,13,5,18,1.371932,103.773917
677819,33,1,34,1.372188,103.773881
677820,1,1,2,1.372624,103.773538
677821,16,208,224,1.37213,103.773912
677822,14,3,17,1.371861,103.77376
677823,0,7,7,1.372073,103.773944
677824,0,1,1,1.372492,103.773664
677825,3,284,287,1.372015,103.773975
677826,49,0,49,1.37179,103.773602
677827,14,9,23,1.371967,103.773996
677828,16,0,16,1.371755,103.773524
677829,238,263,501,1.37193,103.77402
677830,19,1,20,1.371719,103.773445
677831,3,4,7,1.371902,103.774035
677832,11,5,16,1.371684,103.773366
677833,11,365,376,1.371847,103.774064
677834,3,739,742,1.371802,103.774083
677835,22,6,28,1.371931,103.773961
677836,1,0,1,1.371826,103.773681
677837,9,1,10,1.371884,103.773856
677838,3,1,4,1.37242,103.773757
677839,7,1,8,1.371821,103.773716
677840,95,2,97,1.37179,103.773646
677841,1,1,2,1.371896,103.773838
677842,29,4,33,1.371727,103.773506
677843,20,6,26,1.371695,103.773436
677845,0,6,6,1.373339,103.772458
677846,3,3,6,1.3732,103.772388
677847,7,7,14,1.372868,103.772275
677848,14,0,14,1.373246,103.772391
677849,4,6,10,1.372668,103.77227
677850,0,1,1,1.371916,103.773926
677851,2,2,4,1.371853,103.773786
677852,47,2,49,1.372967,103.772266
677853,0,1,1,1.373154,103.772344
677854,21,1,22,1.372768,103.77225
677855,5,2,7,1.372079,103.772435
677856,1,0,1,1.372371,103.772307
677858,119,1,120,1.37247,103.772269
677859,0,2,2,1.371758,103.773576
677860,2,0,2,1.371665,103.77268
677861,1,2,3,1.372584,103.773584
677863,2,13,15,1.371261,103.772915
677864,16,1,17,1.371929,103.772504
677865,52,1,53,1.371759,103.772604
677866,17,0,17,1.37159,103.772705
677867,2,1,3,1.371458,103.772803
677868,1,0,1,1.372569,103.772256
677899,3569,939,4508,1.37978,103.760383
677900,21,421,442,1.38015,103.761217
677901,161,1633,1794,1.380103,103.761103
677902,3,7,10,1.38021,103.761184
677903,38,41,79,1.380337,103.760152
677904,4,19,23,1.380262,103.761155
677905,0,7,7,1.380326,103.76113
677906,5,11,16,1.380393,103.761082
677907,3,3,6,1.380455,103.761051
677908,0,4,4,1.37247,103.772289
677909,5,33,38,1.381498,103.759841
677910,354,1791,2145,1.299509,103.837
677911,33,4562,4595,1.332989,103.843957
677912,0,7,7,1.381683,103.759759
677913,1,5,6,1.381804,103.759727
677914,0,3,3,1.37142,103.772805
677915,1,3,4,1.380524,103.761015
677916,9,24,33,1.380647,103.760957
677918,15,256,271,1.381054,103.760752
677919,256,10,266,1.382051,103.760326
677928,0,963,963,1.395061,103.753509
677929,32,402,434,1.395998,103.753562
677930,2,0,2,1.372277,103.77232
677931,1,0,1,1.371251,103.772905
677932,15,0,15,1.396316,103.753632
677934,1,0,1,1.396189,103.753604
677935,6,0,6,1.396699,103.753717
677937,3,2,5,1.396828,103.7537
677938,1,4,5,1.39684,103.753645
677939,5,81,86,1.396865,103.753536
677942,25,0,25,1.396914,103.753317
677943,18,2,20,1.396701,103.753466
677944,7,1,8,1.396938,103.753207
677946,10,695,705,1.39706,103.754171
677947,0,39,39,1.397134,103.754183
677948,1,23,24,1.39719,103.754198
677949,2,15,17,1.397252,103.754207
677950,0,17,17,1.397404,103.75424
677951,1,14,15,1.397472,103.754261
677952,0,11,11,1.397534,103.754266
677953,1,16,17,1.397602,103.754287
677954,2,25,27,1.397655,103.754299
677955,2,31,33,1.397708,103.754308
677956,2,75,77,1.397779,103.754323
677957,3,74,77,1.396907,103.753918
677958,1,0,1,1.396571,103.753689
677959,0,2,2,1.396061,103.753576
677960,1,0,1,1.396986,103.753661
677961,2,1,3,1.299509,103.837
677963,2,7,9,1.396836,103.753755
677965,5,0,5,1.397277,103.753949
677966,8,1,9,1.397291,103.753871
677969,34,0,34,1.397344,103.753563
677970,0,1,1,1.397028,103.753486
677971,2,0,2,1.397007,103.753568
677972,1,2,3,1.397074,103.753312
677973,0,2,2,1.397396,103.753294
677974,1,0,1,1.397383,103.753382
677975,0,1,1,1.397582,103.754034
677976,2,0,2,1.397572,103.75409
677977,1,0,1,1.397628,103.753776
677978,1,0,1,1.397643,103.753642
677979,0,1,1,1.397667,103.753533
677980,11,0,11,1.397687,103.75341
677981,4,0,4,1.380592,103.76098
677982,0,1,1,1.397684,103.753469
677983,0,2,2,1.397639,103.753698
677985,1,0,1,1.397734,103.753212
677987,2,0,2,1.397906,103.754254
677994,5,423,428,1.397957,103.754495
677995,4,1,5,1.397961,103.754453
678002,1,1,2,1.39785,103.753803
678003,1,2,3,1.397402,103.754172
678004,1,1,2,1.398133,103.753703
678005,15,1,16,1.398199,103.75342
678006,4,0,4,1.397698,103.753345
678007,1,0,1,1.397816,103.754019
678008,0,1,1,1.398233,103.753296
678009,2,0,2,1.398189,103.753468
678010,3,106,109,1.39824,103.754845
678011,1,27,28,1.299509,103.837
678012,4,119,123,1.381586,103.759801
678013,0,46,46,1.299509,103.837
678015,3,136,139,1.382443,103.759473
678016,0,3,3,1.398143,103.753636
678018,1,1,2,1.398295,103.753071
678020,1,0,1,1.398272,103.753139
678021,1,11,12,1.397317,103.754225
678023,2,1,3,1.397655,103.75359
678024,4,1,5,1.397055,103.753397
678025,1,2,3,1.396934,103.753824
678027,1,1,2,1.398072,103.754005
678028,0,4,4,1.398205,103.753381
678032,2,0,2,1.39761,103.753849
678033,1,2,3,1.397362,103.753457
678034,2,1,3,1.397992,103.754307
678037,0,1,1,1.396968,103.753731
678038,8,458,466,1.388801,103.756426
678039,0,136,136,1.411943,103.756992
678040,255,166,421,1.357758,103.76816
678041,2,10,12,1.357797,103.767967
678042,3,0,3,1.398122,103.753816
678043,2,12,14,1.35791,103.767881
678044,21,0,21,1.357985,103.767824
678045,29,0,29,1.358061,103.767766
678046,2,2,4,1.397723,103.753286
678047,4,22,26,1.358236,103.767689
678048,12,0,12,1.358335,103.76767
678049,17,59,76,1.358347,103.76783
678050,72,548,620,1.358485,103.76764
678051,122,1087,1209,1.358541,103.767633
678052,21,76,97,1.358596,103.767625
678053,89,39,128,1.358707,103.76761
678054,37,118,155,1.358818,103.767596
678056,23,84,107,1.358929,103.767581
678058,36,160,196,1.359041,103.767566
678060,21,130,151,1.359152,103.767551
678062,49,410,459,1.359263,103.767537
678063,81,375,456,1.359374,103.767522
678064,214,548,762,1.359483,103.767581
678065,50,260,310,1.359512,103.767504
678066,19,187,206,1.35954,103.7675
678067,7,90,97,1.359595,103.767493
678068,20,176,196,1.359649,103.767486
678069,15,73,88,1.359704,103.767479
678071,16,58,74,1.359814,103.767466
678072,17,93,110,1.359869,103.767459
678073,18,1,19,1.359923,103.767452
678076,15,64,79,1.360033,103.767438
678077,68,25,93,1.360088,103.767431
678078,5,8,13,1.360143,103.767424
678079,9,15,24,1.360198,103.767417
678080,2,20,22,1.360252,103.76741
678081,16,68,84,1.360307,103.767403
678082,5,9,14,1.360362,103.767397
678083,10,19,29,1.360417,103.76739
678084,5,9,14,1.360472,103.767383
678085,4,4,8,1.360526,103.767376
678086,5,2,7,1.360581,103.767369
678087,2,1,3,1.357834,103.767939
678091,13,343,356,1.361051,103.767383
678093,185,35,220,1.361962,103.767769
678095,187,6,193,1.361996,103.767519
678097,11,35,46,1.361974,103.767624
678099,204,5201,5405,1.361923,103.767981
678106,340,92,432,1.362408,103.767844
678116,616,522,1138,1.367872,103.766896
678117,149,349,498,1.369148,103.767475
678122,39,1227,1266,1.372311,103.763387
678123,5,232,237,1.371954,103.763255
678124,6,43,49,1.37198,103.763249
678125,3,77,80,1.372033,103.763238
678126,2,132,134,1.372085,103.763227
678127,4,288,292,1.372138,103.763216
678133,25,14,39,1.3724,103.763159
678134,5,0,5,1.372399,103.763158
678136,0,395,395,1.372399,103.763158
678138,11,21,32,1.373506,103.763909
678139,26,4,30,1.37351,103.764501
678142,9,452,461,1.372663,103.763103
678143,2,57,59,1.372715,103.763091
678144,6,84,90,1.372768,103.76308
678145,2,34,36,1.37282,103.763069
678147,8,236,244,1.372963,103.763161
678149,7,52,59,1.372978,103.763035
678150,2,39,41,1.37303,103.763024
678151,9,93,102,1.373083,103.763013
678152,14,438,452,1.373135,103.763001
678154,34,193,227,1.373214,103.762985
678155,5,0,5,1.373267,103.762974
678156,0,136,136,1.373266,103.762974
678157,14,63,77,1.37332,103.762964
678158,5,393,398,1.373372,103.762954
678159,38,848,886,1.373425,103.762944
678160,6,42,48,1.299509,103.837
678174,16,323,339,1.374966,103.76255
678176,0,13,13,1.37539,103.762476
678178,4,93,97,1.375804,103.762412
678181,200,356,556,1.37524,103.762884
678182,135,0,135,1.374688,103.762697
678183,120,0,120,1.37474,103.762688
678184,127,0,127,1.374793,103.762679
678185,282,0,282,1.374845,103.76267
678186,41,0,41,1.374898,103.762661
678187,99,3,102,1.37495,103.762652
678188,189,166,355,1.375003,103.762643
678189,122,6,128,1.375055,103.762634
678199,6,318,324,1.37558,103.762543
678200,1,101,102,1.375632,103.762533
678201,4,19,23,1.375685,103.762524
678202,12,31,43,1.376661,103.762267
678203,5,173,178,1.375737,103.762515
678205,168,699,867,1.376895,103.762529
678206,197,124,321,1.359759,103.767472
678207,226,650,876,1.37659,103.761815
678210,157,0,157,1.375107,103.762624
678211,761,233,994,1.299509,103.837
678212,136,26,162,1.369687,103.76749
678213,1569,6951,8520,1.378773,103.762012
678265,3105,2184,5289,1.377629,103.763707
678266,83,93,176,1.376702,103.763922
678267,2616,466,3082,1.376105,103.76368
678268,210,4926,5136,1.377941,103.763112
678269,779,5189,5968,1.377739,103.766628
678270,781,288,1069,1.378308,103.763892
678271,9,8,17,1.366555,103.774976
678272,1252,2197,3449,1.368654,103.77593
678273,911,115,1026,1.368654,103.77593
678274,1048,263,1311,1.368915,103.775413
678275,986,128,1114,1.369193,103.775897
678276,979,199,1178,1.368654,103.77593
678277,73,101,174,1.299509,103.837
678278,140,1397,1537,1.378446,103.763427
678295,181,3103,3284,1.376344,103.77097
678296,256,2615,2871,1.376145,103.771302
678355,1,2,3,1.360636,103.767362
678356,0,10,10,1.358086,103.768423
678357,28,2,30,1.358307,103.768701
678358,0,1,1,1.398305,103.753015
678359,1,2,3,1.358213,103.768712
678360,1,0,1,1.358109,103.768732
678361,1,0,1,1.358112,103.768771
678362,7,0,7,1.358115,103.76881
678363,32,1,33,1.35886,103.768648
678364,75,0,75,1.35812,103.768888
678365,0,4,4,1.358136,103.767709
678366,4,1,5,1.358126,103.768966
678368,0,1,1,1.358682,103.768659
678369,39,5,44,1.358288,103.769014
678370,235,0,235,1.358133,103.769076
678371,1,0,1,1.358132,103.769044
678372,22,1,23,1.358134,103.769107
678373,0,1,1,1.358361,103.769003
678374,1,0,1,1.358434,103.768993
678375,1,0,1,1.358136,103.76917
678376,0,1,1,1.359113,103.768813
678378,1,0,1,1.35923,103.76891
678380,1,0,1,1.359331,103.769067
678382,1,1,2,1.397974,103.754382
678383,3,4,7,1.358871,103.768932
678384,16,1,17,1.358944,103.768921
678415,2,0,2,1.358798,103.768942
678416,0,2,2,1.359162,103.768146
678417,1,0,1,1.358725,103.768952
678420,2,0,2,1.359149,103.768492
678421,1,0,1,1.359173,103.768206
678423,24,0,24,1.359381,103.768861
678424,12,1,13,1.35946,103.768968
678425,52,0,52,1.359489,103.769012
678460,6,0,6,1.360379,103.768353
678461,3,0,3,1.358494,103.76868
678463,1,0,1,1.359259,103.768664
678493,18,7,25,1.367851,103.769632
678494,10,0,10,1.367872,103.769661
678496,7,0,7,1.367943,103.769692
678497,4,1,5,1.368,103.769697
678498,5,10,15,1.368086,103.769755
678499,6,1,7,1.3681,103.769741
678500,23,2,25,1.368228,103.769817
678501,3,2,5,1.368199,103.769785
678502,4,0,4,1.358178,103.769029
678503,3,0,3,1.360599,103.768348
678504,7,1,8,1.368512,103.769942
678506,13,2,15,1.368655,103.770005
678507,14,5,19,1.368498,103.769916
678508,12,216,228,1.368787,103.770057
678509,2,0,2,1.359236,103.768567
678510,0,12,12,1.368697,103.770003
678511,2,14,16,1.368797,103.770047
678541,54,4,58,1.359775,103.768549
678542,2,4,6,1.359708,103.768046
678543,0,8,8,1.359795,103.768631
678545,95,3,98,1.359875,103.768687
678546,1,1,2,1.368598,103.76996
678547,2,1,3,1.368299,103.769828
678548,5,1,6,1.359732,103.768418
678549,9,0,9,1.360941,103.768829
678551,76,11,87,1.361058,103.768816
678552,0,1,1,1.360838,103.768389
678553,7,3,10,1.359795,103.768651
678554,1,3,4,1.36837,103.76988
678555,1,1,2,1.359721,103.768353
678558,8,1,9,1.360341,103.768781
678559,0,1,1,1.359755,103.768549
678560,4,1,5,1.360559,103.768806
678561,6,4,10,1.360668,103.768818
678562,2,0,2,1.360056,103.76874
678563,57,2,59,1.360886,103.768843
678565,1,4,5,1.361068,103.768826
678595,0,9,9,1.368133,103.768958
678596,3,0,3,1.360559,103.768786
678597,1,0,1,1.36045,103.768793
678600,2,2,4,1.359935,103.768718
678601,6,3,9,1.367852,103.76951
678602,63,4,67,1.367801,103.76961
678603,3,25,28,1.367776,103.769659
678604,1,10,11,1.36775,103.769708
678605,2,12,14,1.367699,103.769806
678606,20,4,24,1.367534,103.769222
678607,33,0,33,1.367517,103.769231
678608,1,1,2,1.360777,103.76883
678609,1,0,1,1.368057,103.769109
678610,12,1,13,1.367612,103.769226
678611,137,1,138,1.36761,103.769226
678613,26,4,30,1.367559,103.769334
678614,21,0,21,1.367558,103.769333
678615,2,0,2,1.367638,103.769173
678616,7,11,18,1.367506,103.76944
678617,168,43,211,1.367454,103.769549
678618,16,1,17,1.367453,103.769548
678620,14,7,21,1.367402,103.769656
678621,6,0,6,1.3674,103.769656
678622,18,2,20,1.367349,103.769764
678623,5,0,5,1.367348,103.769763
678625,11,2,13,1.367588,103.769891
678626,242,5,247,1.367587,103.76989
678627,13,1,14,1.367538,103.769867
678628,13,2,15,1.367537,103.769866
678631,1,1,2,1.367506,103.769442
678633,6,0,6,1.367349,103.769784
678634,56,2,58,1.367348,103.769783
678636,14,0,14,1.367339,103.769774
678637,1,0,1,1.367637,103.769172
678639,2,8,10,1.367306,103.76976
678642,2,3,5,1.367801,103.76963
678643,0,12,12,1.367658,103.769914
678671,0,3,3,1.368108,103.769008
678672,13,3,16,1.392378,103.756276
678701,38,17,55,1.367583,103.770175
678703,2,0,2,1.367438,103.76982
678704,13,8,21,1.367854,103.770336
678705,1,0,1,1.367338,103.769773
678706,35,8,43,1.36801,103.770412
678707,3,0,3,1.394104,103.759362
678708,0,2,2,1.36777,103.770272
678710,2,1,3,1.36802,103.770402
678711,2,0,2,1.368072,103.770425
678712,15,4,19,1.368435,103.770587
678713,0,1,1,1.367895,103.770337
678714,8,2,10,1.368062,103.771119
678716,2,0,2,1.368331,103.770541
678717,0,15,15,1.36802,103.770422
678718,0,2,2,1.367882,103.770793
678719,14,2,16,1.368193,103.770499
678721,18,0,18,1.368529,103.770643
678722,15,0,15,1.367604,103.770206
678725,14,0,14,1.367603,103.770205
678726,2,0,2,1.368107,103.77046
678727,18,0,18,1.367603,103.770205
678728,39,0,39,1.367603,103.770205
678729,2,0,2,1.367603,103.770205
678730,9,0,9,1.367686,103.770248
678731,29,0,29,1.367603,103.770205
678732,4,25,29,1.367603,103.770205
678733,10,2,12,1.367957,103.770484
678734,5,0,5,1.367924,103.770584
678751,1,101,102,1.357563,103.769109
678752,7,3,10,1.357695,103.768821
678753,3,0,3,1.368228,103.770494
678754,1,1,2,1.367687,103.770249
678756,6,2,8,1.3577,103.769099
678758,0,1,1,1.368539,103.770633
678759,0,2,2,1.357694,103.768961
678763,0,3,3,1.357692,103.768884
678764,9,1,10,1.357958,103.768531
678766,16,1,17,1.357786,103.768633
678767,51,0,51,1.358504,103.768364
678769,1,3,4,1.367903,103.769409
678770,0,1,1,1.3577,103.769245
678771,16,0,16,1.358086,103.768423
678772,0,1,1,1.35867,103.768296
678774,11,3,14,1.358642,103.768144
678776,64,5,69,1.358153,103.768371
678777,0,3,3,1.357608,103.768772
678778,3,0,3,1.358742,103.768134
678780,2,0,2,1.3577,103.769302
678781,2,7,9,1.359142,103.768096
678782,1,1,2,1.358266,103.768288
678783,12,2,14,1.359373,103.768115
678784,0,3,3,1.358209,103.76833
678785,0,2,2,1.358322,103.768246
678786,37,0,37,1.358407,103.768184
678787,0,1,1,1.358705,103.768326
678788,0,3,3,1.358379,103.768205
678789,0,1,1,1.359819,103.768053
678790,3,146,149,1.358532,103.768143
678792,6,211,217,1.358592,103.768128
678793,0,3,3,1.358472,103.768141
678794,19,12,31,1.358642,103.768123
678795,1,0,1,1.35992,103.76805
678796,0,13,13,1.358742,103.768114
678798,0,1,1,1.360223,103.768041
678799,0,2,2,1.359768,103.768054
678800,0,4,4,1.357993,103.768486
678801,12,0,12,1.360525,103.768031
678802,3,1,4,1.358942,103.768095
678803,32,2,34,1.360626,103.768028
678804,0,1,1,1.358842,103.768104
678805,11,4,15,1.360727,103.768025
678806,7,0,7,1.35919,103.768073
678807,142,2,144,1.360828,103.768022
678808,17,4,21,1.359238,103.768069
678809,1,0,1,1.359132,103.768086
678811,23,2,25,1.360929,103.768019
678812,7,0,7,1.35943,103.768056
678813,1,0,1,1.360929,103.768019
678815,3,0,3,1.360122,103.768044
678816,5,0,5,1.359708,103.768046
678817,108,0,108,1.359768,103.768034
678818,2,1,3,1.359622,103.768043
678819,4,0,4,1.359042,103.768086
678820,13,1,14,1.360021,103.768027
678821,10,0,10,1.360122,103.768024
678823,25,0,25,1.360324,103.768018
678825,1,0,1,1.361148,103.768064
678827,110,0,110,1.360626,103.768008
678828,8,0,8,1.360727,103.768005
678829,4,2,6,1.360828,103.768002
678830,5,0,5,1.360929,103.767999
678831,1,0,1,1.360525,103.768011
678832,2,0,2,1.360424,103.768034
678833,182,1,183,1.361209,103.76806
678834,8,2,10,1.361199,103.76807
678863,17,3975,3992,1.371621,103.764117
678864,5,42,47,1.371642,103.76412
678865,1,2,3,1.359819,103.768033
678866,1,6,7,1.371654,103.764154
678867,1,1,2,1.361148,103.768044
678868,1,5,6,1.371677,103.764223
678869,1,2,3,1.371632,103.764148
678870,0,10,10,1.3717,103.764291
678871,5,2,7,1.371694,103.764333
678872,6,2,8,1.371723,103.764359
678873,2,1,3,1.371673,103.764271
678874,5,6,11,1.371746,103.764428
678875,12,1,13,1.371735,103.764456
678876,0,4,4,1.35992,103.76803
678877,2,2,4,1.371769,103.764496
678878,14,5,19,1.371791,103.764564
678879,2,0,2,1.371652,103.764209
678880,7,8,15,1.371814,103.764633
678881,0,2,2,1.371776,103.764579
678882,13,9,22,1.371837,103.764701
678884,1,3,4,1.371756,103.764518
678885,2,0,2,1.371797,103.764641
678886,3,41,44,1.371883,103.764838
678887,2,1,3,1.371714,103.764394
678888,2,4,6,1.371906,103.764906
678889,5,2,7,1.37188,103.764888
678890,12,6,18,1.371929,103.764974
678891,14,1,15,1.371901,103.764949
678892,1,11,12,1.371952,103.765043
678893,2,0,2,1.371839,103.764764
678894,2,14,16,1.371975,103.765111
678895,3,0,3,1.371859,103.764826
678896,0,10,10,1.371998,103.765179
678897,1,3,4,1.37186,103.764769
678898,2,5,7,1.372021,103.765248
678899,1,1,2,1.371921,103.765011
678900,1,7,8,1.372044,103.765316
678901,6,1,7,1.372004,103.765258
678902,0,7,7,1.372066,103.765384
678904,0,4,4,1.371963,103.765134
678905,7,1,8,1.372045,103.765381
678906,0,7,7,1.372112,103.765521
678907,17,2,19,1.372066,103.765442
678908,4,2,6,1.372135,103.765589
678909,6,0,6,1.372087,103.765504
678910,0,7,7,1.372158,103.765657
678912,47,14,61,1.372181,103.765726
678913,2,0,2,1.371983,103.765196
678914,0,5,5,1.372204,103.765794
678915,8,0,8,1.372149,103.765689
678916,17,5,22,1.372227,103.765862
678917,0,5,5,1.372169,103.765751
678918,35,10,45,1.37225,103.765931
678919,2,0,2,1.372128,103.765627
678920,5,10,15,1.372273,103.765999
678921,0,2,2,1.37219,103.765812
678922,75,11,86,1.372296,103.766067
678923,4,0,4,1.372089,103.765452
678924,14,4,18,1.372319,103.766136
678925,1,1,2,1.372211,103.765874
678926,6,14,20,1.372341,103.766204
678927,1,2,3,1.371942,103.765073
678928,1,0,1,1.360929,103.767999
678929,16,0,16,1.372294,103.766121
678930,86,2,88,1.372387,103.766341
678931,1,0,1,1.372364,103.766272
678932,0,18,18,1.37241,103.766409
678933,6,1,7,1.372335,103.766244
678934,5,2,7,1.372433,103.766477
678936,6,34,40,1.372456,103.766546
678938,4,3,7,1.372469,103.766604
678940,1,0,1,1.372314,103.766182
678941,2,0,2,1.372252,103.765997
678942,1,1,2,1.372438,103.766552
678943,92,22,114,1.372168,103.764086
678944,335,88,423,1.372783,103.764543
678945,26,0,26,1.373439,103.765098
678946,1430,140,1570,1.373954,103.765223
678947,101,21,122,1.373687,103.7657
678948,1636,267,1903,1.373154,103.765727
678949,1143,184,1327,1.372564,103.765302
678950,379,14,393,1.372422,103.764716
678972,9,91,100,1.375887,103.764493
678973,582,547,1129,1.376672,103.765814
679002,449,307,756,1.37957,103.769301
679003,76,2642,2718,1.383472,103.769374
679004,609,7543,8152,1.38452,103.770858
679005,1,80,81,1.385118,103.771201
679033,110,322,432,1.363566,103.768426
679034,11,992,1003,1.363347,103.768218
679035,107,159,266,1.363574,103.768487
679036,304,70,374,1.36401,103.769491
679037,377,48,425,1.36446,103.769488
679038,564,112,676,1.364724,103.76927
679039,1,59,60,1.363448,103.769591
679040,151,74,225,1.364536,103.768717
679041,301,36,337,1.365159,103.768875
679042,224,42,266,1.365439,103.769242
679043,785,69,854,1.365277,103.769724
679044,580,197,777,1.365472,103.770013
679045,324,132,456,1.366026,103.769819
679046,176,16,192,1.366097,103.770208
679047,165,19,184,1.365799,103.770468
679048,175,28,203,1.365105,103.770708
679049,357,40,397,1.364525,103.770998
679050,87,78,165,1.364358,103.770656
679051,780,95,875,1.3648,103.770422
679052,553,105,658,1.364753,103.770096
679053,377,213,590,1.363954,103.770473
679057,58,294,352,1.364661,103.773799
679058,36,2,38,1.362296,103.769899
679059,65,284,349,1.360467,103.776973
679060,9,109,118,1.299509,103.837
679061,10,46,56,1.299509,103.837
679086,105,24,129,1.367333,103.770088
679087,19,0,19,1.367333,103.770088
679088,36,1,37,1.367333,103.770088
679089,71,2,73,1.367333,103.770088
679090,37,64,101,1.365011,103.768561
679119,30,0,30,1.367652,103.768523
679120,61,16,77,1.367652,103.768503
679121,0,3,3,1.372273,103.766059
679122,13,47,60,1.367625,103.768522
679123,2,1,3,1.367568,103.768581
679124,2,1,3,1.3674,103.768698
679125,2,1,3,1.367571,103.768559
679126,12,0,12,1.367517,103.768597
679127,0,2,2,1.372459,103.766614
679128,18,10,28,1.367463,103.768634
679130,18,9,27,1.367409,103.768672
679131,3,5,8,1.367022,103.769226
679132,19,0,19,1.367355,103.768709
679134,0,1,1,1.372418,103.766491
679137,9,0,9,1.367084,103.768897
679138,1,0,1,1.367246,103.768784
679139,1,1,2,1.367063,103.768931
679140,15,1,16,1.366922,103.769009
679141,8,0,8,1.366913,103.769076
679174,0,22,22,1.367276,103.768088
679175,6,39,45,1.367272,103.76807
679176,26,12,38,1.367242,103.76811
679177,41,167,208,1.367236,103.768095
679178,1,1,2,1.366976,103.768972
679179,1,0,1,1.36703,103.768934
679180,0,5,5,1.367109,103.768201
679181,1,0,1,1.367162,103.768145
679182,2,0,2,1.367176,103.768156
679183,5,0,5,1.367016,103.768244
679184,37,1,38,1.366976,103.768291
679186,7,0,7,1.366909,103.768337
679187,16,1,17,1.366869,103.768344
679188,2,1,3,1.367231,103.768815
679190,7,0,7,1.366776,103.768427
679191,13,2,15,1.366723,103.768443
679192,29,2,31,1.366709,103.768472
679193,120,2,122,1.366649,103.768493
679194,2,2,4,1.372231,103.765936
679195,2,4,6,1.366576,103.768543
679196,0,2,2,1.367042,103.768246
679227,2,10,12,1.368876,103.769235
679230,15,2,17,1.368991,103.768979
679231,8,0,8,1.368932,103.769121
679232,0,3,3,1.366843,103.768382
679233,0,1,1,1.367089,103.768194
679234,15,3,18,1.369124,103.768704
679235,86,5,91,1.369006,103.768968
679236,12,3,15,1.36918,103.768577
679237,40,1,41,1.369042,103.768892
679238,24,1,25,1.36917,103.768576
679239,23,1,24,1.369079,103.768816
679241,6,5,11,1.369116,103.768739
679242,42,0,42,1.36911,103.768544
679243,5,0,5,1.369153,103.768663
679244,3,0,3,1.369057,103.768841
679245,9,1,10,1.36919,103.768587
679246,106,12,118,1.369031,103.768502
679247,20,0,20,1.369205,103.768557
679248,5,2,7,1.368991,103.76848
679249,5,0,5,1.369219,103.768527
679250,20,1,21,1.368951,103.768459
679251,1,0,1,1.368969,103.769044
679252,1,0,1,1.369249,103.768468
679253,1,0,1,1.368912,103.768438
679254,0,1,1,1.369278,103.768408
679255,2,0,2,1.366586,103.768553
679287,635,1026,1661,1.366297,103.767594
679288,1,1,2,1.369308,103.768348
679289,85,7,92,1.368213,103.768958
679290,3,9,12,1.368858,103.769253
679291,2,7,9,1.368267,103.768988
679292,13,5,18,1.368374,103.769049
679293,16,0,16,1.368428,103.769079
679294,8,7,15,1.368572,103.769151
679295,2,0,2,1.368169,103.768918
679296,2,7,9,1.368801,103.769249
679298,0,2,2,1.368686,103.7692
679299,2,0,2,1.368858,103.769273
679300,9,20,29,1.369386,103.769539
679301,906,1,907,1.36867,103.770848
679303,31,2,33,1.369646,103.769848
679304,221,65,286,1.369766,103.770021
679305,39,0,39,1.369885,103.770194
679306,2,6,8,1.370005,103.770366
679307,29,19,48,1.370115,103.770529
679308,2,8,10,1.370309,103.770817
679309,3,1,4,1.366643,103.768518
679310,4,1,5,1.370903,103.771135
679311,34,4,38,1.371078,103.771206
679312,5,4,9,1.371253,103.771278
679313,19,7,26,1.371428,103.771401
679314,104,8,112,1.370182,103.770736
679315,26,0,26,1.371632,103.771632
679316,0,1,1,1.368872,103.768417
679318,10,11,21,1.370887,103.771242
679320,16,1,17,1.370839,103.771564
679321,15,2,17,1.370806,103.771779
679322,1,3,4,1.370601,103.770971
679323,27,1,28,1.3707,103.772433
679324,94,13,107,1.370903,103.771155
679325,24,0,24,1.371253,103.771298
679326,55,13,68,1.371816,103.771862
679327,7,1,8,1.369497,103.768716
679328,7,0,7,1.369366,103.769045
679329,1,2,3,1.369071,103.768523
679330,20,193,213,1.36602,103.767465
679331,107,6,113,1.367748,103.768145
679332,8,1,9,1.299509,103.837
679356,21,10,31,1.370375,103.770729
679357,5,1,6,1.370309,103.770817
679359,16,4,20,1.37068,103.770437
679360,0,5,5,1.371273,103.770681
679361,26,0,26,1.370748,103.770405
679362,5,13,18,1.371368,103.770736
679363,1,1,2,1.36903,103.769358
679364,5,3,8,1.371452,103.770782
679365,1,3,4,1.371387,103.771672
679366,15,0,15,1.371621,103.770873
679367,8,0,8,1.37162,103.770872
679369,83,3,86,1.37178,103.770954
679370,12,0,12,1.3713,103.77068
679371,47,2,49,1.371883,103.77077
679372,5,6,11,1.371544,103.770103
679373,18,3,21,1.371306,103.770683
679374,1,0,1,1.370669,103.771088
679375,7,0,7,1.371329,103.770696
679377,15,2,17,1.371835,103.769766
679378,9,7,16,1.371967,103.770224
679379,10,0,10,1.372079,103.769679
679380,0,2,2,1.370917,103.770457
679381,12,0,12,1.372256,103.76983
679382,12,0,12,1.372288,103.770494
679384,35,0,35,1.372516,103.770643
679385,0,1,1,1.371724,103.769891
679386,2,0,2,1.372128,103.77039
679387,64,2,66,1.372783,103.770372
679388,40,0,40,1.372548,103.771082
679389,8,2,10,1.372903,103.770491
679390,0,39,39,1.373178,103.770676
679391,103,5,108,1.37239,103.77128
679392,25,1,26,1.372977,103.770813
679393,1,0,1,1.37258,103.770245
679394,34,0,34,1.373009,103.770998
679396,75,3,78,1.373003,103.771478
679398,14,10,24,1.371884,103.771639
679399,8,3,11,1.372593,103.771681
679400,22,0,22,1.371816,103.771862
679401,19,1,20,1.372356,103.771782
679402,18,12,30,1.372198,103.771862
679404,7,6,13,1.371714,103.771929
679405,6,7,13,1.371603,103.771986
679406,15,2,17,1.37138,103.7721
679407,1,1,2,1.372622,103.770807
679409,20,2,22,1.37072,103.772433
679410,11,0,11,1.370563,103.772475
679411,47,2,49,1.37071,103.772443
679412,19,0,19,1.370409,103.772614
679413,3,2,5,1.370118,103.772775
679414,0,4,4,1.3711,103.770564
679415,10,1,11,1.370604,103.770495
679443,5,0,5,1.369938,103.771943
679444,9,10,19,1.370185,103.771881
679445,0,5,5,1.369699,103.771912
679446,5,4,9,1.370193,103.771809
679447,1,1,2,1.371156,103.772215
679448,35,1,36,1.369457,103.771752
679449,54,5,59,1.369572,103.772498
679450,0,1,1,1.372242,103.771321
679451,0,1,1,1.369329,103.772041
679452,0,1,1,1.369543,103.77293
679453,13,1,14,1.369523,103.773353
679454,4,0,4,1.372112,103.771512
679455,14,0,14,1.369337,103.772672
679456,123,6,129,1.369363,103.772939
679457,32,0,32,1.369366,103.773221
679487,101,1,102,1.37029,103.770957
679488,1,1,2,1.369602,103.772065
679489,7,10,17,1.370274,103.771102
679490,11,4,15,1.370267,103.77114
679491,8,1,9,1.370242,103.771393
679492,35,0,35,1.369518,103.771412
679493,2,4,6,1.370209,103.771683
679495,6,10,16,1.370187,103.771964
679496,12,5,17,1.370166,103.772089
679497,108,10,118,1.370176,103.771983
679498,17,10,27,1.370154,103.772224
679500,14,8,22,1.370131,103.772495
679501,12,1,13,1.370174,103.772009
679502,1,0,1,1.36934,103.772229
679503,30,9,39,1.370098,103.772775
679504,7,2,9,1.369898,103.773077
679505,3,5,8,1.370118,103.772775
679514,72,214,286,1.371593,103.77715
679516,292,84,376,1.3725,103.782747
679517,1292,832,2124,1.369833,103.77604
679518,691,104,795,1.369808,103.777141
679519,349,305,654,1.370098,103.776352
679520,559,189,748,1.370289,103.776655
679521,947,167,1114,1.370588,103.777111
679522,796,40,836,1.371208,103.776544
679523,422,384,806,1.370614,103.775702
679524,554,702,1256,1.299509,103.837
679525,9,15,24,1.299509,103.837
679539,13,115,128,1.37033,103.765574
679540,1,104,105,1.370344,103.765587
679541,0,4,4,1.36912,103.772434
679542,1,0,1,1.370098,103.772775
679543,4,1,5,1.370471,103.765505
679545,0,3,3,1.369302,103.769462
679546,16,0,16,1.370646,103.765439
679548,4,0,4,1.370377,103.765551
679549,0,8,8,1.370754,103.765366
679551,0,2,2,1.37029,103.770937
679552,0,512,512,1.370943,103.765273
679553,0,3,3,1.370566,103.765458
679554,3,773,776,1.371037,103.765227
679555,18,2,20,1.371276,103.765794
679556,13,4,17,1.371121,103.765191
679557,1,0,1,1.370404,103.765558
679558,4,0,4,1.370768,103.765379
679559,0,2,2,1.37101,103.76526
679561,5,0,5,1.370796,103.766058
679562,1,99,100,1.370689,103.766117
679563,1,4,5,1.371155,103.765233
679564,11,148,159,1.370915,103.766129
679565,4,0,4,1.371116,103.765882
679566,3,0,3,1.371131,103.765201
679567,6,0,6,1.371198,103.765358
679568,10,16,26,1.371063,103.766042
679569,0,4,4,1.371169,103.765274
679570,9,12,21,1.371115,103.766002
679572,1,3,4,1.371226,103.765441
679573,1,0,1,1.371222,103.765824
679574,1,14,15,1.371253,103.765933
679575,1,0,1,1.371282,103.765608
679576,5,0,5,1.371345,103.765841
679578,3,13,16,1.371372,103.765906
679579,3,0,3,1.370997,103.766085
679580,0,10,10,1.371424,103.766038
679581,0,1,1,1.371311,103.765692
679582,0,38,38,1.371477,103.766169
679583,2,0,2,1.371009,103.765941
679584,2,104,106,1.371529,103.766301
679585,14,2,16,1.371439,103.766026
679586,3,106,109,1.371582,103.766432
679588,26,0,26,1.371634,103.766564
679589,4,0,4,1.371188,103.76597
679590,22,290,312,1.371687,103.766695
679591,0,5,5,1.37154,103.766277
679592,2,1,3,1.371356,103.765817
679593,2,0,2,1.371406,103.765942
679594,29,1,30,1.37164,103.766528
679596,0,1,1,1.371372,103.765859
679597,1,0,1,1.371697,103.766685
679598,1,7,8,1.371707,103.766695
679599,2,0,2,1.371607,103.766444
679600,1,7,8,1.371593,103.766767
679603,27,109,136,1.37129,103.766942
679633,132,203,335,1.371371,103.767659
679634,1,50,51,1.371673,103.767443
679635,176,51,227,1.370943,103.767459
679636,1,0,1,1.371882,103.766583
679637,340,101,441,1.370652,103.767527
679638,1,0,1,1.371678,103.767439
679639,188,5,193,1.370261,103.767745
679640,1,1,2,1.371645,103.766736
679641,58,2,60,1.369981,103.768108
679642,0,1,1,1.371688,103.767431
679643,0,1,1,1.371708,103.767416
679644,171,34,205,1.371563,103.768023
679645,90,10,100,1.371054,103.76804
679646,87,8,95,1.370053,103.768348
679647,20,6,26,1.371767,103.767368
679648,1,1,2,1.371698,103.767423
679650,5,112,117,1.371796,103.767345
679651,2,36,38,1.371806,103.767337
679652,3,98,101,1.372591,103.768624
679653,4,186,190,1.371816,103.767329
679654,1,128,129,1.37265,103.768722
679656,127,91,218,1.373055,103.768236
679658,196,21,217,1.372821,103.767893
679659,0,50,50,1.372813,103.769056
679660,255,76,331,1.372646,103.767555
679661,0,45,45,1.372838,103.769118
679662,495,75,570,1.372762,103.767008
679663,3,0,3,1.371573,103.76636
679664,904,64,968,1.373109,103.766708
679666,603,48,651,1.373611,103.766423
679668,967,209,1176,1.374059,103.766313
679669,3,0,3,1.372858,103.769172
679670,1124,272,1396,1.374674,103.767271
679671,2,0,2,1.371777,103.767361
679672,435,110,545,1.374068,103.767667
679673,1,0,1,1.371717,103.767408
679674,280,124,404,1.373673,103.768015
679675,21,7,28,1.37352,103.767503
679676,214,62,276,1.37293,103.769259
679677,13,393,406,1.372503,103.768478
679678,1,34,35,1.372532,103.768527
679680,0,1,1,1.373039,103.769654
679683,0,1,1,1.373119,103.769869
679684,0,1,1,1.37324,103.770191
679685,0,96,96,1.37332,103.770406
679687,1,42,43,1.373401,103.77062
679688,0,40,40,1.373441,103.770728
679689,0,43,43,1.373481,103.770835
679690,0,5,5,1.373521,103.770942
679691,1,80,81,1.299509,103.837
679692,62,444,506,1.369668,103.76489
679693,182,16,198,1.369149,103.765408
679694,2,256,258,1.299509,103.837
679695,103,477,580,1.368749,103.765586
679696,491,1041,1532,1.299509,103.837
679697,358,362,720,1.370527,103.766753
679698,0,18,18,1.299509,103.837
679706,72,9,81,1.370816,103.768688
679708,15,14,29,1.370847,103.76874
679709,2,1,3,1.372959,103.76944
679710,1,1,2,1.372999,103.769547
679711,3,6,9,1.371032,103.769056
679712,2,0,2,1.37097,103.768951
679713,31,1,32,1.371155,103.769266
679714,1,0,1,1.37328,103.770298
679715,7,0,7,1.371278,103.769477
679716,3,10,13,1.37134,103.769582
679746,2,0,2,1.371093,103.769161
679747,1,228,229,1.372439,103.768444
679749,9,78,87,1.372406,103.768465
679750,1,3,4,1.371506,103.766193
679751,1,46,47,1.372339,103.768509
679752,4,2,6,1.372018,103.768549
679753,2,16,18,1.372281,103.768511
679754,2,0,2,1.372375,103.768507
679755,0,7,7,1.372206,103.768517
679756,10,0,10,1.371589,103.768598
679757,11,1,12,1.372132,103.768523
679759,4,1,5,1.372057,103.768528
679760,3,1,4,1.372162,103.768557
679761,1,2,3,1.370908,103.768845
679762,2,6,8,1.37104,103.768627
679763,1,1,2,1.371771,103.768577
679764,3,1,4,1.371148,103.768615
679765,0,2,2,1.371908,103.76854
679766,1,6,7,1.370116,103.768766
679767,0,2,2,1.371832,103.768544
679768,7,0,7,1.370143,103.76881
679769,1,4,5,1.371682,103.768549
679770,4,1,5,1.370196,103.768899
679771,0,3,3,1.371982,103.768534
679773,11,1,12,1.371537,103.768561
679774,2,0,2,1.371757,103.768549
679775,0,4,4,1.370923,103.768635
679776,6,3,9,1.370357,103.769166
679777,17,5,22,1.371383,103.768571
679778,26,0,26,1.370411,103.769256
679779,0,2,2,1.370303,103.769077
679780,32,1,33,1.370464,103.769345
679781,6,3,9,1.371234,103.76859
679782,13,1,14,1.370518,103.769434
679783,9,5,14,1.371158,103.768601
679784,0,1,1,1.371217,103.769372
679785,10,8,18,1.371084,103.768605
679786,1,0,1,1.370571,103.769523
679787,1,9,10,1.371011,103.76861
679788,41,0,41,1.370678,103.769701
679789,9,6,15,1.370934,103.768619
679790,1,8,9,1.370722,103.76978
679791,1,7,8,1.37086,103.768625
679792,2,18,20,1.371372,103.769552
679793,2,2,4,1.371457,103.768565
679794,1,40,41,1.371393,103.769532
679795,1,3,4,1.370795,103.768624
679797,65,0,65,1.370715,103.768635
679798,1,1,2,1.371308,103.768577
679799,4,1,5,1.370636,103.768644
679801,4,12,16,1.370556,103.768654
679802,46,2,48,1.371567,103.769371
679803,19,12,31,1.370477,103.768663
679804,0,36,36,1.3721,103.768981
679805,0,3,3,1.371599,103.768556
679806,5,0,5,1.371632,103.769311
679807,1,3,4,1.370755,103.76863
679808,7,0,7,1.371687,103.769275
679809,3,1,4,1.370318,103.768682
679810,3,0,3,1.370397,103.768673
679811,1,0,1,1.370625,103.769612
679812,2,3,5,1.370079,103.768711
679813,1,0,1,1.371806,103.769216
679814,21,0,21,1.369944,103.768479
679815,28,0,28,1.371903,103.769197
679818,6,0,6,1.369986,103.76856
679819,52,0,52,1.370013,103.768613
679820,4,0,4,1.370238,103.768692
679821,75,0,75,1.370069,103.768721
679822,84,2,86,1.370085,103.768748
679823,3,0,3,1.371745,103.769243
679824,2,1,3,1.370101,103.768774
679825,2,1,3,1.370133,103.768828
679826,0,2,2,1.37148,103.769452
679827,2,0,2,1.370198,103.768935
679828,5,0,5,1.370262,103.769042
679829,4,0,4,1.370041,103.768667
679830,0,1,1,1.371838,103.76921
679831,1,3,4,1.370294,103.769095
679832,0,3,3,1.370165,103.768881
679833,25,0,25,1.370423,103.769309
679834,0,1,1,1.370326,103.769149
679835,4,5,9,1.370487,103.769416
679836,0,5,5,1.370519,103.769469
679837,4,8,12,1.370551,103.769523
679838,84,7,91,1.370583,103.769576
679839,5,1,6,1.370616,103.76963
679840,0,1,1,1.370455,103.769362
679841,2,2,4,1.370358,103.769202
679842,17,0,17,1.370712,103.76979
679843,1,4,5,1.370832,103.769781
679845,1,5,6,1.371051,103.769742
679846,2,4,6,1.37122,103.769697
679847,3,1,4,1.37068,103.769737
679848,22,0,22,1.371381,103.769563
679849,63,2,65,1.371413,103.769534
679851,0,9,9,1.371538,103.769418
679852,12,0,12,1.371601,103.76936
679853,28,13,41,1.371674,103.769304
679854,27,0,27,1.371715,103.769277
679855,15,2,17,1.371806,103.769236
679856,1,0,1,1.370648,103.769683
679857,17,2,19,1.371944,103.769213
679858,28,3,31,1.372026,103.769205
679859,4,1,5,1.372108,103.769198
679860,4,0,4,1.37135,103.769592
679861,2,0,2,1.37023,103.768988
679862,15,1,16,1.372355,103.769174
679863,10,6,16,1.372437,103.769167
679864,0,1,1,1.371903,103.769217
679866,10,2,12,1.372224,103.768546
679867,11,2,13,1.372098,103.768551
679868,48,2,50,1.371682,103.768589
679869,1,1,2,1.372273,103.769182
679870,4,1,5,1.371473,103.768614
679871,1,0,1,1.372519,103.769159
679872,0,1,1,1.371302,103.768596
679873,14,7,21,1.370982,103.768633
679874,10,2,12,1.370854,103.76864
679875,1,7,8,1.370078,103.76871
679876,42,11,53,1.370078,103.76871
679877,1,0,1,1.371106,103.768622
679878,4,0,4,1.372191,103.76919
679879,1,0,1,1.372018,103.769186
679880,23,0,23,1.372189,103.76917
679881,15,0,15,1.372247,103.769165
679882,0,2,2,1.371787,103.76873
679883,0,1,1,1.372132,103.769175
679884,18,1,19,1.372766,103.769136
679885,13,1,14,1.372848,103.769128
679886,0,2,2,1.372601,103.769151
679887,1,0,1,1.372684,103.769143
679889,1,0,1,1.372304,103.769159
679890,62,23,85,1.372476,103.769143
679891,3,5,8,1.372533,103.769138
679892,7,3,10,1.37259,103.769132
679893,1,5,6,1.372648,103.769127
679910,6,0,6,1.381563,103.764661
679938,170,144,314,1.38206,103.773836
679939,565,4100,4665,1.380071,103.772664
679940,770,4967,5737,1.38778,103.769652
679941,235,3171,3406,1.386702,103.764543
679942,325,3026,3351,1.382722,103.76231
679943,311,7751,8062,1.378212,103.772594
679944,385,136,521,1.384235,103.77377
679945,19,293,312,1.383392,103.772742
679946,312,135,447,1.388897,103.766305
679947,37,1540,1577,1.37776,103.77244
679971,0,48,48,1.377773,103.774077
679973,603,631,1234,1.37858,103.77505
679974,548,282,830,1.378138,103.774492
679975,565,119,684,1.37817,103.774081
679976,343,507,850,1.378992,103.774109
679977,439,585,1024,1.379046,103.774428
679978,400,517,917,1.37858,103.77505
679979,23,14,37,1.378594,103.774073
680000,2,10,12,1.299509,103.837
680001,480,610,1090,1.382546,103.751626
680002,414,3870,4284,1.381995,103.751866
680003,559,554,1113,1.382484,103.752363
680004,647,4185,4832,1.382011,103.752721
680005,477,605,1082,1.382115,103.75341
680006,585,4330,4915,1.381729,103.753554
680007,643,1591,2234,1.381579,103.754404
680008,280,786,1066,1.380675,103.754559
680009,526,533,1059,1.38011,103.754023
680010,657,2010,2667,1.380268,103.7553
680011,863,435,1298,1.379838,103.754826
680012,254,211,465,1.379472,103.75548
680013,116,614,730,1.378962,103.755696
680014,74,78,152,1.378521,103.755507
680015,766,420,1186,1.379069,103.754329
680016,978,922,1900,1.378556,103.754891
680017,322,350,672,1.379145,103.753684
680018,650,530,1180,1.378346,103.754037
680019,523,1217,1740,1.379321,103.752803
680020,1051,612,1663,1.378838,103.753095
680025,981,761,1742,1.377951,103.755083
680026,1710,1030,2740,1.377558,103.755584
680101,824,921,1745,1.377895,103.75423
680102,419,992,1411,1.377069,103.754325
680103,393,265,658,1.377103,103.753659
680104,547,1766,2313,1.377131,103.752767
680105,556,250,806,1.377601,103.752925
680106,664,143,807,1.377976,103.7531
680107,363,604,967,1.37809,103.753569
680108,317,176,493,1.378326,103.752861
680109,298,490,788,1.378651,103.751937
680110,774,405,1179,1.378192,103.751619
680111,789,107,896,1.377836,103.751812
680112,336,1420,1756,1.37755,103.75176
680113,1117,1930,3047,1.377988,103.750801
680114,445,293,738,1.378523,103.750904
680115,278,184,462,1.378964,103.751175
680116,349,375,724,1.379025,103.751733
680117,260,821,1081,1.37957,103.751254
680118,343,902,1245,1.379878,103.750539
680119,552,144,696,1.379235,103.750192
680120,525,158,683,1.378837,103.750118
680121,683,1580,2263,1.378337,103.750044
680122,300,1793,2093,1.378532,103.749627
680123,217,900,1117,1.379263,103.74936
680124,469,1132,1601,1.380066,103.74964
680130,551,883,1434,1.3813,103.750204
680131,387,2693,3080,1.381487,103.750842
680132,680,441,1121,1.381074,103.750769
680133,132,68,200,1.380732,103.751148
680134,469,748,1217,1.38031,103.750971
680135,136,148,284,1.380446,103.751478
680136,212,1259,1471,1.379939,103.751691
680137,285,2036,2321,1.380057,103.752243
680138,3,55,58,1.380263,103.752385
680139,4,116,120,1.380225,103.75254
680140,239,4642,4881,1.380004,103.753025
680141,177,8,185,1.380345,103.752691
680142,143,96,239,1.380748,103.751988
680143,81,126,207,1.380557,103.753062
680144,216,11,227,1.380834,103.752544
680145,59,1980,2039,1.381209,103.752293
680146,13,22,35,1.381124,103.75251
680150,479,1013,1492,1.378279,103.756494
680151,574,327,901,1.378456,103.757298
680152,637,188,825,1.378835,103.758062
680154,615,822,1437,1.379593,103.757828
680155,553,190,743,1.378765,103.757114
680156,340,736,1076,1.378802,103.756627
680157,813,591,1404,1.379362,103.756995
680158,743,366,1109,1.379959,103.757047
680159,839,1682,2521,1.380225,103.756472
680160,1097,1229,2326,1.380816,103.756362
680162,673,261,934,1.380841,103.757711
680163,501,607,1108,1.380908,103.756899
680164,363,302,665,1.381155,103.756298
680165,39,255,294,1.299509,103.837
680166,58,792,850,1.299509,103.837
680201,62,746,808,1.382142,103.749519
680202,402,278,680,1.381888,103.749402
680203,521,1177,1698,1.381247,103.749456
680204,456,1349,1805,1.380499,103.749103
680205,414,178,592,1.380953,103.74839
680206,603,1228,1831,1.380719,103.748232
680207,692,1647,2339,1.381128,103.747693
680208,469,176,645,1.381511,103.748112
680209,40,352,392,1.382828,103.747995
680210,659,8,667,1.382552,103.74791
680211,231,132,363,1.382017,103.747952
680212,940,210,1150,1.382447,103.747365
680213,695,493,1188,1.382169,103.747199
680214,370,385,755,1.382762,103.746709
680215,584,267,851,1.382955,103.747006
680216,133,181,314,1.383253,103.747099
680217,423,393,816,1.383318,103.746557
680218,557,382,939,1.38283,103.746033
680219,141,205,346,1.382532,103.745366
680220,432,2206,2638,1.381935,103.745595
680221,170,692,862,1.382245,103.745086
680223,567,801,1368,1.381509,103.744511
680224,716,1363,2079,1.380806,103.74459
680225,263,153,416,1.380992,103.744864
680226,582,195,777,1.381292,103.745452
680227,339,406,745,1.381106,103.745711
680228,680,1306,1986,1.38091,103.746519
680229,663,205,868,1.380697,103.746333
680230,633,70,703,1.380354,103.746196
680231,43,735,778,1.380099,103.746086
680232,441,803,1244,1.380354,103.746954
680233,694,387,1081,1.380171,103.747364
680234,553,1037,1590,1.38019,103.748085
680235,365,1816,2181,1.379759,103.748745
680236,417,227,644,1.379871,103.74806
680237,736,147,883,1.379423,103.748313
680238,31,796,827,1.379193,103.748207
680239,194,1436,1630,1.379468,103.747602
680248,793,320,1113,1.379169,103.746247
680249,621,215,836,1.379596,103.745559
680250,789,476,1265,1.379283,103.745429
680251,759,534,1293,1.378315,103.744578
680252,531,63,594,1.378041,103.744949
680253,206,52,258,1.377542,103.744413
680254,670,2638,3308,1.378229,103.743933
680271,495,790,1285,1.378708,103.742419
680272,463,621,1084,1.378832,103.742982
680273,110,45,155,1.379179,103.743015
680274,387,167,554,1.379378,103.742822
680275,345,416,761,1.379381,103.742354
680276,467,1217,1684,1.379519,103.744385
680277,544,1397,1941,1.38008,103.744531
680278,344,328,672,1.380176,103.743466
680279,127,852,979,1.380696,103.743408
680280,470,1726,2196,1.380767,103.742842
680281,417,1258,1675,1.380277,103.74256
680282,457,261,718,1.380008,103.743111
680283,657,39,696,1.379701,103.742999
680284,313,309,622,1.379733,103.742085
680285,352,2214,2566,1.380069,103.741801
680286,631,866,1497,1.379639,103.741602
680287,390,604,994,1.379322,103.741652
680288,385,241,626,1.378951,103.740916
680289,450,2075,2525,1.379307,103.7407
680290,592,1150,1742,1.378832,103.740414
680291,338,1062,1400,1.378641,103.739747
680292,130,2220,2350,1.378293,103.739679
680293,445,576,1021,1.37811,103.740106
680294,350,383,733,1.378559,103.740838
680295,858,1330,2188,1.378248,103.741035
680296,648,977,1625,1.377421,103.740759
680297,197,131,328,1.377095,103.741745
680302,38,1135,1173,1.385199,103.743145
680303,60,1131,1191,1.384657,103.743786
680304,503,955,1458,1.38426,103.743096
680305,239,711,950,1.38442,103.742928
680306,369,200,569,1.384944,103.742866
680307,400,401,801,1.385258,103.742713
680308,53,336,389,1.385547,103.742769
680309,15,797,812,1.38504,103.745452
680340,522,3888,4410,1.38406,103.745536
680341,436,887,1323,1.38431,103.746069
680342,602,344,946,1.383859,103.746294
680343,224,327,551,1.38348,103.74561
680344,221,313,534,1.383154,103.745249
680345,425,445,870,1.382895,103.74472
680346,228,295,523,1.383564,103.744853
680350,201,614,815,1.383634,103.743306
680351,284,483,767,1.383425,103.743094
680352,228,714,942,1.382711,103.74328
680353,531,725,1256,1.382146,103.743394
680354,744,392,1136,1.382433,103.74378
680355,580,502,1082,1.383049,103.743783
680401,152,1382,1534,1.379734,103.739655
680402,210,2144,2354,1.379258,103.739389
680403,56,522,578,1.379508,103.738877
680404,432,472,904,1.380053,103.738744
680405,197,120,317,1.38018,103.739316
680406,490,195,685,1.380349,103.740211
680407,198,882,1080,1.380392,103.740728
680408,409,1897,2306,1.379935,103.740501
680409,375,1316,1691,1.381132,103.741868
680410,556,2083,2639,1.380647,103.741533
680411,597,145,742,1.38105,103.741252
680412,501,252,753,1.381818,103.742295
680413,853,1826,2679,1.381328,103.742499
680414,809,387,1196,1.38222,103.742187
680415,121,938,1059,1.382841,103.742384
680416,256,929,1185,1.383333,103.742122
680417,335,363,698,1.383055,103.741432
680418,323,104,427,1.382391,103.741309
680419,431,143,574,1.381915,103.741454
680420,439,187,626,1.381444,103.741394
680421,338,268,606,1.381821,103.740665
680422,755,1514,2269,1.382431,103.740867
680423,908,1061,1969,1.382033,103.740285
680424,106,97,203,1.381494,103.740182
680425,633,1759,2392,1.381167,103.73938
680426,529,969,1498,1.380617,103.739205
680427,548,88,636,1.380895,103.739738
680428,68,307,375,1.381222,103.73999
680429,587,3415,4002,1.382847,103.740168
680430,507,3038,3545,1.383822,103.741111
680431,446,1928,2374,1.384044,103.74168
680432,350,396,746,1.384613,103.74174
680433,366,107,473,1.384919,103.741593
680434,425,174,599,1.384472,103.741114
680435,736,297,1033,1.385081,103.740856
680436,953,295,1248,1.384605,103.740381
680437,319,103,422,1.384149,103.740553
680438,478,168,646,1.384161,103.739702
680439,434,454,888,1.383794,103.739853
680440,360,181,541,1.383778,103.739234
680441,384,101,485,1.383256,103.739732
680442,507,2674,3181,1.380925,103.737638
680443,461,189,650,1.381298,103.737615
680444,756,329,1085,1.381654,103.737305
680445,160,225,385,1.381813,103.736726
680446,650,236,886,1.38081,103.736643
680447,665,1107,1772,1.380623,103.737607
680448,652,2511,3163,1.380312,103.737137
680449,468,3378,3846,1.379076,103.736201
680450,344,258,602,1.379502,103.735998
680451,322,292,614,1.380111,103.735513
680452,357,331,688,1.380391,103.735086
680453,1037,245,1282,1.379938,103.735073
680454,1382,134,1516,1.37916,103.734757
680455,387,162,549,1.379374,103.735083
680456,78,53,131,1.379032,103.735201
680457,543,1576,2119,1.378806,103.736134
680458,886,2929,3815,1.378041,103.736059
680459,159,116,275,1.378193,103.735045
680460,204,620,824,1.377909,103.734799
680461,911,189,1100,1.378118,103.734561
680462,191,169,360,1.37758,103.735082
680463,440,237,677,1.377225,103.735321
680464,645,3637,4282,1.376878,103.735882
680465,730,1450,2180,1.377314,103.736365
680469,787,1319,2106,1.377786,103.737351
680470,246,1303,1549,1.378132,103.73688
680471,631,780,1411,1.378585,103.737143
680472,369,829,1198,1.379082,103.737788
680473,582,1325,1907,1.379664,103.737877
680474,482,1974,2456,1.378523,103.738377
680475,910,7335,8245,1.377746,103.73862
680476,12,53,65,1.376441,103.737799
680483,1582,1120,2702,1.375841,103.737721
680484,1076,684,1760,1.376498,103.737012
680485,1161,370,1531,1.374723,103.737914
680486,841,439,1280,1.375595,103.738412
680487,88,384,472,1.299509,103.837
680488,21,226,247,1.299509,103.837
680489,26,64,90,1.299509,103.837
680490,16,244,260,1.299509,103.837
680501,823,317,1140,1.389457,103.743051
680502,293,165,458,1.389082,103.743365
680503,906,290,1196,1.388332,103.74232
680504,734,204,938,1.388873,103.742486
680505,852,215,1067,1.389127,103.742111
680506,447,157,604,1.388965,103.741659
680507,644,377,1021,1.388933,103.741297
680508,680,161,841,1.38857,103.741472
680509,458,97,555,1.388006,103.741649
680510,226,588,814,1.388127,103.741367
680511,551,403,954,1.389397,103.740791
680512,299,158,457,1.389485,103.741186
680513,387,859,1246,1.389884,103.742586
680514,904,277,1181,1.390267,103.743047
680515,371,201,572,1.390224,103.743496
680516,483,142,625,1.390919,103.743501
680517,665,151,816,1.390704,103.742981
680518,529,379,908,1.390735,103.742536
680523,250,605,855,1.391727,103.740796
680524,255,48,303,1.391632,103.741098
680525,469,68,537,1.391556,103.741555
680526,296,303,599,1.391546,103.741919
680527,348,134,482,1.391841,103.741371
680528,373,268,641,1.39231,103.741725
680529,432,1238,1670,1.392233,103.742034
680530,371,620,991,1.392608,103.741814
680531,298,486,784,1.392864,103.741561
680532,51,886,937,1.392015,103.743131
680533,496,126,622,1.392015,103.743131
680535,517,127,644,1.39135,103.743932
680536,523,327,850,1.391842,103.744071
680537,759,1974,2733,1.39207,103.744222
680540,578,1447,2025,1.392994,103.743659
680541,597,865,1462,1.39312,103.744203
680542,698,75,773,1.393563,103.744779
680543,633,242,875,1.393639,103.744265
680544,678,1026,1704,1.393715,103.743763
680545,394,899,1293,1.39339,103.743475
680546,163,3110,3273,1.392998,103.743177
680547,503,3076,3579,1.393269,103.742366
680548,414,712,1126,1.393597,103.741962
680549,368,355,723,1.393618,103.742559
680550,452,443,895,1.393973,103.742738
680551,390,894,1284,1.394271,103.742993
680552,365,286,651,1.394608,103.742592
680553,273,371,644,1.395774,103.743323
680554,281,784,1065,1.396127,103.743029
680555,592,337,929,1.396244,103.743629
680556,392,112,504,1.395722,103.743721
680557,368,38,406,1.395502,103.74417
680558,388,558,946,1.395447,103.744467
680559,293,136,429,1.395951,103.744639
680560,92,322,414,1.395886,103.74491
680561,547,497,1044,1.396318,103.744865
680562,464,1072,1536,1.396338,103.745798
680563,115,308,423,1.395891,103.745655
680564,311,707,1018,1.395393,103.745551
680565,356,397,753,1.394882,103.745287
680566,340,263,603,1.394719,103.745783
680567,420,304,724,1.394924,103.74592
680568,337,101,438,1.395708,103.746312
680569,238,248,486,1.39611,103.746455
680570,239,177,416,1.394199,103.745361
680571,501,73,574,1.394199,103.745361
680572,549,51,600,1.394199,103.745361
680573,564,46,610,1.394199,103.745361
680574,604,175,779,1.394199,103.745361
680601,146,785,931,1.396952,103.744841
680602,746,72,818,1.397302,103.74457
680603,493,172,665,1.397812,103.744656
680604,593,386,979,1.398172,103.744671
680605,342,657,999,1.398316,103.743379
680606,332,11,343,1.398199,103.74397
680607,419,58,477,1.399025,103.744255
680608,565,333,898,1.398496,103.744591
680609,579,415,994,1.399141,103.74485
680610,523,390,913,1.399286,103.743552
680611,782,237,1019,1.399707,103.743754
680612,499,167,666,1.399994,103.74432
680613,449,67,516,1.400611,103.744333
680614,508,1194,1702,1.401049,103.744001
680615,354,1958,2312,1.400859,103.744837
680616,435,148,583,1.399602,103.744505
680617,631,372,1003,1.400449,103.746345
680618,920,655,1575,1.400347,103.746989
680619,580,381,961,1.400047,103.74758
680620,252,72,324,1.400001,103.747167
680621,312,310,622,1.399151,103.747151
680622,22,190,212,1.398277,103.747186
680623,15,854,869,1.398312,103.747039
680624,70,270,340,1.398094,103.746828
680625,470,813,1283,1.398591,103.746021
680626,442,451,893,1.398315,103.745837
680627,163,212,375,1.397923,103.746116
680631,209,1904,2113,1.396592,103.748029
680632,655,427,1082,1.396598,103.748446
680633,611,424,1035,1.396561,103.749151
680634,358,905,1263,1.396619,103.749627
680635,202,146,348,1.39741,103.749522
680636,207,142,349,1.397348,103.748878
680637,427,670,1097,1.397378,103.748202
680638,391,1923,2314,1.397856,103.748318
680639,696,85,781,1.397889,103.748933
680640,571,160,731,1.397901,103.749541
680641,534,245,779,1.398275,103.749692
680642,468,83,551,1.398367,103.749059
680643,137,1345,1482,1.398519,103.748487
680656,776,1879,2655,1.400231,103.750339
680657,451,860,1311,1.400373,103.749677
680658,596,1487,2083,1.400677,103.749082
680659,775,124,899,1.401355,103.749248
680660,626,255,881,1.401267,103.749749
680661,756,1659,2415,1.401089,103.750388
680662,265,2662,2927,1.401501,103.750652
680663,611,1619,2230,1.402,103.750688
680664,654,1697,2351,1.402335,103.750261
680665,537,286,823,1.402022,103.750008
680666,675,1495,2170,1.402442,103.749829
680667,704,1501,2205,1.402589,103.74952
680668,992,770,1762,1.401803,103.749333
680669,453,1034,1487,1.402858,103.748167
680670,736,1583,2319,1.403109,103.74775
680671,174,74,248,1.402554,103.747962
680672,274,187,461,1.402164,103.74735
680673,600,336,936,1.401252,103.747928
680674,200,90,290,1.401511,103.746883
680675,382,2452,2834,1.40126,103.745938
680676,310,1535,1845,1.401912,103.746032
680677,876,1873,2749,1.401424,103.74521
680678,725,2849,3574,1.401604,103.744182
680679,1240,1906,3146,1.402393,103.744271
680680,1126,503,1629,1.403099,103.744732
680681,1179,2185,3364,1.402923,103.745549
680682,677,675,1352,1.402176,103.745399
680683,54,427,481,1.404338,103.745832
680684,51,315,366,1.404093,103.74633
680685,32,100,132,1.404047,103.747868
680686,35,297,332,1.403905,103.748663
680687,41,323,364,1.403836,103.749875
680688,21,110,131,1.403744,103.750547
680689,57,1328,1385,1.402704,103.751114
680690,32,41,73,1.402958,103.751943
680691,307,1493,1800,1.400917,103.751399
680692,35,48,83,1.399989,103.751037
680701,527,1057,1584,1.39162,103.746244
680702,607,3175,3782,1.391782,103.745507
680703,410,289,699,1.391336,103.745982
680704,600,837,1437,1.390991,103.745611
680705,797,143,940,1.390399,103.746
680706,443,218,661,1.390402,103.746796
680707,530,536,1066,1.390391,103.747111
680708,699,2695,3394,1.39162,103.746811
680751,632,245,877,1.392366,103.747679
680752,554,210,764,1.39234,103.747355
680753,250,164,414,1.392359,103.746909
680754,301,439,740,1.392241,103.746594
680755,471,511,982,1.392427,103.745923
680756,404,788,1192,1.3926,103.745694
680757,482,625,1107,1.392868,103.745961
680758,504,134,638,1.393298,103.746158
680759,500,85,585,1.393219,103.74666
680760,321,226,547,1.393138,103.747301
680761,365,236,601,1.393139,103.747616
680762,720,336,1056,1.392393,103.748538
680763,359,273,632,1.392881,103.748342
680764,389,118,507,1.393219,103.748954
680765,424,327,751,1.392667,103.749595
680766,519,214,733,1.393492,103.749691
680767,790,222,1012,1.393917,103.749174
680768,674,98,772,1.394112,103.749845
680769,848,252,1100,1.394214,103.750451
680770,1014,113,1127,1.394919,103.750289
680771,625,333,958,1.394289,103.749105
680784,569,1154,1723,1.394744,103.747178
680785,505,170,675,1.394731,103.747669
680786,289,174,463,1.395136,103.748429
680787,18,216,234,1.39526,103.747715
680788,510,932,1442,1.395829,103.748309
680789,313,1004,1317,1.395883,103.748983
680790,538,1071,1609,1.39593,103.749655
680791,708,180,888,1.395466,103.749741
680792,432,254,686,1.395208,103.749069
680801,43,68,111,1.299509,103.837
680803,434,1930,2364,1.374189,103.742853
680804,46,704,750,1.299509,103.837
680805,20,189,209,1.299509,103.837
680806,11,510,521,1.299509,103.837
680807,40,84,124,1.299509,103.837
680808,59,293,352,1.376116,103.745862
680809,7,53,60,1.299509,103.837
680810,380,1081,1461,1.374156,103.746519
680811,59,115,174,1.299509,103.837
680812,12,124,136,1.373854,103.746681
680813,38,183,221,1.299509,103.837
680814,8,82,90,1.299509,103.837
680815,90,126,216,1.376461,103.746655
680816,31,375,406,1.299509,103.837
680817,25,274,299,1.299509,103.837
680818,126,253,379,1.377869,103.748353
681008,17,2063,2080,1.380618,103.753749
681118,3,329,332,1.37995,103.75007
681135,1,134,135,1.380389,103.752001
681146,2,84,86,1.299509,103.837
681151,28,941,969,1.378643,103.756353
681154,17,391,408,1.379356,103.758073
681158,24,1765,1789,1.380143,103.756787
681160,66,1518,1584,1.380622,103.756844
681165,1086,806,1892,1.382724,103.753591
681166,711,295,1006,1.383366,103.753065
681203,13,118,131,1.381044,103.749218
681227,17,90,107,1.380557,103.745427
681251,60,1150,1210,1.378852,103.744999
681253,7,75,82,1.377406,103.743965
681276,19,367,386,1.380116,103.744162
681287,9,314,323,1.378442,103.741987
681296,365,423,788,1.377133,103.740941
681297,464,289,753,1.377023,103.742358
681306,9,443,452,1.385144,103.742941
681343,6,201,207,1.383861,103.745973
681351,60,548,608,1.299509,103.837
681421,26,69,95,1.299509,103.837
681429,41,1964,2005,1.383291,103.741066
681430,2,111,113,1.384306,103.741639
681440,6,126,132,1.383486,103.741233
681445,12,147,159,1.381209,103.736662
681450,25,57,82,1.379605,103.735553
681456,7,13,20,1.378921,103.735416
681459,8,29,37,1.37826,103.735444
681462,4,68,72,1.377606,103.735748
681474,11,139,150,1.378438,103.737906
681476,330,2580,2910,1.376441,103.737799
681483,22,254,276,1.376012,103.737096
681484,650,3730,4380,1.376725,103.736749
681485,934,208,1142,1.374559,103.738117
681486,25,91,116,1.37505,103.738415
681487,1548,1046,2594,1.376038,103.73869
681488,275,376,651,1.299509,103.837
681489,1040,837,1877,1.299509,103.837
681490,417,717,1134,1.375195,103.741496
681502,17,253,270,1.38871,103.742948
681511,20,828,848,1.388614,103.741127
681513,18,267,285,1.390384,103.742429
681527,9,207,216,1.392318,103.741063
681533,21,139,160,1.392074,103.742507
681537,5,351,356,1.392069,103.743872
681541,39,213,252,1.393068,103.744621
681552,12,323,335,1.393985,103.742233
681559,14,398,412,1.396187,103.744269
681567,6,74,80,1.395293,103.746071
681572,2,232,234,1.299509,103.837
681573,17,530,547,1.299509,103.837
681602,15,7,22,1.397942,103.7453
681604,17,1255,1272,1.397472,103.745148
681610,22,1976,1998,1.398811,103.743496
681611,44,744,788,1.400473,103.743727
681621,24,1395,1419,1.399676,103.747574
681625,29,365,394,1.398414,103.74676
681632,22,144,166,1.396783,103.748794
681636,5,31,36,1.397042,103.748755
681659,24,864,888,1.401069,103.749058
681660,11,26,37,1.400686,103.750113
681661,12,75,87,1.400697,103.750256
681668,16,225,241,1.401565,103.750234
681669,6,280,286,1.402257,103.7483
681670,357,130,487,1.402631,103.747472
681671,331,195,526,1.402065,103.747817
681672,229,4,233,1.40195,103.7472
681673,347,2326,2673,1.401014,103.747439
681674,231,89,320,1.401599,103.746416
681675,7,494,501,1.4013,103.746746
681676,321,144,465,1.402119,103.746541
681678,49,139,188,1.401924,103.744912
681683,627,394,1021,1.403918,103.745566
681684,315,1197,1512,1.404108,103.746686
681685,433,1958,2391,1.403968,103.74762
681686,893,120,1013,1.404654,103.747937
681687,1245,352,1597,1.404459,103.749901
681688,316,250,566,1.404108,103.750243
681689,631,3150,3781,1.403171,103.7503
681690,647,495,1142,1.402804,103.751445
681691,1010,53,1063,1.401093,103.751315
681692,1615,269,1884,1.400158,103.751145
681708,17,438,455,1.391,103.746448
681754,9,208,217,1.392781,103.746733
681762,5,201,206,1.392203,103.749513
681771,12,94,106,1.39452,103.749956
681787,108,197,305,1.395329,103.748004
681792,5,239,244,1.39527,103.749523
681801,286,352,638,1.299509,103.837
681802,635,435,1070,1.374544,103.743532
681803,1087,482,1569,1.378686,103.748947
681804,573,314,887,1.299509,103.837
681805,319,362,681,1.299509,103.837
681807,620,141,761,1.376756,103.745839
681808,389,31,420,1.299509,103.837
681809,249,26,275,1.299509,103.837
681810,891,1765,2656,1.37393,103.746595
681811,682,83,765,1.299509,103.837
681812,735,890,1625,1.37396,103.747016
681813,241,30,271,1.373468,103.746048
681815,726,431,1157,1.376401,103.746805
681816,578,505,1083,1.378175,103.748564
681817,622,143,765,1.378175,103.748564
681818,292,399,691,1.299509,103.837
682166,516,342,858,1.299509,103.837
682296,425,193,618,1.376838,103.741413
682297,506,249,755,1.377374,103.743124
682476,812,1065,1877,1.376441,103.737799
682484,280,1660,1940,1.376169,103.736114
682485,279,259,538,1.37422,103.7387
682486,9,26,35,1.376432,103.737663
682487,884,2495,3379,1.299509,103.837
682488,361,282,643,1.376863,103.739537
682489,716,421,1137,1.375331,103.740513
682490,412,58,470,1.375609,103.741485
682672,568,169,737,1.401983,103.746972
682673,50,1777,1827,1.400942,103.747804
682678,7,11,18,1.402444,103.744916
682683,380,478,858,1.403871,103.745858
682684,685,584,1269,1.404121,103.747195
682685,622,1531,2153,1.403723,103.748112
682686,809,61,870,1.404594,103.748374
682687,761,512,1273,1.40436,103.750826
682688,684,410,1094,1.403528,103.750123
682689,554,2820,3374,1.403193,103.749638
682690,1042,74,1116,1.403174,103.751756
682691,1218,398,1616,1.401549,103.751438
682692,814,86,900,1.400728,103.751324
682787,338,1138,1476,1.395841,103.747652
682792,12,229,241,1.299509,103.837
682801,307,508,815,1.299509,103.837
682802,218,178,396,1.299509,103.837
682803,497,332,829,1.373535,103.74312
682804,1073,445,1518,1.37324,103.742139
682805,304,117,421,1.372949,103.743163
682807,467,628,1095,1.378686,103.748947
682808,734,501,1235,1.376792,103.745926
682809,331,101,432,1.299509,103.837
682810,645,151,796,1.375209,103.745251
682811,137,59,196,1.299509,103.837
682812,406,226,632,1.299509,103.837
682813,7,31,38,1.299509,103.837
682815,656,259,915,1.376368,103.746444
682816,492,37,529,1.378175,103.748564
682817,775,141,916,1.378175,103.748564
682818,493,654,1147,1.378175,103.748564
683296,327,306,633,1.376565,103.74224
683297,703,219,922,1.377776,103.743031
683476,523,1340,1863,1.377366,103.737935
683484,632,321,953,1.375502,103.736848
683485,608,116,724,1.374887,103.73894
683487,885,116,1001,1.376325,103.738543
683488,145,298,443,1.376543,103.740342
683489,587,304,891,1.299509,103.837
683490,822,1353,2175,1.299509,103.837
683683,537,297,834,1.40469,103.74625
683684,491,220,711,1.40436,103.747134
683685,270,1348,1618,1.403559,103.748574
683686,309,101,410,1.404635,103.748893
683687,633,323,956,1.403893,103.751083
683688,467,307,774,1.4032,103.750966
683690,975,263,1238,1.402626,103.751829
683801,163,415,578,1.299509,103.837
683802,461,538,999,1.299509,103.837
683803,540,346,886,1.299509,103.837
683804,7,239,246,1.299509,103.837
683805,499,185,684,1.372943,103.743158
683807,933,673,1606,1.376756,103.745839
683808,355,386,741,1.299509,103.837
683809,0,45,45,1.299509,103.837
683812,290,125,415,1.373468,103.746048
683815,679,70,749,1.376368,103.746444
683817,912,246,1158,1.299509,103.837
683818,287,208,495,1.378175,103.748564
684296,156,472,628,1.376587,103.742999
684297,775,1488,2263,1.378124,103.743004
684476,224,203,427,1.377295,103.738334
684484,938,239,1177,1.37529,103.737099
684485,825,347,1172,1.375205,103.738902
684488,354,1488,1842,1.299509,103.837
684489,546,343,889,1.375508,103.741275
684490,870,557,1427,1.299509,103.837
684684,611,134,745,1.404566,103.74672
684686,497,412,909,1.40406,103.748237
684687,954,237,1191,1.403671,103.75147
684690,935,148,1083,1.402242,103.751939
684801,152,18,170,1.299509,103.837
684803,523,223,746,1.37294,103.744397
684805,718,91,809,1.374221,103.742391
684808,771,194,965,1.299509,103.837
685296,435,135,570,1.376931,103.743014
685476,1,31,32,1.299509,103.837
688200,8,392,400,1.299509,103.837
688206,0,3,3,1.37039,103.769256
688207,3,1,4,1.372075,103.769181
688208,5,450,455,1.299509,103.837
688209,20,584,604,1.299509,103.837
688210,2,7,9,1.299509,103.837
688211,0,6,6,1.299509,103.837
688212,2,14,16,1.299509,103.837
688213,0,29,29,1.299509,103.837
688214,0,42,42,1.299509,103.837
688215,0,10,10,1.299509,103.837
688236,1124,9,1133,1.374852,103.751746
688237,235,142,377,1.373983,103.749789
688238,5,474,479,1.299509,103.837
688239,7,403,410,1.299509,103.837
688240,5,142,147,1.299509,103.837
688241,39,1195,1234,1.394448,103.753336
688246,1214,172,1386,1.37814,103.745629
688247,81,53,134,1.377974,103.745646
688248,1430,1305,2735,1.379188,103.747819
688253,13,23,36,1.398657,103.742228
688254,51,361,412,1.376074,103.734395
688255,515,278,793,1.398187,103.740957
688256,538,11,549,1.398013,103.738577
688257,12,0,12,1.398008,103.738609
688258,954,83,1037,1.384627,103.753951
688259,16,286,302,1.377219,103.732615
688261,391,278,669,1.383126,103.753548
688263,1614,330,1944,1.383547,103.737222
688265,57,817,874,1.380298,103.745238
688266,523,2337,2860,1.378616,103.749042
688267,52,1269,1321,1.376696,103.753675
688268,392,915,1307,1.403245,103.74729
688269,13,23,36,1.390543,103.752537
688270,7,13,20,1.390543,103.752556
688271,10,0,10,1.39055,103.752507
688273,7,3,10,1.390564,103.752446
688274,1,0,1,1.372418,103.769148
688276,17,2,19,1.390579,103.752402
688277,15,4,19,1.390592,103.752326
688278,9,0,9,1.390593,103.75234
688279,1,0,1,1.390564,103.752463
688280,44,1,45,1.390607,103.752278
688281,0,4,4,1.299509,103.837
688282,1,1,2,1.370159,103.768701
688284,16,0,16,1.390636,103.752154
688285,6,1,7,1.390647,103.752084
688286,3,1,4,1.390619,103.752205
688287,18,0,18,1.390661,103.752024
688288,1,1,2,1.390621,103.752216
688289,65,5,70,1.390675,103.751963
688291,1,0,1,1.390605,103.752265
688292,0,2,2,1.390664,103.752031
688293,0,3,3,1.299509,103.837
688294,49,0,49,1.390707,103.751845
688295,9,0,9,1.390716,103.751782
688296,9,1,10,1.390721,103.751783
688297,3,0,3,1.390703,103.751843
688298,2,0,2,1.390692,103.751907
688299,3,0,3,1.39073,103.751722
688301,20,2,22,1.390758,103.751601
688303,54,0,54,1.390772,103.751541
688304,5,0,5,1.390778,103.751536
688306,3,2,5,1.390792,103.751474
688307,2,0,2,1.390735,103.751722
688308,19,1,20,1.390806,103.751413
688309,34,3,37,1.390814,103.75136
688310,1,1,2,1.3908,103.75142
688311,2,0,2,1.39082,103.751351
688312,45,0,45,1.390834,103.751289
688313,12,0,12,1.390841,103.751239
688314,0,2,2,1.390828,103.751299
688315,4,0,4,1.39065,103.752093
688316,0,6,6,1.390863,103.751165
688317,0,4,4,1.390855,103.751178
688318,7,0,7,1.390877,103.751104
688319,10,0,10,1.390883,103.751058
688320,2,2,4,1.390869,103.751118
688321,6,1,7,1.390897,103.750997
688322,6,0,6,1.390906,103.75098
688323,2,0,2,1.390849,103.751227
688324,18,7,25,1.39092,103.750918
688325,16,1,17,1.390925,103.750877
688326,3,0,3,1.390744,103.751661
688327,11,0,11,1.390939,103.750816
688328,0,2,2,1.390911,103.750937
688329,0,1,1,1.390689,103.751903
688331,1,0,1,1.390953,103.750756
688332,1,8,9,1.390977,103.750671
688333,106,6,112,1.39098,103.750635
688335,3,0,3,1.390934,103.750856
688336,1,4,5,1.391005,103.750547
688337,26,3,29,1.391008,103.750514
688339,4,0,4,1.390891,103.751042
688340,41,4,45,1.391034,103.750424
688342,7,0,7,1.391048,103.750362
688343,2,0,2,1.390948,103.750795
688344,5,0,5,1.391062,103.7503
688345,0,1,1,1.390966,103.750695
688347,33,0,33,1.391077,103.750212
688348,1,1,2,1.39105,103.750333
688349,4,0,4,1.391022,103.750454
688351,5,18,23,1.391105,103.750092
688352,1,0,1,1.391064,103.750273
688354,4,2,6,1.391143,103.749981
688355,0,9,9,1.391123,103.749981
688356,0,7,7,1.389942,103.752634
688357,11,26,37,1.389943,103.752651
688358,8,0,8,1.389948,103.752606
688360,5,5,10,1.389961,103.752549
688361,0,2,2,1.39109,103.750176
688364,1,4,5,1.389986,103.752436
688365,1,3,4,1.391091,103.750152
688366,5,0,5,1.389998,103.75238
688367,3,0,3,1.390994,103.750575
688368,20,3,23,1.39001,103.752324
688369,2,4,6,1.390019,103.752304
688370,4,0,4,1.389991,103.75243
688371,15,0,15,1.390033,103.752241
688372,7,6,13,1.390035,103.752211
688373,10,14,24,1.390047,103.752178
688374,9,0,9,1.390047,103.752154
688375,12,1,13,1.39006,103.752115
688376,3,9,12,1.39006,103.752098
688377,10,10,20,1.390074,103.752052
688378,7,0,7,1.390072,103.752041
688380,0,8,8,1.390084,103.751985
688382,2,0,2,1.389964,103.752556
688383,2,0,2,1.390097,103.751929
688384,7,2,9,1.390109,103.751872
688385,3,1,4,1.390023,103.752267
688386,4,0,4,1.390129,103.7518
688387,3,0,3,1.390005,103.752367
688388,6,3,9,1.390134,103.751759
688389,0,2,2,1.390116,103.751863
688390,2,0,2,1.390157,103.751674
688391,19,0,19,1.390171,103.751611
688392,1,2,3,1.390143,103.751737
688393,3,4,7,1.390185,103.751548
688395,21,0,21,1.390198,103.751485
688396,21,2,23,1.390184,103.751534
688397,1,2,3,1.390159,103.751646
688398,108,0,108,1.390196,103.751477
688399,56,0,56,1.390226,103.751359
688400,0,3,3,1.390212,103.751422
688401,9,0,9,1.39024,103.751297
688404,1,2,3,1.390208,103.751421
688405,1,0,1,1.391119,103.750053
688407,1,0,1,1.390268,103.751171
688408,8,2,10,1.390258,103.751195
688412,30,1,31,1.390282,103.751082
688413,10,1,11,1.390323,103.750919
688414,101,0,101,1.390295,103.751026
688415,39,0,39,1.390337,103.750856
688416,1,2,3,1.390233,103.751308
688417,1,0,1,1.390281,103.751108
688420,1,2,3,1.390307,103.75097
688421,2,1,3,1.390332,103.750857
688422,7,0,7,1.390344,103.7508
688423,94,0,94,1.390392,103.750604
688424,1,1,2,1.390146,103.751703
688425,0,1,1,1.39035,103.750793
688426,1,0,1,1.390406,103.750541
688428,0,1,1,1.390369,103.750687
688429,32,2,34,1.390433,103.750415
688432,93,4,97,1.390406,103.750518
688433,6,3,9,1.390461,103.750289
688435,1,0,1,1.390382,103.750631
688436,0,4,4,1.390122,103.751816
688437,2,1,3,1.390378,103.750667
688438,3,0,3,1.390489,103.750163
688441,10,0,10,1.390516,103.750037
688442,1,0,1,1.390475,103.750226
688443,18,8,26,1.39054,103.749964
688445,0,5,5,1.390493,103.750123
688446,9,0,9,1.390505,103.750067
688447,3,0,3,1.390443,103.750349
688448,2,0,2,1.390357,103.750744
688449,0,7,7,1.390568,103.749955
688450,0,4,4,1.390431,103.750405
688451,5,1,6,1.390681,103.749958
688452,15,4,19,1.390756,103.74996
688453,2,4,6,1.390832,103.749963
688454,2,2,4,1.390605,103.749956
688455,4,1,5,1.390982,103.749967
688456,2,1,3,1.390518,103.75001
688457,1,1,2,1.39052,103.749964
688458,0,1,1,1.390468,103.750236
688459,3,0,3,1.391058,103.749969
688460,7,1,8,1.391255,103.749971
688461,4,1,5,1.391316,103.749972
688462,0,1,1,1.391164,103.749971
688463,1,1,2,1.391133,103.749971
688465,6,2,8,1.391561,103.749972
688466,14,2,16,1.391622,103.749973
688467,8,1,9,1.391683,103.749973
688468,5,2,7,1.391744,103.749973
688470,13,0,13,1.391783,103.749944
688471,12,1,13,1.391823,103.749954
688472,41,7,48,1.391873,103.74996
688473,10,47,57,1.391926,103.74994
688474,0,116,116,1.392013,103.749821
688475,2,39,41,1.392033,103.749889
688476,6,26,32,1.392065,103.749965
688477,18,84,102,1.392084,103.750013
688478,3,179,182,1.392116,103.750047
688479,10,25,35,1.392142,103.750094
688480,0,1,1,1.391377,103.749972
688481,8,57,65,1.392172,103.750167
688482,2,1,3,1.391194,103.749971
688483,11,65,76,1.392198,103.750241
688484,0,2,2,1.391438,103.749972
688485,2,42,44,1.392209,103.750303
688487,33,12,45,1.392219,103.750356
688488,1,3,4,1.390907,103.749965
688489,0,10,10,1.39223,103.7504
688491,3,15,18,1.392239,103.750434
688492,1,2,3,1.39195,103.74999
688493,4,12,16,1.392252,103.750487
688494,13,6,19,1.392297,103.750993
688495,1,16,17,1.39226,103.750554
688496,10,0,10,1.392301,103.751024
688497,3,20,23,1.392273,103.750607
688498,9,2,11,1.392311,103.751084
688499,1,38,39,1.392288,103.750662
688500,8,0,8,1.39232,103.751145
688501,1,53,54,1.392299,103.750743
688502,0,2,2,1.392093,103.750082
688503,1,44,45,1.392303,103.750793
688504,1,4,5,1.392339,103.751266
688505,52,76,128,1.39231,103.750846
688506,2,1,3,1.392292,103.750963
688507,1,161,162,1.392325,103.750906
688508,1,0,1,1.39195,103.74999
688509,2,36,38,1.392317,103.750993
688510,0,1,1,1.392358,103.751387
688511,0,11,11,1.392321,103.751024
688512,1,0,1,1.392368,103.751447
688513,2,5,7,1.392331,103.751084
688514,2,2,4,1.392201,103.750502
688515,2,5,7,1.39234,103.751145
688516,2,0,2,1.39233,103.751205
688517,1,10,11,1.39235,103.751205
688518,0,1,1,1.392377,103.751508
688519,5,11,16,1.392359,103.751266
688520,37,0,37,1.392415,103.75175
688521,2,3,5,1.392369,103.751326
688522,0,1,1,1.392406,103.751689
688523,0,5,5,1.392378,103.751387
688524,1,0,1,1.392425,103.75181
688525,0,6,6,1.392388,103.751447
688526,0,1,1,1.392434,103.751871
688527,1,1,2,1.392396,103.751629
688528,2,5,7,1.392416,103.751629
688529,4,4,8,1.392426,103.751689
688530,0,14,14,1.392435,103.75175
688531,0,7,7,1.392445,103.75181
688533,4,7,11,1.391199,103.752433
688534,3,7,10,1.391199,103.752454
688535,5,0,5,1.391206,103.752401
688536,8,11,19,1.391206,103.752423
688537,2,7,9,1.39122,103.752337
688538,23,0,23,1.39122,103.75236
688539,3,0,3,1.392349,103.751326
688540,12,2,14,1.391233,103.752298
688541,2,1,3,1.391234,103.752273
688542,14,0,14,1.391247,103.752236
688543,1,0,1,1.392397,103.751508
688544,0,1,1,1.391263,103.752146
688545,6,4,10,1.391277,103.752082
688546,6,0,6,1.391275,103.752111
688547,6,0,6,1.391291,103.752018
688548,2,1,3,1.391249,103.752209
688549,7,5,12,1.391305,103.751954
688550,2,0,2,1.392407,103.751568
688551,25,0,25,1.391319,103.75189
688552,5,1,6,1.391316,103.751924
688553,1,5,6,1.391334,103.751826
688554,6,0,6,1.39133,103.751862
688556,0,1,1,1.391261,103.752174
688557,0,3,3,1.391289,103.752049
688558,1,0,1,1.391344,103.7518
688559,1,0,1,1.391358,103.751737
688560,3,4,7,1.391371,103.751675
688561,71,4,75,1.39139,103.75157
688563,25,0,25,1.391404,103.751507
688564,3,7,10,1.391399,103.751551
688565,20,3,23,1.391418,103.751443
688566,4,0,4,1.392387,103.751568
688568,10,5,15,1.391427,103.751426
688569,7,2,9,1.391447,103.751315
688572,1,2,3,1.391362,103.751698
688573,18,10,28,1.391475,103.751187
688574,20,0,20,1.391468,103.751239
688575,2,0,2,1.391302,103.751987
688576,2,5,7,1.391482,103.751177
688577,94,4,98,1.391503,103.751059
688578,8,0,8,1.391496,103.751114
688579,5,0,5,1.391518,103.750995
688580,23,6,29,1.391509,103.751052
688581,12,3,15,1.391532,103.750931
688584,2,3,5,1.391537,103.750928
688585,3,3,6,1.39156,103.750804
688586,1,0,1,1.391376,103.751634
688588,0,3,3,1.391454,103.751301
688589,2,3,5,1.391588,103.750676
688590,9,0,9,1.391578,103.750741
688591,7,0,7,1.391602,103.750612
688593,0,3,3,1.391565,103.750803
688595,0,5,5,1.391631,103.750484
688596,1,1,2,1.391489,103.751123
688597,1,0,1,1.391551,103.750865
688598,6,0,6,1.391634,103.750491
688599,15,0,15,1.391659,103.750356
688600,3,0,3,1.391617,103.750548
688603,23,0,23,1.391687,103.750229
688605,5,8,13,1.391702,103.750165
688606,31,0,31,1.391689,103.750242
688607,31,0,31,1.391716,103.750101
688608,0,5,5,1.391703,103.75018
688609,14,0,14,1.39173,103.750037
688610,1,0,1,1.391645,103.75042
688611,3,5,8,1.391734,103.749983
688612,1,1,2,1.39162,103.750554
688613,71,8,79,1.391754,103.749983
688614,1,6,7,1.391734,103.752338
688615,16,1,17,1.391741,103.75231
688616,34,3,37,1.391757,103.752255
688617,0,2,2,1.39173,103.750055
688618,5,0,5,1.391787,103.752145
688619,6,1,7,1.391748,103.752307
688620,47,3,50,1.391803,103.75209
688621,4,2,6,1.39177,103.752229
688622,2,2,4,1.391413,103.751488
688623,2,0,2,1.391772,103.7522
688624,0,2,2,1.391813,103.752074
688625,7,0,7,1.391856,103.751918
688626,7,0,7,1.391849,103.751925
688627,18,1,19,1.3919,103.751762
688629,58,2,60,1.391944,103.751607
688630,0,1,1,1.391716,103.750118
688631,6,18,24,1.391987,103.751451
688632,33,0,33,1.391895,103.751761
688633,7,0,7,1.39191,103.751706
688634,7,1,8,1.391926,103.751651
688636,9,0,9,1.391956,103.751541
688637,30,1,31,1.391972,103.751486
688638,7,0,7,1.391977,103.751441
688639,35,258,293,1.393132,103.751976
688640,3,146,149,1.393132,103.751956
688641,1,11,12,1.39311,103.752011
688642,1,0,1,1.39188,103.751816
688643,2,8,10,1.393032,103.752118
688644,3,16,19,1.393032,103.752098
688645,2,1,3,1.391647,103.750429
688646,43,6,49,1.392956,103.752161
688647,2,0,2,1.391833,103.75198
688648,2,0,2,1.39297,103.752172
688649,11,3,14,1.392914,103.752208
688651,0,5,5,1.392848,103.752218
688652,27,2,29,1.392731,103.752215
688653,2,22,24,1.392782,103.752228
688654,15,2,17,1.39264,103.752229
688655,0,9,9,1.392716,103.752238
688656,1,2,3,1.393032,103.752118
688657,0,33,33,1.39265,103.752247
688658,2,1,3,1.392548,103.752242
688659,9,0,9,1.392584,103.752257
688661,0,46,46,1.392518,103.752267
688662,1,3,4,1.391818,103.752035
688663,0,1,1,1.393099,103.752009
688664,0,3,3,1.392457,103.752256
688665,19,93,112,1.392386,103.752287
688666,0,2,2,1.392914,103.752188
688667,3,6,9,1.39232,103.752296
688668,135,2,137,1.392,103.752324
688669,65,28,93,1.392254,103.752306
688670,2,0,2,1.392092,103.752311
688671,12,1,13,1.392188,103.752316
688672,2,5,7,1.391817,103.752351
688673,13,13,26,1.392122,103.752326
688674,1,16,17,1.391726,103.752365
688675,2,1,3,1.392183,103.752297
688676,32,11,43,1.39199,103.752346
688677,0,2,2,1.391909,103.752338
688678,1,5,6,1.391858,103.752365
688680,0,7,7,1.391736,103.752375
688681,3,6,9,1.391693,103.752391
688682,0,9,9,1.391659,103.752398
688683,1,2,3,1.392056,103.752336
688684,0,5,5,1.391526,103.752423
688685,4,3,7,1.391459,103.752435
688686,20,5,25,1.391392,103.752448
688687,4,0,4,1.392274,103.752283
688688,0,8,8,1.391259,103.752473
688689,0,1,1,1.392452,103.752277
688690,4,22,26,1.391159,103.75249
688691,0,2,2,1.391924,103.752356
688692,4,16,20,1.391061,103.752505
688693,2,1,3,1.391592,103.75241
688694,0,5,5,1.39093,103.752526
688695,2,2,4,1.391326,103.75246
688696,66,10,76,1.390798,103.752546
688697,0,1,1,1.391202,103.752475
688698,2,1,3,1.390995,103.752516
688699,2,1,3,1.390667,103.752567
688700,1,0,1,1.390733,103.752556
688701,7,3,10,1.390506,103.752592
688702,2,6,8,1.390476,103.752597
688703,27,7,34,1.390416,103.752606
688704,77,2,79,1.390356,103.752616
688705,8,4,12,1.390296,103.752625
688706,3,7,10,1.390236,103.752634
688707,2,1,3,1.390602,103.752577
688708,100,8,108,1.390116,103.752654
688709,3,7,10,1.390056,103.752663
688710,5,1,6,1.389996,103.752672
688711,9,2,11,1.389946,103.752672
688712,4,10,14,1.389904,103.752679
688713,9,4,13,1.389872,103.752676
688714,1,1,2,1.391126,103.752495
688715,3,0,3,1.390176,103.752644
688716,2,121,123,1.38971,103.752657
688717,0,44,44,1.389644,103.752646
688719,3,4,7,1.389549,103.752622
688720,0,1,1,1.390546,103.752577
688721,41,86,127,1.389447,103.752559
688722,4,15,19,1.389443,103.75251
688723,0,28,28,1.389438,103.752481
688724,11,0,11,1.38943,103.752423
688725,8,13,21,1.389433,103.752376
688726,1,0,1,1.389494,103.752595
688727,2,11,13,1.389446,103.752287
688728,14,0,14,1.389457,103.752232
688729,17,7,24,1.389468,103.752176
688731,6,9,15,1.389491,103.752065
688733,162,11,173,1.389513,103.751954
688734,53,0,53,1.389524,103.751899
688735,1,12,13,1.389535,103.751843
688736,6,0,6,1.389546,103.751787
688737,6,9,15,1.389557,103.751732
688739,124,29,153,1.389579,103.751621
688740,3,0,3,1.389776,103.752666
688741,3,4,7,1.389602,103.75151
688742,1,0,1,1.389435,103.752343
688743,4,5,9,1.389624,103.751399
688744,1,0,1,1.389613,103.751454
688745,1,10,11,1.389646,103.751287
688746,11,0,11,1.389657,103.751232
688747,0,5,5,1.389668,103.751176
688748,1,0,1,1.389635,103.751343
688749,3,4,7,1.389691,103.751065
688750,1,0,1,1.389679,103.751121
688751,0,10,10,1.389713,103.750954
688752,18,0,18,1.389724,103.750899
688753,6,19,25,1.389735,103.750843
688755,0,8,8,1.389757,103.750732
688757,72,5,77,1.389779,103.750621
688758,4,0,4,1.390864,103.752536
688759,2,13,15,1.389802,103.75051
688760,2,0,2,1.389809,103.75267
688761,0,19,19,1.389824,103.750399
688762,3,1,4,1.389791,103.750565
688763,7,0,7,1.389846,103.750287
688764,4,7,11,1.389857,103.750232
688765,43,0,43,1.389868,103.750176
688766,4,12,16,1.389879,103.750121
688767,3,0,3,1.389591,103.751565
688768,3,23,26,1.389902,103.75001
688769,3,0,3,1.389891,103.750065
688770,5,6,11,1.389924,103.749899
688771,7,84,91,1.389945,103.749833
688772,6,6,12,1.39227,103.750957
688773,2,0,2,1.389813,103.750454
688774,26,2,28,1.392176,103.75097
688775,1,5,6,1.392255,103.75098
688776,4,2,6,1.392113,103.750979
688777,2,1,3,1.389913,103.749954
688778,1,4,5,1.39205,103.750988
688779,7,1,8,1.392113,103.750999
688780,0,1,1,1.389702,103.75101
688782,3,1,4,1.389835,103.750343
688783,4,0,4,1.391924,103.751005
688784,40,636,676,1.38485,103.752315
688786,142,1519,1661,1.377611,103.750136
688787,1,0,1,1.391987,103.750996
688788,19,27,46,1.398141,103.738804
688790,0,2,2,1.392239,103.750962
688791,118,107,225,1.385533,103.751878
688793,705,0,705,1.385572,103.751906
688794,31,0,31,1.385248,103.751445
688796,1,1,2,1.398141,103.738804
688797,4,1,5,1.385068,103.751584
688798,58,230,288,1.37977,103.753308
688799,29,2286,2315,1.380541,103.753631
688800,25,4228,4253,1.380541,103.753631
688845,204,409,613,1.383169,103.751584
688846,1719,6881,8600,1.382301,103.750669
688847,65,643,708,1.382596,103.75036
688848,520,205,725,1.382536,103.755214
688892,340,5283,5623,1.381435,103.751861
688941,4,123,127,1.379654,103.758625
688942,2,92,94,1.379882,103.758139
688944,10,62,72,1.381255,103.755551
688945,159,37,196,1.381679,103.756524
688992,5,61,66,1.377899,103.747574
688993,39,118,157,1.377894,103.747536
688994,1,17,18,1.377882,103.747509
688995,3,5,8,1.377872,103.747454
688996,3,5,8,1.377847,103.74738
688997,1,3,4,1.391934,103.751015
688998,4,1,5,1.377813,103.747251
688999,116,29,145,1.377785,103.747126
689000,1,12,13,1.377779,103.747122
689001,3,39,42,1.377741,103.746962
689002,2,3,5,1.377744,103.746993
689003,2,11,13,1.377697,103.746798
689005,16,3,19,1.377654,103.746633
689006,0,1,1,1.398141,103.738804
689007,7,6,13,1.37761,103.746469
689008,14,1,15,1.377641,103.746607
689009,3,21,24,1.377566,103.746305
689010,8,3,11,1.377607,103.746478
689011,8,12,20,1.377522,103.746141
689012,0,5,5,1.377572,103.746349
689013,0,6,6,1.377479,103.745977
689014,12,6,18,1.377538,103.74622
689015,3,46,49,1.377445,103.745823
689016,0,8,8,1.377504,103.746091
689017,23,56,79,1.377436,103.745794
689018,1,0,1,1.377676,103.746736
689019,2,11,13,1.377427,103.745765
689020,0,25,25,1.377435,103.745833
689021,2,3,5,1.37741,103.745706
689022,42,20,62,1.377413,103.745785
689023,1,0,1,1.377469,103.745962
689024,5,2,7,1.377402,103.745747
689025,2,0,2,1.385123,103.751541
689026,1,1,2,1.377374,103.74559
689027,1,2,3,1.392208,103.750986
689029,0,7,7,1.377339,103.745473
689030,0,1,1,1.377392,103.745648
689031,27,3,30,1.377321,103.745415
689035,17,3,20,1.377286,103.745298
689036,3,1,4,1.377829,103.74729
689037,2,24,26,1.377268,103.74524
689038,1,0,1,1.377333,103.74552
689039,4,7,11,1.37725,103.745182
689040,1,1,2,1.377379,103.745671
689041,0,19,19,1.377233,103.745123
689043,2,11,13,1.377215,103.745065
689044,0,1,1,1.377241,103.745217
689045,6,0,6,1.377181,103.744952
689046,1,15,16,1.377167,103.744839
689047,797,243,1040,1.378183,103.747078
689048,701,27,728,1.378176,103.746234
689049,1421,15,1436,1.378499,103.746678
689050,1296,754,2050,1.378523,103.747425
689051,980,248,1228,1.377893,103.747535
689093,677,112,789,1.397775,103.751574
689094,245,107,352,1.397558,103.751056
689095,40,3,43,1.397886,103.75017
689096,546,276,822,1.397886,103.75017
689097,896,82,978,1.397886,103.75017
689098,108,86,194,1.398211,103.750968
689099,871,74,945,1.398105,103.751304
689100,259,310,569,1.396985,103.751221
689101,663,229,892,1.398885,103.750041
689102,1195,83,1278,1.398615,103.750978
689103,361,155,516,1.398657,103.751447
689104,679,119,798,1.399023,103.751423
689105,644,163,807,1.399125,103.750971
689106,705,522,1227,1.399288,103.750561
689143,138,61,199,1.40005,103.746125
689189,371,166,537,1.393694,103.747785
689220,2,1,3,1.377357,103.745531
689236,635,1231,1866,1.390985,103.748067
689284,88,1026,1114,1.394727,103.743903
689285,200,79,279,1.394304,103.743605
689286,257,469,726,1.394944,103.74487
689333,9,58,67,1.390468,103.741661
689334,31,70,101,1.39168,103.742861
689338,10,302,312,1.391496,103.74226
689344,2,542,544,1.391495,103.742261
689379,82,540,622,1.379236,103.759111
689382,126,45,171,1.299509,103.837
689385,34,447,481,1.378693,103.759231
689386,6,279,285,1.378532,103.758826
689387,0,20,20,1.378155,103.75811
689388,5,2,7,1.378093,103.758353
689389,3,131,134,1.378039,103.7583
689390,0,1,1,1.377195,103.745065
689391,0,141,141,1.377954,103.758177
689392,5,0,5,1.377932,103.758096
689393,7,38,45,1.377886,103.758026
689396,1,0,1,1.377904,103.758192
689397,0,9,9,1.377767,103.758489
689398,3,2,5,1.377727,103.758446
689399,2,2,4,1.377264,103.745292
689400,3,2,5,1.377685,103.758377
689401,2,3,5,1.377666,103.758344
689402,21,6,27,1.377443,103.757911
689403,1,8,9,1.377639,103.758306
689404,4,0,4,1.377709,103.758406
689405,3,0,3,1.299509,103.837
689407,34,1,35,1.377561,103.758169
689408,1,0,1,1.377795,103.757868
689409,6,2,8,1.377516,103.758096
689411,2,0,2,1.377218,103.745141
689412,3,0,3,1.377597,103.758234
689415,7,3,10,1.377446,103.758623
689416,3,2,5,1.377405,103.758576
689417,1,1,2,1.377462,103.758002
689418,5,2,7,1.377355,103.758491
689419,5,1,6,1.377324,103.758451
689422,1,0,1,1.377538,103.758132
689423,64,0,64,1.37722,103.758264
689424,6,1,7,1.377175,103.75821
689426,4,1,5,1.377107,103.758103
689428,7,0,7,1.377071,103.758018
689430,0,1,1,1.377251,103.758304
689432,14,0,14,1.377011,103.757921
689434,9,1,10,1.376979,103.75784
689435,1,0,1,1.377046,103.757982
689436,25,0,25,1.376828,103.75773
689437,1,16,17,1.377889,103.757482
689438,4,561,565,1.377823,103.757296
689439,1,0,1,1.376962,103.757808
689447,9,963,972,1.377392,103.747812
689448,2,216,218,1.377371,103.74774
689450,1,78,79,1.377328,103.747596
689451,3,137,140,1.377285,103.747452
689453,0,100,100,1.377241,103.747309
689454,0,24,24,1.377198,103.747165
689455,19,161,180,1.377155,103.747021
689456,6,73,79,1.377112,103.746877
689457,7,323,330,1.377069,103.746733
689458,1,149,150,1.377026,103.746589
689459,1,31,32,1.376982,103.746446
689460,0,23,23,1.376939,103.746302
689461,2,391,393,1.376896,103.746158
689462,7,108,115,1.376853,103.746014
689463,14,386,400,1.376922,103.74573
689464,19,215,234,1.376911,103.74569
689465,5,228,233,1.376887,103.745609
689466,27,938,965,1.376864,103.745529
689467,32,3331,3363,1.376841,103.745448
689471,37,1690,1727,1.380562,103.749103
689472,4,368,372,1.376389,103.744143
689473,31,201,232,1.376378,103.744012
689474,6,245,251,1.37634,103.743736
689475,2,261,263,1.376301,103.743429
689476,1,94,95,1.376655,103.743908
689477,7,419,426,1.376655,103.743854
689478,2,12,14,1.376505,103.737723
689479,1,2,3,1.377417,103.757917
689481,1,82,83,1.378544,103.758936
689482,12,145,157,1.378125,103.758465
689483,373,1318,1691,1.37864,103.758037
689484,27,1042,1069,1.376261,103.755621
689485,5,61,66,1.299509,103.837
689527,2545,1846,4391,1.398934,103.749105
689528,2265,19,2284,1.398909,103.749108
689529,531,258,789,1.398931,103.749079
689574,2113,945,3058,1.394469,103.751334
689575,2345,667,3012,1.394965,103.751325
689576,46,138,184,1.395343,103.750634
689577,1495,966,2461,1.395939,103.750812
689578,209,30,239,1.39729,103.746546
689579,519,419,938,1.396788,103.746565
689580,243,2003,2246,1.396788,103.746565
689581,14,614,628,1.299509,103.837
689621,577,237,814,1.393079,103.750966
689668,547,852,1399,1.386643,103.74503
689669,496,78,574,1.387216,103.744767
689670,752,64,816,1.387604,103.744764
689671,776,116,892,1.38797,103.744618
689672,967,553,1520,1.388317,103.745265
689673,1753,305,2058,1.387586,103.745438
689674,764,559,1323,1.386651,103.745143
689675,540,240,780,1.38602,103.742937
689676,444,167,611,1.385783,103.742455
689677,488,201,689,1.386074,103.742344
689678,22,2,24,1.386691,103.743132
689679,375,195,570,1.386335,103.742385
689680,288,28,316,1.386386,103.74259
689681,511,80,591,1.386538,103.742766
689682,340,163,503,1.386977,103.743129
689683,400,146,546,1.387185,103.743448
689684,765,180,945,1.387353,103.743784
689685,999,295,1294,1.386397,103.744041
689686,234,881,1115,1.386473,103.743384
689687,83,19825,19908,1.384342,103.745158
689715,5912,51783,57695,1.397314,103.74739
689716,37,1607,1644,1.395174,103.747007
689717,2,648,650,1.385695,103.746266
689718,2,240,242,1.299509,103.837
689719,33,1077,1110,1.388388,103.746321
689762,385,99,484,1.381324,103.747145
689809,205,1328,1533,1.38166,103.738424
689810,181,15,196,1.385659,103.744252
689811,5,47,52,1.385983,103.743784
689812,6447,64074,70521,1.384848,103.745046
689813,56,4057,4113,1.384819,103.744493
689814,141,82,223,1.380026,103.73625
689815,96,59,155,1.382345,103.739199
689858,187,1950,2137,1.378108,103.738001
689859,253,315,568,1.384366,103.748053
689860,1045,120,1165,1.384194,103.747846
689861,318,25,343,1.383991,103.747702
689862,354,471,825,1.383866,103.747454
689863,451,165,616,1.383609,103.747701
689864,528,134,662,1.383531,103.747922
689865,433,25,458,1.383639,103.748051
689866,266,33,299,1.383959,103.748191
689867,179,24,203,1.38419,103.748338
689868,30,125,155,1.384708,103.748429
689869,189,399,588,1.384495,103.749108
689870,246,42,288,1.38363,103.748668
689871,361,5,366,1.384495,103.749108
689872,209,8,217,1.384495,103.749108
689873,241,59,300,1.384495,103.749108
689874,374,42,416,1.383358,103.748467
689875,432,810,1242,1.384495,103.749108
689876,469,188,657,1.384495,103.749108
689877,56,97,153,1.299509,103.837
689905,214,72,286,1.378056,103.741723
689906,41,166,207,1.378187,103.744641
689907,44,1270,1314,1.37778,103.740755
689955,1,33,34,1.376162,103.742982
690000,1,41,42,1.378866,103.725504
698912,0,3,3,1.376769,103.755051
698913,0,2,2,1.377373,103.758536
698917,91,6,97,1.385992,103.724345
698918,70,534,604,1.375525,103.723353
698923,10,26,36,1.372169,103.710234
698924,484,1397,1881,1.37444,103.722242
698928,2155,166,2321,1.371947,103.720855
698930,407,232,639,1.372752,103.716611
698931,117,0,117,1.376096,103.724305
698932,976,785,1761,1.373238,103.687097
698933,14,297,311,1.374968,103.725602
698934,0,5,5,1.383901,103.720987
698936,2,5,7,1.387723,103.727326
698937,0,3,3,1.386052,103.723215
698938,0,2,2,1.389196,103.726461
698939,7,2,9,1.389845,103.727853
698940,55,18,73,1.37656,103.727406
698941,28,1,29,1.379572,103.725764
698942,4,10,14,1.37546,103.723718
698943,39,4,43,1.379644,103.724314
698944,81,0,81,1.38129,103.723606
698945,15,11,26,1.382817,103.723958
698946,21,8,29,1.380575,103.722129
698947,2,2,4,1.377619,103.758272
698948,36,4,40,1.38249,103.721846
698949,32,31,63,1.384682,103.724663
698950,299,119,418,1.385036,103.721658
698951,6,1,7,1.385829,103.725354
698952,0,2,2,1.387559,103.722703
698953,1,5,6,1.385434,103.722231
698954,659,571,1230,1.382829,103.694501
698955,40,454,494,1.374465,103.71621
698957,41,0,41,1.37657,103.711433
698958,0,8,8,1.366886,103.683223
698972,1,1,2,1.387449,103.727475
698974,34,3,37,1.391895,103.730028
698978,1,0,1,1.377823,103.757296
698982,1,1,2,1.392886,103.730598
698985,20,22,42,1.388384,103.731541
698986,19,6,25,1.39135,103.732407
698987,0,2,2,1.399326,103.728755
698988,16,0,16,1.397857,103.729465
698989,14,2,16,1.399129,103.729999
698990,1,0,1,1.393026,103.730956
698991,0,1,1,1.392057,103.7321
698992,15,14,29,1.395717,103.729895
698993,38,12,50,1.396269,103.730431
698994,27,1,28,1.396325,103.731677
698995,0,4,4,1.385114,103.723376
698996,13,239,252,1.383741,103.724376
698997,29,145,174,1.379703,103.730047
698998,135,107,242,1.379638,103.728378
698999,62,48,110,1.379355,103.727733
699001,1,1,2,1.396444,103.72981
699002,1,12,13,1.383429,103.728242
699003,26,19,45,1.384142,103.731586
699004,43,14,57,1.386494,103.732196
699005,5,13,18,1.383367,103.72999
699006,1,1,2,1.384011,103.728004
699007,14,0,14,1.395244,103.729533
699008,733,173,906,1.381899,103.726131
699011,14,0,14,1.383832,103.725846
699012,440,568,1008,1.380947,103.731387
699013,102,41,143,1.299509,103.837
699191,71,10,81,1.387162,103.728752
699392,1,3,4,1.392461,103.730783
699393,3,212,215,1.371776,103.712909
699795,32,1849,1881,1.374695,103.723331
699798,52,53,105,1.372222,103.701409
699799,0,11,11,1.372253,103.703721
699800,3671,3218,6889,1.377988,103.712657
699803,119,0,119,1.377903,103.712583
699804,30,0,30,1.377905,103.712586
699814,123,12,135,1.372276,103.683634
699815,144,53,197,1.374137,103.692571
699816,1343,608,1951,1.370735,103.688122
699817,573,236,809,1.372989,103.718491
699818,19,16,35,1.370598,103.686984
699819,65,556,621,1.37454,103.693193
700000,1,8,9,1.441751,103.706922
708970,20,112,132,1.389423,103.701607
708971,57,69,126,1.39723,103.69871
708972,666,331,997,1.38874,103.699234
708973,91,2,93,1.388732,103.699204
708974,57,294,351,1.382665,103.698792
708976,324,269,593,1.377253,103.699019
708977,513,1,514,1.384641,103.702724
708978,390,14,404,1.384657,103.702731
708979,39,599,638,1.38251,103.698044
709143,1,7,8,1.385035,103.696675
709144,0,2,2,1.385813,103.730209
709145,8,34,42,1.38489,103.696775
709147,12,11,23,1.385843,103.696362
709148,0,1,1,1.399608,103.729452
709149,0,21,21,1.38618,103.695427
709150,0,7,7,1.390568,103.693896
709152,1,0,1,1.38462,103.696042
709153,99,5,104,1.392462,103.696183
709154,3,71,74,1.38382,103.695193
709155,7,45,52,1.384549,103.694774
709314,6,2,8,1.395132,103.701626
709483,0,1,1,1.392717,103.695838
709484,1,0,1,1.408401,103.72424
709485,0,1,1,1.408428,103.724258
709654,50,25,75,1.44494,103.707548
709822,1,0,1,1.408503,103.724301
709823,7,52,59,1.403012,103.701381
709824,0,4,4,1.372413,103.73108
709825,0,1,1,1.402665,103.702676
709826,0,2,2,1.39311,103.69581
709827,0,459,459,1.403012,103.701381
709828,18,8,26,1.403468,103.702262
709829,2,25,27,1.403108,103.701119
709830,1,4,5,1.4029,103.703022
709831,40,1,41,1.403789,103.702576
710000,7,8,15,1.442187,103.72881
710001,8,25,33,1.422041,103.70337
710003,3,4,7,1.421248,103.704208
710004,1,0,1,1.403012,103.701381
710005,7,9,16,1.422058,103.703995
718793,192,7,199,1.299509,103.837
718794,23,0,23,1.299509,103.837
718798,57,0,57,1.419067,103.707473
718799,8,6,14,1.419074,103.706729
718803,4,1,5,1.429122,103.72043
718804,42,15,57,1.428903,103.720192
718809,1,2,3,1.388084,103.725673
718813,1093,99,1192,1.419323,103.718897
718814,67,5,72,1.418076,103.729646
718818,19,16,35,1.444763,103.729387
718819,8,0,8,1.439674,103.72799
718821,1,1,2,1.403012,103.701381
718827,149,4,153,1.428018,103.704296
718828,517,49,566,1.424085,103.728317
718829,0,1,1,1.421752,103.704573
718830,24,12,36,1.438503,103.727366
718831,1,5,6,1.435825,103.724622
718833,0,2,2,1.439515,103.718083
718834,16,0,16,1.425791,103.717928
718835,32,0,32,1.439222,103.726195
718836,32,45,77,1.427637,103.703459
718837,386,13,399,1.428863,103.703625
718838,6,1,7,1.429062,103.714101
718839,2,0,2,1.425866,103.713921
718840,0,2,2,1.43985,103.713448
718841,19,10,29,1.420078,103.717158
718843,136,8,144,1.441558,103.720631
718845,57,0,57,1.443831,103.712117
718846,16,0,16,1.421214,103.709091
718847,55,16,71,1.427298,103.705808
718848,2,8,10,1.424184,103.705457
718849,0,1,1,1.432213,103.718103
718850,8,0,8,1.431592,103.716535
718851,27,4,31,1.431724,103.717263
718852,1,6,7,1.434619,103.708966
718855,1,0,1,1.432445,103.716824
718858,6,15,21,1.432606,103.708281
718859,130,17,147,1.431605,103.7099
718860,16,2,18,1.436751,103.710455
718861,2,3,5,1.433679,103.717012
718863,2,0,2,1.425664,103.712465
718864,62,2,64,1.435682,103.716856
718866,14,1,15,1.437208,103.716569
718868,2,2,4,1.403012,103.701381
718869,0,1,1,1.432655,103.712465
718870,8,2,10,1.440477,103.719225
718871,1,1,2,1.434944,103.716104
718875,3,2,5,1.444211,103.713574
718876,0,3,3,1.435917,103.718575
718877,6,0,6,1.445421,103.714144
718879,9,1,10,1.446961,103.717114
718880,0,3,3,1.444784,103.713869
718881,0,1,1,1.439948,103.7186
718882,5,1,6,1.431704,103.712726
718883,1,5,6,1.428939,103.710743
718884,234,2,236,1.431835,103.713248
718885,7,0,7,1.430162,103.711779
718888,0,1,1,1.430878,103.710918
718890,7,5,12,1.429691,103.71608
718892,0,1,1,1.430703,103.714326
718893,1,0,1,1.427966,103.714379
718895,6,2,8,1.434321,103.72298
718896,3,0,3,1.426966,103.707134
718898,131,10,141,1.441461,103.729786
718899,7,0,7,1.444753,103.729397
718900,3,3,6,1.439146,103.726827
718901,65,5,70,1.442559,103.728537
718902,10,0,10,1.440458,103.730704
718903,188,11,199,1.444319,103.728998
718904,13,9,22,1.439541,103.730985
718905,29,0,29,1.421998,103.710679
718906,1,0,1,1.428988,103.716332
718907,3,0,3,1.43505,103.723608
718909,9,0,9,1.423297,103.712107
718910,2,0,2,1.442183,103.72134
718911,59,19,78,1.423144,103.716944
718912,40,3,43,1.425288,103.716351
718913,0,1,1,1.421115,103.712887
718914,52,19,71,1.440561,103.733032
718915,179,6,185,1.427308,103.705818
718916,860,870,1730,1.419419,103.697467
718917,13,1,14,1.435585,103.708746
718921,4183,4,4187,1.419462,103.697276
718924,21,21,42,1.43624,103.707986
718925,1199,64,1263,1.446721,103.730055
718926,8,0,8,1.44703,103.716171
718927,3,2,5,1.435667,103.712308
718928,4,0,4,1.438386,103.717302
718929,5,11,16,1.425873,103.721174
719011,5,10,15,1.419555,103.706161
719018,1,8,9,1.416446,103.717535
719019,1,6,7,1.421759,103.716498
719020,1,0,1,1.437117,103.725135
719021,0,1,1,1.427471,103.719317
719022,5,0,5,1.431684,103.722536
719023,6,8,14,1.43175,103.724543
719024,0,5,5,1.433116,103.724534
719025,2,6,8,1.416523,103.710946
719026,572,4,576,1.418319,103.716853
719027,51,3,54,1.418012,103.710324
719028,4,0,4,1.433123,103.71449
719029,2,3,5,1.420122,103.708465
719030,3,3,6,1.41974,103.709537
719031,42,10,52,1.438332,103.729372
719095,12,3,15,1.414598,103.718377
719098,7,10,17,1.416361,103.716851
719099,47,61,108,1.299729,103.857084
719419,22,2,24,1.440462,103.707778
719452,128,108,236,1.372574,103.694593
719453,0,6,6,1.437353,103.707644
719454,23,267,290,1.419373,103.702155
719455,23,1,24,1.440498,103.70738
719456,2,4,6,1.438177,103.705047
719457,1,1,2,1.423506,103.715012
719529,3,4,7,1.445424,103.710103
719530,1,0,1,1.43068,103.723091
719607,15,3,18,1.44031,103.710185
719608,8,2,10,1.439256,103.709375
719685,7,9,16,1.441793,103.70922
719688,1,0,1,1.443575,103.713129
719689,33,1,34,1.440615,103.711381
719766,0,1,1,1.443313,103.710343
719767,3,0,3,1.423534,103.707476
719842,11,4,15,1.42976,103.707735
719843,1,1,2,1.441128,103.706318
719920,61,31,92,1.437348,103.699409
719921,304,7,311,1.43892,103.701805
719922,38,3,41,1.438833,103.700521
728635,60,10,70,1.407511,103.762637
728640,64,9,73,1.299509,103.837
728641,33,4,37,1.299509,103.837
728642,3,1,4,1.419875,103.707244
728643,104,3,107,1.435924,103.745109
728644,1,0,1,1.442341,103.716416
728645,3,0,3,1.443058,103.71771
728646,8,13,21,1.435419,103.745778
728647,9,15,24,1.435025,103.745986
728648,181,76,257,1.433277,103.747698
728649,112,22,134,1.436749,103.745721
728650,9,265,274,1.411461,103.757395
728651,36,86,122,1.410674,103.757681
728652,343,1477,1820,1.409559,103.756976
728653,778,97,875,1.408579,103.756335
728654,32,45,77,1.299509,103.837
728655,35,2,37,1.43185,103.750379
728656,19,8,27,1.433746,103.75087
728657,6,21,27,1.4329,103.750545
728660,101,110,211,1.434139,103.750285
728661,112,2,114,1.432297,103.749786
728662,59,9,68,1.432426,103.749265
728663,14,97,111,1.434448,103.75112
728664,515,7,522,1.410618,103.756705
728665,1,1,2,1.430666,103.707752
728666,8,0,8,1.435092,103.745035
728667,12,0,12,1.434967,103.745101
728668,4,0,4,1.299509,103.837
728669,7,0,7,1.434794,103.745253
728670,5,1,6,1.434672,103.745292
728671,17,0,17,1.434604,103.745363
728672,0,1,1,1.299509,103.837
728673,10,0,10,1.434398,103.745521
728674,9,0,9,1.434302,103.745552
728675,165,1,166,1.434175,103.745651
728676,4,3,7,1.434076,103.745715
728677,6,47,53,1.4363,103.746282
728678,24,39,63,1.432967,103.750593
728679,7,0,7,1.432749,103.747754
728680,28,6,34,1.433574,103.747396
728681,321,82,403,1.407366,103.762447
728682,428,34,462,1.410059,103.745577
728683,150,35,185,1.410853,103.744595
728684,9,6,15,1.408547,103.744905
728685,2,11,13,1.409884,103.74498
728686,21,0,21,1.409216,103.744943
728687,10,24,34,1.410449,103.744496
728688,590,174,764,1.408936,103.74565
728689,81,48,129,1.409438,103.745629
728696,81,20,101,1.410026,103.744468
728697,73,311,384,1.407849,103.757051
728770,56,54,110,1.4078,103.748602
728771,0,164,164,1.406994,103.748129
728772,45,9,54,1.40632,103.747559
728773,7,882,889,1.407224,103.750676
728774,6,34,40,1.406887,103.751656
728775,78,149,227,1.407435,103.751962
728776,38,95,133,1.408022,103.751721
728777,39,91,130,1.405937,103.751047
728778,9,9,18,1.406989,103.748441
728779,12,0,12,1.407151,103.751293
728780,5,5,10,1.40579,103.751476
728781,9,87,96,1.407367,103.749346
728782,12,133,145,1.406356,103.748006
728783,0,2,2,1.43516,103.744972
728784,2,51,53,1.406106,103.75039
728785,53,96,149,1.406022,103.750706
728786,160,150,310,1.406337,103.74701
728787,348,2,350,1.406698,103.75303
728788,181,6,187,1.40634,103.748992
728789,117,5,122,1.40626,103.750048
728790,144,44,188,1.405476,103.752934
728791,47,590,637,1.407335,103.750094
728792,46,483,529,1.406771,103.752064
728793,3,3,6,1.406348,103.749483
728794,109,655,764,1.406627,103.749602
728850,4,149,153,1.429748,103.747476
728851,18,14,32,1.429647,103.747947
728852,9,4,13,1.428947,103.748399
728853,390,0,390,1.42895,103.7483
728854,13,40,53,1.429,103.748695
728855,26,0,26,1.429553,103.749098
728856,15,0,15,1.429104,103.749287
728857,9,0,9,1.429208,103.749878
728858,5,4,9,1.429313,103.75047
728859,9,0,9,1.428048,103.750254
728860,1,0,1,1.434831,103.745921
728861,6,1,7,1.427981,103.749864
728862,23,3,26,1.430277,103.749996
728863,144,5,149,1.427846,103.749082
728864,9,0,9,1.430536,103.750284
728865,40,7,47,1.428179,103.748784
728866,11,0,11,1.430727,103.750536
728867,3,4,7,1.429323,103.75048
728868,3,6,9,1.428115,103.750645
728869,2,2,4,1.43489,103.745164
728870,19,5,24,1.427724,103.750341
728871,34,12,46,1.427624,103.749713
728872,3,2,5,1.427692,103.748301
728873,62,11,73,1.427702,103.748291
728874,12,24,36,1.428895,103.748103
728947,168,33,201,1.423519,103.749506
728948,17,3,20,1.422571,103.74906
728949,13,67,80,1.423459,103.74891
728950,10,13,23,1.422776,103.748244
728951,39,3,42,1.42419,103.748447
728952,3,0,3,1.434007,103.745122
728953,1,5,6,1.423951,103.747394
728954,43,0,43,1.423401,103.747062
728955,31,10,41,1.425028,103.746552
728956,34,18,52,1.422939,103.746188
728957,63,24,87,1.423453,103.745052
729030,23,85,108,1.419542,103.75034
729031,16,1,17,1.418986,103.749845
729032,19,8,27,1.419534,103.75018
729033,6,9,15,1.418891,103.749241
729034,1,5,6,1.419708,103.748592
729035,25,0,25,1.418763,103.748896
729036,239,4,243,1.419657,103.747876
729037,37,26,63,1.418619,103.748076
729038,13,0,13,1.419047,103.747377
729039,9,4,13,1.419055,103.747537
729040,122,0,122,1.418853,103.746256
729041,28,10,38,1.418664,103.74734
729042,60,14,74,1.419392,103.746046
729043,1,1,2,1.405572,103.75178
729044,136,17,153,1.419363,103.745389
729045,151,7,158,1.418548,103.745119
729046,39,37,76,1.420798,103.744962
729047,6,0,6,1.420106,103.745922
729048,668,53,721,1.419458,103.743601
729049,3,0,3,1.42238,103.747724
729050,29,0,29,1.42065,103.748083
729051,21,13,34,1.42043,103.748516
729052,52,0,52,1.420967,103.748852
729053,45,8,53,1.421279,103.749112
729054,228,28,256,1.42199,103.744723
729055,207,4,211,1.421249,103.745595
729056,58,9,67,1.421158,103.746006
729057,30,0,30,1.421695,103.746723
729058,201,18,219,1.421108,103.746754
729059,15,6,21,1.421599,103.747631
729060,31,10,41,1.421198,103.747584
729061,142,13,155,1.421263,103.747994
729062,11,0,11,1.421985,103.749169
729063,5,7,12,1.422016,103.749586
729064,200,13,213,1.418777,103.745936
729066,50,52,102,1.299509,103.837
729136,21,55,76,1.417406,103.7511
729137,95,6,101,1.418013,103.75061
729138,14,16,30,1.416327,103.749366
729139,66,1,67,1.417809,103.749706
729140,26,22,48,1.416027,103.748768
729141,1,0,1,1.429263,103.750076
729142,898,242,1140,1.416297,103.748057
729143,1672,447,2119,1.415791,103.747393
729144,26,1,27,1.41735,103.747485
729145,119,13,132,1.41762,103.74689
729146,79,0,79,1.415682,103.74678
729147,73,30,103,1.417015,103.746345
729148,212,0,212,1.415362,103.745503
729149,23,19,42,1.417548,103.745926
729150,10,55,65,1.417082,103.745571
729151,57,0,57,1.416219,103.745379
729152,5,24,29,1.416673,103.744838
729153,155,209,364,1.416508,103.744194
729154,5,0,5,1.41782,103.748291
729226,160,64,224,1.412769,103.751567
729227,50,61,111,1.411719,103.75013
729228,191,17,208,1.412707,103.751171
729229,48,2,50,1.412584,103.750378
729230,324,28,352,1.41231,103.749543
729231,10,1,11,1.41246,103.749586
729232,7,4,11,1.41101,103.749471
729234,2033,8,2041,1.409928,103.748693
729235,2,2,4,1.427834,103.751046
729236,48,62,110,1.412373,103.74767
729237,7,7,14,1.410475,103.746805
729238,1,6,7,1.4126,103.747061
729239,0,6,6,1.414539,103.746079
729240,13,26,39,1.414332,103.747735
729241,2,5,7,1.413688,103.747754
729242,0,6,6,1.415139,103.749299
729243,29,4,33,1.415397,103.749967
729244,90,5,95,1.413523,103.748226
729245,701,21,722,1.414203,103.750467
729246,41,20,61,1.414952,103.7516
729247,8,126,134,1.412082,103.74739
729248,293,33,326,1.413804,103.746534
729321,10,114,124,1.408883,103.751997
729322,0,136,136,1.409335,103.752468
729323,19,3,22,1.409848,103.75193
729324,10,0,10,1.410051,103.751447
729325,56,13,69,1.409941,103.750851
729326,7,16,23,1.409789,103.750062
729327,51,4,55,1.40973,103.749741
729328,195,93,288,1.409635,103.749253
729329,8,13,21,1.409548,103.748798
729330,3,31,34,1.410253,103.752408
729331,8,2,10,1.410341,103.75072
729332,10,2,12,1.409874,103.750312
729333,457,67,524,1.409796,103.749883
729334,516,20,536,1.40928,103.748047
729335,308,199,507,1.411522,103.751568
729336,2,160,162,1.413186,103.751901
729337,12,168,180,1.413541,103.751839
729338,4,0,4,1.412652,103.74848
729339,81,700,781,1.408351,103.753542
729340,9,124,133,1.414092,103.751169
729341,222,156,378,1.409966,103.754054
729342,104,22,126,1.415166,103.751548
729343,13,1,14,1.410347,103.753259
729344,32,3,35,1.415717,103.750903
729345,11,55,66,1.416292,103.750822
729346,136,5,141,1.411358,103.753402
729347,74,6,80,1.411977,103.753112
729348,41,203,244,1.416656,103.750667
729349,59,92,151,1.412879,103.753552
729350,141,69,210,1.413896,103.75263
729351,7,71,78,1.418736,103.750507
729352,15,77,92,1.415809,103.75231
729353,15,1,16,1.416539,103.752301
729354,186,40,226,1.41989,103.750146
729355,21,1,22,1.416967,103.752272
729356,20,75,95,1.417369,103.751876
729357,5,0,5,1.417977,103.752086
729358,212,84,296,1.421571,103.750362
729359,29,55,84,1.418613,103.752717
729360,5,92,97,1.422736,103.7497
729361,40,0,40,1.419625,103.75264
729362,12,199,211,1.420481,103.751349
729363,168,107,275,1.421243,103.752349
729364,28,40,68,1.42157,103.750381
729365,113,242,355,1.422216,103.750801
729366,12,1,13,1.425942,103.748158
729367,481,202,683,1.42309,103.75136
729368,245,1,246,1.423578,103.750081
729369,77,66,143,1.426021,103.746912
729370,198,10,208,1.423972,103.75077
729371,237,26,263,1.424916,103.751569
729372,56,15,71,1.425214,103.75007
729373,0,23,23,1.425921,103.750565
729374,610,168,778,1.426308,103.750203
729375,6,49,55,1.427641,103.748002
729376,57,153,210,1.410732,103.753278
729377,63,0,63,1.41445,103.752499
729378,1,1,2,1.418638,103.745135
729448,3,65,68,1.420254,103.742488
729449,126,74,200,1.421,103.742365
729450,9,3,12,1.419728,103.741986
729452,0,4,4,1.414252,103.751714
729453,267,2,269,1.42088,103.741495
729454,0,1,1,1.417661,103.748673
729455,438,37,475,1.420451,103.740993
729456,31,3,34,1.419212,103.741183
729457,3,0,3,1.420407,103.746909
729459,73,20,93,1.418059,103.742116
729460,1,1,2,1.422621,103.752217
729462,124,39,163,1.417671,103.742243
729463,48,0,48,1.417739,103.741678
729465,0,3,3,1.418737,103.741728
729466,15,0,15,1.416509,103.742622
729467,13,2,15,1.416449,103.742166
729469,5,19,24,1.416192,103.743344
729470,15,1,16,1.415889,103.742359
729471,11,25,36,1.415864,103.743463
729472,6,4,10,1.415548,103.742468
729474,36,0,36,1.41362,103.74361
729475,9,50,59,1.412878,103.743709
729476,62,0,62,1.411768,103.742971
729477,15,21,36,1.411505,103.743538
729478,8,6,14,1.411323,103.742434
729479,11,2,13,1.407781,103.745563
729480,3,2,5,1.417267,103.741886
729481,33,85,118,1.416121,103.742749
729482,11,44,55,1.413375,103.743657
729483,4,155,159,1.40837,103.745945
729484,45,126,171,1.408317,103.745388
729485,0,29,29,1.418446,103.74199
729486,0,17,17,1.414593,103.743302
729487,9,1,10,1.412538,103.743139
729488,86,3,89,1.415346,103.742982
729489,48,1963,2011,1.404638,103.754948
729490,1049,116,1165,1.408306,103.743327
729491,42,70,112,1.412186,103.743696
729492,101,60,161,1.410931,103.743997
729493,224,68,292,1.407623,103.743411
729494,46,15,61,1.414159,103.744157
729495,139,6,145,1.412186,103.743716
729496,12,16,28,1.417284,103.742369
729497,78,81,159,1.410534,103.743879
729498,43,111,154,1.409562,103.743879
729499,66,32,98,1.413249,103.744464
729500,275,140,415,1.408918,103.742776
729501,449,70,519,1.410543,103.742592
729502,24,0,24,1.410171,103.74327
729503,123,70,193,1.407364,103.744075
729504,1034,116,1150,1.407034,103.744609
729505,597,160,757,1.409771,103.742771
729506,3,23,26,1.414807,103.743927
729507,1207,137,1344,1.408197,103.742877
729508,38,176,214,1.415247,103.743749
729509,28,138,166,1.413803,103.744303
729510,9,39,48,1.408972,103.743277
729511,7,9,16,1.40666,103.745128
729512,365,1,366,1.411566,103.744165
729513,41,411,452,1.407087,103.745986
729514,2,0,2,1.418271,103.741542
729553,12,17,29,1.434802,103.748775
729554,3,0,3,1.416813,103.742027
729555,33,7,40,1.434515,103.748029
729556,161,15,176,1.432246,103.748346
729558,8,72,80,1.431053,103.748462
729560,9,102,111,1.430816,103.747621
729562,9,0,9,1.41882,103.742339
729563,394,185,579,1.418543,103.743755
729564,347,128,475,1.41454,103.745378
729565,26,40,66,1.409655,103.746749
729566,256,142,398,1.409215,103.746822
729567,5,14,19,1.413943,103.745237
729568,174,139,313,1.41348,103.745691
729569,90,27,117,1.411272,103.745354
729570,30,2,32,1.404875,103.752773
729571,8,35,43,1.41066,103.745396
729572,156,1,157,1.411949,103.745305
729573,293,340,633,1.412586,103.744863
729574,8,130,138,1.432247,103.747006
729575,48,10,58,1.413994,103.745788
729576,5,5,10,1.431815,103.747049
729577,360,213,573,1.412857,103.746161
729639,207,51,258,1.398983,103.75432
729640,8,26,34,1.398983,103.7543
729641,26,153,179,1.400151,103.755117
729642,18,172,190,1.399431,103.753593
729643,22,16,38,1.400801,103.755111
729644,2,44,46,1.400419,103.753578
729645,119,102,221,1.401787,103.755362
729646,17,52,69,1.401346,103.753817
729647,10,12,22,1.401448,103.754265
729648,1755,556,2311,1.402668,103.755387
729649,11,45,56,1.402322,103.754446
729650,12,84,96,1.403406,103.755412
729651,19,55,74,1.402332,103.754456
729652,120,20,140,1.403843,103.75549
729653,0,41,41,1.403227,103.754643
729654,20,29,49,1.403237,103.754653
729655,2,130,132,1.405344,103.755091
729656,2,80,82,1.404779,103.754957
729657,61,62,123,1.40605,103.755234
729659,25,2493,2518,1.407307,103.755364
729660,27,16,43,1.407394,103.753568
729661,20,187,207,1.408936,103.751487
729662,2,0,2,1.414521,103.744012
729663,81,23,104,1.40789,103.750906
729664,7,81,88,1.408285,103.750975
729665,147,94,241,1.407939,103.750185
729666,32,40,72,1.408247,103.750231
729667,22,21,43,1.408753,103.750079
729668,40,100,140,1.407823,103.749284
729669,11,68,79,1.408692,103.749264
729670,24,1050,1074,1.407426,103.747753
729671,289,249,538,1.408602,103.748792
729672,8,145,153,1.408797,103.74833
729673,380,250,630,1.407977,103.747261
729674,10,27,37,1.408635,103.747628
729675,106,1713,1819,1.408649,103.746929
729677,30,516,546,1.407541,103.752958
729678,55,1389,1444,1.406755,103.755377
729679,538,236,774,1.40609,103.75483
729680,196,165,361,1.39868,103.754543
729750,13,182,195,1.411065,103.761094
729752,6,265,271,1.411267,103.756341
729753,56,44,100,1.407963,103.7745
729754,1098,548,1646,1.406889,103.769457
729755,63,425,488,1.407865,103.774496
729756,264,810,1074,1.406734,103.769481
729757,4,163,167,1.414083,103.784574
729758,118,141,259,1.299509,103.837
729759,11,801,812,1.411247,103.776369
729760,8,0,8,1.299509,103.837
729825,1,181,182,1.406756,103.783213
729826,7806,78778,86584,1.404971,103.790678
729827,9,201,210,1.406761,103.783642
729829,38,19,57,1.299509,103.837
729900,105,40,145,1.405508,103.757206
729901,4,52,56,1.406036,103.757656
729902,9,156,165,1.407229,103.758549
729903,160,32,192,1.407119,103.757638
729904,10,29,39,1.408042,103.758571
729905,8,7,15,1.407279,103.758692
729906,265,16,281,1.408975,103.75891
729907,14,118,132,1.408256,103.759564
729908,579,25,604,1.408594,103.759779
729909,0,1,1,1.419162,103.742133
729910,61,27,88,1.406747,103.760167
729911,249,9,258,1.407741,103.759753
729912,3,18,21,1.406355,103.758973
729913,1,15,16,1.406757,103.760177
729914,11,2,13,1.406625,103.75884
729915,0,2,2,1.408889,103.751086
729916,2,1,3,1.434703,103.748909
729917,97,16,113,1.40694,103.759165
729918,204,42,246,1.406025,103.758371
729920,2,23,25,1.405421,103.757764
729921,4,0,4,1.419441,103.742266
729922,7,4,11,1.405554,103.75775
729923,10,1853,1863,1.405643,103.757741
729924,8,18,26,1.405732,103.757733
729925,0,2,2,1.406894,103.758708
729926,5,17,22,1.405909,103.757715
729927,208,34,242,1.405998,103.757706
729928,49,3480,3529,1.406821,103.757065
729929,131,145,276,1.406093,103.757013
729930,350,8,358,1.406737,103.760177
729931,100,33,133,1.406086,103.759105
729932,694,35,729,1.405389,103.758592
729933,576,96,672,1.405377,103.757768
729934,113,24,137,1.408256,103.759584
729935,116,107,223,1.406318,103.759576
729937,355,10,365,1.406673,103.760198
729938,323,3,326,1.406427,103.757699
729939,14,13,27,1.405925,103.759201
729940,193,36,229,1.40723,103.758193
729941,9,3,12,1.299509,103.837
730001,556,367,923,1.440718,103.776477
730002,615,205,820,1.440718,103.776477
730003,586,343,929,1.438867,103.776546
730004,334,318,652,1.439545,103.7749
730005,577,313,890,1.439545,103.7749
730006,650,166,816,1.441188,103.775964
730007,561,136,697,1.441188,103.775964
730008,591,98,689,1.441188,103.775964
730009,339,2576,2915,1.441188,103.775964
730010,213,3628,3841,1.441188,103.775964
730011,229,2123,2352,1.441188,103.775964
730012,448,1735,2183,1.441588,103.779347
730013,248,1595,1843,1.441588,103.779347
730015,524,1548,2072,1.442047,103.778224
730016,347,505,852,1.442249,103.777941
730017,684,1990,2674,1.44282,103.777703
730018,223,14723,14946,1.443049,103.777685
730019,511,225,736,1.442977,103.777277
730020,75,937,1012,1.444249,103.777745
730021,47,1380,1427,1.444249,103.777745
730022,290,1345,1635,1.442659,103.774277
730023,494,2335,2829,1.441628,103.77273
730024,562,1544,2106,1.441578,103.772549
730025,608,263,871,1.441967,103.772454
730026,452,543,995,1.441973,103.772688
730027,725,1040,1765,1.442659,103.774277
730028,489,491,980,1.442659,103.774277
730029,367,1411,1778,1.442659,103.774277
730030,459,335,794,1.442339,103.772406
730031,590,180,770,1.444253,103.772675
730032,350,5452,5802,1.444253,103.772675
730033,703,106,809,1.444253,103.772675
730034,398,264,662,1.444253,103.772675
730035,567,127,694,1.445117,103.772459
730036,212,4792,5004,1.445117,103.772459
730037,123,154,277,1.445117,103.772459
730101,400,952,1352,1.43603,103.781849
730102,543,1346,1889,1.436088,103.781142
730103,138,50,188,1.436607,103.78098
730104,464,246,710,1.43651,103.781501
730105,794,86,880,1.4369,103.781458
730106,143,1783,1926,1.436709,103.782174
730107,287,1371,1658,1.437361,103.782182
730108,814,174,988,1.437235,103.78149
730109,43,15,58,1.437438,103.781004
730110,577,124,701,1.437627,103.781494
730111,523,1810,2333,1.437911,103.78198
730112,241,635,876,1.438277,103.781609
730113,316,33,349,1.437937,103.78113
730114,189,1846,2035,1.438772,103.781142
730115,376,208,584,1.438325,103.780865
730116,70,67,137,1.438095,103.780304
730117,48,22,70,1.43824,103.780039
730118,241,229,470,1.43847,103.780462
730119,360,225,585,1.438829,103.780229
730120,554,2876,3430,1.439225,103.780447
730121,28,63,91,1.439101,103.779897
730122,25,123,148,1.439109,103.779628
730123,458,165,623,1.439191,103.779209
730124,461,165,626,1.438843,103.779348
730125,624,151,775,1.438535,103.779419
730126,63,66,129,1.438236,103.779794
730127,71,124,195,1.438176,103.779383
730128,457,61,518,1.437475,103.778734
730129,435,139,574,1.437807,103.778478
730130,512,493,1005,1.438134,103.778458
730131,1081,272,1353,1.438494,103.778403
730132,23,212,235,1.438284,103.777968
730133,79,86,165,1.437529,103.77809
730134,535,81,616,1.436837,103.777604
730135,83,181,264,1.437576,103.777683
730136,371,5330,5701,1.438646,103.777659
730137,629,4159,4788,1.438424,103.777094
730138,374,408,782,1.438073,103.777232
730139,322,115,437,1.437717,103.777248
730140,119,202,321,1.437669,103.776703
730141,343,99,442,1.437353,103.776948
730142,274,199,473,1.436994,103.776959
730143,71,17,88,1.436839,103.776663
730144,43,2279,2322,1.436028,103.772465
730145,333,367,700,1.436102,103.773162
730146,347,781,1128,1.436103,103.773958
730147,67,257,324,1.436022,103.774738
730148,332,208,540,1.435794,103.773914
730149,366,150,516,1.435792,103.772935
730150,27,15,42,1.435307,103.773682
730151,196,70,266,1.435424,103.774296
730152,156,111,267,1.435065,103.774345
730153,47,680,727,1.43516,103.774887
730154,298,1147,1445,1.43483,103.775241
730155,445,149,594,1.434773,103.7746
730156,18,6,24,1.434253,103.774323
730157,681,146,827,1.434425,103.774821
730158,221,141,362,1.43405,103.774832
730159,115,246,361,1.433713,103.774704
730160,391,331,722,1.433348,103.77471
730161,284,311,595,1.433317,103.773305
730162,280,2211,2491,1.432986,103.773233
730163,3,23,26,1.433083,103.773988
730164,3,21,24,1.433084,103.774212
730165,208,296,504,1.432984,103.775124
730166,278,1150,1428,1.434267,103.775423
730167,126,338,464,1.433204,103.775832
730168,546,134,680,1.433008,103.776388
730169,245,232,477,1.433287,103.776438
730170,360,316,676,1.433602,103.776441
730171,335,207,542,1.433961,103.776463
730172,404,199,603,1.433986,103.777364
730173,425,370,795,1.432992,103.77769
730174,417,116,533,1.433329,103.777679
730175,231,152,383,1.43365,103.777657
730176,70,91,161,1.433532,103.778327
730177,437,272,709,1.434385,103.777975
730178,442,509,951,1.434542,103.77754
730179,46,174,220,1.4348,103.778161
730180,47,5278,5325,1.439237,103.778185
730181,0,48,48,1.299509,103.837
730182,0,14,14,1.434997,103.787644
730183,0,179,179,1.299509,103.837
730201,291,2369,2660,1.443275,103.774325
730202,563,3724,4287,1.443275,103.774325
730203,321,2376,2697,1.443275,103.774325
730204,677,308,985,1.443275,103.774325
730205,1141,510,1651,1.444662,103.772723
730206,424,2382,2806,1.444662,103.772723
730210,22,183,205,1.446698,103.773833
730211,258,4317,4575,1.446698,103.773833
730212,232,3426,3658,1.446698,103.773833
730213,62,10,72,1.446698,103.773833
730214,62,35,97,1.446592,103.773836
730215,850,368,1218,1.446592,103.773836
730216,867,214,1081,1.446592,103.773836
730217,623,264,887,1.446698,103.773833
730218,360,922,1282,1.446698,103.773833
730301,233,6312,6545,1.431601,103.77371
730302,423,3156,3579,1.431536,103.774639
730303,504,1170,1674,1.430999,103.774003
730304,95,3899,3994,1.429969,103.773743
730305,46,961,1007,1.430465,103.774129
730306,201,281,482,1.429942,103.774809
730307,548,1486,2034,1.429472,103.776427
730308,427,334,761,1.42983,103.776519
730309,62,40,102,1.429749,103.775955
730310,326,197,523,1.430142,103.775952
730311,339,389,728,1.430487,103.776134
730312,86,143,229,1.430703,103.77559
730313,577,244,821,1.430768,103.77607
730314,433,87,520,1.431114,103.776009
730315,41,291,332,1.431475,103.775796
730316,373,418,791,1.431552,103.776199
730317,462,2529,2991,1.431833,103.77612
730318,610,2834,3444,1.431836,103.777235
730319,397,220,617,1.431558,103.777265
730320,128,1040,1168,1.431545,103.778065
730321,643,2806,3449,1.431839,103.779032
730322,702,394,1096,1.431493,103.778979
730323,447,328,775,1.431189,103.779234
730324,96,3790,3886,1.431251,103.779671
730325,779,305,1084,1.430809,103.779283
730326,466,214,680,1.430436,103.779271
730327,132,1570,1702,1.430263,103.78017
730328,433,254,687,1.430075,103.779302
730329,45,212,257,1.430413,103.778818
730330,71,150,221,1.429749,103.778517
730331,281,1561,1842,1.42946,103.778521
730332,12,66,78,1.429716,103.779085
730333,88,96,184,1.429791,103.779953
730334,79,298,377,1.429952,103.780215
730335,395,1407,1802,1.429766,103.780566
730336,542,3963,4505,1.430409,103.781799
730337,251,563,814,1.430715,103.781639
730338,59,397,456,1.430683,103.781126
730339,403,334,737,1.43103,103.781468
730340,329,396,725,1.431307,103.781247
730341,343,163,506,1.431546,103.781053
730342,129,225,354,1.431953,103.781
730343,28,204,232,1.431827,103.780623
730344,243,332,575,1.432036,103.780323
730345,296,1271,1567,1.432318,103.780201
730346,286,422,708,1.432415,103.780837
730347,486,1633,2119,1.433186,103.781518
730348,488,283,771,1.432965,103.781777
730349,464,336,800,1.433576,103.782466
730350,658,2119,2777,1.433801,103.782169
730351,562,175,737,1.432067,103.784188
730352,306,2191,2497,1.43168,103.784662
730353,476,3292,3768,1.431827,103.78518
730354,196,136,332,1.432385,103.785053
730355,384,147,531,1.43286,103.78448
730356,306,187,493,1.43328,103.784868
730357,257,106,363,1.433133,103.784366
730358,571,178,749,1.43365,103.783674
730359,255,1396,1651,1.434288,103.783908
730360,141,257,398,1.434182,103.784283
730361,188,1179,1367,1.433949,103.784852
730362,183,481,664,1.43376,103.785153
730363,477,1511,1988,1.433881,103.785536
730364,505,14828,15333,1.434009,103.786441
730365,673,3252,3925,1.434241,103.78775
730366,165,25,190,1.433856,103.78758
730367,265,198,463,1.43351,103.786426
730368,189,67,256,1.433227,103.786591
730369,839,1068,1907,1.433486,103.787497
730370,322,1165,1487,1.432547,103.787319
730371,544,3687,4231,1.432301,103.786651
730401,137,2814,2951,1.430182,103.772749
730402,293,787,1080,1.431006,103.772189
730403,201,79,280,1.430713,103.772221
730404,175,89,264,1.430297,103.772226
730405,312,246,558,1.429994,103.772262
730406,381,578,959,1.429359,103.772663
730408,364,682,1046,1.42878,103.772522
730409,223,588,811,1.429094,103.77344
730410,161,132,293,1.428632,103.773345
730411,435,147,582,1.428481,103.772731
730412,217,117,334,1.428071,103.772765
730413,174,1393,1567,1.427778,103.772758
730414,476,858,1334,1.427926,103.773339
730415,153,782,935,1.42788,103.774081
730416,367,67,434,1.428318,103.773881
730417,379,226,605,1.428807,103.774113
730418,627,2663,3290,1.428822,103.774604
730419,603,175,778,1.428514,103.774553
730420,191,96,287,1.428065,103.774581
730421,139,1314,1453,1.427791,103.774609
730424,212,1209,1421,1.427247,103.774511
730425,351,1531,1882,1.427239,103.774008
730426,238,1233,1471,1.42724,103.773182
730427,599,888,1487,1.427217,103.772618
730428,280,245,525,1.426952,103.772717
730429,460,386,846,1.426573,103.772873
730436,677,357,1034,1.426599,103.774332
730437,422,235,657,1.42696,103.774436
730501,215,1064,1279,1.432983,103.792047
730502,368,898,1266,1.433284,103.791802
730503,365,155,520,1.432492,103.791855
730504,269,62,331,1.433001,103.790911
730505,280,153,433,1.432213,103.791232
730506,223,102,325,1.432571,103.790712
730507,509,1348,1857,1.43181,103.790713
730508,194,718,912,1.432087,103.790454
730509,520,1665,2185,1.432588,103.789047
730510,966,1814,2780,1.432745,103.788276
730511,1365,792,2157,1.43362,103.788454
730512,222,672,894,1.434155,103.788564
730513,1842,1654,3496,1.433755,103.789521
730514,715,1680,2395,1.434786,103.789491
730515,506,2112,2618,1.434924,103.790247
730516,742,597,1339,1.434841,103.791105
730517,806,1117,1923,1.433836,103.791635
730518,748,45,793,1.434406,103.791574
730519,758,516,1274,1.434346,103.792013
730520,1856,168,2024,1.43423,103.792223
730521,1221,132,1353,1.433772,103.793244
730522,765,384,1149,1.433888,103.793811
730523,753,676,1429,1.433101,103.794042
730524,498,5565,6063,1.432659,103.793789
730525,589,301,890,1.432442,103.792996
730526,766,557,1323,1.432607,103.792682
730527,352,230,582,1.431862,103.792073
730528,552,20,572,1.431599,103.792493
730529,376,915,1291,1.431708,103.792796
730530,238,6455,6693,1.43121,103.792958
730531,190,2089,2279,1.431026,103.792797
730532,234,4460,4694,1.430708,103.792425
730533,389,2376,2765,1.430681,103.792184
730534,219,1573,1792,1.430815,103.79184
730535,412,53,465,1.431105,103.791957
730536,336,394,730,1.431528,103.791663
730537,422,113,535,1.430051,103.792522
730538,336,967,1303,1.429535,103.792035
730539,422,1597,2019,1.428826,103.792275
730540,405,4213,4618,1.428259,103.792599
730541,103,127,230,1.427979,103.792934
730542,329,288,617,1.427692,103.793543
730543,759,904,1663,1.428585,103.793915
730544,1740,189,1929,1.428672,103.793034
730545,577,1605,2182,1.429247,103.793715
730546,435,1089,1524,1.429709,103.793929
730547,310,347,657,1.430263,103.792839
730548,844,560,1404,1.430554,103.79392
730549,990,3764,4754,1.431763,103.794424
730550,445,3180,3625,1.432946,103.794799
730551,509,951,1460,1.433116,103.79537
730552,790,700,1490,1.431933,103.795211
730553,344,1958,2302,1.431541,103.795039
730554,328,1835,2163,1.432114,103.79653
730555,333,244,577,1.432289,103.795813
730556,705,939,1644,1.432957,103.796071
730557,350,463,813,1.432591,103.796694
730567,35,4,39,1.428286,103.790023
730569,25,82,107,1.430447,103.789288
730570,45,91,136,1.430978,103.78997
730571,24,70,94,1.430149,103.790183
730572,4,12,16,1.430965,103.789329
730573,9,114,123,1.299509,103.837
730574,2,17,19,1.299509,103.837
730575,636,293,929,1.431151,103.797084
730576,773,262,1035,1.430443,103.796688
730577,421,172,593,1.431151,103.796491
730578,887,451,1338,1.431583,103.795893
730579,199,249,448,1.430841,103.795724
730580,477,467,944,1.430537,103.796303
730581,317,214,531,1.430027,103.796458
730582,183,193,376,1.430286,103.795868
730583,447,3713,4160,1.430556,103.795354
730584,535,915,1450,1.429556,103.794628
730585,265,14,279,1.429343,103.795608
730586,637,1365,2002,1.428555,103.794556
730587,409,6,415,1.428394,103.79533
730588,636,1226,1862,1.427693,103.794543
730589,647,1576,2223,1.428002,103.79548
730601,448,747,1195,1.43862,103.796497
730602,446,2714,3160,1.438223,103.796345
730603,443,1958,2401,1.437548,103.796386
730604,211,1764,1975,1.437141,103.796481
730605,394,1344,1738,1.437198,103.796968
730606,473,1470,1943,1.436502,103.796798
730607,347,1444,1791,1.436448,103.796435
730608,457,202,659,1.436225,103.796712
730609,501,3955,4456,1.435779,103.796139
730610,259,1271,1530,1.43537,103.796246
730611,401,222,623,1.435441,103.796909
730612,388,15,403,1.434907,103.796365
730613,470,143,613,1.434358,103.796864
730614,125,215,340,1.434504,103.796143
730615,228,210,438,1.434138,103.796369
730616,342,640,982,1.434247,103.79606
730617,271,3151,3422,1.433898,103.795752
730618,344,2048,2392,1.433702,103.796438
730619,808,2617,3425,1.433727,103.798153
730620,542,1565,2107,1.433862,103.798664
730621,497,224,721,1.4341,103.79806
730622,215,547,762,1.434035,103.798667
730623,475,2184,2659,1.434798,103.798894
730626,373,321,694,1.433492,103.800459
730627,496,347,843,1.433523,103.801008
730629,213,1173,1386,1.43419,103.801085
730630,324,4732,5056,1.435165,103.801711
730631,331,1159,1490,1.435686,103.801191
730632,732,717,1449,1.4359,103.801754
730633,273,2375,2648,1.435718,103.802388
730634,551,3141,3692,1.436208,103.802572
730635,322,346,668,1.436552,103.80224
730636,261,282,543,1.436772,103.802687
730637,305,1267,1572,1.437422,103.802533
730638,456,258,714,1.436993,103.803204
730639,327,516,843,1.437655,103.803068
730640,380,302,682,1.438379,103.802502
730643,223,668,891,1.437829,103.801694
730644,356,3947,4303,1.436853,103.801474
730645,206,197,403,1.437105,103.800918
730646,259,182,441,1.437529,103.800405
730647,646,68,714,1.437873,103.801005
730648,241,125,366,1.438202,103.801415
730649,501,504,1005,1.438968,103.800945
730650,388,119,507,1.438581,103.8007
730651,455,1200,1655,1.438299,103.799673
730652,531,115,646,1.437962,103.799762
730653,295,642,937,1.437749,103.798628
730654,243,47,290,1.437683,103.799049
730655,401,98,499,1.437106,103.798332
730656,390,84,474,1.436831,103.799082
730657,369,89,458,1.436691,103.798531
730658,406,149,555,1.436545,103.799443
730659,512,76,588,1.436096,103.798944
730660,569,1115,1684,1.435452,103.799352
730661,407,1953,2360,1.435344,103.798614
730662,320,464,784,1.435456,103.798236
730663,397,124,521,1.436228,103.798151
730664,392,1623,2015,1.436343,103.79786
730665,508,905,1413,1.438022,103.797695
730666,245,248,493,1.438642,103.797356
730667,288,18,306,1.438602,103.79773
730668,374,125,499,1.438973,103.798312
730669,375,1777,2152,1.438295,103.798338
730670,535,361,896,1.438691,103.799258
730671,358,48,406,1.439337,103.798784
730672,294,549,843,1.43964,103.799744
730673,220,555,775,1.438983,103.79988
730676,4,57,61,1.439698,103.800553
730677,143,73,216,1.439313,103.801863
730678,129,248,377,1.439805,103.801588
730679,96,906,1002,1.439966,103.801908
730680,209,841,1050,1.439459,103.802191
730681,8,18,26,1.439665,103.80343
730682,37,47,84,1.440682,103.803927
730685,19,497,516,1.440898,103.805593
730686,38,42,80,1.442683,103.805755
730687,46,79,125,1.441243,103.806601
730688,107,3866,3973,1.443986,103.807367
730689,19,45,64,1.444723,103.808883
730690,41,514,555,1.442966,103.808473
730691,2,278,280,1.299509,103.837
730692,0,17,17,1.299509,103.837
730693,4,363,367,1.299509,103.837
730694,1,4,5,1.299509,103.837
730701,311,927,1238,1.441771,103.79592
730702,621,57,678,1.441902,103.796494
730703,247,110,357,1.440919,103.796345
730704,333,1819,2152,1.440234,103.795915
730705,155,1352,1507,1.439737,103.79603
730706,327,542,869,1.439734,103.79667
730707,222,98,320,1.440641,103.796589
730708,580,1756,2336,1.440022,103.79721
730709,136,842,978,1.4403,103.798023
730710,545,106,651,1.440758,103.797177
730711,436,55,491,1.441205,103.797554
730712,734,752,1486,1.44189,103.797086
730713,171,898,1069,1.441896,103.797908
730714,620,471,1091,1.44173,103.798552
730715,207,299,506,1.441847,103.799741
730716,390,137,527,1.441492,103.799687
730717,113,2704,2817,1.441111,103.799198
730718,459,26813,27272,1.441552,103.800912
730719,367,357,724,1.441689,103.800236
730720,647,1016,1663,1.442545,103.800956
730721,300,134,434,1.443937,103.800248
730722,474,712,1186,1.445122,103.799752
730723,321,4665,4986,1.445175,103.798909
730724,490,557,1047,1.444466,103.79864
730725,334,480,814,1.444312,103.798981
730726,515,32,547,1.443976,103.799369
730727,206,582,788,1.443603,103.799598
730728,271,233,504,1.442822,103.798959
730729,447,289,736,1.442508,103.798345
730730,419,327,746,1.442503,103.797887
730731,263,103,366,1.442779,103.797468
730732,221,96,317,1.443312,103.798441
730733,422,683,1105,1.443666,103.79892
730734,268,172,440,1.444167,103.798078
730735,328,32,360,1.443341,103.79704
730736,606,528,1134,1.443045,103.79693
730737,301,118,419,1.443658,103.796704
730738,510,203,713,1.444239,103.797443
730739,303,68,371,1.444248,103.79702
730740,197,92,289,1.444574,103.796152
730741,505,1044,1549,1.444397,103.795939
730742,268,571,839,1.443882,103.795799
730743,306,236,542,1.443565,103.796029
730744,306,963,1269,1.442906,103.795695
730745,525,924,1449,1.44209,103.795494
730746,416,1728,2144,1.442381,103.795257
730747,580,103,683,1.443248,103.795207
730748,188,113,301,1.445348,103.795141
730749,547,166,713,1.44476,103.794626
730750,558,4885,5443,1.444194,103.793925
730751,367,88,455,1.445145,103.794377
730752,432,479,911,1.445309,103.794618
730753,484,237,721,1.445689,103.794356
730754,16,71,87,1.445536,103.793676
730755,314,2222,2536,1.445286,103.793026
730756,463,1276,1739,1.445709,103.792862
730757,244,2391,2635,1.446456,103.794728
730758,177,16,193,1.446142,103.795342
730759,300,2009,2309,1.446408,103.795105
730760,153,1794,1947,1.446983,103.796719
730761,328,1469,1797,1.446366,103.79645
730762,633,169,802,1.44608,103.796239
730763,530,380,910,1.445369,103.795894
730764,174,1681,1855,1.445131,103.796908
730765,23,151,174,1.446006,103.796782
730766,414,10,424,1.446184,103.797002
730767,216,1888,2104,1.44615,103.797576
730768,589,305,894,1.445962,103.798159
730769,242,251,493,1.447239,103.798843
730770,326,11429,11755,1.446526,103.798492
730771,244,8286,8530,1.446747,103.79816
730772,88,128,216,1.44713,103.797934
730773,156,2522,2678,1.447465,103.79767
730774,321,2268,2589,1.448164,103.799172
730775,394,2881,3275,1.448451,103.79979
730776,563,155,718,1.447748,103.79999
730777,319,163,482,1.447808,103.799145
730778,257,676,933,1.447191,103.799564
730779,296,422,718,1.447703,103.800293
730780,37,389,426,1.299509,103.837
730782,11,59,70,1.299509,103.837
730783,0,143,143,1.299509,103.837
730784,9,98,107,1.299509,103.837
730785,1,50,51,1.299509,103.837
730786,27,523,550,1.447039,103.799987
730788,558,855,1413,1.443123,103.801642
730789,293,265,558,1.443249,103.802311
730790,150,45,195,1.44295,103.802651
730791,122,99,221,1.443064,103.802056
730792,179,1226,1405,1.442099,103.802375
730793,221,2110,2331,1.442263,103.802777
730794,355,1043,1398,1.442635,103.803464
730795,429,1293,1722,1.442858,103.803967
730796,259,44,303,1.443187,103.803258
730797,252,349,601,1.443547,103.803045
730798,1106,376,1482,1.443743,103.803517
730801,288,2681,2969,1.441786,103.786135
730802,581,1781,2362,1.440897,103.786115
730803,396,1546,1942,1.44043,103.786961
730804,299,838,1137,1.440168,103.78789
730805,393,142,535,1.440782,103.787001
730806,271,79,350,1.441338,103.78659
730807,424,304,728,1.442182,103.787294
730808,454,1848,2302,1.442411,103.786989
730809,284,430,714,1.44305,103.787875
730810,242,363,605,1.44271,103.788088
730816,514,5232,5746,1.442008,103.790032
730817,108,905,1013,1.442063,103.790741
730818,371,315,686,1.441691,103.790054
730819,110,61,171,1.44118,103.790614
730820,361,191,552,1.441146,103.789995
730821,292,202,494,1.440841,103.790024
730822,70,2077,2147,1.441872,103.789439
730823,69,559,628,1.440912,103.78949
730824,483,2958,3441,1.439229,103.788696
730825,1425,1660,3085,1.438774,103.789281
730826,324,306,630,1.439214,103.789507
730827,421,90,511,1.439962,103.789076
730828,76,20,96,1.439717,103.789871
730829,84,58,142,1.439672,103.790148
730830,263,1160,1423,1.439341,103.790799
730831,233,376,609,1.439506,103.791276
730832,607,226,833,1.439712,103.790756
730833,36,50,86,1.440142,103.790508
730834,453,454,907,1.440027,103.791101
730835,181,106,287,1.440424,103.790963
730836,301,973,1274,1.440097,103.791621
730837,530,144,674,1.441311,103.791498
730838,109,1164,1273,1.442105,103.791258
730839,292,1165,1457,1.442605,103.791712
730840,154,2490,2644,1.443797,103.792415
730841,348,1178,1526,1.443597,103.791665
730842,411,113,524,1.443475,103.792352
730843,602,112,714,1.44312,103.792647
730844,147,739,886,1.443918,103.793098
730845,377,391,768,1.442749,103.792756
730846,312,1940,2252,1.443284,103.793426
730847,334,258,592,1.442117,103.791811
730848,481,258,739,1.441768,103.791807
730849,400,246,646,1.441262,103.791902
730850,327,233,560,1.440964,103.791912
730851,403,236,639,1.440406,103.792311
730852,378,1635,2013,1.439395,103.792376
730853,324,1259,1583,1.439407,103.792973
730854,654,288,942,1.439756,103.792951
730855,691,459,1150,1.440142,103.793233
730856,199,1305,1504,1.440468,103.793202
730857,232,410,642,1.440246,103.794006
730858,288,158,446,1.440248,103.794304
730859,226,278,504,1.439853,103.793959
730860,652,933,1585,1.439428,103.793984
730861,250,1119,1369,1.439506,103.795105
730862,121,327,448,1.439917,103.795057
730863,223,509,732,1.440376,103.79501
730864,256,798,1054,1.440834,103.794999
730865,381,716,1097,1.441139,103.792607
730866,214,173,387,1.441546,103.792509
730867,186,161,347,1.442323,103.792898
730868,105,127,232,1.442522,103.793335
730869,285,2457,2742,1.442821,103.793924
730870,267,1371,1638,1.443548,103.788654
730871,318,1677,1995,1.443818,103.789081
730872,406,696,1102,1.444017,103.789749
730873,363,184,547,1.44332,103.78952
730874,437,82,519,1.442924,103.789567
730875,346,2098,2444,1.442564,103.789607
730876,417,1123,1540,1.444818,103.790498
730877,414,1001,1415,1.445145,103.791265
730878,212,993,1205,1.445462,103.79196
730879,336,528,864,1.444948,103.792218
730880,419,1807,2226,1.444485,103.792567
730881,121,592,713,1.444448,103.791807
730882,444,234,678,1.444289,103.790894
730883,227,1653,1880,1.442756,103.790708
730884,2,162,164,1.443482,103.790739
730886,33,693,726,1.299509,103.837
730887,16,114,130,1.437839,103.794869
730888,1264,7745,9009,1.437703,103.79527
730889,22,225,247,1.438169,103.792874
730890,41,220,261,1.437984,103.792692
730891,519,392,911,1.437722,103.791149
730892,664,401,1065,1.437225,103.789745
730893,396,580,976,1.436738,103.790548
730894,460,234,694,1.435972,103.790271
730895,465,447,912,1.436059,103.791675
730896,548,136,684,1.436465,103.793115
730897,234,164,398,1.436478,103.794078
730898,189,179,368,1.435375,103.794792
730899,451,364,815,1.435798,103.794948
730900,2055,6694,8749,1.435152,103.787195
731001,388,8833,9221,1.441691,103.770859
731002,324,2419,2743,1.440772,103.770856
731003,38,3022,3060,1.440772,103.770856
731004,108,490,598,1.439874,103.769856
731005,180,3145,3325,1.439874,103.769856
731006,762,2561,3323,1.443043,103.770155
731007,78,1366,1444,1.441188,103.775964
731012,719,171,890,1.441588,103.779347
731013,10,3880,3890,1.441588,103.779347
731029,9,110,119,1.442751,103.772923
731034,18,2540,2558,1.444253,103.772675
731180,425,2788,3213,1.439237,103.778185
731182,7,108,115,1.299509,103.837
731183,0,8,8,1.299509,103.837
731185,0,5,5,1.299509,103.837
731302,520,3535,4055,1.431815,103.775091
731304,16,3685,3701,1.430538,103.77361
731306,66,1877,1943,1.429987,103.77503
731354,10,102,112,1.432863,103.785087
731358,8,158,166,1.433364,103.783911
731370,13,87,100,1.299509,103.837
731371,14,268,282,1.432874,103.786442
731406,1,170,171,1.429327,103.772013
731413,6,215,221,1.427966,103.772219
731421,33,230,263,1.427935,103.775174
731426,266,491,757,1.426619,103.773613
731502,176,885,1061,1.433308,103.791172
731505,18,220,238,1.432093,103.791608
731509,12,717,729,1.433217,103.789499
731515,254,719,973,1.434212,103.79001
731516,130,1525,1655,1.434126,103.790717
731517,12,169,181,1.434084,103.791469
731519,42,1261,1303,1.434564,103.792144
731521,18,900,918,1.433947,103.793577
731523,12,4323,4335,1.432915,103.793943
731524,69,842,911,1.433255,103.793278
731525,3,414,417,1.432482,103.792794
731527,15,465,480,1.432066,103.792575
731536,31,1583,1614,1.431279,103.791427
731546,4,53,57,1.430087,103.793521
731549,18,107,125,1.432235,103.794804
731552,1,41,42,1.432472,103.79539
731554,8,170,178,1.43256,103.796319
731569,759,1017,1776,1.429632,103.789466
731570,221,3217,3438,1.430924,103.790837
731571,368,1937,2305,1.43013,103.791005
731572,110,45,155,1.430882,103.789575
731573,9,220,229,1.299509,103.837
731574,3,2,5,1.299509,103.837
731575,33,636,669,1.431526,103.796978
731578,7,179,186,1.431497,103.796678
731579,37,822,859,1.431084,103.795378
731586,94,1313,1407,1.429265,103.794451
731588,314,1537,1851,1.42806,103.79453
731605,4,317,321,1.437844,103.797127
731608,19,1551,1570,1.436223,103.797127
731614,26,2733,2759,1.435057,103.79582
731622,38,706,744,1.43413,103.799104
731624,156,1093,1249,1.434181,103.799652
731625,322,436,758,1.433439,103.799575
731626,13,141,154,1.434175,103.80008
731628,623,4103,4726,1.435023,103.80082
731630,39,314,353,1.435157,103.80112
731633,5,667,672,1.436295,103.802014
731638,18,527,545,1.436508,103.803098
731639,21,999,1020,1.437872,103.802587
731644,2,239,241,1.437202,103.801169
731649,16,607,623,1.438591,103.800145
731656,10,262,272,1.437161,103.798768
731661,1,244,245,1.435803,103.798532
731667,8,791,799,1.438886,103.797819
731668,3,9,12,1.438562,103.798178
731671,11,306,317,1.439608,103.799293
731672,1,10,11,1.439164,103.799374
731676,0,399,399,1.299509,103.837
731678,33,1954,1987,1.440493,103.801801
731681,715,449,1164,1.439454,103.803808
731682,231,86,317,1.440232,103.803248
731683,344,2355,2699,1.440029,103.802792
731684,525,1091,1616,1.441217,103.804982
731685,50,734,784,1.441542,103.805633
731686,667,616,1283,1.442058,103.805581
731687,878,519,1397,1.441037,103.80728
731688,583,173,756,1.442866,103.807015
731689,538,465,1003,1.444459,103.807895
731690,473,166,639,1.443481,103.808415
731691,3,50,53,1.299509,103.837
731693,4,253,257,1.299509,103.837
731694,2,207,209,1.299509,103.837
731701,48,3858,3906,1.441114,103.795895
731709,5,488,493,1.441142,103.797965
731711,10,104,114,1.440993,103.796962
731714,4,168,172,1.441536,103.799047
731717,90,1322,1412,1.441321,103.798477
731718,33,3352,3385,1.441581,103.800648
731721,25,1938,1963,1.444777,103.799847
731722,38,118,156,1.445032,103.79934
731728,6,450,456,1.443347,103.799131
731732,5,48,53,1.442876,103.798142
731736,13,367,380,1.443276,103.796658
731737,6,642,648,1.443231,103.796202
731739,14,115,129,1.444619,103.796809
731740,16,294,310,1.444779,103.796505
731744,150,113,263,1.44276,103.795331
731747,11,1567,1578,1.443372,103.795571
731748,15,609,624,1.444781,103.795142
731749,8,25,33,1.444804,103.794213
731754,303,90,393,1.445556,103.794099
731757,9,1967,1976,1.446036,103.793731
731759,3,351,354,1.446685,103.79602
731762,1,31,32,1.446296,103.795815
731764,83,228,311,1.44563,103.796607
731765,2,6,8,1.445855,103.79703
731766,4,139,143,1.44558,103.797197
731773,5,1450,1455,1.447772,103.798526
731775,16,1079,1095,1.448095,103.800385
731780,184,1257,1441,1.448201,103.801756
731782,1053,374,1427,1.447972,103.802533
731783,0,51,51,1.299509,103.837
731784,4,44,48,1.299509,103.837
731785,18,35,53,1.299509,103.837
731786,17,5628,5645,1.446048,103.800007
731787,1,46,47,1.444667,103.801672
731788,7,125,132,1.44432,103.801861
731792,17,1794,1811,1.44261,103.801733
731796,6,174,180,1.443444,103.803901
731802,3,157,160,1.299509,103.837
731823,6,221,227,1.441423,103.789461
731824,92,328,420,1.439487,103.789007
731839,11,253,264,1.442945,103.791998
731846,6,347,353,1.442923,103.79366
731859,1,84,85,1.439866,103.794472
731862,4,95,99,1.299509,103.837
731866,8,228,236,1.442264,103.792593
731874,12,628,640,1.443105,103.788845
731881,3,366,369,1.444512,103.791413
731883,7,207,214,1.443199,103.791027
731886,478,201,679,1.438331,103.79468
731887,575,926,1501,1.437311,103.793833
731888,70,7736,7806,1.438029,103.795086
731889,439,799,1238,1.437548,103.793541
731890,277,99,376,1.438169,103.792917
731891,699,239,938,1.43787,103.790652
731892,345,695,1040,1.437537,103.789607
731893,558,51,609,1.43675,103.789745
731894,418,378,796,1.435976,103.789527
731895,704,1623,2327,1.435628,103.791664
731896,356,280,636,1.437122,103.79259
731897,236,191,427,1.43602,103.794126
731898,712,740,1452,1.435169,103.795156
731899,653,218,871,1.436109,103.794971
732002,22,641,663,1.440718,103.776477
732005,426,62,488,1.440718,103.776477
732006,37,184,221,1.440966,103.772075
732012,158,242,400,1.441588,103.779347
732034,14,58,72,1.444253,103.772675
732180,250,163,413,1.439237,103.778185
732302,12,1058,1070,1.299509,103.837
732304,1,20,21,1.429781,103.774302
732546,6,241,247,1.429355,103.793023
732569,701,439,1140,1.429632,103.789466
732570,353,2712,3065,1.430924,103.790837
732571,249,638,887,1.430086,103.790506
732572,390,245,635,1.431752,103.78989
732574,4,107,111,1.299509,103.837
732588,189,19,208,1.42829,103.794935
732624,391,5389,5780,1.434819,103.799897
732625,181,614,795,1.433428,103.800003
732628,430,84,514,1.434302,103.800668
732676,0,45,45,1.299509,103.837
732681,631,686,1317,1.439264,103.803326
732682,465,121,586,1.440436,103.803724
732683,206,2138,2344,1.440545,103.802615
732684,344,1919,2263,1.441817,103.804597
732685,321,166,487,1.441359,103.806012
732686,759,230,989,1.442746,103.806257
732687,479,425,904,1.441774,103.807393
732688,260,580,840,1.443515,103.806876
732689,449,88,537,1.444642,103.808245
732690,703,86,789,1.443261,103.808237
732691,2,30,32,1.299509,103.837
732694,3,61,64,1.299509,103.837
732717,77,261,338,1.44147,103.798647
732764,285,1407,1692,1.299509,103.837
732780,482,1158,1640,1.448201,103.801756
732782,577,206,783,1.299509,103.837
732783,1,5,6,1.299509,103.837
732784,6,40,46,1.299509,103.837
732785,27,26,53,1.299509,103.837
732786,334,1257,1591,1.44549,103.80098
732787,151,2277,2428,1.444328,103.801068
732788,283,2190,2473,1.443747,103.801178
732886,548,99,647,1.438296,103.795111
732887,543,1478,2021,1.437839,103.79431
732889,406,292,698,1.437679,103.792171
732890,447,55,502,1.299509,103.837
732891,9,164,173,1.438136,103.791402
732892,86,1932,2018,1.436848,103.789334
732893,272,331,603,1.436299,103.790478
732894,374,1054,1428,1.435649,103.790275
732895,516,87,603,1.435942,103.792717
732896,605,232,837,1.436958,103.793111
732897,494,157,651,1.435741,103.79415
732899,222,629,851,1.436555,103.794974
733012,578,399,977,1.441588,103.779347
733180,974,1917,2891,1.439202,103.778401
733183,0,73,73,1.299509,103.837
733570,713,2493,3206,1.431386,103.790116
733571,317,102,419,1.43037,103.789926
733573,2,1,3,1.406867,103.75921
733574,0,58,58,1.299509,103.837
733681,603,304,907,1.439909,103.802991
733682,277,216,493,1.440637,103.804249
733683,170,184,354,1.441129,103.803303
733684,316,142,458,1.441599,103.80419
733685,533,45,578,1.441684,103.805706
733686,668,813,1481,1.442114,103.806831
733687,742,95,837,1.44184,103.806541
733688,530,94,624,1.443526,103.807183
733689,479,577,1056,1.444919,103.808339
733690,699,249,948,1.442919,103.807965
733691,0,2,2,1.405821,103.757724
733694,3,45,48,1.299509,103.837
733717,4,115,119,1.299509,103.837
733780,210,3167,3377,1.448201,103.801756
733782,483,95,578,1.447761,103.803262
733783,8,344,352,1.299509,103.837
733784,3,9,12,1.299509,103.837
733785,12,73,85,1.299509,103.837
733786,576,147,723,1.446068,103.800932
733787,462,1378,1840,1.444827,103.801002
733788,356,90,446,1.443907,103.80189
733886,614,359,973,1.43719,103.792602
733887,243,1405,1648,1.437618,103.794705
733889,283,565,848,1.43798,103.792842
733890,9,97,106,1.299509,103.837
733893,300,172,472,1.436311,103.789769
733894,519,945,1464,1.435658,103.789433
733895,7,186,193,1.436083,103.792211
733897,6,350,356,1.436326,103.794565
734012,14,117,131,1.441588,103.779347
734573,2,10,12,1.299509,103.837
734574,3,56,59,1.299509,103.837
734681,340,415,755,1.44013,103.80348
734682,636,190,826,1.440874,103.804753
734683,385,78,463,1.440829,103.803067
734684,532,124,656,1.44134,103.804282
734687,145,248,393,1.441708,103.807694
734688,754,143,897,1.443634,103.807569
734689,342,124,466,1.444384,103.808769
734690,903,237,1140,1.442613,103.807935
734691,4,8,12,1.299509,103.837
734693,0,60,60,1.299509,103.837
734780,333,57,390,1.448201,103.801756
734782,835,47,882,1.448387,103.803114
734783,8,162,170,1.299509,103.837
734785,9,83,92,1.299509,103.837
734786,394,571,965,1.446416,103.8008
734787,457,493,950,1.445172,103.801738
734788,634,108,742,1.444052,103.802291
734886,313,163,476,1.299509,103.837
734889,267,348,615,1.437836,103.79253
734893,4,6,10,1.436988,103.790876
734895,5,375,380,1.435818,103.792079
734897,4,273,277,1.435659,103.794651
735688,419,95,514,1.443903,103.807823
735689,336,201,537,1.443868,103.808552
735690,612,356,968,1.442109,103.807842
735694,0,1,1,1.40727,103.7599
735780,711,59,770,1.448201,103.801756
735782,215,190,405,1.447972,103.802533
735783,6,131,137,1.299509,103.837
735785,0,57,57,1.299509,103.837
735786,189,367,556,1.447037,103.800375
735787,413,195,608,1.444767,103.802036
735788,465,254,719,1.44455,103.802292
736688,589,86,675,1.443526,103.80879
736689,462,342,804,1.443565,103.808688
736690,545,396,941,1.442619,103.807336
736780,230,1083,1313,1.448201,103.801756
736782,3,333,336,1.299509,103.837
736786,156,263,419,1.44621,103.8003
737709,32,291,323,1.299509,103.837
737713,11,1898,1909,1.299509,103.837
737718,23,510,533,1.299509,103.837
737723,309,569,878,1.46154,103.809509
737728,20,0,20,1.299509,103.837
737729,115,35,150,1.299509,103.837
737730,116,63,179,1.443932,103.788203
737733,51,2036,2087,1.299509,103.837
737734,3,14,17,1.299509,103.837
737735,23,73,96,1.299509,103.837
737736,176,1828,2004,1.299509,103.837
737738,7,62,69,1.299509,103.837
737739,11,82,93,1.299509,103.837
737740,113,320,433,1.426487,103.79657
737743,122,101,223,1.45817,103.81124
737753,92,703,795,1.449029,103.802647
737758,322,125,447,1.380382,103.760072
737763,415,128,543,1.299509,103.837
737768,274,3,277,1.299509,103.837
737769,239,0,239,1.299509,103.837
737770,72,7,79,1.299509,103.837
737771,85,96,181,1.299509,103.837
737772,65,268,333,1.299509,103.837
737773,98,371,469,1.299509,103.837
737774,323,6,329,1.431853,103.798673
737775,122,53,175,1.432297,103.799155
737776,196,2,198,1.299509,103.837
737777,89,93,182,1.432006,103.798769
737778,113,519,632,1.43039,103.762613
737779,1034,254,1288,1.429,103.763017
737780,28,699,727,1.299509,103.837
737783,452,40,492,1.427898,103.785393
737784,455,2,457,1.431172,103.785678
737785,198,86,284,1.431172,103.785678
737786,355,56,411,1.431172,103.785678
737787,142,6,148,1.431172,103.785678
737788,355,843,1198,1.431172,103.785678
737789,204,347,551,1.431172,103.785678
737790,177,4,181,1.427898,103.785393
737791,329,56,385,1.299509,103.837
737792,262,136,398,1.427502,103.78575
737793,328,15,343,1.431172,103.785678
737794,205,371,576,1.431172,103.785678
737795,402,145,547,1.427898,103.785393
737796,150,52,202,1.427898,103.785393
737797,252,245,497,1.431172,103.785678
737803,364,242,606,1.447201,103.801789
737808,552,173,725,1.430231,103.784061
737809,337,904,1241,1.430231,103.784061
737810,267,5,272,1.430231,103.784061
737811,645,5,650,1.430191,103.784147
737812,1,10,11,1.299509,103.837
737813,5,1,6,1.299509,103.837
737814,1,0,1,1.299509,103.837
737815,45,0,45,1.299509,103.837
737816,6,0,6,1.430231,103.784061
737817,5,0,5,1.299509,103.837
737818,18,0,18,1.430231,103.784061
737819,5,0,5,1.299509,103.837
737820,187,0,187,1.299509,103.837
737821,126,1,127,1.299509,103.837
737822,2,0,2,1.299509,103.837
737823,23,0,23,1.299509,103.837
737824,11,11,22,1.429059,103.832386
737825,47,10,57,1.299509,103.837
737827,6,0,6,1.299509,103.837
737828,12,0,12,1.299509,103.837
737829,7,0,7,1.299509,103.837
737830,18,0,18,1.299509,103.837
737831,15,0,15,1.299509,103.837
737832,18,0,18,1.299509,103.837
737833,3,0,3,1.299509,103.837
737834,4,0,4,1.405466,103.757759
737835,1,1,2,1.299509,103.837
737836,53,0,53,1.299509,103.837
737837,0,2,2,1.299509,103.837
737838,8,1582,1590,1.299509,103.837
737839,1,0,1,1.299509,103.837
737840,4,80,84,1.430231,103.784061
737841,2,0,2,1.299509,103.837
737842,4,59,63,1.430231,103.784061
737843,4,0,4,1.299509,103.837
737844,9,124,133,1.299509,103.837
737846,9,554,563,1.299509,103.837
737847,4,47,51,1.299509,103.837
737848,1,367,368,1.299509,103.837
737849,2,0,2,1.299509,103.837
737850,11,673,684,1.299509,103.837
737853,2247,359,2606,1.434085,103.802391
737854,2033,1950,3983,1.434077,103.803514
737855,1285,201,1486,1.436549,103.806099
737856,54,397,451,1.299509,103.837
737863,434,204,638,1.428784,103.767643
737868,10,100,110,1.431544,103.755244
737869,49,6,55,1.299509,103.837
737873,662,179,841,1.429427,103.785762
737874,557,74,631,1.429442,103.786331
737875,898,41,939,1.429043,103.786345
737876,315,8,323,1.428994,103.785816
737877,237,430,667,1.429225,103.785734
737878,168,2516,2684,1.430117,103.794288
737879,413,1042,1455,1.299509,103.837
737880,258,3,261,1.299509,103.837
737881,152,1,153,1.299509,103.837
737882,162,2,164,1.299509,103.837
737883,46,318,364,1.437731,103.797939
737888,291,186,477,1.428957,103.790631
737889,37,321,358,1.433185,103.766991
737890,12,10,22,1.438718,103.802285
737891,19,97,116,1.44866,103.81094
737892,235,120,355,1.431898,103.79729
737893,303,678,981,1.432059,103.797327
737894,427,322,749,1.432207,103.797367
737895,537,405,942,1.432353,103.797412
737896,304,278,582,1.432725,103.797916
737897,198,8,206,1.432388,103.798031
737898,234,170,404,1.43178,103.798106
737899,309,192,501,1.431749,103.798307
737900,582,179,761,1.431722,103.798512
737901,508,2,510,1.432667,103.798236
737902,473,179,652,1.429201,103.788334
737903,36,17,53,1.444888,103.786797
737904,25,19,44,1.445232,103.785733
737905,8,136,144,1.444735,103.785827
737906,20,58,78,1.444156,103.785808
737907,24,4,28,1.443878,103.785335
737908,100,0,100,1.444432,103.785287
737909,12,0,12,1.442982,103.787061
737910,4,71,75,1.445494,103.785156
737911,1020,612,1632,1.445833,103.809729
737912,171,107,278,1.427109,103.787582
737913,1295,623,1918,1.426703,103.789056
737914,4,336,340,1.447652,103.811061
737915,56,2,58,1.428662,103.779561
737916,599,103,702,1.445881,103.802398
737917,534,378,912,1.430545,103.78553
737918,839,124,963,1.430592,103.786021
737919,819,262,1081,1.430611,103.78654
737920,428,295,723,1.429985,103.786464
737921,465,70,535,1.430034,103.786016
737922,683,130,813,1.430021,103.785595
737923,157,18,175,1.431496,103.754752
737924,754,348,1102,1.426395,103.793419
737925,1,0,1,1.427421,103.779124
737926,10,0,10,1.427275,103.779125
737928,6,0,6,1.427201,103.77877
737929,5,0,5,1.426935,103.778721
737930,30,5,35,1.428233,103.779864
737931,0,1,1,1.427421,103.779124
737932,42,0,42,1.42823,103.779589
737934,315,255,570,1.431188,103.785398
737935,326,145,471,1.431094,103.785633
737936,498,255,753,1.431093,103.785838
737937,486,130,616,1.431127,103.786108
737938,555,2541,3096,1.431495,103.786547
737939,586,45,631,1.431457,103.786755
737940,233,572,805,1.431454,103.787026
737941,9,152,161,1.431405,103.785904
737942,235,135,370,1.43985,103.804609
737943,20,70,90,1.428816,103.779547
737944,51,109,160,1.416438,103.754746
737945,12,36,48,1.416421,103.755125
737946,35,3,38,1.416438,103.754928
737947,134,8,142,1.416395,103.755128
737948,4,0,4,1.299509,103.837
737949,13,6,19,1.416342,103.755136
737950,258,1,259,1.416447,103.755166
737951,33,1,34,1.41629,103.755143
737952,14,1,15,1.416447,103.75521
737953,25,13,38,1.416237,103.75515
737954,4,11,15,1.416448,103.755299
737955,59,9,68,1.416185,103.755157
737956,5,0,5,1.416448,103.755388
737957,15,3,18,1.416132,103.755165
737958,5,1,6,1.416449,103.755477
737959,42,89,131,1.41608,103.755172
737960,1,0,1,1.428237,103.779721
737961,170,3,173,1.416141,103.755184
737962,13,0,13,1.41645,103.755655
737963,5,9,14,1.416202,103.755175
737964,13,1,14,1.41645,103.755744
737965,117,9,126,1.416325,103.755158
737966,1,1,2,1.299509,103.837
737967,6,0,6,1.416078,103.755686
737983,1,0,1,1.416449,103.755566
737992,1,0,1,1.416906,103.756443
738009,1,0,1,1.417622,103.756982
738021,0,5,5,1.41581,103.7565
738038,1,0,1,1.417645,103.757867
738062,1,6,7,1.42655,103.77772
738063,1,2,3,1.42654,103.77771
738064,18,13,31,1.427414,103.778647
738065,21,0,21,1.427574,103.778443
738066,9,2,11,1.427087,103.777696
738067,0,16,16,1.426674,103.777724
738068,3722,575,4297,1.454559,103.809223
738069,5,0,5,1.428504,103.779566
738070,1,755,756,1.438571,103.80204
738071,0,2,2,1.41645,103.755833
738072,0,8,8,1.427566,103.779997
738074,538,516,1054,1.450285,103.803948
738075,19,4,23,1.427433,103.777896
738076,4,3,7,1.426804,103.778738
738077,9,331,340,1.444783,103.80948
738078,2568,787,3355,1.422209,103.762266
738079,319,2167,2486,1.433234,103.790306
738080,11,36,47,1.454191,103.80468
738081,892,348,1240,1.44467,103.806025
738082,839,3933,4772,1.444572,103.806493
738083,30,8,38,1.44496,103.806401
738084,998,428,1426,1.444954,103.806871
738085,786,969,1755,1.445382,103.807289
738086,1355,380,1735,1.445667,103.806858
738087,1556,192,1748,1.444913,103.805988
738088,28,27,55,1.426379,103.778326
738089,598,549,1147,1.44358,103.804453
738090,438,144,582,1.444265,103.804687
738091,870,160,1030,1.444497,103.804822
738092,210,149,359,1.444749,103.804941
738093,1251,150,1401,1.444539,103.805587
738094,1162,2275,3437,1.443707,103.805471
738095,26,9,35,1.443887,103.805072
738096,360,1878,2238,1.443273,103.804861
738097,314,1369,1683,1.443677,103.804394
738098,368,155,523,1.443689,103.804392
738099,4683,63114,67797,1.435855,103.786222
738100,870,2534,3404,1.44703,103.809142
738101,35,0,35,1.426808,103.777698
738102,2,0,2,1.427559,103.779791
738103,3068,169,3237,1.444662,103.769618
738104,0,6,6,1.427937,103.776959
738105,4,12,16,1.427957,103.776951
738106,18,2,20,1.427936,103.776926
738107,20,2,22,1.427956,103.776911
738108,2,0,2,1.427067,103.777696
738109,1,2,3,1.42654,103.77771
738110,40,0,40,1.427932,103.776797
738111,2,3,5,1.427951,103.776751
738112,3,0,3,1.427953,103.776831
738113,45,3,48,1.427948,103.776671
738114,2,0,2,1.427934,103.776861
738115,8,7,15,1.427946,103.776591
738116,10,0,10,1.427926,103.776602
738117,2,2,4,1.416457,103.755131
738118,2,1,3,1.42793,103.776732
738119,8,4,12,1.427941,103.776431
738120,2,1,3,1.427924,103.776538
738121,90,0,90,1.427939,103.776351
738122,1,2,3,1.427922,103.776473
738123,3,1,4,1.427944,103.776511
738124,3,2,5,1.427918,103.776343
738125,0,3,3,1.42792,103.776408
738127,41,5,46,1.427931,103.776111
738128,0,2,2,1.427928,103.776667
738129,2,9,11,1.427929,103.776031
738130,5,2,7,1.427913,103.776149
738131,0,2,2,1.427915,103.776214
738132,2,1,3,1.427934,103.776191
738133,0,4,4,1.427936,103.776271
738134,9,0,9,1.427909,103.77602
738135,81,5,86,1.427922,103.775791
738137,2,2,4,1.427924,103.775871
738138,10,2,12,1.427905,103.77589
738139,68,692,760,1.427917,103.775631
738140,7,3,10,1.427903,103.775825
738141,2,0,2,1.427927,103.775951
738142,43,0,43,1.427899,103.775696
738143,147,2731,2878,1.427897,103.775631
738144,5,0,5,1.427574,103.7773
738145,46,6,52,1.427605,103.777289
738146,1,1,2,1.427901,103.775761
738147,2,1,3,1.427911,103.776084
738148,20,1,21,1.427482,103.777271
738149,31,3,34,1.42749,103.777254
738150,0,3,3,1.427566,103.777277
738151,24,3,27,1.427461,103.777252
738152,3,1,4,1.427919,103.775711
738153,2,2,4,1.427389,103.777178
738154,30,0,30,1.427383,103.777145
738155,0,1,1,1.416478,103.757045
738156,14,1,15,1.42737,103.77708
738157,6,1,7,1.42739,103.777047
738158,8,1,9,1.427369,103.777021
738159,5,3,8,1.427389,103.776981
738160,1,1,2,1.427543,103.77729
738161,0,3,3,1.427424,103.777227
738162,8,1,9,1.427368,103.776902
738163,10,2,12,1.427388,103.776848
738164,28,4,32,1.427368,103.776842
738165,34,1,35,1.427387,103.776782
738166,9,2,11,1.427367,103.776783
738167,2,2,4,1.427409,103.777178
738168,1,2,3,1.427388,103.776914
738169,2,3,5,1.427386,103.776649
738170,79,0,79,1.427366,103.776664
738171,14,2,16,1.427385,103.776583
738172,58,5,63,1.427365,103.776605
738173,0,1,1,1.427396,103.777113
738174,11,0,11,1.427365,103.776545
738175,0,3,3,1.427366,103.776724
738176,1,4,5,1.427364,103.776486
738177,6,7,13,1.427383,103.776384
738178,2,7,9,1.427364,103.776426
738179,1,4,5,1.427383,103.776317
738180,3,12,15,1.427363,103.776367
738181,0,15,15,1.427382,103.776251
738182,1,34,35,1.427362,103.776308
738183,3,0,3,1.427384,103.77645
738184,7,59,66,1.427362,103.776248
738185,17,6,23,1.427381,103.776118
738186,1,24,25,1.427361,103.776189
738187,17,5,22,1.42738,103.776052
738188,20,5,25,1.427361,103.776129
738189,0,5,5,1.427379,103.775986
738190,35,6,41,1.42736,103.77607
738191,0,5,5,1.427379,103.775919
738192,61,9,70,1.42736,103.77601
738193,0,2,2,1.427369,103.776961
738194,1,8,9,1.427359,103.775951
738195,3,3,6,1.427377,103.775787
738196,29,6,35,1.427358,103.775892
738197,2,2,4,1.427386,103.776715
738198,2,6,8,1.427358,103.775832
738199,51,4078,4129,1.427376,103.775654
738200,0,1,1,1.427384,103.776516
738201,44,32,76,1.427357,103.775713
738202,38,226,264,1.427356,103.775654
738203,8406,204539,212945,1.444073,103.768567
738204,46,298,344,1.449693,103.804247
738205,1135,116,1251,1.446023,103.811209
738206,12,1,13,1.427557,103.779132
738207,638,95,733,1.429059,103.78194
738208,230,5,235,1.429059,103.78194
738209,365,464,829,1.429059,103.78194
738210,476,58,534,1.429059,103.78194
738211,404,364,768,1.429059,103.78194
738212,380,19,399,1.429059,103.78194
738213,4,5,9,1.427004,103.779612
738214,2,14,16,1.427006,103.779691
738215,0,4,4,1.427377,103.77572
738216,55,3,58,1.427009,103.779849
738217,0,1,1,1.427357,103.775773
738218,1,7,8,1.427013,103.780007
738219,1,8,9,1.427494,103.779123
738220,73,506,579,1.434068,103.76753
738221,26,455,481,1.45122,103.804348
738222,1,70,71,1.427013,103.780007
738223,2,1,3,1.427381,103.776185
738224,2,11,13,1.427556,103.780007
738225,1,0,1,1.427011,103.779928
738226,2,9,11,1.427571,103.78032
738227,0,8,8,1.427619,103.780512
738228,23,3,26,1.427795,103.78059
738229,67,22,89,1.428009,103.780919
738230,327,178,505,1.429056,103.781368
738231,0,5,5,1.427562,103.779574
738232,7,12,19,1.428228,103.780246
738233,1,7,8,1.426976,103.779283
738234,46,12,58,1.42698,103.779428
738235,53,24,77,1.426986,103.779717
738236,2,4,6,1.42733,103.777687
738237,24,7,31,1.427546,103.777688
738238,12,0,12,1.427129,103.779126
738239,83,1810,1893,1.436147,103.800671
738240,183,538,721,1.434839,103.797928
738241,71,3,74,1.427424,103.778285
738242,40,3,43,1.427561,103.779594
738243,333,1,334,1.42756,103.779672
738247,0,10,10,1.427546,103.779997
738248,75,10,85,1.452008,103.80391
738249,19,182,201,1.454456,103.8048
738250,6,0,6,1.454605,103.80505
738252,246,0,246,1.454745,103.80461
738253,15,4,19,1.428235,103.78047
738254,5,3,8,1.42822,103.780016
738255,8,35,43,1.42708,103.777828
738256,1,40,41,1.428459,103.776206
738257,18,6,24,1.427577,103.779132
738258,15,4,19,1.427566,103.77925
738259,0,37,37,1.42794,103.780769
738260,8,16,24,1.426983,103.779128
738261,12,1,13,1.428602,103.78051
738262,99,3,102,1.428478,103.780498
738263,19,735,754,1.428853,103.780482
738264,1,75,76,1.428706,103.780498
738265,152,114,266,1.45238,103.802835
738266,84,0,84,1.427594,103.778443
738267,131,4,135,1.428232,103.779955
738268,4,2,6,1.428233,103.779884
738269,51,10,61,1.428237,103.779741
738270,0,3,3,1.42728,103.780012
738271,2,14,16,1.42834,103.779599
738272,1,0,1,1.428336,103.780498
738274,5,24,29,1.42884,103.7796
738275,0,13,13,1.427064,103.777752
738276,17,6,23,1.427061,103.777809
738277,9,6,15,1.427054,103.777922
738278,28,8,36,1.427048,103.778035
738279,9,6,15,1.426549,103.778311
738280,89,9,98,1.426549,103.778114
738281,11,0,11,1.42655,103.777917
738282,18,5,23,1.42655,103.77772
738283,316,64,380,1.448277,103.805876
738284,45,295,340,1.448546,103.807213
738285,13,215,228,1.448035,103.810685
738286,1,5,6,1.428816,103.780466
738287,0,3,3,1.42825,103.779589
738288,1,3,4,1.427008,103.77977
738289,44,4,48,1.428245,103.780465
738290,6,23,29,1.428254,103.780442
738291,0,4,4,1.428429,103.780472
738292,1,0,1,1.42844,103.779599
738293,9,1,10,1.428249,103.780278
738294,2,45,47,1.426607,103.777727
738295,64,6,70,1.426994,103.779178
738296,39,25,64,1.426995,103.779217
738297,0,25,25,1.426997,103.779296
738298,51,10,61,1.426998,103.779375
738299,0,11,11,1.427,103.779454
738300,1,4,5,1.427002,103.779533
738301,5,9,14,1.426993,103.780007
738302,0,13,13,1.427564,103.779358
738303,0,5,5,1.427072,103.777959
738304,12,1,13,1.427058,103.778223
738305,15,5,20,1.428232,103.779935
738306,2,3,5,1.426741,103.777721
738307,80,0,80,1.426544,103.778701
738308,341,279,620,1.449346,103.811868
738309,142,957,1099,1.452014,103.805759
738310,21,0,21,1.427576,103.778798
738311,19,5,24,1.427566,103.779161
738312,2,10,12,1.427566,103.779201
738313,2,10,12,1.427565,103.779279
738314,22,0,22,1.427564,103.779358
738315,3,2,5,1.427563,103.779437
738317,1492,5,1497,1.448434,103.811756
738318,7,79,86,1.452764,103.802639
738319,310,273,583,1.449511,103.811075
738320,163,105,268,1.451695,103.803244
738321,55,1659,1714,1.447482,103.809904
738322,772,366,1138,1.448591,103.809077
738323,15,191,206,1.448596,103.804885
738324,14,0,14,1.428878,103.77976
738325,0,2,2,1.427378,103.775853
738326,2,2,4,1.428253,103.780409
738327,0,2,2,1.428873,103.779953
738328,1,2,3,1.428622,103.780469
738329,18,2,20,1.428244,103.780147
738330,25,0,25,1.428242,103.780082
738331,179,0,179,1.42824,103.780016
738332,13,2,15,1.427042,103.778147
738333,0,1,1,1.428251,103.780344
738334,15,2,17,1.427029,103.778373
738335,22,27,49,1.427023,103.778486
738336,7,17,24,1.426936,103.778479
738337,1,1,2,1.428864,103.780339
738338,26,2,28,1.426647,103.778487
738339,55,1,56,1.426549,103.77841
738340,387,219,606,1.446724,103.807845
738341,7,51,58,1.451845,103.803494
738343,28,54,82,1.437284,103.787152
738344,2208,35207,37415,1.440681,103.800957
738345,16,3,19,1.427698,103.778075
738346,35,65,100,1.449239,103.804369
738347,1,2,3,1.428246,103.780213
738348,4,136,140,1.428248,103.777236
738349,9,121,130,1.428388,103.777291
738350,13,268,281,1.428501,103.777306
738351,1,457,458,1.428615,103.777321
738352,1,0,1,1.427036,103.77826
738353,69,3,72,1.427707,103.778279
738354,3,0,3,1.428205,103.7772
738355,54,0,54,1.453806,103.804769
738356,2,0,2,1.42684,103.778482
738357,18,58,76,1.453356,103.805019
738358,27,22,49,1.453132,103.805144
738359,19,181,200,1.453019,103.805206
738360,9,0,9,1.452897,103.805279
738361,27,0,27,1.45246,103.805514
738362,12,19,31,1.428034,103.777054
738363,126,27,153,1.447652,103.806557
738364,9,296,305,1.451363,103.80301
738365,5,23,28,1.451482,103.803311
738366,188,768,956,1.451668,103.803691
738367,16,6,22,1.428213,103.778501
738368,4,1,5,1.428214,103.778613
738370,101,5,106,1.428247,103.778922
738371,4,2,6,1.428358,103.778956
738372,40,0,40,1.428512,103.778956
738373,26,0,26,1.428666,103.778952
738374,13,338,351,1.42881,103.778952
738375,5,0,5,1.428852,103.778781
738376,0,7,7,1.428857,103.778581
738377,35,6,41,1.428862,103.778382
738379,10,0,10,1.428241,103.778017
738380,37,1,38,1.428248,103.77815
738381,25,2,27,1.428244,103.778293
738382,20,8,28,1.428243,103.778364
738383,1,2,3,1.453994,103.804701
738384,51,2,53,1.427791,103.777789
738385,5,1,6,1.427773,103.777597
738386,112,5,117,1.427826,103.777411
738387,8,17,25,1.427985,103.777261
738388,90,131,221,1.449007,103.805893
738389,5,0,5,1.453693,103.803
738391,195,13,208,1.453433,103.803122
738392,39,0,39,1.453365,103.803155
738393,2,34,36,1.453288,103.803198
738394,11,0,11,1.453032,103.80334
738395,12,0,12,1.452776,103.803483
738396,32,0,32,1.45252,103.803625
738397,11,0,11,1.452264,103.803768
738398,7,0,7,1.452136,103.803839
738399,3,510,513,1.428841,103.777956
738400,145,1,146,1.428615,103.777971
738402,92,3,95,1.428339,103.777982
738403,2,0,2,1.453581,103.804894
738404,1,0,1,1.428728,103.777336
738405,60,11,71,1.428292,103.776176
738406,9936,1710,11646,1.438347,103.767112
738407,1,0,1,1.428297,103.776264
738408,0,7,7,1.428253,103.778503
738409,1,4,5,1.428255,103.77856
738410,6,2,8,1.428257,103.778617
738411,7,0,7,1.428259,103.778674
738412,37,3,40,1.428261,103.778731
738413,123,2,125,1.428263,103.778788
738414,2,8,10,1.428264,103.778816
738415,33,5,38,1.428265,103.778845
738416,4,40,44,1.428437,103.778908
738417,0,18,18,1.428628,103.778909
738418,1,3,4,1.428869,103.780146
738419,0,15,15,1.42882,103.77803
738420,0,147,147,1.42863,103.778029
738421,21,98,119,1.428441,103.778028
738422,0,4,4,1.428799,103.778898
738423,1,3,4,1.428346,103.778028
738425,0,8,8,1.428244,103.778313
738426,35,6,41,1.428243,103.778384
738427,45,173,218,1.450348,103.804956
738428,160,536,696,1.450621,103.805404
738429,72,17,89,1.450398,103.805046
738430,112,157,269,1.450926,103.80594
738431,43,13,56,1.4505,103.805225
738432,8,26,34,1.45123,103.806477
738433,1,0,1,1.428251,103.778446
738434,677,458,1135,1.451534,103.807013
738435,7,0,7,1.450703,103.805582
738436,21,104,125,1.451838,103.80755
738437,5,42,47,1.450804,103.805761
738438,21,1294,1315,1.452143,103.808086
738439,10,0,10,1.450906,103.80594
738440,12,345,357,1.452447,103.808623
738441,43,0,43,1.451007,103.806119
738442,399,671,1070,1.452751,103.809159
738443,787,62,849,1.451108,103.806298
738444,181,122,303,1.453055,103.809696
738445,174,0,174,1.45121,103.806477
738446,20,273,293,1.453513,103.809578
738447,22,0,22,1.451311,103.806655
738448,7,4,11,1.451413,103.806834
738449,52,0,52,1.451514,103.807013
738450,16,50,66,1.451616,103.807192
738451,9,0,9,1.451717,103.807371
738452,6,14,20,1.451818,103.80755
738453,11,6,17,1.45192,103.807729
738454,10,8,18,1.452021,103.807907
738455,7,6,13,1.452123,103.808086
738456,31,0,31,1.452224,103.808265
738457,11,0,11,1.452325,103.808444
738458,8,0,8,1.452427,103.808623
738459,130,0,130,1.452528,103.808802
738460,18,0,18,1.45263,103.808981
738461,35,0,35,1.452731,103.809159
738462,25,0,25,1.452833,103.809338
738463,19,5,24,1.452934,103.809517
738464,166,0,166,1.453035,103.809696
738465,3,0,3,1.427696,103.777889
738466,105,0,105,1.453238,103.810054
738467,10,1,11,1.45334,103.810232
738468,17,71,88,1.453441,103.810411
738469,9,420,429,1.453543,103.81059
738470,14,356,370,1.453644,103.810769
738471,30,78,108,1.450469,103.805135
738472,71,1095,1166,1.453654,103.810759
738488,117,1206,1323,1.439408,103.791808
738489,524,170,694,1.441283,103.794011
738507,316,8,324,1.443472,103.790457
738524,283,91,374,1.44088,103.788728
738525,211,618,829,1.442105,103.788557
738526,102,1095,1197,1.439772,103.788381
738544,17,222,239,1.42829,103.775427
738545,41,234,275,1.428628,103.775425
738546,60,564,624,1.428874,103.775487
738547,8710,288,8998,1.425425,103.775333
738579,827,8168,8995,1.430806,103.775072
738580,12,2061,2073,1.42948,103.775466
738581,208,1648,1856,1.429581,103.775149
738597,78,231,309,1.435024,103.780449
738600,197,31,228,1.434622,103.779376
738602,3,411,414,1.437664,103.774459
738603,7,65,72,1.437151,103.773743
738620,125,379,504,1.43438,103.779704
738656,154,327,481,1.419029,103.757487
738664,6,167,173,1.415028,103.755553
738689,421,278,699,1.434286,103.76192
738691,0,15,15,1.435814,103.762893
738692,0,296,296,1.431931,103.762002
738694,1,9,10,1.433301,103.762679
738695,30,636,666,1.438569,103.765601
738696,3,5,8,1.436075,103.764163
738697,23,10,33,1.436353,103.764485
738698,10,89,99,1.438435,103.765493
738700,333,177,510,1.443738,103.770261
738702,2503,43615,46118,1.425249,103.762
738719,274,159,433,1.449143,103.806128
738720,148,106,254,1.449268,103.806352
738721,62,5,67,1.449519,103.806802
738722,21,0,21,1.44977,103.807251
738723,17,15,32,1.450021,103.807701
738724,31,75,106,1.450273,103.80815
738725,61,2,63,1.450524,103.8086
738726,112,120,232,1.450775,103.809049
738727,73,1,74,1.451362,103.808998
738728,32,325,357,1.451518,103.809305
738729,9,0,9,1.451748,103.809687
738730,141,345,486,1.451924,103.810057
738731,11,0,11,1.451919,103.810455
738732,588,624,1212,1.452343,103.810807
738733,933,324,1257,1.450379,103.811297
738734,415,113,528,1.452606,103.811945
738735,1,1,2,1.428306,103.776439
738736,9,3,12,1.449133,103.807597
738737,83,401,484,1.450459,103.8099
738738,29,0,29,1.449223,103.806308
738739,108,7,115,1.450353,103.80833
738740,43,32,75,1.449569,103.808035
738741,17,781,798,1.453654,103.810779
738750,862,227,1089,1.42901,103.76415
738782,60,88,148,1.430838,103.762176
738799,1653,2146,3799,1.432165,103.767564
738853,169,1248,1417,1.436771,103.791794
738907,206,75,281,1.442888,103.799693
738908,296,1964,2260,1.444082,103.795038
738909,84,1353,1437,1.444649,103.797891
738926,4,998,1002,1.435341,103.773143
738927,191,3,194,1.433827,103.773663
738931,123,1052,1175,1.441245,103.769394
738932,14,541,555,1.440683,103.768921
738954,89,475,564,1.44445,103.790016
738955,836,520,1356,1.455484,103.809923
738956,251,20,271,1.456271,103.810434
738957,380,36,416,1.456599,103.810965
738958,122,109,231,1.456061,103.810862
738959,864,586,1450,1.455381,103.81038
738960,843,489,1332,1.455089,103.811389
738961,828,5968,6796,1.442737,103.785453
738962,98,1263,1361,1.44339,103.786579
738963,87,8,95,1.443529,103.784843
738964,208,24,232,1.443008,103.785698
738965,32,27,59,1.444332,103.78414
738966,424,23,447,1.444847,103.784147
738967,45,26,71,1.44569,103.783538
738968,240,0,240,1.447254,103.78429
738969,254,116,370,1.447255,103.784295
738970,70,2,72,1.445217,103.78466
738971,11,0,11,1.44459,103.784684
738972,2205,1026,3231,1.45615,103.801493
738973,86,60,146,1.45428,103.800252
738990,397,816,1213,1.428068,103.796334
738991,43,972,1015,1.439028,103.802687
738992,405,273,678,1.430955,103.799658
738993,208,382,590,1.430745,103.799847
738994,62,70,132,1.431755,103.799167
738995,364,587,951,1.431058,103.800034
738996,176,76,252,1.430745,103.799847
738997,123,3,126,1.430745,103.799847
738998,117,10,127,1.430745,103.799847
738999,258,0,258,1.431251,103.799315
739000,220,52,272,1.431151,103.798942
739009,1208,496,1704,1.433902,103.803444
739010,32,1267,1299,1.432797,103.801191
739011,21,69,90,1.43268,103.800389
739012,4,81,85,1.299509,103.837
739013,3,1,4,1.428261,103.778028
739014,2,1,3,1.453137,103.809875
739015,0,2,2,1.450059,103.809087
739016,5,76,81,1.432613,103.801062
739017,3,89,92,1.299509,103.837
739019,2,1,3,1.299509,103.837
739020,1,39,40,1.299509,103.837
739021,5,86,91,1.299509,103.837
739022,3,1,4,1.299509,103.837
739027,16,178,194,1.299509,103.837
739044,1072,49055,50127,1.432563,103.774161
739045,6,111,117,1.299509,103.837
739062,242,39,281,1.430948,103.777326
739063,122,97,219,1.4302,103.778088
739064,248,2621,2869,1.429353,103.779364
739065,151,8679,8830,1.428724,103.781141
739066,61,699,760,1.431043,103.784416
739067,269,537,806,1.432693,103.78577
739068,65,3061,3126,1.42953,103.7744
739069,122,52,174,1.427547,103.792184
739070,1,63,64,1.299509,103.837
739082,24,63,87,1.444321,103.778659
739083,7,245,252,1.443105,103.780592
739084,13,182,195,1.442664,103.782179
739085,40,24,64,1.442461,103.782652
739086,20,144,164,1.441792,103.783522
739087,26,18,44,1.442321,103.784053
739088,128,274,402,1.443255,103.780324
739107,58,121,179,1.44321,103.780936
739108,78,1290,1368,1.440634,103.779963
739109,46,2543,2589,1.43837,103.775374
739110,296,2653,2949,1.436669,103.775995
739111,196,274,470,1.439565,103.774208
739127,83,505,588,1.440188,103.779577
739144,261,39,300,1.442793,103.779488
739145,254,205,459,1.444443,103.777755
739146,21,1023,1044,1.443515,103.775893
739147,47,1250,1297,1.444773,103.777305
739148,17,113,130,1.444732,103.775019
739149,14,15,29,1.446048,103.775097
739150,56,730,786,1.446223,103.774679
739151,36,29,65,1.446299,103.774324
739152,459,653,1112,1.445623,103.775527
739169,7,4,11,1.44123,103.782878
739170,8,7,15,1.441567,103.783121
739171,10,3,13,1.441797,103.781905
739172,9,7,16,1.442122,103.782044
739173,27,30,57,1.442202,103.781002
739175,54,212,266,1.44262,103.781674
739193,425,439,864,1.441247,103.783658
739211,292,149,441,1.442095,103.782971
739229,7,117,124,1.438976,103.782142
739230,6,492,498,1.439544,103.781511
739249,9,48,57,1.439357,103.78246
739250,5,7,12,1.439889,103.7818
739251,40,6,46,1.440063,103.781974
739252,10,85,95,1.44034,103.780897
739253,6,1,7,1.44063,103.781071
739254,59,3459,3518,1.439473,103.782831
739255,8,49,57,1.439589,103.782611
739256,2151,168,2319,1.43981,103.783109
739257,1175,783,1958,1.440028,103.783808
739275,19,4,23,1.440418,103.782229
739276,25,50,75,1.440966,103.781331
739277,33,10,43,1.440658,103.782508
739278,6,13,19,1.441276,103.781651
739279,18,212,230,1.441744,103.780713
739297,50,1370,1420,1.441169,103.775734
739352,12,373,385,1.410655,103.769291
739353,4,379,383,1.411115,103.76981
739354,14,295,309,1.411043,103.767496
739356,1,0,1,1.450601,103.805404
739361,1,352,353,1.414367,103.76861
739362,0,27,27,1.413614,103.769545
739363,0,158,158,1.413723,103.769561
739400,9,479,488,1.410886,103.774972
739425,3,41,44,1.434326,103.751891
739426,0,14,14,1.434701,103.750506
739427,37,52,89,1.435505,103.750352
739428,12,64,76,1.434446,103.749544
739429,0,1,1,1.412275,103.768276
739430,8,61,69,1.435754,103.748456
739431,1,0,1,1.436698,103.748318
739432,0,16,16,1.436161,103.74768
739433,7,1,8,1.437106,103.746923
739434,1,35,36,1.437735,103.746047
739436,2,14,16,1.438489,103.745333
739437,66,0,66,1.437093,103.745891
739438,0,2,2,1.299509,103.837
739440,51,11,62,1.43905,103.743436
739441,5,5,10,1.433867,103.730206
739442,2,69,71,1.435672,103.749409
739443,1,0,1,1.436433,103.747182
739444,3,1,4,1.299509,103.837
739445,0,1,1,1.436093,103.749355
739446,4,0,4,1.437098,103.743758
739447,1,7,8,1.437777,103.743539
739448,6,1,7,1.43797,103.743422
739449,26,10,36,1.435368,103.748226
739450,45,0,45,1.435963,103.746722
739451,223,7,230,1.436463,103.744431
739452,98,40,138,1.299509,103.837
739453,234,146,380,1.44672,103.730149
739461,57,218,275,1.434408,103.756002
739462,33,0,33,1.435102,103.75591
739464,3,0,3,1.432797,103.801191
739465,108,44,152,1.435316,103.755131
739467,122,38,160,1.436743,103.75492
739480,20,158,178,1.432188,103.755275
739481,2,0,2,1.438537,103.744456
739482,68,0,68,1.432972,103.755161
739483,18,82,100,1.433104,103.755127
739484,102,0,102,1.433548,103.754317
739485,47,0,47,1.434856,103.753974
739486,31,34,65,1.435246,103.754199
739487,14,12,26,1.435691,103.75428
739488,13,33,46,1.436244,103.754776
739489,1,0,1,1.437366,103.743694
739490,1,0,1,1.436271,103.754771
739494,2,1,3,1.435415,103.755674
739495,2,0,2,1.432491,103.75522
739498,20,2,22,1.436993,103.754478
739499,1,2,3,1.435947,103.754708
739503,16,1,17,1.435974,103.75398
739505,24,52,76,1.436478,103.753848
739506,4,36,40,1.43694,103.753825
739507,6,15,21,1.437395,103.754639
739508,1,3,4,1.437544,103.743619
739509,1,7,8,1.437395,103.754639
739510,2,42,44,1.437395,103.754639
739511,1,2,3,1.43594,103.754655
739512,4,2,6,1.437395,103.754639
739513,2,2,4,1.437395,103.754639
739514,0,2,2,1.435946,103.754702
739515,5,1,6,1.437395,103.754639
739516,3,2,5,1.437395,103.754639
739517,3,10,13,1.437395,103.754639
739518,14,97,111,1.437282,103.753103
739519,20,64,84,1.436034,103.75502
739520,178,179,357,1.427801,103.758204
739521,5,92,97,1.43678,103.753827
739522,146,11,157,1.431967,103.759884
739535,3,0,3,1.437395,103.754639
739536,10,4,14,1.433431,103.756481
739537,25,58,83,1.433633,103.755665
739538,38,82,120,1.432494,103.75585
739539,18,2,20,1.433507,103.756743
739540,3,2,5,1.432425,103.756477
739541,1,5,6,1.433576,103.757338
739542,11,5,16,1.433011,103.756508
739543,118,23,141,1.433685,103.757829
739544,268,0,268,1.434482,103.757515
739545,5,1,6,1.434725,103.757433
739546,2,0,2,1.437395,103.754639
739548,0,25,25,1.434276,103.759173
739550,36,0,36,1.434891,103.75915
739551,19,6,25,1.435683,103.757553
739552,2,0,2,1.435053,103.757351
739553,4,2,6,1.435869,103.758826
739554,0,1,1,1.436327,103.754762
739555,31,0,31,1.436105,103.757533
739556,3,0,3,1.433429,103.756415
739557,5,0,5,1.436326,103.757574
739558,3,0,3,1.437194,103.759717
739559,4,4,8,1.436407,103.75715
739560,1,0,1,1.436429,103.759426
739561,24,11,35,1.436549,103.75667
739562,0,1,1,1.437711,103.756411
739564,152,20,172,1.436553,103.755692
739565,1,2,3,1.437494,103.757633
739566,3,26,29,1.436597,103.751819
739567,0,3,3,1.436074,103.753268
739568,3,0,3,1.435236,103.758701
739625,66,2,68,1.417315,103.758214
739626,4,0,4,1.437395,103.754639
739627,36,4,40,1.416695,103.758319
739628,6,0,6,1.416633,103.758368
739629,0,1,1,1.437776,103.755394
739630,77,1,78,1.416532,103.758449
739631,37,2,39,1.416431,103.758555
739632,5,1,6,1.416331,103.758661
739633,2,1,3,1.428686,103.756338
739634,4,2,6,1.41618,103.758829
739635,0,3,3,1.416231,103.758767
739636,4,3,7,1.416036,103.75919
739637,5,2,7,1.415665,103.759514
739638,7,0,7,1.415629,103.759552
739641,23,0,23,1.417234,103.758211
739654,1,1,2,1.435613,103.75898
739655,11,1,12,1.41737,103.758436
739656,10,1,11,1.417375,103.758613
739657,14,2,16,1.417381,103.758791
739658,1,1,2,1.417368,103.758347
739659,5,1,6,1.417391,103.759146
739660,2,7,9,1.417392,103.759207
739662,2,3,5,1.417393,103.759389
739663,110,4,114,1.417394,103.759511
739665,2,0,2,1.417386,103.758968
739666,4,1,5,1.417397,103.759875
739667,0,2,2,1.417396,103.759754
739668,3,2,5,1.417399,103.760118
739669,81,1,82,1.4174,103.76024
739670,7,0,7,1.41741,103.759097
739671,3,0,3,1.416109,103.759101
739672,14,2,16,1.417405,103.758949
739673,4,0,4,1.417146,103.758213
739674,1,138,139,1.418028,103.75893
739675,4,2,6,1.417951,103.759161
739676,2,4,6,1.4179,103.759196
739677,9,12,21,1.417887,103.759312
739678,0,2,2,1.417398,103.759997
739679,21,17,38,1.417784,103.759486
739687,9,10,19,1.414814,103.757528
739688,9,0,9,1.414852,103.757588
739689,6,0,6,1.414929,103.757708
739691,2,0,2,1.417805,103.759365
739692,18,0,18,1.415158,103.758068
739693,6,0,6,1.415208,103.758134
739694,2,0,2,1.415082,103.757948
739695,8,0,8,1.415359,103.758331
739696,0,2,2,1.415258,103.758199
739697,6,0,6,1.41557,103.758523
739698,1,0,1,1.416577,103.7584
739699,0,1,1,1.415625,103.758569
739700,6,1,7,1.415741,103.758658
739701,9,0,9,1.415848,103.758738
739702,7,3,10,1.415954,103.758817
739703,2,0,2,1.415429,103.758401
739705,0,3,3,1.417408,103.759047
739706,8,2,10,1.415682,103.758526
739707,8,2,10,1.415729,103.758452
739710,1,3,4,1.417402,103.75885
739711,3,2,5,1.415916,103.758239
739712,5,1,6,1.415916,103.758259
739714,52,0,52,1.416009,103.758153
739715,9,1,10,1.416103,103.758026
739716,44,1,45,1.416103,103.758046
739717,3,1,4,1.415822,103.758366
739719,4,10,14,1.41628,103.757823
739720,0,6,6,1.41629,103.757833
739772,9,2,11,1.41583,103.757495
739774,10,0,10,1.415983,103.757601
739776,139,26,165,1.416188,103.757742
739777,2,3,5,1.41629,103.757813
739779,0,1,1,1.415688,103.758619
739780,1,0,1,1.416399,103.757885
739781,14,0,14,1.416616,103.758028
739782,56,0,56,1.416694,103.758108
739783,0,2,2,1.416061,103.758897
739784,1,0,1,1.416507,103.757956
739785,17,5,22,1.416796,103.758287
739786,2,1,3,1.415682,103.758506
739788,5,0,5,1.416807,103.758698
739789,2,2,4,1.416196,103.75792
739790,7,0,7,1.416816,103.759026
739791,1,0,1,1.416796,103.758287
739793,3,0,3,1.416798,103.758369
739795,183,3,186,1.416633,103.759586
739796,21,4,25,1.416838,103.759847
739797,7,0,7,1.416573,103.759656
739798,2,1,3,1.416829,103.759518
739799,1,0,1,1.41682,103.75919
739800,9,0,9,1.416683,103.760316
739801,1,1,2,1.416752,103.758189
739819,1,1,2,1.416777,103.758245
739820,3,0,3,1.416831,103.760049
739821,5,2,7,1.41527,103.757978
739823,2,3,5,1.415372,103.757879
739824,39,0,39,1.415372,103.757859
739826,3,1,4,1.416811,103.758862
739827,2,2,4,1.41544,103.757792
739828,44,1,45,1.415507,103.757726
739831,0,4,4,1.415575,103.757679
739833,18,0,18,1.415711,103.757526
739851,0,2,2,1.415219,103.758028
739852,0,1,1,1.416781,103.760134
739854,50,1,51,1.415121,103.757181
739856,0,1,1,1.415313,103.756996
739857,1,0,1,1.414953,103.757329
739859,47,7,54,1.414418,103.757964
739862,48,0,48,1.41451,103.758136
739865,16,0,16,1.414652,103.75844
739866,8,2,10,1.414631,103.758364
739867,0,1,1,1.41487,103.757404
739868,0,7,7,1.414692,103.758478
739869,13,4,17,1.414794,103.758707
739870,0,5,5,1.414753,103.758593
739871,2,1,3,1.415236,103.757992
739874,0,4,4,1.415779,103.75748
739875,1,0,1,1.414723,103.758574
739876,1,0,1,1.415098,103.758978
739877,3,0,3,1.414858,103.758782
739878,2,1,3,1.415213,103.75907
739879,11,0,11,1.415328,103.759163
739880,32,1,33,1.415173,103.759018
739881,0,2,2,1.415313,103.756996
739882,1,0,1,1.41497,103.758854
739883,11,0,11,1.415558,103.759349
739884,2,0,2,1.415443,103.759256
739886,6,1,7,1.415477,103.759263
739888,3,1,4,1.414878,103.758782
739889,2,0,2,1.415376,103.759181
739890,2,0,2,1.415783,103.759535
739891,1,0,1,1.415274,103.7591
739892,36,3,39,1.415731,103.759468
739893,1,0,1,1.415836,103.759581
739894,7,8,15,1.415798,103.759528
739895,1,1,2,1.41568,103.759427
739896,0,1,1,1.41594,103.759674
739897,3,0,3,1.415071,103.758936
739900,1,0,1,1.415866,103.759588
739902,4,0,4,1.415579,103.759345
739903,3,2,5,1.416464,103.76014
739904,15,0,15,1.416404,103.760067
739905,2,0,2,1.416045,103.759767
739907,1,1,2,1.416568,103.760233
739908,18,2,20,1.416673,103.760306
739909,8,19,27,1.416716,103.760365
739910,9,0,9,1.416744,103.760372
739911,111,0,111,1.416759,103.760405
739912,0,1,1,1.416135,103.759827
739913,18,2,20,1.416845,103.760484
739914,1,1,2,1.416663,103.760316
739915,21,0,21,1.41693,103.760562
739916,3,1,4,1.416269,103.759947
739917,3,3,6,1.417016,103.760641
739918,4,65,69,1.417092,103.76071
739919,4,1,5,1.416672,103.760305
739920,192,1,193,1.416672,103.760305
739921,2,4,6,1.414014,103.758327
739922,94,0,94,1.414055,103.758282
739925,4,2,6,1.414297,103.758008
739926,2,8,10,1.414378,103.757917
739927,3,0,3,1.41615,103.75986
739928,1,0,1,1.416816,103.760437
739929,2,1,3,1.414404,103.757974
739931,3,0,3,1.414402,103.757973
739932,1,15,16,1.417143,103.760701
739956,5,21,26,1.428913,103.77617
739957,49,70,119,1.428915,103.776223
739958,0,28,28,1.428919,103.776328
739959,0,34,34,1.428923,103.776433
739960,16,41,57,1.428927,103.776537
739961,0,1,1,1.414439,103.75804
739962,4,22,26,1.428942,103.776957
739963,0,5,5,1.428946,103.777062
739964,3,113,116,1.428948,103.777094
739965,0,136,136,1.428943,103.777193
739966,0,194,194,1.42892,103.77729
739967,0,25,25,1.428824,103.77732
739968,67,7,74,1.428297,103.776098
739969,40,8,48,1.428599,103.776093
739970,60,492,552,1.428911,103.776098
739971,1,1074,1075,1.42891,103.777614
739972,37,0,37,1.428682,103.777618
739973,3,5,8,1.428746,103.777374
739974,20,0,20,1.428119,103.777127
739975,12,3,15,1.428577,103.77738
739976,1,22,23,1.427958,103.776991
739977,1,0,1,1.42893,103.776642
739978,17,1,18,1.42819,103.777274
739979,8,99,107,1.441347,103.774676
739980,134,1859,1993,1.440852,103.773535
739981,52,584,636,1.442508,103.776276
739983,163,2900,3063,1.440966,103.772075
739984,159,458,617,1.445703,103.776815
750104,2,0,2,1.416959,103.760569
750105,0,16,16,1.299509,103.837
750106,4,8,12,1.299509,103.837
750107,0,1,1,1.428377,103.77734
750108,4,79,83,1.299509,103.837
750114,8,14,22,1.299509,103.837
750115,5,210,215,1.299509,103.837
750116,3,27,30,1.299509,103.837
750117,1,0,1,1.299509,103.837
750118,2,165,167,1.299509,103.837
750119,6,9,15,1.299509,103.837
750120,28,25,53,1.445359,103.83113
750121,33,0,33,1.299509,103.837
750128,0,3,3,1.415797,103.759527
750129,1,6,7,1.299509,103.837
750130,17,53,70,1.299509,103.837
750300,328,986,1314,1.445934,103.822568
750302,335,761,1096,1.445068,103.822927
750303,1128,1549,2677,1.444841,103.822289
750304,303,154,457,1.445219,103.822133
750305,448,70,518,1.445544,103.821994
750306,870,104,974,1.446052,103.822289
750307,349,27,376,1.446088,103.821737
750308,577,184,761,1.446487,103.821626
750309,418,337,755,1.446877,103.821461
750310,482,1231,1713,1.447061,103.821887
750311,676,2802,3478,1.446705,103.822436
750312,575,395,970,1.4445,103.820904
750313,1225,226,1451,1.444469,103.82145
750314,462,1532,1994,1.443795,103.821177
750315,575,575,1150,1.44689,103.820486
750316,581,31,612,1.44646,103.820818
750317,612,53,665,1.446126,103.820225
750318,524,3002,3526,1.446574,103.819918
750319,287,789,1076,1.446112,103.81925
750320,639,194,833,1.446626,103.818394
750321,697,255,952,1.446029,103.818388
750322,491,122,613,1.445599,103.818201
750323,447,311,758,1.445066,103.817964
750324,676,354,1030,1.444628,103.817758
750325,444,280,724,1.444494,103.818698
750326,534,524,1058,1.444682,103.819099
750327,636,123,759,1.445674,103.818939
750328,481,301,782,1.44539,103.819158
750329,518,277,795,1.446363,103.817625
750330,525,355,880,1.446883,103.817718
750331,655,422,1077,1.447541,103.816647
750332,553,213,766,1.446713,103.81694
750333,865,318,1183,1.447018,103.816228
750334,742,346,1088,1.447272,103.815595
750335,533,636,1169,1.447153,103.814974
750336,582,98,680,1.446927,103.815358
750337,717,350,1067,1.446092,103.815463
750338,596,187,783,1.445914,103.815113
750339,27,792,819,1.448333,103.817634
750340,43,122,165,1.447443,103.817999
750341,190,720,910,1.447184,103.818699
750350,30,1094,1124,1.450225,103.821157
750351,20,330,350,1.45122,103.82032
750353,10,275,285,1.451025,103.818964
750354,22,1481,1503,1.450049,103.818404
750355,92,285,377,1.449646,103.818602
750356,24,22,46,1.449466,103.817155
750357,484,521,1005,1.450036,103.816527
750358,6,36,42,1.449283,103.81642
750359,534,449,983,1.449867,103.815968
750360,22,31,53,1.449018,103.815439
750361,1,31,32,1.299509,103.837
750362,5,781,786,1.299509,103.837
750363,0,1,1,1.299509,103.837
750365,3,104,107,1.299509,103.837
750367,0,2,2,1.299509,103.837
750401,446,3971,4417,1.454324,103.815672
750402,224,1930,2154,1.453814,103.815604
750403,222,166,388,1.453986,103.81618
750404,378,176,554,1.453517,103.816497
750405,218,3720,3938,1.453367,103.815955
750406,637,3541,4178,1.452962,103.817017
750407,265,248,513,1.453264,103.816819
750408,300,123,423,1.45339,103.817635
750409,242,148,390,1.453053,103.817686
750410,307,161,468,1.452704,103.817701
750411,508,208,716,1.452294,103.818047
750412,296,85,381,1.45191,103.818252
750413,244,1455,1699,1.451731,103.817731
750414,484,954,1438,1.451238,103.817953
750415,318,377,695,1.451598,103.818376
750416,339,1171,1510,1.451862,103.818961
750417,255,622,877,1.451967,103.819493
750418,497,763,1260,1.452418,103.81922
750419,494,134,628,1.452297,103.818861
750420,298,286,584,1.452561,103.818836
750421,506,87,593,1.453102,103.818553
750422,547,205,752,1.45326,103.818378
750423,856,63,919,1.453712,103.818214
750424,564,284,848,1.453718,103.818598
750425,644,190,834,1.454412,103.818523
750462,980,292,1272,1.454665,103.813885
750463,69,2725,2794,1.456101,103.814296
750465,16,589,605,1.453284,103.815242
750466,22,69,91,1.455532,103.813499
750467,812,217,1029,1.452467,103.814547
750468,29,341,370,1.450748,103.81395
750469,547,1180,1727,1.448361,103.813896
750470,369,77,446,1.451725,103.815196
750471,397,225,622,1.451932,103.815499
750472,354,193,547,1.451599,103.816044
750473,216,29,245,1.451057,103.816212
750474,408,2875,3283,1.450692,103.816479
750475,357,1755,2112,1.450892,103.81706
750476,666,619,1285,1.451514,103.816835
750477,448,523,971,1.452067,103.816553
750478,444,2420,2864,1.452594,103.816199
750479,127,236,363,1.452669,103.815614
750480,397,108,505,1.452046,103.815046
750481,495,662,1157,1.452893,103.814941
750482,287,146,433,1.455317,103.815429
750483,847,545,1392,1.455885,103.815519
750484,755,332,1087,1.457095,103.815182
750485,479,192,671,1.456722,103.815871
750486,992,207,1199,1.456185,103.816094
750487,366,236,602,1.455636,103.815988
750488,338,444,782,1.454964,103.816559
750489,354,367,721,1.454951,103.81693
750490,591,404,995,1.455059,103.817122
750491,1262,832,2094,1.456244,103.81773
750492,515,108,623,1.456599,103.816916
750493,667,173,840,1.456517,103.816472
750501,12,322,334,1.451784,103.821157
750502,22,226,248,1.451311,103.821915
750503,46,120,166,1.45055,103.821983
750504,5,147,152,1.450849,103.82409
750505,54,1946,2000,1.450256,103.822972
750506,6,148,154,1.452661,103.823401
750507,13,82,95,1.452043,103.823416
750508,46,2166,2212,1.453116,103.820005
750509,22,36,58,1.453615,103.821028
750511,767,2456,3223,1.453736,103.819382
750512,240,223,463,1.453856,103.81997
750513,451,257,708,1.454028,103.820297
750588,37,12,49,1.450195,103.825092
750590,164,315,479,1.299509,103.837
750591,5,78,83,1.299509,103.837
750592,13,23,36,1.299509,103.837
750593,70,254,324,1.299509,103.837
751106,129,48,177,1.299509,103.837
751107,8,0,8,1.299509,103.837
751108,18,10,28,1.299509,103.837
751115,42,4,46,1.299509,103.837
751117,0,54,54,1.299509,103.837
751118,6,293,299,1.299509,103.837
751119,271,111,382,1.445948,103.831311
751120,28,66,94,1.299509,103.837
751121,125,44,169,1.44726,103.833606
751128,5,7,12,1.299509,103.837
751129,13,88,101,1.442578,103.807029
751130,71,30,101,1.444015,103.831881
751306,9,374,383,1.445376,103.822578
751313,36,494,530,1.444317,103.820841
751316,18,315,333,1.446606,103.820103
751322,28,535,563,1.446296,103.818086
751323,10,133,143,1.445264,103.818279
751325,11,217,228,1.444994,103.818746
751330,1,226,227,1.447325,103.81735
751334,125,3024,3149,1.448037,103.816342
751335,3,250,253,1.447798,103.815447
751336,12,659,671,1.446326,103.81501
751337,29,80,109,1.446369,103.81559
751339,513,109,622,1.448116,103.817775
751340,338,204,542,1.447496,103.81763
751341,883,4206,5089,1.44747,103.818687
751350,222,680,902,1.45046,103.82053
751351,278,147,425,1.450415,103.820111
751352,203,89,292,1.450783,103.819656
751353,249,53,302,1.450599,103.818876
751354,171,123,294,1.450037,103.818699
751355,234,696,930,1.449646,103.818602
751356,332,96,428,1.44938,103.816859
751357,1040,364,1404,1.450093,103.817001
751358,32,2100,2132,1.448927,103.816307
751359,542,2180,2722,1.449742,103.815497
751360,623,126,749,1.449124,103.815789
751362,0,38,38,1.299509,103.837
751363,0,22,22,1.299509,103.837
751365,0,12,12,1.299509,103.837
751366,1,13,14,1.299509,103.837
751403,16,175,191,1.453642,103.816009
751404,9,637,646,1.45453,103.815945
751406,45,3298,3343,1.452376,103.817468
751415,5,29,34,1.45187,103.818603
751423,7,9,16,1.453439,103.817927
751424,19,1025,1044,1.453216,103.819056
751462,16,106,122,1.454607,103.813848
751463,658,59,717,1.455684,103.813642
751466,240,259,499,1.455009,103.813688
751467,937,202,1139,1.452781,103.813735
751468,874,299,1173,1.45036,103.813875
751469,733,395,1128,1.450016,103.813665
751475,13,53,66,1.451186,103.816876
751476,6,378,384,1.451954,103.816742
751480,4,102,106,1.451963,103.814835
751481,18,337,355,1.452868,103.81572
751482,20,258,278,1.454644,103.816225
751484,13,224,237,1.456474,103.815259
751492,6,149,155,1.456675,103.817381
751501,496,3875,4371,1.451793,103.820694
751502,366,1679,2045,1.451217,103.821227
751503,348,1052,1400,1.45044,103.821567
751504,737,247,984,1.4514,103.82378
751506,423,324,747,1.452227,103.823752
751507,473,692,1165,1.453107,103.823654
751508,318,1511,1829,1.452586,103.820203
751509,429,376,805,1.453003,103.820584
751510,367,119,486,1.453654,103.820222
751588,490,123,613,1.45066,103.82555
751589,449,328,777,1.449725,103.825793
751590,566,107,673,1.450623,103.826674
751591,194,247,441,1.451002,103.82629
751592,574,1212,1786,1.450884,103.82786
751593,798,5,803,1.450884,103.82786
752104,5,5,10,1.299509,103.837
752106,67,48,115,1.44462,103.83465
752107,62,22,84,1.299509,103.837
752108,3,7,10,1.299509,103.837
752115,4,0,4,1.417102,103.7607
752117,0,12,12,1.299509,103.837
752118,1,25,26,1.299509,103.837
752119,47,5,52,1.446092,103.831224
752120,1,24,25,1.299509,103.837
752121,100,19,119,1.299509,103.837
752128,3,0,3,1.299509,103.837
752129,4,5,9,1.448222,103.822375
752130,45,8,53,1.299509,103.837
752306,4,389,393,1.44671,103.822124
752339,342,271,613,1.448049,103.817276
752340,547,122,669,1.447149,103.818126
752341,436,5991,6427,1.448115,103.818279
752350,154,414,568,1.45,103.820666
752351,223,296,519,1.450828,103.819934
752352,122,65,187,1.450371,103.819836
752353,161,31,192,1.450031,103.819187
752354,327,157,484,1.450349,103.818547
752356,451,997,1448,1.44907,103.817321
752357,219,701,920,1.450402,103.81744
752359,789,1322,2111,1.449482,103.815075
752360,356,1217,1573,1.448598,103.815209
752362,1,5,6,1.299509,103.837
752363,0,24,24,1.444834,103.820249
752364,4,26,30,1.299509,103.837
752365,3,69,72,1.299509,103.837
752366,5,7,12,1.299509,103.837
752462,18,307,325,1.454677,103.813907
752463,161,126,287,1.456101,103.814296
752466,522,297,819,1.454895,103.813183
752467,924,276,1200,1.450923,103.813678
752468,599,2295,2894,1.450182,103.81415
752469,1162,1867,3029,1.448242,103.813268
752482,1,240,241,1.455155,103.815727
752484,32,208,240,1.456753,103.815253
752501,459,403,862,1.452214,103.821227
752503,356,1218,1574,1.450479,103.821988
752504,118,71,189,1.450719,103.823169
752507,426,636,1062,1.452929,103.823074
752508,271,428,699,1.452813,103.820737
752509,766,380,1146,1.453206,103.821053
752510,333,257,590,1.453893,103.820694
752588,801,114,915,1.450608,103.824931
752589,278,401,679,1.449679,103.825201
752590,310,740,1050,1.450097,103.826804
752592,742,326,1068,1.450884,103.82786
752593,855,377,1232,1.450884,103.82786
753104,5,7,12,1.299509,103.837
753107,22,4,26,1.299509,103.837
753115,1,3,4,1.299509,103.837
753120,13,82,95,1.299509,103.837
753121,28,27,55,1.299509,103.837
753128,0,1,1,1.299509,103.837
753129,9,5,14,1.299509,103.837
753350,184,25843,26027,1.449869,103.82027
753351,297,343,640,1.451375,103.819663
753352,248,9888,10136,1.449982,103.819826
753353,209,2083,2292,1.449787,103.819115
753354,217,1850,2067,1.450772,103.818272
753356,521,816,1337,1.449193,103.817768
753357,474,448,922,1.449686,103.817714
753359,509,1595,2104,1.449291,103.814493
753360,515,2358,2873,1.448492,103.814641
753362,2,1,3,1.299509,103.837
753363,2,71,73,1.299509,103.837
753365,0,14,14,1.299509,103.837
753463,265,2444,2709,1.299509,103.837
753466,533,113,646,1.456008,103.812983
753468,507,1311,1818,1.450544,103.814712
753501,483,61,544,1.451581,103.821656
753503,603,351,954,1.45059,103.8225
753504,720,2589,3309,1.450213,103.823467
753507,566,178,744,1.452133,103.823068
753508,322,557,879,1.452973,103.821115
753588,455,99,554,1.450778,103.824498
753589,682,893,1575,1.449746,103.824648
753590,614,324,938,1.450097,103.826804
753592,764,317,1081,1.450884,103.82786
754104,5,2,7,1.299509,103.837
754115,5,71,76,1.299509,103.837
754120,4,8,12,1.299509,103.837
754121,122,68,190,1.299509,103.837
754128,0,7,7,1.299509,103.837
754351,216,122,338,1.45109,103.819376
754354,305,147,452,1.450828,103.818455
754466,441,178,619,1.456102,103.81349
754468,598,572,1170,1.45103,103.814292
754501,379,168,547,1.451322,103.822221
754504,361,124,485,1.450759,103.823814
754507,586,132,718,1.451533,103.822773
754589,463,2366,2829,1.4499,103.824062
756982,4,257,261,1.299509,103.837
756992,241,382,623,1.456104,103.787348
756997,9,1238,1247,1.448031,103.819
757022,10,286,296,1.299509,103.837
757032,0,14,14,1.299509,103.837
757033,0,14,14,1.299509,103.837
757034,1,10,11,1.299509,103.837
757035,0,2,2,1.299509,103.837
757036,3,5,8,1.299509,103.837
757037,0,2,2,1.299509,103.837
757038,0,4,4,1.299509,103.837
757039,0,2,2,1.299509,103.837
757040,0,2,2,1.299509,103.837
757041,55,134,189,1.299509,103.837
757043,8,79,87,1.299509,103.837
757047,481,69,550,1.449157,103.798802
757048,14,643,657,1.448531,103.797374
757052,182,84,266,1.444704,103.816787
757057,117,6,123,1.299509,103.837
757058,364,19,383,1.299509,103.837
757059,14,755,769,1.299509,103.837
757060,287,95,382,1.299509,103.837
757061,346,41,387,1.4438,103.819879
757087,1306,443,1749,1.44485,103.812834
757088,118,94,212,1.444153,103.814094
757089,8,4,12,1.44441,103.814104
757090,13,37,50,1.299509,103.837
757091,11,161,172,1.299509,103.837
757092,154,355,509,1.444748,103.817398
757093,421,60,481,1.299509,103.837
757094,276,403,679,1.299509,103.837
757095,197,127,324,1.299509,103.837
757096,135,293,428,1.444704,103.816787
757097,8,0,8,1.299509,103.837
757098,20,0,20,1.299509,103.837
757099,2,7,9,1.299509,103.837
757100,20,3,23,1.299509,103.837
757102,12,46,58,1.299509,103.837
757103,1,7,8,1.299509,103.837
757104,15,4,19,1.460488,103.838335
757105,24,1,25,1.299509,103.837
757106,20,19,39,1.299509,103.837
757107,52,0,52,1.299509,103.837
757108,10,14,24,1.299509,103.837
757109,19,0,19,1.299509,103.837
757110,5,4,9,1.299509,103.837
757111,4,16,20,1.299509,103.837
757112,2,3,5,1.299509,103.837
757113,14,45,59,1.299509,103.837
757114,4,2,6,1.299509,103.837
757115,42,1,43,1.299509,103.837
757116,17,0,17,1.299509,103.837
757117,1,0,1,1.299509,103.837
757118,0,3,3,1.299509,103.837
757119,43,10,53,1.299509,103.837
757120,1,4,5,1.299509,103.837
757121,0,1,1,1.299509,103.837
757122,16,0,16,1.299509,103.837
757123,1,1,2,1.299509,103.837
757124,1,0,1,1.299509,103.837
757125,5,1,6,1.299509,103.837
757127,3,2,5,1.299509,103.837
757128,8,0,8,1.299509,103.837
757129,8,0,8,1.299509,103.837
757133,6,2,8,1.299509,103.837
757134,2,0,2,1.299509,103.837
757136,1,0,1,1.299509,103.837
757138,4,1,5,1.299509,103.837
757139,4,0,4,1.299509,103.837
757140,7,2,9,1.299509,103.837
757141,6,0,6,1.299509,103.837
757142,1,7,8,1.299509,103.837
757144,9,2,11,1.299509,103.837
757145,4,0,4,1.299509,103.837
757146,3,1,4,1.299509,103.837
757148,0,26,26,1.299509,103.837
757149,31,0,31,1.299509,103.837
757150,11,1,12,1.299509,103.837
757151,0,1,1,1.299509,103.837
757153,51,0,51,1.299509,103.837
757154,1,0,1,1.299509,103.837
757155,29,7,36,1.299509,103.837
757156,7,2,9,1.299509,103.837
757157,3,0,3,1.299509,103.837
757158,2,2,4,1.299509,103.837
757159,14,0,14,1.299509,103.837
757160,19,2,21,1.299509,103.837
757161,3,2,5,1.299509,103.837
757167,0,4,4,1.299509,103.837
757168,5,0,5,1.299509,103.837
757169,1,4,5,1.299509,103.837
757170,6,0,6,1.299509,103.837
757171,9,2,11,1.299509,103.837
757172,2,1,3,1.299509,103.837
757173,10,0,10,1.299509,103.837
757174,0,2,2,1.299509,103.837
757177,369,203,572,1.450195,103.796476
757178,22,16,38,1.454764,103.799937
757182,3,0,3,1.299509,103.837
757183,46,0,46,1.299509,103.837
757187,4,0,4,1.299509,103.837
757188,1,1,2,1.299509,103.837
757189,5,0,5,1.299509,103.837
757191,3,1,4,1.299509,103.837
757192,6,0,6,1.299509,103.837
757193,19,8,27,1.299509,103.837
757194,2,0,2,1.299509,103.837
757195,19,3,22,1.299509,103.837
757196,1,0,1,1.299509,103.837
757197,12,0,12,1.299509,103.837
757198,3,4,7,1.299509,103.837
757200,5,5,10,1.460192,103.839934
757201,50,13,63,1.299509,103.837
757202,6,0,6,1.299509,103.837
757203,1,4,5,1.299509,103.837
757204,2,0,2,1.299509,103.837
757205,0,9,9,1.299509,103.837
757206,14,0,14,1.299509,103.837
757207,4,31,35,1.299509,103.837
757208,34,1,35,1.460308,103.840486
757209,12,0,12,1.299509,103.837
757210,12,0,12,1.299509,103.837
757211,2,1,3,1.299509,103.837
757212,7,2,9,1.299509,103.837
757213,1,4,5,1.299509,103.837
757214,1,3,4,1.299509,103.837
757215,35,5,40,1.299509,103.837
757216,14,4,18,1.299509,103.837
757217,5,2,7,1.299509,103.837
757218,125,3,128,1.299509,103.837
757219,3,3,6,1.299509,103.837
757220,3,4,7,1.299509,103.837
757221,2,6,8,1.299509,103.837
757222,15,0,15,1.299509,103.837
757223,21,4,25,1.459877,103.838352
757224,11,0,11,1.299509,103.837
757225,1,2,3,1.299509,103.837
757226,2,0,2,1.299509,103.837
757228,0,1,1,1.299509,103.837
757230,3,1,4,1.299509,103.837
757231,8,0,8,1.299509,103.837
757232,0,4,4,1.299509,103.837
757233,12,0,12,1.299509,103.837
757234,6,2,8,1.299509,103.837
757237,6,0,6,1.458721,103.838005
757238,0,10,10,1.458691,103.838029
757239,1,0,1,1.299509,103.837
757240,8,0,8,1.458879,103.838125
757241,1,1,2,1.299509,103.837
757242,3,0,3,1.299509,103.837
757243,6,1,7,1.459024,103.838185
757244,1,1,2,1.458928,103.838155
757245,39,0,39,1.459116,103.838238
757246,1,0,1,1.458824,103.838062
757252,2,4,6,1.45905,103.83795
757253,10,0,10,1.459128,103.83797
757254,0,1,1,1.459173,103.838286
757256,2,0,2,1.459069,103.838238
757257,2,0,2,1.459251,103.838013
757258,1,0,1,1.459145,103.83799
757259,0,2,2,1.459331,103.838041
757260,6,1,7,1.299509,103.837
757261,62,10,72,1.299509,103.837
757262,6,0,6,1.299509,103.837
757263,5,16,21,1.299509,103.837
757264,46,3,49,1.299509,103.837
757265,3,0,3,1.458974,103.838176
757266,1,11,12,1.299509,103.837
757272,10,3,13,1.460822,103.838687
757273,1,0,1,1.299509,103.837
757274,4,2,6,1.460759,103.838754
757275,5,12,17,1.460713,103.8388
757276,13,0,13,1.299509,103.837
757277,2,7,9,1.451857,103.792446
757278,0,3,3,1.299509,103.837
757279,2,1,3,1.451774,103.792471
757280,4,3,7,1.451613,103.792548
757281,1,2,3,1.451664,103.792514
757282,2,1,3,1.4515,103.7926
757283,2,4,6,1.451345,103.792616
757284,8,1,9,1.45128,103.792649
757285,1,1,2,1.299509,103.837
757287,0,3,3,1.45145,103.792599
757288,1,3,4,1.299509,103.837
757289,1,0,1,1.460806,103.838728
757290,1,1,2,1.450608,103.792442
757291,7,122,129,1.450608,103.792442
757292,1,107,108,1.450608,103.792442
757293,0,6,6,1.450608,103.792442
757294,1,1,2,1.450608,103.792442
757295,28,2,30,1.450608,103.792442
757296,1,2,3,1.450608,103.792442
757297,1,0,1,1.450608,103.792442
757299,1,4,5,1.45132,103.792387
757300,2,4,6,1.451373,103.792331
757301,10,2,12,1.451442,103.79233
757302,13,1,14,1.451543,103.792278
757303,1,3,4,1.450608,103.792442
757304,0,9,9,1.45169,103.792255
757305,3,16,19,1.451793,103.792224
757306,4,170,174,1.451832,103.792166
757307,7,1378,1385,1.451778,103.791944
757308,0,6,6,1.451668,103.791941
757309,3,2,5,1.451594,103.791997
757310,2,5,7,1.451478,103.792006
757311,9,1,10,1.451406,103.792061
757312,1,5,6,1.451321,103.792089
757313,4,1,5,1.451252,103.792081
757314,0,3,3,1.450608,103.792442
757315,3,3,6,1.450608,103.792442
757316,0,8,8,1.450608,103.792442
757317,0,10,10,1.450608,103.792442
757318,2,11,13,1.450608,103.792442
757319,16,6,22,1.450608,103.792442
757320,6,14,20,1.450608,103.792442
757321,9,163,172,1.450608,103.792442
757322,1119,827,1946,1.450735,103.791237
757327,0,2,2,1.450608,103.792442
757328,3,0,3,1.451207,103.792142
757329,5,42,47,1.46023,103.838635
757330,4,0,4,1.4516,103.792278
757331,0,3,3,1.46027,103.838582
757332,13,0,13,1.460121,103.838782
757333,1,0,1,1.450608,103.792442
757334,30,0,30,1.460051,103.838874
757335,1,7,8,1.460024,103.838909
757337,0,3,3,1.46015,103.838737
757338,7,0,7,1.459937,103.83904
757339,18,2,20,1.459909,103.839071
757340,12,3,15,1.459887,103.839118
757341,2,3,5,1.460704,103.838458
757342,3,0,3,1.459965,103.838996
757343,2,0,2,1.460309,103.838534
757344,12,0,12,1.460589,103.838579
757346,13,5,18,1.460547,103.838702
757347,0,3,3,1.460674,103.838475
757348,6,2,8,1.460323,103.838791
757349,3,0,3,1.460348,103.838742
757350,5,1,6,1.460262,103.838876
757351,1,2,3,1.46029,103.838834
757352,1,2,3,1.460236,103.838915
757353,6,7,13,1.460177,103.839005
757354,57,0,57,1.460149,103.839044
757355,7,3,10,1.460121,103.839085
757356,1,0,1,1.460083,103.838826
757358,8,5,13,1.460447,103.838303
757360,3,0,3,1.460202,103.838958
757361,1,0,1,1.460091,103.83913
757362,3,2,5,1.460794,103.838947
757363,11,0,11,1.460759,103.838999
757364,4,7,11,1.460721,103.839049
757365,5,0,5,1.460685,103.839099
757366,1,1,2,1.460626,103.838554
757367,3,3,6,1.460619,103.839188
757369,2,4,6,1.460553,103.839277
757370,26,1,27,1.460523,103.839322
757371,0,3,3,1.460379,103.838426
757372,1,1,2,1.460651,103.839148
757373,5,4,9,1.460947,103.838464
757374,1,0,1,1.460342,103.838473
757375,1,2,3,1.460485,103.839372
757376,18,0,18,1.460834,103.838603
757377,24,12,36,1.460319,103.837798
757378,11,2,13,1.460304,103.837862
757379,1,6,7,1.460291,103.837912
757380,24,3,27,1.460271,103.837978
757381,0,1,1,1.460888,103.838499
757382,3,3,6,1.458842,103.837388
757383,1,2,3,1.4609,103.838584
757384,3,2,5,1.460226,103.837738
757385,20,2,22,1.458977,103.83789
757386,1,1,2,1.460444,103.839435
757387,648,302,950,1.452225,103.794322
757388,34,7,41,1.450056,103.794869
757392,2,2,4,1.460191,103.83869
757393,1,0,1,1.45878,103.837345
757394,4,0,4,1.459389,103.838828
757395,13,7,20,1.299509,103.837
757396,1,0,1,1.459339,103.838873
757397,4,2,6,1.460184,103.837882
757398,8,139,147,1.460367,103.837563
757399,15,0,15,1.460358,103.837621
757400,3,24,27,1.460347,103.837682
757401,13,14,27,1.460333,103.837744
757402,41,1,42,1.459638,103.837941
757403,5,2,7,1.459688,103.83797
757405,8,0,8,1.45978,103.838006
757406,1,7,8,1.459833,103.838029
757407,8,8,16,1.459571,103.837723
757408,2,6,8,1.459611,103.837633
757409,6,2,8,1.459652,103.837533
757410,11,12,23,1.459685,103.83744
757411,1,5,6,1.460163,103.837953
757412,4,8,12,1.459184,103.838278
757413,1,1,2,1.458993,103.83789
757414,0,11,11,1.459314,103.838371
757415,52,10,62,1.459386,103.838403
757416,1,6,7,1.459455,103.838453
757417,27,5,32,1.458835,103.837731
757418,8,2,10,1.458836,103.837789
757419,10,5,15,1.458795,103.837835
757420,4,0,4,1.459286,103.838942
757421,47,2,49,1.458715,103.837955
757422,2,3,5,1.45896,103.838327
757423,1,1,2,1.45926,103.838325
757424,36,8,44,1.459259,103.838453
757425,2,2,4,1.458754,103.837883
757426,11,1,12,1.459122,103.838246
757427,4,7,11,1.459652,103.837707
757428,1,0,1,1.299509,103.837
757429,15,7,22,1.459209,103.837354
757430,8,1,9,1.459541,103.837894
757431,4,3,7,1.459591,103.83792
757432,13634,10,13644,1.45482,103.793629
757437,2818,2535,5353,1.463076,103.81437
757438,3674,1831,5505,1.46213,103.815813
757439,54,433,487,1.462292,103.810699
757440,419,687,1106,1.462043,103.814341
757441,267,451,718,1.299509,103.837
757443,199,320,519,1.459828,103.8201
757444,124,37,161,1.461269,103.818398
757445,24,80,104,1.453902,103.777717
757446,11,101,112,1.299509,103.837
757447,15,61,76,1.447772,103.793422
757448,1,2,3,1.460198,103.837815
757449,1,3,4,1.459063,103.838201
757450,2,5,7,1.447948,103.79336
757451,5,2,7,1.448262,103.793978
757453,0,1,1,1.459739,103.837562
757454,3,1,4,1.447877,103.793385
757455,5,12,17,1.448382,103.794325
757456,2,9,11,1.448369,103.793213
757457,3,0,3,1.447807,103.793409
757458,10,0,10,1.448509,103.793164
757459,10,2,12,1.448579,103.793139
757461,29,2,31,1.448581,103.793828
757462,0,1,1,1.448347,103.79418
757463,2,0,2,1.459167,103.838402
757464,0,2,2,1.448645,103.793979
757465,0,13,13,1.448936,103.794009
757466,18,10,28,1.448895,103.793931
757467,4,1,5,1.448844,103.793865
757469,2,1,3,1.448439,103.793188
757470,3,0,3,1.448808,103.79367
757472,2,0,2,1.448645,103.794058
757474,0,6,6,1.44868,103.793321
757475,6,4,10,1.44898,103.79322
757476,17,2,19,1.449027,103.793294
757477,3,1,4,1.448347,103.794236
757478,3,0,3,1.448757,103.793618
757479,20,2,22,1.44912,103.793553
757480,1,0,1,1.448606,103.793915
757481,4,0,4,1.449063,103.793353
757482,0,5,5,1.449199,103.793784
757483,2,5,7,1.449234,103.793857
757484,0,2,2,1.448729,103.793438
757487,309,6,315,1.426518,103.824313
757488,593,1,594,1.426866,103.82443
757489,100,3,103,1.427172,103.824498
757492,0,4,4,1.449175,103.793725
757493,5,0,5,1.449769,103.792535
757495,1,0,1,1.449117,103.793636
757497,2,1,3,1.449083,103.793471
757498,4,0,4,1.45007,103.792446
757499,1,1,2,1.449257,103.793979
757500,40,3,43,1.449527,103.791918
757502,1,2,3,1.449618,103.79221
757503,69,0,69,1.449442,103.791674
757504,42,15,57,1.449399,103.791566
757505,1,215,216,1.449364,103.791521
757506,3,479,482,1.449731,103.791407
757507,2,10,12,1.449786,103.791456
757508,0,12,12,1.449809,103.791577
757509,1,8,9,1.449824,103.791653
757510,2,7,9,1.449848,103.791745
757511,7,37,44,1.449905,103.791837
757512,115,577,692,1.452053,103.792746
757513,6,0,6,1.451667,103.792989
757514,83,13,96,1.451457,103.793128
757515,81,107,188,1.451066,103.793277
757516,426,1861,2287,1.45211,103.79208
757517,42,243,285,1.460715,103.805046
757521,243,6,249,1.454201,103.817423
757522,20,62,82,1.449966,103.791975
757523,2,43,45,1.449963,103.792084
757524,2,28,30,1.450021,103.792155
757525,0,13,13,1.450021,103.79224
757526,2,4,6,1.450052,103.792348
757527,15,435,450,1.447231,103.819675
757537,0,2,2,1.449585,103.792036
757538,1,0,1,1.449714,103.792356
757539,0,1,1,1.461397,103.839557
757546,0,1,1,1.46139,103.839605
757547,0,1,1,1.461216,103.839892
757551,0,3,3,1.449464,103.791741
757555,3,0,3,1.461058,103.840046
757561,0,2,2,1.461419,103.839493
757582,0,1,1,1.461178,103.839919
757586,0,2,2,1.461493,103.839989
757587,3,158,161,1.462126,103.838853
757591,0,1,1,1.462008,103.839078
757600,0,1,1,1.46183,103.838875
757602,0,4,4,1.449594,103.792085
757609,9,0,9,1.4612,103.838459
757610,4,79,83,1.451627,103.80086
757611,185,59,244,1.460781,103.811057
757612,24,142,166,1.460872,103.811674
757613,7,0,7,1.460904,103.811288
757614,144,5771,5915,1.454723,103.81481
757615,19,573,592,1.461665,103.827395
757616,980,76,1056,1.440815,103.822978
757618,133,764,897,1.463971,103.814896
757619,29,0,29,1.463971,103.814896
757620,78,555,633,1.455922,103.819495
757622,194,3651,3845,1.456638,103.813826
757624,289,0,289,1.43033,103.825519
757625,47,0,47,1.430354,103.825522
757626,10,0,10,1.430361,103.825519
757627,3,0,3,1.461324,103.840199
757628,1,0,1,1.4616,103.839234
757629,30,0,30,1.430356,103.825543
757630,3,0,3,1.430332,103.825514
757632,152,1083,1235,1.444723,103.819606
757633,46,670,716,1.444702,103.819476
757634,1,8,9,1.458765,103.837478
757635,1,1,2,1.462083,103.838897
757636,1,3,4,1.461549,103.839339
757637,2,0,2,1.458743,103.837495
757638,0,2,2,1.458693,103.837564
757639,0,3,3,1.430327,103.825522
757640,8,6,14,1.45862,103.837724
757641,0,4,4,1.458719,103.837534
757642,3,0,3,1.458637,103.837681
757643,7,2,9,1.458506,103.837897
757644,1,3,4,1.458582,103.83778
757645,3,0,3,1.458547,103.837831
757646,0,2,2,1.458665,103.837628
757647,1,1,2,1.458383,103.83813
757648,1,0,1,1.430355,103.825539
757649,3,12,15,1.458285,103.838314
757650,6,3,9,1.458363,103.83828
757651,2,0,2,1.458337,103.838211
757652,0,2,2,1.458395,103.838221
757653,1,0,1,1.458306,103.838269
757654,4,1,5,1.458509,103.838013
757655,0,3,3,1.458436,103.838018
757656,1,0,1,1.458467,103.83809
757657,1,0,1,1.45892,103.838322
757658,2,4,6,1.458882,103.838393
757659,4,1,5,1.45886,103.838429
757660,3,8,11,1.458821,103.838498
757661,16,1,17,1.45879,103.838561
757662,0,3,3,1.458942,103.838277
757663,31,0,31,1.458835,103.838547
757664,12,8,20,1.458852,103.838505
757665,1,1,2,1.458427,103.838161
757666,0,3,3,1.458809,103.838588
757667,6,8,14,1.458967,103.838315
757668,2,0,2,1.458869,103.838481
757669,15,2,17,1.459011,103.837316
757670,3,12,15,1.457241,103.837374
757671,2,15,17,1.45727,103.837382
757672,4,0,4,1.458466,103.83796
757673,6,1,7,1.457318,103.83745
757674,2,2,4,1.457274,103.837442
757675,1,0,1,1.458901,103.838356
757676,2,5,7,1.457726,103.83747
757677,0,1,1,1.457434,103.83736
757679,3,0,3,1.458891,103.838435
757680,72,0,72,1.457727,103.837538
757681,2,0,2,1.45891,103.83743
757682,1,2,3,1.457689,103.837534
757683,5,1,6,1.457657,103.837583
757685,22,5,27,1.457604,103.837676
757686,20,1,21,1.457693,103.837614
757687,2,0,2,1.457643,103.837613
757688,32,1,33,1.457644,103.837687
757689,39,5,44,1.457595,103.83771
757690,1,2,3,1.457709,103.837575
757691,6,2,8,1.457562,103.837763
757692,4,3,7,1.458063,103.83773
757694,4,0,4,1.457236,103.837421
757695,1976,1618,3594,1.461615,103.812348
757696,415,147,562,1.456702,103.793965
757697,6,36,42,1.452684,103.80067
757698,256,496,752,1.449195,103.782315
757699,469,764,1233,1.453794,103.814663
757700,241,168,409,1.45477,103.798559
757701,16,9,25,1.452506,103.800762
757702,305,556,861,1.452297,103.8219
757703,239,79,318,1.449765,103.798903
757704,496,172,668,1.445241,103.816996
757705,80,450,530,1.449185,103.79505
757706,686,599,1285,1.435736,103.825013
757707,787,122,909,1.435493,103.824031
757708,232,118,350,1.435726,103.823439
757709,225,31,256,1.435848,103.824199
757710,273,17,290,1.436108,103.82462
757711,441,32,473,1.436363,103.825327
757712,142,1749,1891,1.436363,103.825327
757713,3121,11779,14900,1.448385,103.819187
757714,189,67,256,1.450666,103.81587
757715,118,2166,2284,1.44497,103.820734
757716,1980,1166,3146,1.455513,103.7995
757717,163,36,199,1.440016,103.824058
757718,556,296,852,1.455152,103.798652
757719,49,2263,2312,1.45398,103.79589
757720,333,226,559,1.454273,103.796285
757721,7,652,659,1.450756,103.795324
757722,0,99,99,1.450475,103.795451
757723,0,5,5,1.454298,103.796999
757724,229,1000,1229,1.452723,103.795029
757725,3,27,30,1.453204,103.7949
757726,86,1174,1260,1.453156,103.794818
757727,1,4,5,1.453241,103.794973
757728,38,3830,3868,1.453237,103.794945
757729,0,7,7,1.453317,103.795117
757730,6,108,114,1.453309,103.795081
757731,16,8,24,1.453392,103.795262
757732,5,87,92,1.453451,103.795355
757733,1,6,7,1.453468,103.795407
757734,36,862,898,1.453594,103.795628
757735,0,3,3,1.457575,103.837735
757736,124,8,132,1.453619,103.795696
757737,16,9,25,1.453694,103.795841
757738,49,107,156,1.45377,103.795986
757739,6,64,70,1.453845,103.79613
757740,0,9,9,1.453921,103.796275
757741,86,94,180,1.454449,103.797268
757742,2,11,13,1.453996,103.79642
757743,43,91,134,1.454459,103.797278
757744,5,8,13,1.454072,103.796564
757745,0,3,3,1.453543,103.795552
757746,4,2,6,1.454223,103.796854
757747,20,6,26,1.454374,103.797143
757748,47,110,157,1.454439,103.797278
757749,21,292,313,1.451193,103.795119
757750,10,25,35,1.451048,103.795188
757752,222,0,222,1.41961,103.821086
757753,7,0,7,1.422326,103.828275
757754,1870,133,2003,1.419613,103.821088
757755,1,0,1,1.457707,103.837505
757756,1,0,1,1.419615,103.821084
757758,220,181,401,1.422186,103.823115
757762,1,0,1,1.419611,103.821086
757763,35,4,39,1.439352,103.824325
757764,0,1,1,1.439272,103.824343
757765,11,3,14,1.439501,103.824236
757766,7,0,7,1.43826,103.824801
757767,2,0,2,1.457625,103.837641
757768,9,85,94,1.43826,103.824801
757769,2,110,112,1.43826,103.824801
757770,1,0,1,1.439432,103.824286
757771,4,1,5,1.43826,103.824801
757773,0,140,140,1.438392,103.824795
757774,0,14,14,1.438512,103.824733
757775,4,11,15,1.438592,103.824716
757776,0,11,11,1.438667,103.824682
757777,4,44,48,1.438736,103.824671
757778,2,7,9,1.439791,103.824439
757780,83,1479,1562,1.455072,103.800223
757781,4,82,86,1.454645,103.799066
757782,0,9,9,1.454564,103.798898
757784,7,18,25,1.454403,103.798561
757786,4,25,29,1.454241,103.798224
757788,15,34,49,1.45408,103.797887
757790,5,0,5,1.453928,103.79756
757792,4,3,7,1.453592,103.797368
757794,1,3,4,1.45809,103.837751
757796,8,0,8,1.453026,103.797633
757798,1,5,6,1.452659,103.7978
757801,8,0,8,1.453261,103.798528
757802,8,1,9,1.453404,103.798781
757803,13,0,13,1.453435,103.798924
757804,4,0,4,1.453404,103.797456
757806,118,10,128,1.453849,103.799267
757808,3,2,5,1.453284,103.799124
757810,4,0,4,1.453581,103.799212
757812,2,1,3,1.454147,103.796709
757814,0,4,4,1.452801,103.798619
757816,2,5,7,1.451896,103.798324
757818,0,1,1,1.43826,103.824801
757820,8,1,9,1.452056,103.798648
757822,26,4,30,1.452696,103.799439
757824,14,1,15,1.452743,103.799551
757825,7,7,14,1.452126,103.800128
757826,28,0,28,1.452485,103.799513
757827,0,2,2,1.43826,103.824801
757828,3,0,3,1.452648,103.798189
757830,19,12,31,1.451388,103.798724
757832,6,8,14,1.450065,103.799045
757833,63,0,63,1.450197,103.799311
757834,1,11,12,1.451122,103.799601
757835,19,5,24,1.450724,103.800378
757836,8,19,27,1.451049,103.800851
757837,1,7,8,1.453712,103.797145
757838,11,5,16,1.453653,103.797021
757839,1,7,8,1.453536,103.796773
757840,15,11,26,1.453418,103.796526
757841,7,2,9,1.453301,103.796278
757842,0,3,3,1.451576,103.79903
757843,22,4,26,1.453066,103.795782
757844,0,8,8,1.452948,103.795535
757846,5,140,145,1.452723,103.795049
757847,10,15,25,1.452713,103.795039
757848,2,275,277,1.452454,103.794522
757849,4,67,71,1.45136,103.795076
757850,5,49,54,1.451381,103.79512
757851,2,7,9,1.451877,103.795669
757852,0,6,6,1.45197,103.795811
757853,6,0,6,1.452285,103.795987
757855,8,1,9,1.452325,103.796536
757856,96,3,99,1.452384,103.796673
757857,13,3,16,1.4525,103.796942
757859,18,0,18,1.452699,103.797404
757860,2,1,3,1.453183,103.79603
757861,1,1,2,1.452052,103.799267
757863,1,1,2,1.452366,103.797718
757864,9,1,10,1.451973,103.796366
757865,57,2,59,1.452015,103.796455
757866,0,2,2,1.45205,103.797122
757867,7,8,15,1.4521,103.796633
757868,4,0,4,1.452585,103.798109
757869,1,0,1,1.451949,103.798432
757871,23,111,134,1.451244,103.796108
757872,9,39,48,1.450748,103.796004
757873,4,12,16,1.451022,103.796557
757874,3,9,12,1.451295,103.79711
757875,1,27,28,1.451479,103.796952
757876,5,17,22,1.451541,103.797061
757877,33,31,64,1.449958,103.798814
757878,9,9,18,1.4504,103.798183
757879,1,32,33,1.449608,103.798091
757880,15,11,26,1.449374,103.797608
757881,11,8,19,1.449141,103.797126
757882,31,258,289,1.448907,103.796644
757883,5,248,253,1.447196,103.792586
757897,9,0,9,1.458983,103.828882
757898,0,70,70,1.459308,103.828338
757900,33,2,35,1.4597,103.828673
757901,0,1,1,1.451588,103.796005
757902,1,2,3,1.452954,103.797458
757903,3,1,4,1.451512,103.796177
757918,2,19,21,1.450004,103.788885
757934,8,181,189,1.461397,103.826626
757964,2,0,2,1.452057,103.796544
757965,0,12,12,1.453336,103.826226
757981,3,3,6,1.455661,103.827947
757982,37,17,54,1.456048,103.827843
757983,4,2,6,1.456101,103.827472
757984,36,4,40,1.456441,103.827612
757985,0,5,5,1.456509,103.827209
757986,6,4,10,1.456847,103.827402
757987,31,13,44,1.457428,103.826617
757988,3,0,3,1.459968,103.828962
757989,7,21,28,1.457596,103.826344
757990,4,2,6,1.457533,103.826827
757991,11,1,12,1.457687,103.826183
757995,8,1,9,1.456941,103.825602
757996,23,0,23,1.45768,103.826984
757997,20,0,20,1.457702,103.82699
758027,1,33,34,1.465072,103.809028
758028,94,14,108,1.465038,103.810068
758029,62,14,76,1.465264,103.810428
758030,31,0,31,1.465491,103.810788
758031,805,208,1013,1.465707,103.811137
758032,226,158,384,1.466088,103.811759
758033,17,338,355,1.46673,103.811359
758034,11,19,30,1.466372,103.812593
758035,84,31,115,1.466168,103.811838
758036,14,1,15,1.467063,103.812505
758037,15,3,18,1.467062,103.812504
758038,6,1,7,1.467601,103.812149
758039,10,0,10,1.467823,103.813024
758040,136,1,137,1.467823,103.813004
758041,2,0,2,1.453197,103.825824
758042,33,44,77,1.468203,103.813264
758043,29,15,44,1.468322,103.813361
758044,80,28,108,1.468364,103.811816
758045,0,5,5,1.468548,103.81405
758046,519,87,606,1.469331,103.811735
758047,324,1,325,1.468916,103.81432
758048,5,4,9,1.468825,103.810432
758049,56,58,114,1.469393,103.814055
758050,2,10,12,1.469388,103.813098
758051,28,16,44,1.468753,103.813128
758052,41,1,42,1.469611,103.812131
758053,130,70,200,1.469771,103.811083
758054,36,21,57,1.469364,103.810185
758055,265,25,290,1.469798,103.811593
758056,143,3,146,1.467822,103.813023
758057,1377,15,1392,1.463592,103.810154
758058,14,231,245,1.464412,103.809117
758059,275,10,285,1.470163,103.813766
758060,91,2,93,1.470141,103.814547
758061,13,1,14,1.46984,103.81537
758069,2111,183,2294,1.459858,103.806333
758070,226,1,227,1.458373,103.805923
758071,89,1,90,1.458984,103.806796
758072,3,0,3,1.457232,103.827164
758073,3,33,36,1.458296,103.805882
758074,23,0,23,1.458131,103.805692
758075,87,17,104,1.457635,103.805087
758076,2,36,38,1.45783,103.805343
758077,6,7,13,1.457615,103.805087
758078,34,1,35,1.457411,103.804841
758079,0,20,20,1.456325,103.804541
758080,2,30,32,1.455947,103.804103
758081,299,85,384,1.455595,103.803632
758082,60,22,82,1.455197,103.803195
758083,36,32,68,1.454827,103.802719
758084,41,218,259,1.454955,103.801891
758085,24,256,280,1.454088,103.801825
758086,31,31,62,1.457015,103.803493
758087,22,6,28,1.456612,103.803858
758088,50,457,507,1.454566,103.801399
758089,211,54,265,1.457022,103.80435
758090,36,87,123,1.455629,103.801926
758091,657,24,681,1.456323,103.802164
758092,11,50,61,1.458526,103.804897
758093,267,617,884,1.457378,103.803276
758094,24,146,170,1.457431,103.804841
758095,85,7,92,1.458648,103.80461
758096,135,205,340,1.45926,103.804911
758097,11,54,65,1.458146,103.803891
758098,93,116,209,1.455794,103.802874
758099,270,250,520,1.457197,103.802722
758100,6,71,77,1.462814,103.803393
758101,8,1,9,1.46373,103.80347
758102,52,62,114,1.464259,103.803128
758103,1353,0,1353,1.464632,103.798773
758104,9,24,33,1.465124,103.802087
758105,2,81,83,1.464595,103.802021
758106,2,0,2,1.468193,103.813274
758107,7,424,431,1.46506,103.801968
758108,287,92,379,1.465459,103.803623
758109,2,6,8,1.46556,103.801645
758110,85,1,86,1.465847,103.804192
758111,10,0,10,1.466013,103.801454
758112,178,0,178,1.466164,103.804677
758113,10,21,31,1.466578,103.805083
758114,1481,0,1481,1.467225,103.802564
758115,6,62,68,1.467173,103.804642
758116,85,61,146,1.466529,103.804159
758117,7,0,7,1.468476,103.804055
758118,51,15,66,1.466677,103.804378
758119,47,3,50,1.468479,103.805296
758120,25,7,32,1.466282,103.803179
758121,82,6,88,1.467779,103.805704
758122,10,16,26,1.466004,103.802671
758123,449,134,583,1.466961,103.806231
758124,15,34,49,1.465753,103.802335
758125,2,3,5,1.46576,103.801925
758126,6,9,15,1.466603,103.802263
758127,8,71,79,1.466319,103.802505
758128,33,5,38,1.466939,103.803456
758129,8,21,29,1.467265,103.803929
758130,12,2,14,1.467602,103.804386
758131,3,0,3,1.458657,103.805994
758133,210,1,211,1.468745,103.803725
758134,176,154,330,1.460176,103.803957
758135,2,40,42,1.463624,103.802253
758145,1,7,8,1.460956,103.802391
758146,4,68,72,1.460833,103.803568
758147,35,29,64,1.460245,103.803283
758148,12,99,111,1.460081,103.802008
758150,16,180,196,1.459456,103.801054
758151,125,329,454,1.457979,103.800999
758152,478,1,479,1.458922,103.800515
758153,4,55,59,1.458964,103.799808
758154,20,2659,2679,1.458528,103.799151
758155,36,5,41,1.457481,103.798559
758156,10,205,215,1.458178,103.798832
758157,5,1395,1400,1.458837,103.798979
758158,41,353,394,1.457985,103.798454
758159,12,6,18,1.458777,103.798448
758160,59,82,141,1.458478,103.79862
758161,3,444,447,1.459375,103.798065
758162,2,9,11,1.459365,103.798055
758163,12,27,39,1.459375,103.798045
758164,3,2,5,1.460068,103.797608
758165,0,10,10,1.460078,103.797618
758166,0,1,1,1.459836,103.828849
758168,11068,430,11498,1.45822,103.802369
758169,90,94,184,1.457362,103.799808
758170,133,220,353,1.456862,103.798896
758171,13,871,884,1.456312,103.797586
758172,157,1,158,1.460614,103.803938
758174,246,183,429,1.456551,103.798248
758182,16,1,17,1.45982,103.796825
758183,16,12,28,1.459413,103.796291
758197,644,286,930,1.458808,103.797157
758198,2,58,60,1.457444,103.797124
758199,29,164,193,1.458818,103.797167
758200,849,54,903,1.457667,103.797619
758201,63,119,182,1.459527,103.799072
758202,1,7,8,1.459574,103.798347
758203,3,24,27,1.459837,103.799631
758204,2,65,67,1.460894,103.798553
758205,9,0,9,1.460426,103.799688
758206,2,13,15,1.460143,103.799221
758207,348,0,348,1.459892,103.800434
758208,85,195,280,1.461235,103.799558
758209,7,157,164,1.460385,103.801251
758210,2,0,2,1.465141,103.803131
758211,34,32,66,1.460892,103.801686
758212,2,0,2,1.461331,103.799919
758213,2,41,43,1.462063,103.800711
758214,109,31,140,1.461728,103.803392
758215,19,299,318,1.462871,103.80351
758216,14,29,43,1.462927,103.801781
758217,12,18,30,1.462949,103.803627
758218,0,46,46,1.462735,103.802753
758219,70,11,81,1.463104,103.80386
758221,190,0,190,1.463259,103.804094
758222,22,4,26,1.464253,103.80411
758223,101,74,175,1.463414,103.804328
758224,26,0,26,1.46435,103.804565
758225,10,0,10,1.463569,103.804562
758226,12,7,19,1.463724,103.804795
758227,5,30,35,1.464981,103.804668
758228,9,1,10,1.463268,103.804925
758229,64,10,74,1.463347,103.805042
758230,34,0,34,1.465206,103.805419
758231,4,2,6,1.463407,103.805172
758232,10,44,54,1.463518,103.805493
758233,13,0,13,1.463721,103.805725
758234,5,0,5,1.46382,103.805836
758235,19,36,55,1.463879,103.806005
758236,6,0,6,1.465427,103.806507
758237,19,0,19,1.463756,103.8063
758238,29,0,29,1.466376,103.807754
758239,30,49,79,1.467491,103.808587
758240,0,15,15,1.465266,103.80861
758241,14,0,14,1.465876,103.808946
758244,31,11,42,1.467238,103.8102
758245,38,142,180,1.456918,103.796824
758246,3,22,25,1.462358,103.801087
758247,17,283,300,1.457597,103.796232
758248,31,461,492,1.458354,103.79657
758249,59,1,60,1.463898,103.805029
758250,43,16,59,1.46669,103.808397
758259,27,164,191,1.461421,103.80447
758260,3,84,87,1.461202,103.80486
758261,6,32,38,1.461491,103.804579
758262,1,0,1,1.46043,103.797402
758263,230,48,278,1.461916,103.807136
758264,6,3,9,1.461768,103.805015
758265,865,166,1031,1.46273,103.80859
758266,17,0,17,1.461907,103.805234
758268,12,7,19,1.462184,103.80567
758269,50,8,58,1.464154,103.808325
758270,2,23,25,1.462323,103.805888
758271,73,129,202,1.464515,103.808039
758272,29,19,48,1.462462,103.806106
758273,21,10,31,1.464905,103.807341
758274,16,0,16,1.462698,103.805636
758275,13,0,13,1.462739,103.806542
758276,52,5,57,1.462979,103.806114
758277,125,1,126,1.463063,103.806265
758278,43,38,81,1.463178,103.8064
758279,78,0,78,1.463274,103.806508
758281,41,22,63,1.463423,103.807623
758282,1,24,25,1.464963,103.806665
758283,9,148,157,1.460857,103.805239
758284,3,28,31,1.461011,103.805518
758285,10,223,233,1.461076,103.80563
758286,1,15,16,1.461133,103.805788
758287,3,81,84,1.461198,103.805902
758288,0,2,2,1.461834,103.800246
758289,12,40,52,1.461361,103.806175
758292,12,6,18,1.461851,103.805178
758293,0,1,1,1.461629,103.804797
758294,0,2,2,1.461293,103.806032
758295,0,3,3,1.467052,103.802962
758296,150,247,397,1.460914,103.805362
758297,1092,786,1878,1.464721,103.811381
758298,199,2056,2255,1.464768,103.81304
758299,187,6,193,1.465277,103.812265
758300,176,718,894,1.465697,103.811147
758301,9,46,55,1.467248,103.81019
758302,15,117,132,1.467322,103.810919
758303,177,0,177,1.467823,103.809845
758304,44,12,56,1.467872,103.810629
758305,225,78,303,1.468131,103.808927
758306,24,5,29,1.468398,103.80952
758307,11,0,11,1.468398,103.8095
758308,12,8,20,1.468641,103.808496
758309,24,0,24,1.468414,103.808041
758310,64,129,193,1.469924,103.809169
758311,203,0,203,1.467589,103.807506
758312,221,0,221,1.468865,103.804835
758313,20,20,40,1.468724,103.807599
758314,532,114,646,1.469234,103.808138
758326,14,11,25,1.4413,103.822524
758327,32,0,32,1.441327,103.822581
758328,0,2,2,1.461851,103.805178
758329,0,32,32,1.441389,103.822544
758331,10,1,11,1.441449,103.822511
758332,4,2,6,1.441511,103.822426
758334,5,0,5,1.441614,103.822387
758336,6,5,11,1.441701,103.822349
758352,1865,1754,3619,1.416646,103.815968
758353,15,826,841,1.425734,103.825625
758354,4,50,54,1.425813,103.825644
758355,4,10,14,1.425869,103.825635
758356,81,138,219,1.425948,103.825668
758357,4,12,16,1.425995,103.825711
758358,9,245,254,1.42606,103.825739
758359,12,237,249,1.42611,103.825733
758361,1,2,3,1.461851,103.805178
758363,1,0,1,1.461851,103.805178
758367,3,0,3,1.426291,103.825272
758371,2,1,3,1.426398,103.824947
758372,4,1,5,1.426479,103.824688
758373,9,0,9,1.426497,103.824648
758374,1,1,2,1.44136,103.822495
758375,6,0,6,1.426516,103.824572
758376,7,211,218,1.426347,103.825829
758377,2,44,46,1.426369,103.825879
758378,1,31,32,1.426444,103.825876
758379,10,15,25,1.42647,103.825922
758380,4,17,21,1.426513,103.825912
758381,2,401,403,1.426568,103.825955
758382,167,1337,1504,1.426914,103.826071
758383,8,114,122,1.427232,103.826248
758384,2,89,91,1.427291,103.826291
758385,9,135,144,1.427356,103.826285
758386,10,149,159,1.427416,103.826336
758387,5,433,438,1.427483,103.826356
758388,10,182,192,1.427534,103.826338
758389,14,513,527,1.427568,103.826392
758390,13,771,784,1.427721,103.8264
758391,7,169,176,1.427786,103.826449
758392,11,177,188,1.427842,103.826431
758393,1,235,236,1.4279,103.826486
758394,0,63,63,1.427967,103.826499
758395,2,90,92,1.428023,103.826511
758396,70,259,329,1.428094,103.826484
758398,15,424,439,1.428273,103.826511
758399,7,305,312,1.42834,103.826502
758400,0,87,87,1.428399,103.826498
758401,7,98,105,1.428485,103.826507
758402,2,14,16,1.428546,103.826519
758403,20,758,778,1.428598,103.826492
758404,27,336,363,1.428691,103.826504
758407,12,112,124,1.437022,103.825914
758408,15,301,316,1.437205,103.825898
758410,22,56,78,1.437497,103.825943
758411,0,1,1,1.426327,103.82517
758412,1,98,99,1.437894,103.82604
758413,0,400,400,1.437969,103.825996
758414,4,0,4,1.460146,103.829152
758415,1,61,62,1.438074,103.825998
758418,0,1,1,1.437629,103.825999
758420,7,108,115,1.439179,103.825656
758421,0,28,28,1.439257,103.825604
758422,0,11,11,1.43939,103.825551
758423,9,1,10,1.438236,103.824926
758424,13,191,204,1.438514,103.824689
758425,40,0,40,1.438553,103.824658
758426,0,11,11,1.439436,103.825531
758427,9,0,9,1.43861,103.82465
758430,1,33,34,1.439586,103.825456
758433,3,25,28,1.439671,103.825443
758435,0,29,29,1.43979,103.825391
758436,2,10,12,1.438958,103.824565
758437,1,22,23,1.439124,103.824491
758438,8,5,13,1.439261,103.824451
758439,5,50,55,1.439856,103.825373
758440,8,8,16,1.439427,103.824377
758441,2,32,34,1.439525,103.824343
758442,10,0,10,1.438929,103.824506
758444,2,0,2,1.426503,103.824608
758445,5,1,6,1.439115,103.824414
758446,2,0,2,1.439052,103.824448
758447,0,2,2,1.43917,103.824399
758448,3,155,158,1.440069,103.825205
758450,15,284,299,1.44043,103.825083
758451,4,746,750,1.440695,103.825
758452,3,58,61,1.440276,103.824568
758453,8,620,628,1.440734,103.824966
758454,7,385,392,1.440676,103.82439
758455,8,595,603,1.440832,103.824926
758456,3,279,282,1.441002,103.824862
758457,0,284,284,1.441069,103.82486
758458,7,1502,1509,1.441168,103.824817
758459,1401,11951,13352,1.441872,103.824824
758460,21,18213,18234,1.299509,103.837
758461,0,14,14,1.441872,103.824823
758463,1,143,144,1.40292,103.817764
758464,1,91,92,1.4501,103.82807
758465,4,0,4,1.438013,103.826042
758466,8,34,42,1.450345,103.828356
758467,39,0,39,1.450282,103.82841
758468,20,3,23,1.450164,103.828466
758469,1,1,2,1.439216,103.824373
758470,9,5,14,1.44997,103.828638
758471,11,0,11,1.449925,103.828671
758472,66,160,226,1.450513,103.828519
758474,1,1,2,1.450096,103.828512
758478,32,537,569,1.450675,103.828789
758479,0,1,1,1.438317,103.825972
758480,1,2,3,1.42647,103.824738
758482,27,0,27,1.450317,103.829046
758483,11,1,12,1.450261,103.829109
758484,5,314,319,1.450796,103.828965
758485,4,0,4,1.450052,103.828108
758486,12,19,31,1.450592,103.829097
758487,5,0,5,1.450548,103.829103
758488,0,1,1,1.450612,103.828813
758489,1,0,1,1.45045,103.8292
758490,6,124,130,1.451038,103.829279
758491,1,1,2,1.450272,103.828647
758492,0,5,5,1.450863,103.829367
758493,1,17,18,1.450785,103.829433
758495,53,1827,1880,1.453342,103.832398
758496,15,112,127,1.453366,103.832415
758497,11,50,61,1.453402,103.832484
758498,12,222,234,1.453461,103.832519
758499,26,79,105,1.45349,103.832584
758500,108,311,419,1.453518,103.832661
758501,31,76,107,1.45355,103.832697
758502,61,399,460,1.453554,103.832773
758503,45,985,1030,1.453621,103.832834
758504,99,101,200,1.453652,103.832875
758506,8,83,91,1.456301,103.834751
758507,0,5,5,1.456332,103.834796
758508,0,7,7,1.45646,103.834976
758509,46,0,46,1.456523,103.835066
758510,0,3,3,1.450502,103.82894
758511,2,5,7,1.45665,103.835246
758512,1,0,1,1.45036,103.829263
758513,4,1,5,1.45675,103.835375
758514,28,1,29,1.456865,103.835471
758516,3,30,33,1.458091,103.835883
758517,6,51,57,1.458091,103.835883
758518,26,75,101,1.458219,103.835936
758519,1,46,47,1.458404,103.836039
758520,13,101,114,1.458594,103.836227
758522,1,37,38,1.458603,103.836242
758523,2,92,94,1.458609,103.836251
758524,8,0,8,1.458616,103.836261
758525,19,97,116,1.458622,103.836271
758526,67,8,75,1.461517,103.838153
758528,175,20,195,1.451703,103.828834
758529,4,84,88,1.437231,103.825888
758530,7,30,37,1.437547,103.825948
758531,1,61,62,1.437649,103.826013
758532,643,58,701,1.422344,103.828316
758533,1332,0,1332,1.419644,103.821089
758534,30,0,30,1.422289,103.828277
758535,4,0,4,1.45073,103.828954
758536,2,0,2,1.450976,103.829311
758537,2,0,2,1.422314,103.828249
758540,0,4,4,1.419636,103.821092
758541,1,1,2,1.419609,103.821086
758542,1,0,1,1.456683,103.835289
758587,4,15,19,1.456131,103.830774
758588,14,39,53,1.455969,103.830755
758589,2,1,3,1.456586,103.835156
758590,109,1,110,1.456066,103.83105
758592,1,1,2,1.419636,103.821117
758594,20,1,21,1.456464,103.83282
758595,35,2,37,1.455955,103.83243
758596,2,2,4,1.42229,103.828258
758597,2,0,2,1.456103,103.832445
758598,32,0,32,1.457537,103.832731
758599,18,2,20,1.456455,103.832997
758600,1,14,15,1.456588,103.833054
758615,5,1,6,1.427618,103.825665
758616,0,6,6,1.427635,103.82559
758617,12,66,78,1.427652,103.825517
758618,10,1,11,1.427675,103.825443
758619,1,1,2,1.456121,103.832713
758620,35,0,35,1.427715,103.825289
758621,5,4,9,1.427732,103.825215
758622,0,1,1,1.422327,103.828278
758623,6,2,8,1.427772,103.825061
758624,1,4,5,1.427789,103.824987
758625,1,6,7,1.427812,103.824919
758626,21,6,27,1.427823,103.824845
758627,36,7,43,1.427841,103.824771
758628,16,0,16,1.427863,103.824702
758629,3,5,8,1.427881,103.824628
758630,0,1,1,1.427749,103.825141
758631,16,1,17,1.427789,103.824732
758632,8,7,15,1.427755,103.824846
758633,1,5,6,1.427709,103.824999
758634,4,1,5,1.427692,103.825091
758635,1,4,5,1.427663,103.825182
758636,1,1,2,1.427698,103.825363
758637,2,44,46,1.427566,103.825478
758638,0,2,2,1.427617,103.825318
758639,0,3,3,1.456149,103.8313
758640,2,0,2,1.42752,103.82562
758641,2,3,5,1.427811,103.82464
758642,6,1,7,1.427811,103.82464
758644,0,1,1,1.427846,103.824533
758645,3,4,7,1.428071,103.824742
758646,0,2,2,1.427811,103.82464
758647,3,3,6,1.428129,103.824563
758649,0,2,2,1.428107,103.82463
758650,15,1,16,1.427965,103.825022
758651,1,8,9,1.299509,103.837
758654,33,576,609,1.453507,103.830596
758656,22,25,47,1.454096,103.8308
758672,22,19,41,1.457555,103.825385
758673,12,2,14,1.457387,103.824756
758674,17,3,20,1.457251,103.824357
758675,7,0,7,1.45716,103.823723
758676,22,3,25,1.457085,103.822761
758677,22,554,576,1.457148,103.822245
758692,132,0,132,1.447755,103.824079
758693,1,43,44,1.448898,103.822364
758694,2,13,15,1.448112,103.823778
758695,1,63,64,1.447895,103.823964
758696,37,0,37,1.447096,103.824742
758697,1,4,5,1.446911,103.824408
758699,1,13,14,1.447662,103.82406
758707,5,2,7,1.456485,103.828624
758708,37,2,39,1.456858,103.828586
758709,0,1,1,1.427811,103.82464
758710,2,3,5,1.45717,103.828192
758711,0,1,1,1.457061,103.828257
758712,1,0,1,1.457726,103.82811
758713,1,0,1,1.457298,103.828055
758714,1,3,4,1.456677,103.832982
758715,1,2,3,1.427503,103.825711
758716,16,3,19,1.457864,103.827636
758718,6,3,9,1.458203,103.827089
758719,12,3,15,1.45836,103.82682
758720,10,0,10,1.458513,103.826556
758750,13,5,18,1.455636,103.829068
758751,1,3,4,1.457463,103.828257
758752,3,5,8,1.45528,103.829344
758753,6,3,9,1.454871,103.82955
758754,19,2,21,1.454939,103.829373
758755,50,0,50,1.454476,103.829383
758756,3,1,4,1.455777,103.829131
758757,9,1,10,1.454277,103.829215
758758,4,2,6,1.454244,103.828978
758759,0,1,1,1.457719,103.827786
758760,7,2,9,1.454477,103.828444
758761,1,0,1,1.4541,103.828713
758762,15,5,20,1.453823,103.828284
758763,56,1,57,1.454983,103.827855
758764,22,0,22,1.454263,103.828236
758765,4,1,5,1.454891,103.827732
758819,2,24,26,1.456979,103.830311
758820,4,15,19,1.457242,103.830355
758821,0,3,3,1.458005,103.827437
758822,7,11,18,1.456955,103.831709
758823,3,0,3,1.457149,103.830551
758824,1,0,1,1.454384,103.828062
758825,44,1,45,1.458831,103.83149
758826,38,1,39,1.458253,103.832292
758828,13,0,13,1.457543,103.832053
758843,12,332,344,1.452342,103.783068
758858,109,101,210,1.452593,103.787476
758859,25,68,93,1.45216,103.788671
758874,17,1,18,1.451824,103.825338
758875,3,1,4,1.454338,103.829079
758876,9,142,151,1.451437,103.825041
758877,17,0,17,1.452519,103.825786
758878,11,96,107,1.451479,103.825329
758879,35,20,55,1.451656,103.825497
758880,21,11,32,1.452058,103.825759
758881,9,3,12,1.453595,103.826551
758882,5,1,6,1.452165,103.825801
758883,4,2,6,1.453838,103.826881
758884,0,2,2,1.428121,103.824508
758885,12,3,15,1.453106,103.826521
758886,6,1,7,1.453674,103.826811
758887,8,1,9,1.453827,103.827048
758907,0,1,1,1.458319,103.830954
758930,932,182,1114,1.437344,103.824992
758932,486,57,543,1.436849,103.82407
758946,54,888,942,1.442183,103.823676
758947,4,8,12,1.442172,103.823653
758948,7,14,21,1.442156,103.823624
758949,14,25,39,1.44215,103.823595
758950,13,4,17,1.442138,103.823575
758951,15,26,41,1.442127,103.823555
758952,107,0,107,1.442112,103.823529
758953,0,18,18,1.442094,103.823488
758954,11,0,11,1.442072,103.823448
758955,1,0,1,1.460986,103.838804
758956,4,5,9,1.441998,103.823339
758958,33,7,40,1.441911,103.823373
758960,55,1,56,1.441825,103.823414
758961,0,2,2,1.452327,103.825878
758962,3,0,3,1.457611,103.831324
758963,0,8,8,1.441706,103.823464
758964,10,6,16,1.44166,103.823478
758965,0,1,1,1.442047,103.823391
758966,27,26,53,1.441586,103.823506
758967,8,9,17,1.441559,103.823513
759015,12,0,12,1.457877,103.835917
759016,5,13,18,1.457794,103.835917
759017,0,2,2,1.441789,103.823426
759018,7,0,7,1.457729,103.83601
759019,3,1,4,1.452096,103.825614
759020,13,1,14,1.457665,103.836097
759021,0,2,2,1.457835,103.835969
759022,19,0,19,1.457616,103.836166
759025,0,15,15,1.457646,103.836223
759026,0,3,3,1.441748,103.823447
759027,2,3,5,1.457462,103.836362
759028,2,4,6,1.457587,103.836298
759029,0,1,1,1.441618,103.823489
759030,110,0,110,1.457537,103.836367
759034,7,0,7,1.457429,103.836501
759036,1,1,2,1.457738,103.8361
759037,1,0,1,1.457409,103.836417
759039,0,6,6,1.457159,103.836729
759041,7,51,58,1.457259,103.836724
759055,33,12,45,1.459255,103.841548
759056,2,1,3,1.457507,103.836289
759057,210,45,255,1.458682,103.843194
759058,59,18,77,1.458834,103.843924
759075,358,96,454,1.425631,103.824775
759087,16,0,16,1.425693,103.825373
759090,13,0,13,1.425714,103.825264
759091,3,0,3,1.459776,103.843055
759092,8,92,100,1.425749,103.825173
759094,1,0,1,1.457206,103.836665
759095,7,38,45,1.425743,103.823878
759096,0,10,10,1.425819,103.823915
759097,14,109,123,1.425806,103.825003
759098,6,1,7,1.42562,103.823852
759099,30,0,30,1.425805,103.824924
759100,9,3,12,1.425358,103.823769
759102,2,4,6,1.425222,103.823722
759103,4,11,15,1.425862,103.824741
759104,9,3,12,1.425035,103.823657
759105,8,1,9,1.425069,103.823661
759106,2,20,22,1.425878,103.824691
759107,1,1,2,1.457378,103.836571
759108,22,0,22,1.425883,103.824645
759109,0,3,3,1.425731,103.825219
759110,0,8,8,1.4259,103.824603
759111,0,6,6,1.424516,103.823487
759112,43,0,43,1.42592,103.824559
759113,4,2,6,1.424495,103.823407
759115,11,6,17,1.425926,103.824519
759116,0,1,1,1.425783,103.825059
759117,43,5,48,1.425932,103.824473
759118,1,1,2,1.424798,103.823577
759119,1,3,4,1.457785,103.836033
759120,0,1,1,1.42466,103.823458
759122,0,1,1,1.42495,103.823558
759124,4,1,5,1.425384,103.823697
759128,5,0,5,1.425652,103.823781
759130,29,26,55,1.425741,103.823802
759131,7,70,77,1.426101,103.823816
759136,14,7,21,1.426211,103.823646
759138,48,7,55,1.426266,103.823757
759140,11,210,221,1.426359,103.823615
759147,0,23,23,1.425705,103.825308
759148,0,3,3,1.424637,103.823524
759149,3,1,4,1.425943,103.824416
759150,132,1050,1182,1.424927,103.825025
759151,161,611,772,1.424609,103.824919
759152,1005,1410,2415,1.424315,103.82454
759153,211,24,235,1.424748,103.824378
759154,245,17,262,1.425229,103.824453
759155,258,31,289,1.425716,103.82452
759156,34,11,45,1.42454,103.824573
759157,4,2,6,1.425276,103.823664
759158,810,49,859,1.426282,103.823615
759159,106,16,122,1.42744,103.824302
759160,129,19,148,1.426227,103.824257
759161,13,10,23,1.456883,103.835556
759162,7,24,31,1.456883,103.835536
759163,6,0,6,1.456849,103.835597
759164,0,1,1,1.425174,103.823621
759165,0,1,1,1.456849,103.835577
759166,7,1,8,1.456779,103.835661
759168,13,0,13,1.45671,103.835744
759169,1,0,1,1.456779,103.835681
759171,0,1,1,1.456641,103.835848
759173,3,0,3,1.425042,103.823589
759176,2,0,2,1.424786,103.823504
759178,1,0,1,1.456571,103.835931
759179,4,7,11,1.456304,103.836255
759180,8,0,8,1.456294,103.836245
759195,44,3,47,1.42819,103.826226
759197,5,9,14,1.428199,103.826184
759198,1,2,3,1.456571,103.835911
759199,1,6,7,1.428085,103.825779
759200,1,5,6,1.428198,103.825644
759201,5,0,5,1.428102,103.82571
759203,3,0,3,1.428148,103.826244
759204,6,1,7,1.428251,103.825486
759205,0,1,1,1.456363,103.836162
759206,23,5,28,1.428276,103.825392
759207,1,1,2,1.456433,103.836078
759208,4,0,4,1.424872,103.823524
759209,4,1,5,1.428188,103.825426
759210,0,3,3,1.428225,103.82558
759211,1,2,3,1.428319,103.825221
759212,23,2,25,1.428216,103.825283
759213,15,0,15,1.428362,103.825051
759214,2,2,4,1.428302,103.825307
759216,4,2,6,1.428251,103.825141
759217,0,3,3,1.428199,103.825358
759218,2,2,4,1.428233,103.82521
759221,1,0,1,1.428148,103.825574
759222,7,0,7,1.428561,103.82476
759223,0,1,1,1.428331,103.824828
759224,2,1,3,1.428404,103.824912
759225,2,0,2,1.428165,103.8255
759226,0,4,4,1.428273,103.825073
759227,8,6,14,1.428826,103.825089
759228,0,1,1,1.428755,103.824814
759229,1,1,2,1.428621,103.824777
759230,160,0,160,1.428789,103.825534
759231,1,1,2,1.428809,103.825192
759232,2,0,2,1.428792,103.825285
759233,12,0,12,1.428775,103.825379
759235,1,0,1,1.428805,103.825467
759236,0,2,2,1.428775,103.825589
759237,1,2,3,1.428688,103.824797
759238,15,0,15,1.428712,103.825822
759239,2,0,2,1.428745,103.825707
759240,36,0,36,1.428698,103.825889
759242,2,0,2,1.42868,103.825687
759243,0,16,16,1.42862,103.825883
759244,7,3,10,1.428735,103.825767
759246,0,1,1,1.428749,103.825482
759247,1,1,2,1.428684,103.825961
759248,1,2,3,1.428715,103.825576
759249,1,1,2,1.428249,103.826303
759250,2,1,3,1.428266,103.826264
759251,34,0,34,1.428225,103.82558
759252,3,4,7,1.428225,103.82558
759263,7,863,870,1.4417,103.824025
759264,18,2891,2909,1.441392,103.823895
759265,25,2800,2825,1.441715,103.823964
759266,8,4,12,1.44166,103.823932
759267,0,14,14,1.441659,103.823931
759268,1,4,5,1.441678,103.823874
759269,5,1,6,1.441581,103.823748
759270,1,52,53,1.441306,103.823726
759271,3,21,24,1.441642,103.82378
759272,0,9,9,1.441512,103.823573
759273,0,2,2,1.428345,103.825136
759274,52,60,112,1.441594,103.823693
759275,1,20,21,1.44148,103.82357
759276,13,16,29,1.441429,103.823451
759277,0,5,5,1.441383,103.823337
759278,3,3,6,1.441341,103.823227
759279,4,0,4,1.42882,103.825418
759281,4,1,5,1.441219,103.822925
759282,0,3,3,1.428697,103.825632
759283,9,1,10,1.44111,103.822651
759284,6,0,6,1.441053,103.822532
759299,1,8,9,1.457369,103.835755
759300,3,12,15,1.457363,103.835741
759301,0,2,2,1.441307,103.82365
759302,1,0,1,1.428271,103.826218
759303,1,0,1,1.457329,103.835782
759304,0,1,1,1.457281,103.835858
759305,7,1,8,1.457222,103.835927
759306,6,1,7,1.45719,103.835945
759307,2,0,2,1.457339,103.835789
759308,2,0,2,1.457164,103.835997
759309,2,4,6,1.457105,103.836066
759310,2,1,3,1.441173,103.822794
759311,0,1,1,1.45726,103.835863
759312,1,3,4,1.441299,103.823131
759313,7,2,9,1.456914,103.836272
759314,48,7,55,1.45693,103.836273
759315,6,3,9,1.456845,103.836354
759316,0,5,5,1.456871,103.836342
759317,21,1,22,1.456775,103.836436
759318,3,1,4,1.456988,103.836204
759319,5,2,7,1.456706,103.836517
759320,1,5,6,1.456754,103.836481
759321,0,6,6,1.456637,103.836599
759322,2,9,11,1.456696,103.83655
759323,0,12,12,1.456647,103.836609
759339,7,0,7,1.458414,103.836029
759340,11,3,14,1.458165,103.836565
759341,0,1,1,1.456983,103.83619
759342,0,1,1,1.458365,103.836132
759343,0,2,2,1.457121,103.836027
759344,67,4,71,1.458155,103.836555
759345,158,0,158,1.458102,103.836617
759347,16,0,16,1.457956,103.836756
759348,0,2,2,1.458155,103.836555
759365,0,12,12,1.458014,103.837188
759367,0,3,3,1.457052,103.836109
759368,2,0,2,1.457867,103.836837
759369,0,1,1,1.458268,103.836338
759370,4,0,4,1.456813,103.836412
759371,0,1,1,1.457937,103.837099
759372,4,0,4,1.457913,103.837048
759373,3,1,4,1.457949,103.83709
759375,2,3,5,1.457792,103.83693
759376,1,0,1,1.457885,103.837039
759391,1,0,1,1.45805,103.837208
759392,0,2,2,1.457876,103.837005
759393,69,9,78,1.458216,103.836626
759394,0,9,9,1.458212,103.836646
759396,0,1,1,1.45819,103.836595
759397,0,13,13,1.458316,103.836747
759398,6,0,6,1.458347,103.836808
759399,1,0,1,1.458278,103.836726
759414,5,9,14,1.441489,103.823024
759415,0,16,16,1.441607,103.823034
759416,5,1,6,1.441558,103.822996
759417,2,0,2,1.458179,103.836605
759418,48,0,48,1.441649,103.822953
759420,2,4,6,1.441732,103.822928
759421,2,2,4,1.457834,103.83698
759422,2,3,5,1.441809,103.822899
759423,0,1,1,1.458357,103.836798
759424,1,0,1,1.441899,103.822915
759425,1,0,1,1.441893,103.822862
759440,1,2,3,1.457985,103.837157
759441,0,3,3,1.45606,103.834953
759442,0,5,5,1.455959,103.835099
759443,35,1,36,1.455909,103.835169
759445,3,1,4,1.44183,103.822942
759446,1,1,2,1.441662,103.823004
759447,6,0,6,1.455769,103.835383
759448,4,5,9,1.455732,103.835443
759495,1,1,2,1.455823,103.835307
759497,5,0,5,1.426526,103.82544
759498,4,0,4,1.455864,103.835239
759499,3,0,3,1.456013,103.83501
759500,2,2,4,1.426586,103.825441
759502,7,2,9,1.426819,103.825503
759503,1,0,1,1.441988,103.822891
759505,1,1,2,1.426428,103.825406
759506,15,2,17,1.427024,103.825582
759507,5,2,7,1.427076,103.825588
759508,3,0,3,1.426633,103.825454
759509,5,1,6,1.427094,103.82548
759510,1,0,1,1.426878,103.825519
759512,0,2,2,1.426982,103.825545
759513,6,3,9,1.426933,103.825446
759514,1,0,1,1.426811,103.825434
759515,2,1,3,1.427133,103.825599
759516,1,0,1,1.42687,103.825446
759517,0,1,1,1.426693,103.825389
759518,6,1,7,1.426567,103.825366
759519,0,4,4,1.426695,103.825475
759520,3,4,7,1.426609,103.824873
759521,2,1,3,1.426746,103.825416
759522,6,0,6,1.426729,103.82489
759523,2,0,2,1.426985,103.825451
759524,11,1,12,1.426867,103.824924
759525,5,0,5,1.42701,103.824981
759526,46,5,51,1.427079,103.824998
759527,2,0,2,1.426792,103.824907
759530,8,3,11,1.42721,103.825044
759531,3,0,3,1.426666,103.824879
759532,4,2,6,1.427286,103.824988
759535,2,4,6,1.427088,103.82492
759536,2,8,10,1.427014,103.824897
759538,13,0,13,1.426847,103.824858
759540,2,5,7,1.426716,103.824824
759541,9,2,11,1.426647,103.824801
759542,4,15,19,1.426572,103.824778
759582,81,27,108,1.457711,103.835209
759587,0,1,1,1.426635,103.825378
759588,1,0,1,1.457137,103.834989
759596,17,2,19,1.460601,103.829046
759597,2,6,8,1.460935,103.828491
759598,2,0,2,1.426935,103.824957
759599,3,0,3,1.427329,103.825009
759600,15,3,18,1.461289,103.827847
759616,5,14,19,1.45998,103.827132
759618,0,8,8,1.460314,103.827261
759620,4,5,9,1.460906,103.827335
759621,123,0,123,1.460771,103.82732
759636,2,1,3,1.461259,103.827915
759637,16,2,18,1.452715,103.828545
759638,306,23,329,1.453546,103.828178
759639,17,6,23,1.453039,103.828734
759640,53,9,62,1.452699,103.82903
759641,2,4,6,1.453304,103.829122
759642,24,21,45,1.453199,103.829782
759657,598,262,860,1.464438,103.833305
759660,27,6,33,1.459791,103.830281
759676,2,150,152,1.456043,103.820838
759690,0,897,897,1.45231,103.789655
759691,20,35,55,1.452514,103.789635
759692,1,21,22,1.452861,103.789443
759693,0,57,57,1.453018,103.789275
759694,0,2,2,1.460988,103.828405
759695,4,4,8,1.453265,103.788824
759710,93,39,132,1.458353,103.83457
759711,17,0,17,1.458393,103.834093
759740,3,347,350,1.459647,103.819825
759744,5,838,843,1.45982,103.819902
759760,1,268,269,1.456352,103.820714
759774,760,615,1375,1.458449,103.821776
759775,2832,16310,19142,1.449009,103.819791
759776,6,97,103,1.457119,103.819052
759789,5,0,5,1.456509,103.829445
759790,17,0,17,1.456677,103.829487
759791,10,6,16,1.455371,103.827427
759792,11,10,21,1.456723,103.829309
759793,7,2,9,1.455508,103.828474
759795,3,3,6,1.455118,103.827053
759796,43,1,44,1.454713,103.826667
759797,9,3,12,1.454966,103.826821
759798,0,1,1,1.457342,103.835119
759799,0,4,4,1.426498,103.825361
759800,5,0,5,1.452234,103.825679
759801,11,1,12,1.453072,103.825068
759802,8,2,10,1.452263,103.824643
759803,1,49,50,1.452769,103.824895
759804,28,10,38,1.451802,103.824961
759819,70,12,82,1.458035,103.82397
759820,53,76,129,1.457964,103.823527
759821,21,166,187,1.457938,103.82302
759822,22,112,134,1.457872,103.822549
759823,0,3,3,1.454215,103.826873
759837,139,0,139,1.463372,103.836923
759868,5,10,15,1.459738,103.82771
759869,10,23,33,1.460067,103.828174
759870,3,5,8,1.459743,103.827683
759871,2,6,8,1.460133,103.828289
759872,0,3,3,1.299509,103.837
759873,16,1,17,1.460781,103.827902
759874,27,0,27,1.46092,103.82794
759875,0,5,5,1.461045,103.827967
759891,1,0,1,1.453624,103.826116
759906,109,1,110,1.456336,103.79683
759907,344,19,363,1.463354,103.794636
759908,244,152,396,1.461703,103.792447
759909,56,6,62,1.458457,103.79556
759910,197,257,454,1.45785,103.794856
759911,11,6,17,1.461357,103.792036
759922,4,37,41,1.458577,103.837112
759923,2,4,6,1.45885,103.83673
759924,2,6,8,1.458801,103.836788
759925,9,1,10,1.458727,103.836889
759926,7,2,9,1.458681,103.836972
759927,7,3,10,1.458577,103.837112
759928,3,4,7,1.458517,103.837191
759929,10,3,13,1.458479,103.83722
759930,36,12,48,1.458428,103.83734
759931,98,5,103,1.458801,103.836788
759932,8,2,10,1.458854,103.836929
759933,2,0,2,1.453158,103.789002
759934,0,4,4,1.453221,103.82519
759935,6,0,6,1.458059,103.838003
759936,5,1,6,1.458033,103.838047
759941,2,7,9,1.458639,103.837208
759942,1,3,4,1.458775,103.837034
759943,13,4,17,1.45842,103.837354
759946,34,370,404,1.462803,103.820217
759947,9923,8157,18080,1.459976,103.822717
759948,330,1536,1866,1.460191,103.822953
759951,39,672,711,1.459743,103.823873
759953,2,49,51,1.449641,103.783413
759956,5469,1110,6579,1.461072,103.824257
759957,5,21,26,1.460528,103.825821
759958,27,0,27,1.463967,103.814898
759959,396,278,674,1.463971,103.814896
759960,47,0,47,1.464842,103.814541
759961,14,0,14,1.463965,103.814899
759962,542,45,587,1.469366,103.819445
759964,0,32,32,1.459355,103.824802
759965,2,0,2,1.458806,103.836983
759967,0,4,4,1.459355,103.824802
759968,0,23,23,1.459355,103.824802
759969,2,0,2,1.459355,103.824802
759971,1,0,1,1.460207,103.828397
759972,102,31,133,1.456206,103.82999
759973,49,1,50,1.457387,103.829283
759974,18,34,52,1.457711,103.829085
759975,17,104,121,1.458133,103.828782
759976,3,0,3,1.460648,103.827874
759977,3,15,18,1.458879,103.82781
759978,3,39,42,1.458929,103.827715
759979,6,6,12,1.458968,103.827644
759980,0,10,10,1.459072,103.827433
759981,0,77,77,1.45911,103.827358
759982,0,5,5,1.459187,103.827271
759987,10,24,34,1.455261,103.832941
759988,85,90,175,1.454879,103.831576
759989,2,5,7,1.454901,103.832036
759990,3,22,25,1.454371,103.832622
759991,131,50,181,1.454764,103.832127
759992,19,71,90,1.4547,103.831283
760101,584,12233,12817,1.430632,103.827649
760102,247,4900,5147,1.430859,103.828837
760103,461,115,576,1.431578,103.828487
760104,27,27,54,1.431763,103.828388
760105,44,722,766,1.431945,103.827988
760106,632,10269,10901,1.431553,103.827353
760107,675,1629,2304,1.432263,103.827305
760108,632,462,1094,1.432351,103.828498
760109,252,656,908,1.432807,103.828475
760110,710,7530,8240,1.433558,103.829046
760111,379,248,627,1.433271,103.82854
760112,382,3990,4372,1.434244,103.828718
760113,432,554,986,1.434447,103.828588
760114,1197,1865,3062,1.434638,103.826641
760115,576,154,730,1.434502,103.82793
760116,373,296,669,1.435093,103.827947
760117,859,976,1835,1.435587,103.827672
760118,503,1322,1825,1.435967,103.828713
760119,133,380,513,1.43539,103.829091
760120,297,677,974,1.434895,103.829188
760121,333,5734,6067,1.434314,103.829892
760122,451,2603,3054,1.434935,103.830913
760123,481,2749,3230,1.43468,103.831715
760124,262,148,410,1.434661,103.830971
760125,69,85,154,1.434293,103.830324
760126,270,3088,3358,1.433598,103.829976
760127,141,76,217,1.434119,103.830682
760128,555,160,715,1.433914,103.831135
760129,139,858,997,1.433766,103.831677
760130,211,350,561,1.43354,103.831124
760131,680,341,1021,1.433214,103.831219
760132,739,423,1162,1.432856,103.831298
760133,108,346,454,1.432608,103.830682
760134,644,177,821,1.43244,103.83125
760135,159,984,1143,1.432319,103.83174
760136,312,432,744,1.432048,103.831238
760137,658,351,1009,1.431983,103.830017
760138,469,425,894,1.431681,103.830393
760139,541,113,654,1.431746,103.831366
760140,549,461,1010,1.43118,103.830396
760141,289,2350,2639,1.430957,103.829873
760142,227,1656,1883,1.430861,103.830436
760143,119,119,238,1.431033,103.830925
760144,98,36,134,1.43106,103.83127
760145,341,1125,1466,1.430934,103.831742
760146,445,1926,2371,1.431134,103.832321
760147,525,183,708,1.431326,103.831777
760148,1021,821,1842,1.431942,103.832435
760149,474,439,913,1.431584,103.832604
760150,400,6000,6400,1.430863,103.833624
760151,346,1002,1348,1.430876,103.834144
760152,58,411,469,1.431036,103.834614
760153,461,255,716,1.431226,103.834142
760154,517,194,711,1.431599,103.834096
760155,683,223,906,1.431975,103.83404
760156,285,1719,2004,1.431952,103.833507
760157,520,221,741,1.432295,103.834008
760158,47,337,384,1.432591,103.834322
760159,684,102,786,1.432806,103.833722
760160,297,559,856,1.432499,103.833132
760161,771,68,839,1.432803,103.832921
760162,1052,1903,2955,1.433095,103.832371
760165,317,4150,4467,1.435857,103.831569
760166,399,295,694,1.436297,103.831448
760167,735,516,1251,1.436626,103.832267
760170,641,738,1379,1.437168,103.83257
760171,357,240,597,1.436931,103.831948
760172,449,601,1050,1.436729,103.831045
760173,713,1552,2265,1.43708,103.830921
760174,818,2515,3333,1.4374,103.831785
760175,814,1184,1998,1.43753,103.832398
760201,443,418,861,1.430748,103.837837
760202,144,1126,1270,1.430764,103.837261
760203,718,1077,1795,1.430783,103.836347
760204,344,4000,4344,1.430794,103.835799
760205,452,372,824,1.431143,103.836142
760206,13,21,34,1.431295,103.836621
760207,32,22,54,1.431274,103.837047
760208,402,263,665,1.431095,103.837571
760209,597,413,1010,1.431472,103.837637
760210,613,1392,2005,1.431443,103.838448
760211,624,508,1132,1.431751,103.838056
760212,418,337,755,1.431806,103.837363
760213,763,70,833,1.431851,103.836331
760214,523,214,737,1.43153,103.836136
760215,526,2024,2550,1.431869,103.835544
760216,563,292,855,1.432351,103.836249
760217,331,528,859,1.432693,103.836157
760218,617,173,790,1.433043,103.836044
760219,814,147,961,1.433338,103.83597
760220,456,1939,2395,1.433342,103.835212
760221,286,161,447,1.433787,103.835841
760222,584,204,788,1.434119,103.835604
760223,794,183,977,1.434477,103.835433
760224,499,1395,1894,1.434629,103.835043
760225,418,3079,3497,1.434827,103.835683
760226,54,868,922,1.434462,103.835999
760227,535,3869,4404,1.435152,103.836505
760228,347,1806,2153,1.435304,103.837503
760229,545,427,972,1.434889,103.836926
760230,97,577,674,1.434654,103.836544
760231,493,259,752,1.434165,103.836937
760232,423,422,845,1.434644,103.837103
760233,176,4327,4503,1.434925,103.83803
760234,404,180,584,1.434407,103.837616
760235,391,255,646,1.434638,103.838351
760236,603,2387,2990,1.434065,103.839015
760237,104,298,402,1.433459,103.838868
760238,452,235,687,1.433166,103.839224
760239,244,3550,3794,1.434031,103.839514
760240,465,241,706,1.432773,103.839348
760241,510,1153,1663,1.432163,103.839377
760242,306,1066,1372,1.432726,103.839911
760243,596,2912,3508,1.433657,103.840428
760244,180,1876,2056,1.433959,103.841059
760245,499,3001,3500,1.43452,103.841925
760246,541,3609,4150,1.434986,103.842432
760247,579,620,1199,1.435086,103.842004
760248,642,3785,4427,1.43566,103.842275
760249,287,345,632,1.435334,103.84178
760250,385,80,465,1.435559,103.841664
760251,22,69,91,1.434803,103.841373
760252,108,105,213,1.434706,103.841046
760253,454,138,592,1.434938,103.840378
760254,150,427,577,1.434629,103.840426
760255,273,269,542,1.434332,103.840535
760256,148,5092,5240,1.434131,103.839936
760257,360,3279,3639,1.434491,103.839496
760258,73,93,166,1.435201,103.83977
760259,591,1523,2114,1.435084,103.839143
760260,623,302,925,1.435489,103.839147
760261,112,4271,4383,1.4354,103.83848
760262,394,430,824,1.435786,103.839015
760263,358,972,1330,1.436187,103.838922
760264,209,200,409,1.435885,103.838331
760265,734,1380,2114,1.436733,103.838282
760266,566,341,907,1.43699,103.838687
760267,24,267,291,1.437009,103.839184
760268,168,519,687,1.437107,103.839518
760269,621,1988,2609,1.437113,103.840095
760270,482,355,837,1.437374,103.839874
760271,215,5558,5773,1.437817,103.840255
760272,572,1388,1960,1.438055,103.839472
760273,672,450,1122,1.437786,103.839495
760274,577,345,922,1.437478,103.838625
760275,555,386,941,1.437751,103.838555
760276,754,885,1639,1.437954,103.837846
760277,575,2580,3155,1.438009,103.836812
760278,1081,174,1255,1.43823,103.837766
760279,409,368,777,1.438435,103.837159
760280,529,481,1010,1.438632,103.836867
760281,58,45,103,1.439095,103.837392
760282,195,105,300,1.439527,103.838592
760283,823,272,1095,1.43944,103.838945
760284,284,232,516,1.439802,103.838782
760285,324,4673,4997,1.440218,103.839297
760286,147,284,431,1.440145,103.83865
760287,479,317,796,1.439716,103.837591
760288,768,4413,5181,1.439977,103.837548
760289,564,10000,10564,1.440415,103.838521
760290,63,2249,2312,1.436158,103.836039
760291,756,14799,15555,1.436545,103.836396
760292,597,182,779,1.437003,103.837201
760293,347,665,1012,1.436379,103.837894
760294,27,841,868,1.437003,103.837201
760296,301,548,849,1.435391,103.835402
760297,560,610,1170,1.435949,103.835331
760298,293,200,493,1.435981,103.834846
760299,325,1196,1521,1.436381,103.834464
760302,648,1745,2393,1.429959,103.839707
760303,569,187,756,1.430216,103.839967
760304,799,394,1193,1.430558,103.840234
760305,418,248,666,1.430874,103.839386
760306,367,81,448,1.430979,103.840189
760307,5,482,487,1.430776,103.840895
760308,426,252,678,1.431277,103.840469
760309,259,2112,2371,1.432369,103.840603
760310,163,453,616,1.432085,103.841303
760311,407,305,712,1.431434,103.840848
760312,303,120,423,1.431671,103.841147
760314,383,4476,4859,1.431632,103.841751
760315,29,831,860,1.299509,103.837
760316,18,346,364,1.299509,103.837
760317,90,1076,1166,1.433787,103.842141
760318,17,161,178,1.299509,103.837
760320,373,463,836,1.429332,103.841518
760321,706,403,1109,1.42912,103.841342
760322,501,2408,2909,1.428855,103.840853
760323,389,409,798,1.42828,103.841209
760324,730,416,1146,1.428769,103.841967
760325,537,166,703,1.42936,103.841978
760326,418,365,783,1.429758,103.842304
760327,267,405,672,1.430134,103.84235
760328,438,261,699,1.429827,103.842995
760329,306,326,632,1.430521,103.84238
760330,601,2205,2806,1.430833,103.842565
760331,331,1824,2155,1.430886,103.843161
760332,308,388,696,1.430507,103.843387
760333,49,341,390,1.431611,103.845062
760334,45,240,285,1.431358,103.844568
760342,16,172,188,1.430733,103.844336
760343,535,166,701,1.429523,103.844059
760344,113,109,222,1.429124,103.844284
760345,350,152,502,1.428604,103.84406
760346,485,527,1012,1.428836,103.843387
760347,15,72,87,1.299509,103.837
760348,113,2457,2570,1.426615,103.842938
760349,398,2916,3314,1.426116,103.843633
760350,646,1316,1962,1.425635,103.844287
760351,328,268,596,1.426464,103.844031
760352,284,47,331,1.42651,103.844938
760353,442,556,998,1.426236,103.845203
760354,495,346,841,1.425827,103.845207
760355,460,197,657,1.425464,103.844918
760356,472,8867,9339,1.425419,103.845465
760357,456,5870,6326,1.42591,103.845927
760358,182,3470,3652,1.426937,103.845969
760359,245,199,444,1.427469,103.845709
760360,135,437,572,1.427845,103.845735
760361,61,1400,1461,1.42832,103.845943
760362,408,104,512,1.428636,103.844907
760363,485,404,889,1.429066,103.845133
760364,19,64,83,1.429138,103.844641
760365,509,476,985,1.429254,103.845125
760366,412,5606,6018,1.429191,103.845823
760367,721,2932,3653,1.429603,103.845203
760385,2,147,149,1.428364,103.847548
760386,565,4611,5176,1.429081,103.846496
760387,174,183,357,1.429596,103.847125
760388,288,443,731,1.429294,103.847169
760389,893,523,1416,1.429625,103.848332
760390,677,480,1157,1.429346,103.848376
760391,630,2186,2816,1.429332,103.849101
760392,673,789,1462,1.428588,103.849133
760393,921,421,1342,1.428569,103.848562
760394,700,98,798,1.428929,103.848367
760395,76,54,130,1.428922,103.847236
760396,38,83,121,1.428493,103.847107
760397,891,185,1076,1.428006,103.847301
760398,429,3969,4398,1.427503,103.84656
760399,510,262,772,1.427571,103.847329
760401,104,302,406,1.427122,103.847148
760402,260,197,457,1.426676,103.847306
760403,591,437,1028,1.426981,103.848472
760404,383,253,636,1.426709,103.848389
760405,543,1329,1872,1.426698,103.849175
760406,1096,416,1512,1.426383,103.849192
760407,990,379,1369,1.426016,103.848415
760408,843,309,1152,1.426316,103.848387
760409,205,392,597,1.426243,103.84718
760410,697,6127,6824,1.426173,103.846726
760411,648,416,1064,1.425964,103.847653
760412,447,279,726,1.425573,103.846953
760413,465,416,881,1.424924,103.846012
760414,80,104,184,1.424554,103.846593
760415,371,698,1069,1.423959,103.84564
760416,72,640,712,1.423959,103.84564
760417,140,190,330,1.424411,103.846319
760418,59,174,233,1.424749,103.847187
760419,809,9692,10501,1.423867,103.84731
760423,486,167,653,1.422937,103.848246
760424,34,585,619,1.299509,103.837
760425,591,307,898,1.422446,103.848278
760426,72,354,426,1.299509,103.837
760427,1200,537,1737,1.422148,103.848307
760428,77,461,538,1.299509,103.837
760429,33,341,374,1.299509,103.837
760430,105,265,370,1.299509,103.837
760431,119,1090,1209,1.42019,103.847536
760433,808,295,1103,1.42093,103.847272
760435,510,355,865,1.421409,103.847253
760436,514,212,726,1.421432,103.84617
760437,365,289,654,1.421703,103.847227
760438,477,84,561,1.421707,103.84613
760439,833,470,1303,1.422075,103.846379
760440,551,262,813,1.42237,103.846387
760441,6,198,204,1.422774,103.845574
760442,479,3957,4436,1.423363,103.845473
760443,795,1677,2472,1.423829,103.844968
760444,22,4781,4803,1.299509,103.837
760445,871,951,1822,1.423208,103.844655
760446,515,206,721,1.422982,103.845018
760447,51,76,127,1.422792,103.845055
760448,538,380,918,1.422484,103.844908
760449,550,1706,2256,1.423022,103.844208
760450,420,576,996,1.422128,103.844128
760451,1694,421,2115,1.422182,103.844665
760452,933,248,1181,1.422237,103.845407
760453,767,472,1239,1.419833,103.845182
760454,538,1457,1995,1.419833,103.845182
760455,1130,833,1963,1.419979,103.844368
760456,502,1080,1582,1.420442,103.844296
760457,695,196,891,1.420422,103.84555
760458,614,144,758,1.420691,103.846232
760459,1037,377,1414,1.421046,103.846332
760461,1,13,14,1.299509,103.837
760462,3,0,3,1.45828,103.828703
760463,0,65,65,1.299509,103.837
760468,0,385,385,1.299509,103.837
760469,0,53,53,1.299509,103.837
760501,25,79,104,1.299509,103.837
760502,14,74,88,1.299509,103.837
760504,226,373,599,1.417511,103.843988
760506,33,41,74,1.299509,103.837
760507,20,148,168,1.415335,103.839717
760510,11,300,311,1.299509,103.837
760511,51,251,302,1.299509,103.837
760512,24,75,99,1.415411,103.842429
760513,12,2,14,1.416074,103.84351
760514,7,545,552,1.299509,103.837
760602,360,2645,3005,1.422427,103.836359
760603,768,791,1559,1.422081,103.835577
760604,214,1323,1537,1.421798,103.835421
760605,259,3725,3984,1.421807,103.836227
760606,423,3487,3910,1.421365,103.836076
760607,201,120,321,1.4214,103.835583
760608,105,2398,2503,1.420949,103.835216
760609,309,230,539,1.421053,103.835863
760610,120,210,330,1.420661,103.835955
760611,338,217,555,1.420179,103.83599
760612,289,644,933,1.420378,103.835239
760613,368,466,834,1.420109,103.835187
760614,505,168,673,1.419926,103.835938
760615,447,241,688,1.41965,103.8353
760616,257,1156,1413,1.419731,103.83482
760617,340,225,565,1.419368,103.835207
760618,304,395,699,1.418761,103.835519
760619,480,502,982,1.41916,103.834754
760620,601,2197,2798,1.41894,103.834589
760621,440,205,645,1.418718,103.834919
760622,455,1107,1562,1.418383,103.834812
760624,367,17180,17547,1.417959,103.834849
760625,600,183,783,1.418153,103.836058
760626,234,3959,4193,1.417519,103.835747
760627,246,1719,1965,1.417705,103.836588
760628,364,524,888,1.418161,103.8368
760629,389,350,739,1.418505,103.837614
760630,340,1532,1872,1.418151,103.837677
760631,31,1356,1387,1.41849,103.838209
760632,768,1772,2540,1.418624,103.839026
760633,207,939,1146,1.41871,103.839703
760634,519,317,836,1.418991,103.838884
760635,583,672,1255,1.419232,103.838709
760636,371,73,444,1.41977,103.839178
760637,230,58,288,1.420162,103.839013
760638,408,4714,5122,1.420333,103.838396
760639,1406,376,1782,1.420634,103.838269
760640,324,22,346,1.421111,103.838681
760641,352,383,735,1.420852,103.838006
760642,366,2088,2454,1.421045,103.837298
760643,392,488,880,1.421368,103.837318
760644,739,463,1202,1.421795,103.837278
760645,237,84,321,1.421977,103.838401
760646,285,418,703,1.422142,103.837595
760647,291,1884,2175,1.422396,103.83692
760650,20,372,392,1.422992,103.839089
760651,85,4090,4175,1.423539,103.839334
760652,282,7936,8218,1.42381,103.839995
760653,518,495,1013,1.423159,103.839584
760654,331,5051,5382,1.422918,103.840472
760655,551,573,1124,1.422784,103.839668
760656,32,20,52,1.422427,103.838862
760657,456,195,651,1.422296,103.839297
760658,382,344,726,1.42198,103.839412
760659,104,18,122,1.42152,103.839225
760660,482,264,746,1.421775,103.839886
760661,321,1919,2240,1.422074,103.840582
760662,361,138,499,1.420418,103.840352
760663,607,144,751,1.419939,103.83999
760664,267,1172,1439,1.420297,103.841045
760665,500,895,1395,1.419734,103.840578
760666,451,2398,2849,1.418963,103.840252
760671,27,592,619,1.299509,103.837
760673,0,197,197,1.299509,103.837
760675,1,1773,1774,1.299509,103.837
760676,1,235,236,1.41911,103.832211
760701,821,12513,13334,1.429985,103.82864
760702,179,2588,2767,1.429872,103.829305
760703,333,318,651,1.429663,103.828637
760704,582,415,997,1.429302,103.828663
760705,49,2389,2438,1.42914,103.829348
760706,359,317,676,1.428936,103.828706
760707,529,444,973,1.42895,103.827538
760708,46,480,526,1.428765,103.827078
760709,468,528,996,1.428631,103.827521
760710,481,253,734,1.428246,103.827529
760711,50,1606,1656,1.428069,103.827078
760712,543,469,1012,1.42791,103.827546
760713,786,139,925,1.427536,103.827313
760714,405,920,1325,1.427019,103.827547
760715,693,1104,1797,1.426368,103.826886
760716,765,1442,2207,1.426131,103.82745
760717,316,3165,3481,1.425947,103.828067
760718,286,894,1180,1.426638,103.828344
760719,359,2439,2798,1.426647,103.82891
760720,677,496,1173,1.426364,103.828687
760721,439,371,810,1.426159,103.828705
760722,332,85,417,1.425943,103.828716
760723,467,310,777,1.426015,103.82975
760724,379,884,1263,1.426573,103.829741
760725,322,972,1294,1.426974,103.830648
760726,1052,468,1520,1.426619,103.830821
760727,597,302,899,1.42627,103.830873
760728,715,190,905,1.425847,103.830651
760729,481,7983,8464,1.426094,103.831687
760730,360,4035,4395,1.427156,103.831428
760731,158,2572,2730,1.42841,103.831038
760732,75,1872,1947,1.429086,103.830239
760733,638,75,713,1.429703,103.830708
760734,330,315,645,1.429366,103.830788
760735,321,121,442,1.428937,103.831165
760736,461,702,1163,1.428664,103.831558
760737,333,297,630,1.429064,103.832248
760738,327,240,567,1.429409,103.832299
760739,445,339,784,1.429831,103.831918
760740,471,1117,1588,1.430132,103.831921
760741,395,1998,2393,1.430118,103.832899
760742,433,201,634,1.429805,103.832888
760743,47,140,187,1.42994,103.833502
760744,83,62,145,1.429206,103.833876
760745,431,205,636,1.429351,103.83332
760746,291,633,924,1.428991,103.833277
760747,158,811,969,1.428283,103.833404
760748,161,542,703,1.427617,103.833366
760749,310,145,455,1.428413,103.833818
760750,395,240,635,1.428011,103.834087
760751,509,170,679,1.427611,103.834083
760752,436,219,655,1.42727,103.833862
760753,28,451,479,1.427041,103.834509
760754,424,444,868,1.426959,103.833862
760755,470,2187,2657,1.427065,103.832583
760756,565,533,1098,1.426646,103.833065
760757,517,164,681,1.426609,103.833969
760758,273,129,402,1.426032,103.834029
760759,519,372,891,1.426276,103.833059
760760,313,1873,2186,1.425896,103.832517
760761,90,489,579,1.425443,103.833179
760762,512,252,764,1.425762,103.833829
760763,33,2258,2291,1.425486,103.834409
760764,557,166,723,1.425439,103.833811
760765,361,97,458,1.425096,103.833832
760766,697,138,835,1.42474,103.833778
760767,71,933,1004,1.42455,103.834358
760768,577,616,1193,1.424375,103.833781
760769,77,1054,1131,1.42465,103.833149
760770,595,1997,2592,1.424462,103.83242
760771,330,348,678,1.423974,103.832396
760772,475,165,640,1.42372,103.832402
760773,392,2698,3090,1.423307,103.832686
760774,312,2923,3235,1.423517,103.831838
760775,567,1256,1823,1.422595,103.832036
760776,482,1765,2247,1.422624,103.833815
760777,43,738,781,1.42208,103.834221
760778,613,180,793,1.422214,103.833668
760779,39,23,62,1.422385,103.833623
760780,81,46,127,1.422176,103.832775
760781,266,249,515,1.422229,103.83219
760782,109,1102,1211,1.422038,103.831671
760783,366,209,575,1.421913,103.832365
760784,486,210,696,1.421918,103.833494
760785,425,257,682,1.421463,103.833802
760786,517,1010,1527,1.421454,103.831947
760787,800,1611,2411,1.421068,103.831951
760788,299,389,688,1.421077,103.833849
760789,67,180,247,1.420585,103.834032
760790,428,213,641,1.420084,103.833648
760791,416,115,531,1.420559,103.8334
760792,124,131,255,1.420723,103.832182
760793,55,754,809,1.420597,103.8318
760794,313,1779,2092,1.420062,103.83206
760795,206,154,360,1.41971,103.832403
760796,465,199,664,1.419719,103.833325
760797,90,595,685,1.41924,103.833457
760798,475,5520,5995,1.419089,103.832974
760799,547,3901,4448,1.419247,103.832491
760800,457,1961,2418,1.418776,103.831909
760801,173,359,532,1.418153,103.832047
760802,432,104,536,1.418538,103.831631
760803,313,67,380,1.418204,103.831513
760804,1358,213,1571,1.41788,103.831408
760805,331,210,541,1.41758,103.831219
760806,516,243,759,1.417233,103.830964
760807,385,189,574,1.41681,103.831389
760808,332,258,590,1.416968,103.830842
760809,427,118,545,1.416628,103.830702
760810,319,133,452,1.416221,103.83166
760811,32,968,1000,1.416445,103.832054
760812,305,467,772,1.417086,103.832139
760813,19,1630,1649,1.299509,103.837
760816,996,1003,1999,1.411853,103.833275
760817,232,742,974,1.412143,103.83381
760819,27,92,119,1.412721,103.834119
760820,741,240,981,1.413106,103.833757
760821,819,1051,1870,1.41341,103.833978
760822,274,403,677,1.413955,103.83391
760823,72,243,315,1.414017,103.833568
760824,503,89,592,1.413832,103.83317
760825,1073,260,1333,1.414388,103.832895
760826,796,529,1325,1.414283,103.832282
760827,122,1083,1205,1.414828,103.83238
760828,282,1595,1877,1.415187,103.832772
760829,819,191,1010,1.414615,103.83303
760830,793,112,905,1.414298,103.833682
760832,541,696,1237,1.414798,103.834636
760833,355,96,451,1.414702,103.833882
760834,368,341,709,1.415166,103.833882
760835,181,77,258,1.415124,103.833335
760836,338,378,716,1.415572,103.832901
760837,95,1908,2003,1.41606,103.833003
760838,493,6595,7088,1.416381,103.833273
760839,603,202,805,1.415913,103.833616
760840,819,305,1124,1.41568,103.833499
760841,727,193,920,1.416011,103.834256
760844,337,1769,2106,1.415635,103.835288
760845,23,70,93,1.41607,103.834937
760846,820,491,1311,1.416772,103.834277
760848,104,579,683,1.416239,103.835301
760849,1121,8855,9976,1.416781,103.835361
760850,379,1682,2061,1.416346,103.83596
760851,282,3073,3355,1.415682,103.836647
760852,102,78,180,1.41596,103.83677
760853,545,196,741,1.416467,103.836745
760854,241,461,702,1.416745,103.837213
760855,426,3249,3675,1.417023,103.836634
760858,349,3513,3862,1.417682,103.838346
760859,185,1109,1294,1.418001,103.839093
760860,292,1361,1653,1.417843,103.839727
760861,445,332,777,1.417561,103.839394
760862,362,217,579,1.417179,103.839182
760863,334,255,589,1.417065,103.838407
760864,614,1458,2072,1.416707,103.839252
760865,645,2305,2950,1.414297,103.8381
760866,508,1707,2215,1.41474,103.837254
760867,669,220,889,1.414101,103.837615
760868,926,251,1177,1.413699,103.837466
760870,435,455,890,1.413149,103.837834
760871,662,494,1156,1.413187,103.837299
760872,736,609,1345,1.413655,103.836814
760873,466,349,815,1.415016,103.836672
760874,514,1731,2245,1.415383,103.835925
760875,424,206,630,1.414819,103.836184
760876,353,3655,4008,1.414791,103.83545
760877,867,1505,2372,1.413902,103.83527
760878,264,133,397,1.414174,103.835744
760879,595,163,758,1.414471,103.835982
760880,420,336,756,1.413962,103.836188
760921,35,3417,3452,1.428453,103.83661
760924,3,1,4,1.459355,103.824802
760925,120,83,203,1.427567,103.83756
760926,449,1869,2318,1.427895,103.837806
760927,509,2182,2691,1.427647,103.837667
760928,271,1130,1401,1.427296,103.837441
760930,402,473,875,1.426886,103.837305
760931,100,2397,2497,1.426635,103.83715
760932,358,1476,1834,1.426375,103.836995
760934,126,730,856,1.425757,103.836589
760935,737,1387,2124,1.425375,103.836514
761101,11,562,573,1.430927,103.828268
761115,431,255,686,1.43331,103.82751
761162,28,781,809,1.432413,103.832263
761269,645,3984,4629,1.299509,103.837
761296,12,1034,1046,1.435358,103.834662
761315,551,241,792,1.433437,103.842934
761316,213,161,374,1.433282,103.842005
761317,608,458,1066,1.433437,103.842934
761318,453,702,1155,1.434578,103.843193
761333,516,217,733,1.431358,103.844568
761334,782,240,1022,1.431358,103.844568
761335,661,1160,1821,1.431607,103.845099
761336,227,1450,1677,1.431909,103.84424
761342,596,517,1113,1.430733,103.844336
761343,7,123,130,1.430733,103.844336
761347,772,163,935,1.427467,103.842313
761348,662,1454,2116,1.427238,103.841973
761350,83,282,365,1.426098,103.844331
761355,27,15,42,1.426099,103.844703
761419,16,114,130,1.424339,103.847669
761424,321,3785,4106,1.299509,103.837
761426,884,5747,6631,1.299509,103.837
761428,386,65,451,1.299509,103.837
761429,1014,495,1509,1.422281,103.849472
761430,864,279,1143,1.42081,103.848013
761431,927,2962,3889,1.41967,103.846953
761432,669,564,1233,1.41967,103.846953
761443,1,158,159,1.299509,103.837
761446,4,76,80,1.299509,103.837
761456,5,248,253,1.419833,103.845182
761458,9,6,15,1.420878,103.845971
761462,0,45,45,1.299509,103.837
761468,9,211,220,1.299509,103.837
761469,6,577,583,1.299509,103.837
761501,234,606,840,1.299509,103.837
761502,214,213,427,1.299509,103.837
761504,711,396,1107,1.419046,103.844041
761505,329,288,617,1.419046,103.844041
761506,526,2271,2797,1.299509,103.837
761507,80,1849,1929,1.299509,103.837
761508,118,1009,1127,1.414809,103.839706
761509,34,446,480,1.413512,103.839302
761510,227,250,477,1.415385,103.842124
761511,677,444,1121,1.415423,103.842797
761512,362,635,997,1.415622,103.841511
761513,76,196,272,1.299509,103.837
761633,69,228,297,1.419139,103.83979
761636,41,221,262,1.419567,103.839615
761637,89,135,224,1.4205,103.839248
761640,13,147,160,1.420917,103.83911
761645,11,81,92,1.42229,103.83839
761663,48,22,70,1.420191,103.839682
761664,167,441,608,1.420702,103.841142
761666,30,170,200,1.419375,103.840006
761671,209,101,310,1.418708,103.841978
761672,192,323,515,1.299509,103.837
761673,0,1,1,1.45551,103.830422
761674,0,2,2,1.463971,103.814896
761675,0,1127,1127,1.299509,103.837
761676,1,115,116,1.299509,103.837
761677,2,36,38,1.299509,103.837
761701,291,7920,8211,1.429952,103.827832
761783,10,53,63,1.421892,103.83295
761795,101,139,240,1.419727,103.832886
761796,68,99,167,1.419382,103.833009
761813,70,1398,1468,1.299509,103.837
761840,11,363,374,1.415467,103.834139
761848,44,532,576,1.416531,103.835452
762101,3,20,23,1.431102,103.828005
762115,754,1638,2392,1.433284,103.827026
762269,607,654,1261,1.436415,103.841229
762315,463,1868,2331,1.435866,103.844271
762316,492,303,795,1.433437,103.842934
762317,872,1143,2015,1.434145,103.842824
762318,430,232,662,1.299509,103.837
762333,233,308,541,1.299509,103.837
762334,856,154,1010,1.299509,103.837
762335,859,29,888,1.431358,103.844568
762336,441,3421,3862,1.431358,103.844568
762342,379,3540,3919,1.430733,103.844336
762347,886,12,898,1.427238,103.841973
762348,719,976,1695,1.427238,103.841973
762424,399,4818,5217,1.299509,103.837
762426,272,86,358,1.299509,103.837
762428,418,131,549,1.422087,103.847204
762429,906,1198,2104,1.299509,103.837
762430,705,1845,2550,1.420661,103.848166
762431,257,454,711,1.41967,103.846953
762432,579,911,1490,1.41967,103.846953
762461,0,59,59,1.299509,103.837
762462,1,5,6,1.299509,103.837
762469,0,134,134,1.299509,103.837
762501,170,408,578,1.417488,103.840696
762502,266,92,358,1.299509,103.837
762504,763,190,953,1.299509,103.837
762505,658,759,1417,1.419046,103.844041
762506,162,429,591,1.299509,103.837
762507,14,39,53,1.415673,103.840026
762508,80,135,215,1.299509,103.837
762509,26,100,126,1.413783,103.840038
762510,402,162,564,1.299509,103.837
762511,406,385,791,1.415622,103.841511
762512,469,653,1122,1.41507,103.84192
762513,98,1,99,1.299509,103.837
762666,8,246,254,1.299509,103.837
762671,123,172,295,1.299509,103.837
762672,162,31,193,1.299509,103.837
762673,1,1,2,1.299509,103.837
762674,1,1,2,1.299509,103.837
762675,2,348,350,1.299509,103.837
762677,0,1,1,1.41911,103.832211
762701,311,1066,1377,1.42985,103.827301
762813,44,227,271,1.299509,103.837
762853,10,2,12,1.299509,103.837
763101,1,130,131,1.431555,103.827984
763115,539,54,593,1.433781,103.827511
763242,7,0,7,1.4330785,103.835367
763315,631,61,692,1.432376,103.843223
763316,474,133,607,1.433555,103.842255
763317,347,25,372,1.433437,103.842934
763318,640,143,783,1.433437,103.842934
763333,254,1278,1532,1.431751,103.845616
763334,988,339,1327,1.43254,103.846246
763335,367,94,461,1.299509,103.837
763336,569,230,799,1.431358,103.844568
763342,685,25,710,1.430733,103.844336
763347,12,401,413,1.299509,103.837
763348,1030,2475,3505,1.427238,103.841973
763424,270,1066,1336,1.423433,103.848629
763426,101,69,170,1.422848,103.847024
763429,9,423,432,1.299509,103.837
763431,141,17,158,1.277471,103.799484
763432,646,1583,2229,1.41967,103.846953
763462,0,2,2,1.299509,103.837
763502,64,489,553,1.299509,103.837
763504,836,566,1402,1.417838,103.843545
763505,993,818,1811,1.419046,103.844041
763506,232,48,280,1.414809,103.839706
763509,40,58,98,1.299509,103.837
763511,471,355,826,1.299509,103.837
763512,423,663,1086,1.415356,103.841553
763513,47,735,782,1.299509,103.837
763672,118,1916,2034,1.299509,103.837
763673,0,1,1,1.299509,103.837
763674,0,8,8,1.299509,103.837
763675,0,23,23,1.299509,103.837
763677,1,0,1,1.299509,103.837
763701,4,1182,1186,1.430085,103.82748
764333,332,382,714,1.431358,103.844568
764334,1144,922,2066,1.431358,103.844568
764342,7,65,72,1.299509,103.837
764348,999,591,1590,1.42669,103.84277
764424,433,234,667,1.299509,103.837
764426,938,2235,3173,1.422974,103.846595
764431,721,107,828,1.420013,103.84759
764432,311,63,374,1.41967,103.846953
764462,6,50,56,1.421427,103.846946
764502,115,157,272,1.41752,103.840931
764504,774,803,1577,1.419046,103.844041
764505,789,338,1127,1.299509,103.837
764511,5,173,178,1.299509,103.837
764513,20,209,229,1.299509,103.837
764673,0,1,1,1.299509,103.837
767949,1,0,1,1.299509,103.837
767950,0,1,1,1.299509,103.837
767954,1,0,1,1.299509,103.837
767955,0,15,15,1.299509,103.837
767956,0,3,3,1.299509,103.837
767957,1,2,3,1.299509,103.837
767958,0,4,4,1.427094,103.836484
767959,0,4,4,1.299509,103.837
767960,0,5,5,1.299509,103.837
767961,0,8,8,1.299509,103.837
767962,0,19,19,1.299509,103.837
767963,4,417,421,1.299509,103.837
767969,7,223,230,1.299509,103.837
767970,4,108,112,1.299509,103.837
767971,0,19,19,1.433553,103.832069
767972,3,16,19,1.299509,103.837
767973,1,62,63,1.299509,103.837
767974,0,3,3,1.299509,103.837
767975,3,279,282,1.299509,103.837
767989,0,2,2,1.299509,103.837
767990,0,39,39,1.299509,103.837
767992,0,9,9,1.299509,103.837
767993,1,26,27,1.299509,103.837
767994,2,0,2,1.299509,103.837
767995,16,29,45,1.299509,103.837
767996,6,98,104,1.299509,103.837
767997,1,33,34,1.299509,103.837
767998,5,136,141,1.299509,103.837
767999,1,23,24,1.299509,103.837
768000,7,5,12,1.299509,103.837
768001,1,28,29,1.299509,103.837
768002,2,16,18,1.299509,103.837
768004,2,79,81,1.299509,103.837
768005,1,59,60,1.299509,103.837
768006,0,61,61,1.299509,103.837
768007,4,744,748,1.299509,103.837
768008,1,2,3,1.299509,103.837
768010,1,1,2,1.299509,103.837
768011,0,41,41,1.421155,103.840576
768012,1,13,14,1.299509,103.837
768013,0,3,3,1.299509,103.837
768014,1,118,119,1.299509,103.837
768015,2,187,189,1.299509,103.837
768019,11,0,11,1.299509,103.837
768024,276,1210,1486,1.423508,103.837149
768039,3306,444,3750,1.424134,103.850588
768044,32,683,715,1.414705,103.824058
768045,3,838,841,1.299509,103.837
768046,1,0,1,1.299509,103.837
768049,28,60,88,1.299509,103.837
768050,7,59,66,1.299509,103.837
768051,7,20,27,1.299509,103.837
768052,1,12,13,1.299509,103.837
768053,6,2,8,1.299509,103.837
768054,0,2,2,1.299509,103.837
768055,5,6,11,1.299509,103.837
768056,1,3,4,1.299509,103.837
768057,10,18,28,1.299509,103.837
768058,477,201,678,1.299509,103.837
768060,182,1,183,1.418053,103.848109
768061,361,5,366,1.299509,103.837
768062,392,141,533,1.418053,103.848109
768063,521,56,577,1.418053,103.848109
768064,157,27,184,1.418053,103.848109
768065,604,0,604,1.418053,103.848109
768066,32,265,297,1.299509,103.837
768069,539,267,806,1.438677,103.830227
768070,96,716,812,1.437044,103.828935
768071,290,295,585,1.299509,103.837
768072,600,19,619,1.299509,103.837
768073,218,3,221,1.299509,103.837
768074,213,18,231,1.299509,103.837
768075,243,38,281,1.299509,103.837
768076,106,21,127,1.299509,103.837
768077,167,34,201,1.299509,103.837
768078,308,703,1011,1.299509,103.837
768079,4,1,5,1.299509,103.837
768080,5,21,26,1.299509,103.837
768081,7,0,7,1.299509,103.837
768082,7,128,135,1.299509,103.837
768083,0,2,2,1.299509,103.837
768085,28,59,87,1.417522,103.844866
768086,11,6,17,1.299509,103.837
768087,5,136,141,1.299509,103.837
768088,0,23,23,1.299509,103.837
768089,289,1,290,1.438687,103.844367
768090,407,340,747,1.436646,103.843696
768091,521,384,905,1.437736,103.844705
768094,432,130,562,1.438604,103.831283
768095,225,225,450,1.438604,103.831283
768096,145,34,179,1.438604,103.831283
768097,536,275,811,1.438604,103.831283
768098,423,68,491,1.438604,103.831283
768099,444,1258,1702,1.438604,103.831283
768100,287,139,426,1.438604,103.831283
768101,977,349,1326,1.451486,103.820553
768102,496,143,639,1.430994,103.829015
768103,325,68,393,1.299509,103.837
768104,260,157,417,1.299509,103.837
768105,110,16,126,1.41697,103.848154
768106,140,3,143,1.299509,103.837
768107,73,1,74,1.41697,103.848154
768108,131,0,131,1.299509,103.837
768109,120,3,123,1.299509,103.837
768110,107,1,108,1.299509,103.837
768111,37,33,70,1.41697,103.848154
768112,244,5,249,1.299509,103.837
768113,126,4,130,1.41697,103.848154
768114,110,11,121,1.41697,103.848154
768115,140,111,251,1.41697,103.848154
768116,156,328,484,1.41697,103.848154
768117,224,316,540,1.41697,103.848154
768118,260,33,293,1.299509,103.837
768119,125,4,129,1.41697,103.848154
768120,91,0,91,1.41697,103.848154
768121,84,4,88,1.41697,103.848154
768122,208,3,211,1.41697,103.848154
768123,380,561,941,1.299509,103.837
768124,230,124,354,1.444808,103.824887
768125,263,12,275,1.444808,103.824887
768126,120,52,172,1.444808,103.824887
768127,99,17,116,1.444808,103.824887
768128,170,11,181,1.444808,103.824887
768129,119,1692,1811,1.444808,103.824887
768130,236,575,811,1.444808,103.824887
768131,79,113,192,1.444808,103.824887
768132,210,1,211,1.444808,103.824887
768133,64,46,110,1.444808,103.824887
768134,221,5,226,1.444808,103.824887
768135,101,2,103,1.444808,103.824887
768136,220,244,464,1.444808,103.824887
768137,70,2,72,1.299509,103.837
768138,293,1166,1459,1.438604,103.831283
768139,114,9,123,1.299509,103.837
768140,391,460,851,1.438604,103.831283
768141,677,590,1267,1.438604,103.831283
768142,366,369,735,1.438604,103.831283
768143,201,103,304,1.438604,103.831283
768144,29,283,312,1.415857,103.825577
768145,1,66,67,1.415613,103.826773
768146,7,2,9,1.415176,103.824971
768147,18,44,62,1.415323,103.826657
768148,14,529,543,1.41543,103.824191
768154,10,0,10,1.299509,103.837
768159,423,563,986,1.436489,103.842651
768160,1447,6915,8362,1.437106,103.841939
768161,148,34,182,1.438408,103.843311
768162,209,48,257,1.438444,103.84338
768163,238,368,606,1.438787,103.843452
768169,2,3,5,1.415976,103.84587
768170,4,3,7,1.415952,103.845825
768171,111,12,123,1.416012,103.845711
768172,4,6,10,1.416071,103.845806
768173,2,1,3,1.299509,103.837
768174,2,0,2,1.299509,103.837
768175,10,0,10,1.41615,103.845933
768176,8,0,8,1.416156,103.845955
768178,0,1,1,1.299509,103.837
768179,18,0,18,1.416226,103.846101
768180,3,0,3,1.416099,103.845821
768182,1,0,1,1.416178,103.84608
768183,2,0,2,1.416084,103.845873
768185,4,0,4,1.299509,103.837
768187,2,3,5,1.417064,103.847171
768189,1,1,2,1.416248,103.8463
768190,7,11,18,1.417245,103.847236
768191,117,9,126,1.417287,103.847254
768192,11,18,29,1.417309,103.847307
768193,0,16,16,1.417383,103.847325
768194,1,15,16,1.417403,103.847317
768195,31,15,46,1.417477,103.847336
768196,0,12,12,1.417494,103.847379
768197,6,3,9,1.41757,103.847373
768198,1,6,7,1.417613,103.847426
768199,4,3,7,1.417662,103.847439
768200,2,36,38,1.417684,103.84743
768201,6,19,25,1.418239,103.846965
768202,0,1,1,1.41624,103.846276
768203,3,1,4,1.416224,103.846437
768204,2,3,5,1.417593,103.847285
768205,2,6,8,1.417547,103.84727
768206,3,2,5,1.417498,103.847252
768207,28,3,31,1.417447,103.847223
768208,3,7,10,1.417427,103.847209
768209,6,4,10,1.417391,103.847162
768210,10,2,12,1.417337,103.847161
768211,6,2,8,1.41727,103.847146
768212,5,2,7,1.417244,103.847103
768213,17,4,21,1.417197,103.847076
768214,6,1,7,1.417126,103.847084
768215,40,250,290,1.417421,103.847064
768216,1,0,1,1.417718,103.847304
768218,1,0,1,1.417272,103.846515
768219,7,1,8,1.417359,103.846658
768220,0,3,3,1.416212,103.846141
768221,6,0,6,1.4174,103.846718
768222,2,0,2,1.417167,103.847236
768223,8,2,10,1.417412,103.846842
768224,11,6,17,1.417438,103.846884
768225,0,1,1,1.417342,103.846578
768226,2,2,4,1.417663,103.847282
768228,98,0,98,1.418124,103.847078
768229,0,1,1,1.417483,103.846885
768230,0,3,3,1.417383,103.846665
768231,6,3,9,1.418111,103.84709
768232,67,5,72,1.418107,103.847094
768233,3,10,13,1.418102,103.847098
768234,3,1,4,1.417538,103.846967
768235,6,0,6,1.418094,103.847107
768236,10,0,10,1.41809,103.847111
768237,5,0,5,1.418085,103.847115
768238,16,1,17,1.418081,103.847119
768239,67,1,68,1.418077,103.847123
768242,4,1,5,1.41754,103.84674
768244,10,0,10,1.417469,103.846615
768245,4,0,4,1.418098,103.847103
768246,1,0,1,1.418119,103.847082
768247,1,0,1,1.417435,103.846549
768248,1,133,134,1.417387,103.846467
768249,219,163,382,1.417599,103.846535
768250,0,1,1,1.417436,103.846511
768251,1,0,1,1.41762,103.846584
768253,14,3,17,1.418017,103.847182
768254,1,0,1,1.41767,103.846592
768256,29,0,29,1.418008,103.847193
768257,29,0,29,1.418006,103.847199
768259,4,0,4,1.417455,103.846574
768260,34,57,91,1.417997,103.847215
768261,6,146,152,1.417995,103.84722
768262,13,18,31,1.417992,103.847226
768263,2,51,53,1.417989,103.847231
768264,12,241,253,1.417986,103.847237
768266,1,34,35,1.417981,103.847247
768267,1,0,1,1.418013,103.847186
768268,3,62,65,1.417788,103.846619
768269,3,65,68,1.417309,103.846378
768270,0,43,43,1.417284,103.84637
768271,5,16,21,1.417202,103.846303
768272,1,9,10,1.417135,103.846287
768273,13,5,18,1.417098,103.846257
768274,4,4,8,1.417046,103.846228
768275,3,7,10,1.416946,103.846203
768276,2,2,4,1.418,103.84721
768277,0,2,2,1.417397,103.846768
768278,0,1,1,1.417793,103.846667
768279,1,0,1,1.41679,103.846116
768280,0,2,2,1.41682,103.846152
768281,1,0,1,1.416718,103.846115
768282,1,0,1,1.41659,103.846063
768283,9,8,17,1.416483,103.845982
768284,1,2,3,1.418115,103.847086
768285,0,1,1,1.416487,103.846014
768287,7,0,7,1.416379,103.846053
768288,3,0,3,1.416271,103.845882
768290,11,0,11,1.416537,103.846121
768291,5,0,5,1.416598,103.846173
768292,1,0,1,1.416314,103.84595
768293,1,0,1,1.416638,103.846191
768295,1,1,2,1.416652,103.846093
768296,6,1,7,1.416918,103.846283
768297,4,0,4,1.416918,103.846178
768298,12,0,12,1.417025,103.846337
768300,19,0,19,1.41714,103.846382
768301,2,0,2,1.416863,103.846276
768302,91,0,91,1.417193,103.84658
768303,31,1,32,1.417154,103.846662
768304,19,0,19,1.417136,103.846672
768306,10,1,11,1.417128,103.846771
768307,1,2,3,1.416379,103.846071
768308,24,0,24,1.417091,103.846867
768309,2,0,2,1.417187,103.846446
768310,46,0,46,1.417051,103.846989
768311,1,2,3,1.417082,103.846817
768312,2,0,2,1.417044,103.846932
768313,11,0,11,1.416965,103.847098
768314,3,0,3,1.417023,103.847
768316,1,1,2,1.416988,103.847077
768317,1,0,1,1.416736,103.846222
768318,3,0,3,1.416938,103.847147
768319,1,1,2,1.41679,103.84725
768320,1,1,2,1.416857,103.847093
768321,1,0,1,1.416818,103.847183
768323,1,0,1,1.416859,103.847032
768325,82,0,82,1.416965,103.846814
768326,1,1,2,1.41684,103.847068
768327,0,1,1,1.416905,103.846937
768329,1,0,1,1.417008,103.846748
768330,1,0,1,1.417026,103.846628
768331,5,0,5,1.41709,103.84653
768332,0,1,1,1.417069,103.846615
768333,33,0,33,1.416888,103.846456
768334,20,0,20,1.41688,103.846437
768335,6,0,6,1.416822,103.846418
768336,4,0,4,1.416964,103.846332
768337,6,0,6,1.416709,103.846379
768339,8,0,8,1.416609,103.846363
768341,6,0,6,1.416549,103.846322
768342,2,0,2,1.416992,103.846789
768343,51,0,51,1.41645,103.846282
768344,32,1,33,1.416369,103.846264
768345,6,0,6,1.416401,103.846374
768346,15,0,15,1.416449,103.846399
768347,34,0,34,1.416474,103.846412
768348,10,0,10,1.416537,103.846462
768349,16,1,17,1.41659,103.846476
768350,1,1,2,1.416502,103.846281
768351,6,1,7,1.41668,103.846517
768352,5,1,6,1.416702,103.846506
768353,3,0,3,1.416836,103.847161
768354,3,0,3,1.416781,103.84653
768355,1,0,1,1.416972,103.846475
768356,3,0,3,1.4168,103.846584
768357,7,1,8,1.416845,103.846726
768358,5,1,6,1.416824,103.846744
768360,3,0,3,1.416916,103.846614
768362,6,0,6,1.416735,103.84696
768363,1,0,1,1.41684,103.846595
768364,3,1,4,1.416751,103.8464
768365,2,0,2,1.416602,103.846505
768366,22,0,22,1.416635,103.847113
768367,1,0,1,1.4167,103.847001
768369,1,1,2,1.416685,103.847067
768372,1,0,1,1.416614,103.847161
768373,7,1,8,1.416632,103.84692
768374,1,1,2,1.41664,103.847274
768375,31,2,33,1.416666,103.846788
768376,15,0,15,1.416684,103.846743
768377,17,1,18,1.416701,103.846722
768378,8,0,8,1.416699,103.846686
768379,2,0,2,1.416613,103.846866
768380,4,1,5,1.416234,103.846559
768381,1,0,1,1.416578,103.846965
768382,0,1,1,1.416268,103.846635
768384,1,0,1,1.416267,103.846682
768385,5,1,6,1.416348,103.846828
768386,65,0,65,1.41634,103.846847
768388,13,0,13,1.416394,103.846944
768389,1,0,1,1.416341,103.846744
768390,106,1,107,1.416394,103.847042
768391,60,0,60,1.416402,103.84709
768393,26,0,26,1.41646,103.847182
768394,4,0,4,1.41667,103.847026
768395,1,0,1,1.416402,103.847024
768396,4,4,8,1.416337,103.847315
768397,0,5,5,1.416323,103.847266
768398,7,0,7,1.416341,103.847249
768399,1,2,3,1.416776,103.846865
768400,4,2,6,1.416305,103.847117
768401,0,2,2,1.416243,103.846515
768402,1,1,2,1.416271,103.847104
768403,1,1,2,1.416278,103.847025
768404,2,1,3,1.416319,103.847175
768405,0,2,2,1.41627,103.84698
768408,15,1,16,1.416158,103.846765
768409,1,0,1,1.416489,103.847312
768410,2,0,2,1.416207,103.846884
768411,35,1,36,1.416136,103.846599
768412,11,1,12,1.41609,103.846564
768413,14,2,16,1.416101,103.846461
768414,9,0,9,1.416141,103.846374
768415,9,1,10,1.416118,103.846346
768416,3,1,4,1.416445,103.847233
768417,1,0,1,1.416143,103.84672
768418,6,0,6,1.416112,103.846212
768420,1,2,3,1.416259,103.84696
768421,8,0,8,1.416061,103.846042
768422,19,2,21,1.416036,103.845994
768423,3,2,5,1.415994,103.845938
768424,2,5,7,1.415964,103.84592
768425,681,441,1122,1.438807,103.830239
768426,440,233,673,1.438807,103.830239
768427,859,96,955,1.438807,103.830239
768428,417,434,851,1.438807,103.830239
768429,635,71,706,1.438807,103.830239
768430,303,2,305,1.438807,103.830239
768431,837,0,837,1.438807,103.830239
768432,89,1756,1845,1.438807,103.830239
768433,455,42,497,1.43925,103.829652
768434,344,38,382,1.43925,103.829652
768435,41,994,1035,1.43925,103.829652
768436,740,45,785,1.43925,103.829652
768437,320,272,592,1.43925,103.829652
768438,525,0,525,1.43925,103.829652
768439,618,0,618,1.43925,103.829652
768440,296,1,297,1.43925,103.829652
768441,552,960,1512,1.437925,103.841475
768442,1890,1212,3102,1.439902,103.842371
768443,20,3,23,1.441611,103.82543
768445,928,1353,2281,1.413707,103.834822
768446,314,109,423,1.413201,103.83559
768447,930,195,1125,1.413409,103.836117
768448,551,314,865,1.413228,103.836617
768449,1566,50,1616,1.412811,103.836721
768450,82,60,142,1.412562,103.835773
768451,1451,373,1824,1.41237,103.835094
768452,408,1114,1522,1.41284,103.834802
768453,238,3256,3494,1.413707,103.834822
768454,221,2106,2327,1.414902,103.83835
768455,362,358,720,1.41499,103.835008
768456,47,15,62,1.415112,103.835055
768515,318,187,505,1.427671,103.830498
768516,359,333,692,1.428129,103.828833
768547,231,3501,3732,1.418737,103.837311
768548,354,252,606,1.420277,103.837683
768578,290,34,324,1.435827,103.840098
768579,458,4349,4807,1.437282,103.837535
768610,282,265,547,1.43231,103.837858
768611,164,211,375,1.433577,103.837571
768642,28,873,901,1.430713,103.832975
768643,216,73,289,1.433543,103.832949
768645,80,1770,1850,1.431024,103.83314
768675,473,966,1439,1.424637,103.829634
768676,3,635,638,1.434706,103.834022
768677,373,13038,13411,1.431141,103.829386
768678,10,393,403,1.4339,103.828301
768679,281,686,967,1.434101,103.833896
768680,6,14,20,1.427923,103.844727
768681,65,2237,2302,1.435165,103.830511
768682,34,1842,1876,1.434871,103.832438
768683,38,1415,1453,1.417558,103.837789
768684,22,3118,3140,1.417254,103.837542
768687,433,274,707,1.417009,103.830256
768689,559,281,840,1.41924,103.831032
768690,19,214,233,1.429648,103.8299
768691,10,178,188,1.434642,103.833697
768692,442,515,957,1.421082,103.845179
768693,82,1376,1458,1.427177,103.846586
768721,111,14,125,1.443089,103.835294
768722,68,37,105,1.44285,103.835004
768723,24,22,46,1.442736,103.834799
768724,388,142,530,1.44256,103.834437
768725,95,2101,2196,1.440152,103.834693
768726,4,62,66,1.442152,103.833875
768727,35,41,76,1.442079,103.834001
768728,142,7,149,1.441272,103.834627
768729,11,27,38,1.44154,103.83535
768730,51,25,76,1.441816,103.835922
768731,7,16,23,1.442891,103.835375
768732,17,2197,2214,1.444037,103.836552
768733,241,1082,1323,1.443732,103.836894
768734,307,96,403,1.443398,103.837255
768735,36,223,259,1.443101,103.837566
768736,2,30,32,1.441688,103.836859
768737,75,101,176,1.442168,103.836313
768738,11,16,27,1.442624,103.83601
768739,89,712,801,1.444253,103.83601
768740,34,2291,2325,1.442978,103.837691
768741,52,1066,1118,1.441402,103.838781
768742,4,122,126,1.441076,103.835154
768743,89,1347,1436,1.441621,103.831424
768758,19,10,29,1.441234,103.833346
768759,18,3,21,1.441133,103.833438
768760,15,2,17,1.440753,103.833658
768761,23,18,41,1.440496,103.833862
768762,67,158,225,1.443059,103.834135
768763,42,153,195,1.443484,103.834748
768764,18,360,378,1.442254,103.837955
768765,1183,11,1194,1.442782,103.838711
768766,12,1,13,1.441121,103.838082
768767,376,19,395,1.442476,103.834764
768768,27,134,161,1.442163,103.837501
768769,5,65,70,1.44355,103.835421
768770,12,187,199,1.443431,103.835513
768771,5,200,205,1.44359,103.835373
768772,185,297,482,1.441642,103.831781
768773,337,45,382,1.442769,103.835939
768774,118,735,853,1.444357,103.836778
768775,1069,40,1109,1.44351,103.837291
768794,231,38684,38915,1.430014,103.836348
768795,1,0,1,1.416137,103.84625
768796,1282,7691,8973,1.426776,103.838377
768797,38,257,295,1.299509,103.837
768798,1,520,521,1.299509,103.837
768799,0,405,405,1.299509,103.837
768800,1,549,550,1.299509,103.837
768801,0,170,170,1.299509,103.837
768802,6,1152,1158,1.299509,103.837
768804,1,6,7,1.299509,103.837
768805,0,34,34,1.299509,103.837
768806,1,5,6,1.299509,103.837
768807,1,45,46,1.299509,103.837
768808,1,162,163,1.299509,103.837
768826,26,2409,2435,1.423369,103.837076
768827,56,2206,2262,1.429227,103.840426
768828,1126,57752,58878,1.423798,103.838436
768829,48,19865,19913,1.422842,103.838759
768830,18,1293,1311,1.299509,103.837
768857,222,17,239,1.426943,103.843853
768858,388,2019,2407,1.423756,103.848086
768859,467,48,515,1.423907,103.848204
768860,187,26,213,1.423907,103.848204
768861,266,1,267,1.424849,103.848068
768862,165,3,168,1.423907,103.848204
768863,159,58,217,1.423907,103.848204
768864,327,211,538,1.423907,103.848204
768865,548,1318,1866,1.423907,103.848204
768866,272,3817,4089,1.42081,103.848013
768888,149,1757,1906,1.431674,103.839759
768889,9,1314,1323,1.434002,103.841591
768890,10,1329,1339,1.434002,103.841591
768891,6,20,26,1.434002,103.841591
768893,86,952,1038,1.43078,103.838693
768894,177,2690,2867,1.299509,103.837
768895,388,2970,3358,1.43292,103.84114
768896,93,1531,1624,1.299509,103.837
768897,730,22,752,1.433254,103.841425
768923,4904,106,5010,1.440348,103.840661
768924,1107,5005,6112,1.442212,103.839674
768925,622,2291,2913,1.440684,103.836587
768926,110,460,570,1.439707,103.834158
768927,395,1258,1653,1.438692,103.833416
768928,480,810,1290,1.436663,103.829889
768929,88,179,267,1.444431,103.838931
768930,568,134,702,1.444883,103.838506
768959,303,3440,3743,1.438563,103.839285
768960,133,534,667,1.427616,103.848313
768961,688,443,1131,1.423917,103.849346
768962,219,1193,1412,1.423904,103.84908
768963,91,372,463,1.424849,103.849236
768964,820,96,916,1.424248,103.848903
768965,510,63,573,1.424849,103.849236
768966,543,380,923,1.424849,103.849236
768991,121,156,277,1.430207,103.830019
768992,139,2130,2269,1.430247,103.830948
768993,25,11950,11975,1.432161,103.829401
768994,1,205,206,1.432163,103.829226
768995,4,134,138,1.432162,103.829022
768997,4,488,492,1.430254,103.830295
769026,276,600,876,1.420935,103.840768
769027,670,7,677,1.423708,103.84065
769028,260,27,287,1.416055,103.839091
769029,214,2465,2679,1.299509,103.837
769057,158,892,1050,1.424085,103.833686
769058,6,2,8,1.422708,103.832985
769060,22,3234,3256,1.422708,103.832985
769061,136,1508,1644,1.423252,103.831142
769092,2155,25519,27674,1.41736,103.832919
769093,2335,81266,83601,1.429394,103.835005
769095,2,0,2,1.416121,103.846663
769098,4538,38343,42881,1.429848,103.835554
769099,146,2167,2313,1.436839,103.834034
769130,112,4328,4440,1.412094,103.83112
769131,88,2001,2089,1.412687,103.831777
769132,110,106,216,1.410547,103.831115
769133,793,1671,2464,1.410528,103.83049
769134,680,833,1513,1.410547,103.831115
769135,468,49,517,1.410547,103.831115
769136,749,30,779,1.410547,103.831115
769137,943,529,1472,1.410667,103.831756
769138,1158,898,2056,1.410921,103.832145
769139,579,176,755,1.410957,103.832428
769140,7,27,34,1.409964,103.831981
769162,6668,5558,12226,1.410939,103.843691
769193,96,216,312,1.4178,103.825414
769194,120,8,128,1.415812,103.826608
769197,363,130,493,1.416679,103.824687
769198,945,637,1582,1.412975,103.829633
769199,235,23,258,1.299509,103.837
769200,9,25,34,1.414974,103.82797
769201,68,62,130,1.414261,103.827911
769227,55,381,436,1.4064,103.820227
769312,0,8,8,1.442624,103.82596
769313,5,1,6,1.442612,103.826148
769314,1,0,1,1.427916,103.836356
769315,3,10,13,1.44259,103.826074
769316,0,2,2,1.427812,103.836589
769318,0,1,1,1.442642,103.826057
769320,2,3,5,1.299509,103.837
769321,3,0,3,1.41605,103.846088
769350,7,2,9,1.438395,103.826437
769352,0,2,2,1.44267,103.826165
769353,1,0,1,1.442688,103.826262
769354,1,1,2,1.438582,103.826631
769355,0,1,1,1.438501,103.826684
769356,26,16,42,1.438687,103.826859
769357,2,7,9,1.438619,103.826957
769358,0,12,12,1.438744,103.82699
769360,5,3,8,1.438752,103.827176
769361,4,0,4,1.416114,103.846303
769362,2,0,2,1.438652,103.826763
769363,19,3,22,1.439003,103.82737
769364,3,0,3,1.299509,103.837
769365,12,1,13,1.43906,103.82745
769366,0,3,3,1.438885,103.827401
769367,1,1,2,1.43881,103.827276
769368,1,0,1,1.438556,103.826809
769369,145,2,147,1.439192,103.82767
769370,1,1,2,1.439146,103.827563
769371,1,0,1,1.439044,103.827642
769372,11,7,18,1.439172,103.827856
769375,2,1,3,1.43894,103.827496
769376,2,1,3,1.439392,103.827999
769377,9,0,9,1.439408,103.828202
769378,0,4,4,1.438934,103.827267
769379,2,1,3,1.43932,103.828072
769381,0,2,2,1.439102,103.827739
769408,0,48,48,1.441979,103.825402
769409,0,4,4,1.438982,103.827559
769410,0,28,28,1.441837,103.825459
769411,0,36,36,1.441928,103.825425
769412,0,25,25,1.442031,103.825385
769413,1,12,13,1.442112,103.825362
769414,45,6,51,1.442192,103.825328
769415,4,3,7,1.442295,103.825283
769416,5,0,5,1.442398,103.825237
769418,1,2,3,1.438839,103.827131
769447,11,8,19,1.442003,103.826213
769448,3,1,4,1.441716,103.825511
769449,6,15,21,1.442053,103.826372
769450,0,2,2,1.439352,103.828119
769451,1,0,1,1.439268,103.827797
769452,2,1,3,1.442547,103.825162
769453,1,10,11,1.442398,103.827046
769454,107,5,112,1.442462,103.827097
769455,2,3,5,1.442594,103.827156
769456,7,3,10,1.442861,103.827193
769457,6,0,6,1.442948,103.82718
769458,1,7,8,1.443003,103.827183
769459,34,3,37,1.443095,103.827173
769460,1,57,58,1.443181,103.827154
769461,2,0,2,1.442077,103.82643
769462,8,1,9,1.443479,103.826974
769463,9,0,9,1.443542,103.826902
769464,23,4,27,1.443626,103.826843
769465,56,0,56,1.443691,103.82674
769466,16,0,16,1.443757,103.826652
769467,0,7,7,1.443238,103.827125
769468,89,46,135,1.44428,103.825391
769469,0,7,7,1.44385,103.826537
769470,5,10,15,1.443913,103.826457
769471,67,489,556,1.443205,103.824814
769472,496,32,528,1.443205,103.824814
769473,430,326,756,1.443205,103.824814
769474,216,16,232,1.443205,103.824814
769475,250,36,286,1.443205,103.824814
769497,0,2,2,1.443395,103.827028
769498,13,2,15,1.437246,103.826286
769499,1,0,1,1.442229,103.826765
769500,2,5,7,1.437353,103.826289
769501,2,6,8,1.437512,103.826401
769502,3,0,3,1.442272,103.826867
769503,1,4,5,1.437703,103.826403
769504,2,12,14,1.437656,103.82633
769505,0,2,2,1.437136,103.826289
769506,2,0,2,1.438528,103.82625
769508,1,1,2,1.437974,103.826303
769511,50,1,51,1.438316,103.826246
769512,1,1,2,1.438064,103.826298
769513,3,0,3,1.4375,103.826298
769514,1,1,2,1.440804,103.825358
769515,28,6,34,1.438474,103.826179
769517,3,1,4,1.442026,103.826293
769518,51,1,52,1.441048,103.825259
769519,3,13,16,1.439053,103.825915
769520,0,1,1,1.437399,103.826382
769522,0,1,1,1.44115,103.825211
769524,1,2,3,1.438391,103.826216
769526,3,47,50,1.44138,103.825111
769530,1,2,3,1.441305,103.825138
769533,1,3,4,1.438551,103.826151
769534,1,34,35,1.44019,103.825418
769535,0,2,2,1.440872,103.825327
769536,9,17,26,1.440357,103.825357
769537,13,0,13,1.440447,103.825321
769538,7,0,7,1.440528,103.825291
769539,0,6,6,1.440625,103.825258
769540,2,9,11,1.440715,103.825217
769541,0,1,1,1.441215,103.825181
769543,27,3,30,1.440945,103.825131
769544,0,1,1,1.440794,103.825185
769545,0,3,3,1.43982,103.825573
769546,0,3,3,1.4411,103.825075
769547,0,1,1,1.441024,103.825104
769548,16,32,48,1.441348,103.825005
769549,78,14,92,1.43742,103.826288
769550,0,3,3,1.441175,103.825052
769551,0,7,7,1.440576,103.82545
769552,0,2,2,1.440275,103.825393
769553,5,1,6,1.437581,103.8264
769554,5,0,5,1.437554,103.826309
769555,3,0,3,1.440711,103.825393
769556,0,1,1,1.441265,103.825028
769557,0,2,2,1.44065,103.825418
769579,2,2,4,1.440113,103.825452
769581,1,2,3,1.437827,103.828085
769583,0,2,2,1.437942,103.828233
769584,1,0,1,1.299509,103.837
769585,25,0,25,1.438045,103.82841
769586,4,11,15,1.438102,103.828495
769587,14,0,14,1.438188,103.828586
769588,2,0,2,1.437942,103.828233
769589,1,0,1,1.437988,103.828313
769591,2,4,6,1.438491,103.828801
769592,12,2,14,1.299509,103.837
769622,1,1,2,1.438247,103.828658
769623,3,0,3,1.437827,103.828085
769624,25,0,25,1.439924,103.825849
769625,118,0,118,1.439993,103.825846
769627,7,2,9,1.440138,103.825865
769628,0,2,2,1.439767,103.825782
769629,10,1,11,1.440221,103.825879
769630,0,1,1,1.438324,103.828708
769631,1,0,1,1.440461,103.825842
769635,0,1,1,1.440307,103.825896
769636,172,0,172,1.440742,103.825881
769637,0,3,3,1.439829,103.825804
769638,18,0,18,1.440833,103.825893
769639,3,4,7,1.440771,103.825981
769641,1,0,1,1.440525,103.825936
769642,2,0,2,1.440375,103.82583
769643,1,19,20,1.441012,103.826015
769644,21,2,23,1.441137,103.825938
769646,1,2,3,1.440634,103.825953
769647,2,0,2,1.441034,103.825932
769649,1,0,1,1.440878,103.826001
769650,0,1,1,1.441339,103.826049
769651,26,2,28,1.441488,103.826055
769652,0,4,4,1.437734,103.827901
769653,3,4,7,1.441573,103.826066
769654,0,1,1,1.441412,103.825978
769655,0,1,1,1.441965,103.825986
769656,12,0,12,1.442096,103.825921
769657,76,15,91,1.441843,103.826078
769658,3,1,4,1.441859,103.826011
769659,4,1,5,1.442909,103.82569
769660,1,1,2,1.441247,103.826044
769661,2,3,5,1.443038,103.8257
769663,250,5,255,1.442458,103.825755
769665,59,15,74,1.443518,103.82588
769666,4,0,4,1.442169,103.825886
769667,2,8,10,1.443575,103.82591
769668,5,0,5,1.442885,103.825571
769669,3,1,4,1.442704,103.825641
769670,1,1,2,1.442273,103.825834
769671,6,0,6,1.443734,103.825963
769672,0,4,4,1.443655,103.825929
769673,77,6,83,1.443812,103.825998
769674,5,20,25,1.443324,103.825689
769675,18,12,30,1.443873,103.826019
769676,2,10,12,1.443519,103.825766
769677,4,11,15,1.44395,103.82605
769678,2,0,2,1.442974,103.825572
769679,2,5,7,1.444026,103.826072
769680,3,0,3,1.441234,103.825961
769681,7,36,43,1.444099,103.82609
769683,3,0,3,1.443639,103.825809
769684,4,10,14,1.443828,103.825883
769685,2,0,2,1.443577,103.82579
769686,7,0,7,1.443952,103.825935
769688,5,0,5,1.444082,103.82598
769689,12,0,12,1.44413,103.825998
769692,0,14,14,1.440097,103.825789
769693,1,9,10,1.440206,103.8258
769694,1,4,5,1.299509,103.837
769720,5,7,12,1.439155,103.826115
769721,4,4,8,1.438974,103.826323
769722,2,7,9,1.438549,103.825701
769723,6,3,9,1.438594,103.825781
769724,1,4,5,1.438635,103.825883
769725,2,1,3,1.443757,103.825861
769726,1,2,3,1.438671,103.825947
769727,7,0,7,1.439019,103.826353
769729,0,2,2,1.443893,103.825908
769731,2,1,3,1.439216,103.826151
769732,13,0,13,1.439374,103.82623
769733,0,1,1,1.44174,103.826072
769734,2,0,2,1.439058,103.826383
769736,0,1,1,1.439158,103.826445
769737,0,2,2,1.439426,103.826254
769739,2,0,2,1.439479,103.826273
769740,1,0,1,1.439261,103.826496
769741,98,1,99,1.43958,103.826316
769742,3,3,6,1.439494,103.826592
769743,8,0,8,1.43964,103.826333
769745,6,1,7,1.439695,103.82635
769746,7,5,12,1.439594,103.826613
769747,8,1,9,1.439755,103.826361
769748,6,0,6,1.43965,103.826631
769749,0,5,5,1.439813,103.826374
769750,2,0,2,1.439524,103.826293
769751,0,2,2,1.439706,103.826642
769752,1,2,3,1.439105,103.826413
769753,6,0,6,1.439984,103.82641
769754,27,1,28,1.439815,103.826667
769755,0,1,1,1.439386,103.826564
769756,0,2,2,1.439926,103.826402
769757,0,8,8,1.440097,103.826421
769758,18,3,21,1.439918,103.826693
769759,7,2,9,1.440157,103.826438
769760,1,2,3,1.439765,103.826658
769762,3,0,3,1.439978,103.826702
769763,3,19,22,1.440291,103.826452
769764,0,7,7,1.44013,103.82672
769766,0,12,12,1.440183,103.826727
769767,1,1,2,1.439866,103.826682
769768,62,1,63,1.440236,103.826736
769769,3,1,4,1.443089,103.825588
769771,1,1,2,1.440412,103.826465
769773,14,0,14,1.440647,103.826489
769775,25,0,25,1.440733,103.826511
769777,2,13,15,1.440844,103.826523
769778,1,0,1,1.44004,103.826417
769779,120,0,120,1.440955,103.826532
769780,31,1,32,1.440685,103.826784
769781,4,0,4,1.440471,103.826473
769782,5,0,5,1.440791,103.8268
769783,1,1,2,1.440533,103.826481
769784,1,7,8,1.440904,103.826817
769785,5,6,11,1.441321,103.826573
769786,3,1,4,1.44109,103.826547
769787,1,0,1,1.440597,103.826773
769788,3,2,5,1.44111,103.826853
769789,0,3,3,1.440074,103.826712
769792,62,6,68,1.441305,103.826882
769793,7,1,8,1.441796,103.826632
769794,34,2,36,1.441404,103.826898
769795,9,2,11,1.441909,103.826645
769796,0,1,1,1.441424,103.82659
769797,25,1,26,1.442835,103.8265
769799,9,0,9,1.443097,103.826395
769800,3,2,5,1.441715,103.826924
769802,36,3,39,1.441808,103.826934
769804,0,1,1,1.44151,103.826907
769806,1,0,1,1.442599,103.826589
769807,0,1,1,1.442705,103.826585
769809,3,1,4,1.441018,103.826836
769811,2,10,12,1.4431,103.826513
769813,10,0,10,1.443226,103.826382
769814,7,2,9,1.443309,103.826279
769815,3,0,3,1.441561,103.826608
769816,6,0,6,1.4429,103.826491
769817,8,6,14,1.44297,103.826457
769818,12,509,521,1.438698,103.825997
769819,0,1,1,1.443147,103.826096
769820,11,0,11,1.44332,103.825962
769821,45,18,63,1.443349,103.825856
769846,12,11,23,1.43786,103.826478
769847,3,6,9,1.437668,103.82694
769848,85,3,88,1.437862,103.826614
769849,6,0,6,1.43751,103.826955
769850,10,0,10,1.437867,103.826745
769851,7,0,7,1.437428,103.826968
769852,1,0,1,1.443269,103.826127
769853,0,2,2,1.44118,103.826555
769854,1,0,1,1.437865,103.826876
769855,0,3,3,1.443355,103.826194
769857,3,1,4,1.442899,103.826562
769858,8,4,12,1.438222,103.827514
769859,4,3,7,1.438214,103.827352
769860,0,3,3,1.4375,103.827036
769861,1,2,3,1.438254,103.827577
769863,3,1,4,1.437689,103.827005
769864,1,5,6,1.43835,103.827753
769865,10,3,13,1.438435,103.827697
769867,15,4,19,1.438509,103.827823
769869,0,1,1,1.438027,103.827139
769870,3,0,3,1.438289,103.827459
769871,25,13,38,1.438641,103.828032
769872,18,23,41,1.438542,103.828075
769873,17,0,17,1.438717,103.828144
769875,26,4,30,1.438787,103.828263
769876,0,6,6,1.438632,103.828246
769877,14,3,17,1.438857,103.82837
769878,3,0,3,1.4385,103.828011
769879,7,1,8,1.438942,103.828506
769880,0,4,4,1.438362,103.827578
769881,8,3,11,1.439008,103.82861
769882,57,0,57,1.438796,103.82851
769883,0,1,1,1.438581,103.827933
769884,1,0,1,1.438845,103.828578
769885,1,5,6,1.438926,103.828721
769886,4,0,4,1.438737,103.828411
769887,41,1,42,1.437419,103.827054
769889,13,5,18,1.299509,103.837
769890,9,19,28,1.299509,103.837
769891,3,0,3,1.438697,103.828343
769916,8,9,17,1.436989,103.826418
769918,1,0,1,1.438895,103.828668
769919,2,2,4,1.437367,103.827064
769920,10,1,11,1.4369,103.827084
769921,3,14,17,1.437034,103.827356
769922,4,0,4,1.436896,103.826923
769923,2,8,10,1.437187,103.827559
769924,0,9,9,1.4373,103.827628
769925,2,3,5,1.437646,103.827645
769927,4,1,5,1.437892,103.827516
769928,11,4,15,1.438053,103.827434
769929,2,0,2,1.437362,103.826993
769930,7,1,8,1.437963,103.827479
769931,2,4,6,1.437369,103.82768
769959,48,1561,1609,1.421441,103.825917
769960,14,331,345,1.419875,103.82711
769961,4,28,32,1.419182,103.826604
769962,239,31,270,1.420524,103.827453
769963,23,0,23,1.418578,103.827039
769964,1,0,1,1.436904,103.826761
769965,2,0,2,1.436972,103.826479
769966,1,5,6,1.418625,103.828404
769967,12,2,14,1.416911,103.827994
769968,14,7,21,1.416694,103.828671
769969,24,0,24,1.419827,103.825725
769970,14,8,22,1.419649,103.825857
769971,20,15,35,1.420108,103.827525
769972,5,1,6,1.299509,103.837
770000,86,73,159,1.299509,103.837
778787,647,723,1370,1.299509,103.837
778792,133,89,222,1.41731,103.795416
778793,136,915,1051,1.417355,103.79793
778880,4,747,751,1.404601,103.818801
778881,24,1010,1034,1.4046,103.8188
778882,6,180,186,1.404623,103.818767
778883,2,0,2,1.417859,103.829102
778884,3,11,14,1.404669,103.818698
778885,2,41,43,1.404714,103.81863
778886,3,45,48,1.40476,103.818561
778887,0,56,56,1.404805,103.818493
778888,1,61,62,1.404851,103.818424
778889,0,40,40,1.404738,103.818484
778890,6,42,48,1.404942,103.818287
778891,4,80,84,1.404987,103.818219
778892,60,1323,1383,1.405032,103.818151
778893,283,611,894,1.405214,103.817877
778895,155,0,155,1.409958,103.81535
778896,372,0,372,1.40996,103.815342
778897,1,0,1,1.418172,103.827274
778901,881,1,882,1.406196,103.815621
778903,60,16,76,1.404679,103.817701
778904,157,10,167,1.405123,103.818014
778905,447,9,456,1.404381,103.817528
778907,4,0,4,1.437106,103.827459
778910,45,0,45,1.409964,103.815343
778912,1,0,1,1.409961,103.815347
778979,0,1,1,1.409929,103.81535
778983,19,2,21,1.40278,103.817577
778984,7,0,7,1.402827,103.817478
778986,1,6,7,1.403124,103.816707
778988,1,0,1,1.402868,103.817411
778991,6,5,11,1.402746,103.817668
778992,1,0,1,1.403474,103.816646
778993,8,10,18,1.402787,103.817582
778994,1,3,4,1.40994,103.815347
778995,6,6,12,1.402841,103.817468
778996,3,4,7,1.402895,103.817354
778997,2,1,3,1.299509,103.837
778998,2,0,2,1.404622,103.818766
778999,18,0,18,1.402976,103.817183
779000,1,2,3,1.402922,103.817297
779001,3,0,3,1.403003,103.817126
779005,0,1,1,1.40276,103.817639
779006,0,3,3,1.403345,103.816583
779007,0,1,1,1.403213,103.816685
779008,10,2,12,1.403481,103.81674
779009,6,8,14,1.403581,103.81679
779010,8,4,12,1.403682,103.816839
779075,21,856,877,1.402733,103.817676
779076,0,112,112,1.402733,103.817676
779077,3,144,147,1.402734,103.817676
779079,34,159,193,1.402734,103.817677
779080,5,186,191,1.402735,103.817677
779081,7,173,180,1.402735,103.817677
779082,23,242,265,1.402736,103.817677
779083,11,83,94,1.402735,103.817676
779084,106,1140,1246,1.404009,103.817497
779085,141,56,197,1.402688,103.817783
779086,49,60,109,1.402675,103.817778
779087,113,684,797,1.40325,103.81843
779088,102,3,105,1.403057,103.818732
779089,56,179,235,1.403459,103.81858
779105,84,64,148,1.405751,103.820175
779124,7,272,279,1.299509,103.837
779204,1,81,82,1.402384,103.81403
779205,8,32,40,1.402334,103.814066
779207,0,3,3,1.40333,103.816666
779208,0,1,1,1.404021,103.816832
779209,8,1,9,1.402639,103.813966
779210,4,4,8,1.403147,103.813778
779211,4,1,5,1.402842,103.813898
779212,2,5,7,1.403442,103.813687
779213,9,0,9,1.403045,103.813831
779214,0,1,1,1.402842,103.813878
779215,20,0,20,1.403249,103.813764
779218,0,1,1,1.40322,103.813191
779219,1,20,21,1.403131,103.813218
779220,0,2,2,1.402949,103.81724
779221,6,164,170,1.403182,103.812567
779224,1,0,1,1.403156,103.81321
779225,0,1,1,1.40308,103.813234
779226,1,0,1,1.403028,103.81323
779229,8,4,12,1.403255,103.813205
779230,1,0,1,1.403054,103.813242
779231,0,1,1,1.403003,103.813258
779234,1,0,1,1.403267,103.813234
779236,1,0,1,1.403603,103.813578
779238,2,1,3,1.402435,103.814033
779241,4,0,4,1.402814,103.817525
779246,1,0,1,1.403654,103.813672
779247,0,1,1,1.4036,103.813929
779248,5,0,5,1.403634,103.813989
779250,1,0,1,1.403951,103.814217
779254,1,0,1,1.403669,103.81405
779255,2,2,4,1.403389,103.813517
779256,3,0,3,1.403479,103.813717
779257,8,3,11,1.403883,103.814724
779258,12,0,12,1.404141,103.814931
779259,0,1,1,1.403738,103.814171
779261,7,0,7,1.403917,103.814946
779262,4,4,8,1.404008,103.815266
779263,1,1,2,1.403182,103.813183
779264,57,27,84,1.403909,103.815536
779265,6,0,6,1.404298,103.815818
779266,6,0,6,1.404221,103.815881
779267,0,1,1,1.4039,103.814835
779268,7,2,9,1.403731,103.815146
779269,0,1,1,1.403809,103.815136
779270,0,3,3,1.403772,103.814231
779271,9,3,12,1.40303,103.815125
779272,21,3,24,1.403326,103.815109
779273,3,0,3,1.403549,103.81516
779274,18,0,18,1.403657,103.815096
779276,21,2,23,1.403878,103.814947
779277,0,5,5,1.403867,103.814851
779278,1,1,2,1.403934,103.815057
779279,30,0,30,1.403829,103.814633
779280,1,1,2,1.403844,103.814738
779281,12,7,19,1.403784,103.814401
779282,21,1,22,1.403565,103.814371
779283,12,0,12,1.403462,103.814431
779284,19,0,19,1.403333,103.81444
779285,5,0,5,1.403142,103.814526
779286,24,3,27,1.402869,103.814577
779287,26,10,36,1.402713,103.814661
779288,0,3,3,1.403552,103.815117
779289,2,19,21,1.402587,103.814716
779290,38,41,79,1.40266,103.81459
779291,16,0,16,1.402739,103.814571
779293,1,0,1,1.403628,103.815151
779294,0,2,2,1.403803,103.814487
779295,98,0,98,1.403165,103.81446
779296,5,1,6,1.40333,103.81438
779297,1,0,1,1.402973,103.814504
779298,63,0,63,1.403538,103.814341
779299,4,3,7,1.403627,103.814311
779300,79,2,81,1.402881,103.815144
779301,2,4,6,1.402757,103.815161
779302,1,1,2,1.403101,103.814479
779303,3,0,3,1.402415,103.814705
779304,1,1,2,1.402881,103.815144
779305,1,12,13,1.403899,103.814834
779306,1,1,2,1.403181,103.813202
779307,2,2,4,1.403865,103.814613
779308,1,2,3,1.403171,103.81513
779310,45,1,46,1.403044,103.81383
779311,1,2,3,1.40293,103.813876
779312,0,1,1,1.403394,103.81437
779384,967,218,1185,1.400321,103.809062
779385,1,9,10,1.402464,103.815479
779386,1,12,13,1.40254,103.815465
779387,24,12,36,1.402588,103.81588
779391,257,63,320,1.404432,103.811206
779392,1,36,37,1.402236,103.814887
779393,2443,4723,7166,1.413775,103.809682
779394,3,39,42,1.402683,103.816443
779395,0,3,3,1.403179,103.813757
779396,25,0,25,1.402743,103.816466
779397,10,0,10,1.402783,103.816481
779398,5,0,5,1.402823,103.816497
779399,16,1,17,1.402863,103.816512
779400,23,1,24,1.402903,103.816528
779401,7,1,8,1.402943,103.816543
779402,2,0,2,1.402719,103.813943
779403,0,14,14,1.403013,103.816564
779564,12,123,135,1.421792,103.793124
779915,29,203,232,1.404379,103.811801
779916,1,5,6,1.404049,103.81182
779917,8,313,321,1.405231,103.811134
783163,23,2,25,1.299509,103.837
786000,1,25,26,1.299509,103.837
786015,15,4245,4260,1.299509,103.837
786020,8,425,433,1.299509,103.837
786025,0,2,2,1.402983,103.816559
786027,29,1,30,1.299509,103.837
786028,0,1,1,1.299509,103.837
786030,0,2,2,1.299509,103.837
786033,1,0,1,1.299509,103.837
786034,1,0,1,1.299509,103.837
786036,0,2,2,1.299509,103.837
786037,0,1,1,1.299509,103.837
786038,5,0,5,1.299509,103.837
786039,6,1,7,1.299509,103.837
786045,7,0,7,1.299509,103.837
786047,30,2,32,1.299509,103.837
786048,4,1,5,1.299509,103.837
786049,0,1,1,1.299509,103.837
786051,1,0,1,1.299509,103.837
786055,0,4,4,1.402719,103.813943
786061,0,1,1,1.299509,103.837
786063,0,1,1,1.299509,103.837
786066,0,1,1,1.299509,103.837
786069,1,0,1,1.299509,103.837
786071,0,1,1,1.299509,103.837
786078,0,4,4,1.299509,103.837
786079,1,1,2,1.299509,103.837
786089,0,2,2,1.299509,103.837
786092,0,2,2,1.299509,103.837
786093,1,2,3,1.402703,103.81645
786094,0,1,1,1.299509,103.837
786096,2,0,2,1.299509,103.837
786098,0,1,1,1.299509,103.837
786100,0,209,209,1.299509,103.837
786116,6,2,8,1.299509,103.837
786117,2,2,4,1.299509,103.837
786118,4,0,4,1.299509,103.837
786119,5,0,5,1.299509,103.837
786121,24,0,24,1.299509,103.837
786123,0,1,1,1.299509,103.837
786124,7,0,7,1.299509,103.837
786128,1,0,1,1.299509,103.837
786129,29,6,35,1.299509,103.837
786130,0,1,1,1.299509,103.837
786132,2,0,2,1.299509,103.837
786133,70,0,70,1.299509,103.837
786134,37,1,38,1.299509,103.837
786135,17,1,18,1.299509,103.837
786136,29,1,30,1.299509,103.837
786137,23,1,24,1.299509,103.837
786139,2,0,2,1.299509,103.837
786145,0,2,2,1.299509,103.837
786150,0,2,2,1.299509,103.837
786152,0,1,1,1.299509,103.837
786153,61,0,61,1.299509,103.837
786154,13,0,13,1.299509,103.837
786155,0,1,1,1.299509,103.837
786156,2,1,3,1.299509,103.837
786157,39,1,40,1.299509,103.837
786158,3,0,3,1.299509,103.837
786159,4,0,4,1.299509,103.837
786161,12,0,12,1.299509,103.837
786162,1,0,1,1.299509,103.837
786164,1,0,1,1.299509,103.837
786165,3,0,3,1.299509,103.837
786166,6,0,6,1.405204,103.822574
786167,1,1,2,1.299509,103.837
786168,5,0,5,1.299509,103.837
786169,2,3,5,1.299509,103.837
786170,96,0,96,1.405148,103.823392
786171,8,0,8,1.299509,103.837
786172,1,0,1,1.299509,103.837
786173,4,0,4,1.299509,103.837
786174,3,1,4,1.299509,103.837
786177,2,0,2,1.299509,103.837
786178,3,1,4,1.299509,103.837
786179,11,0,11,1.299509,103.837
786180,5,1,6,1.299509,103.837
786181,1,0,1,1.299509,103.837
786182,1,0,1,1.299509,103.837
786183,21,1,22,1.299509,103.837
786184,18,0,18,1.299509,103.837
786185,2,1,3,1.299509,103.837
786186,21,0,21,1.299509,103.837
786192,49,4,53,1.386797,103.828044
786195,2,5,7,1.299509,103.837
786196,74,3,77,1.299509,103.837
786197,0,6,6,1.299509,103.837
786198,2,2,4,1.299509,103.837
786199,8,6,14,1.299509,103.837
786200,1,18,19,1.299509,103.837
786201,56,1,57,1.299509,103.837
786202,1,15,16,1.299509,103.837
786203,5,2,7,1.299509,103.837
786205,15,0,15,1.405202,103.822082
786208,12,0,12,1.405482,103.822121
786209,8,0,8,1.405573,103.822139
786210,0,1,1,1.403422,103.821123
786212,0,2,2,1.299509,103.837
786213,2,0,2,1.405716,103.822435
786214,14,1,15,1.405793,103.822644
786215,1,4,5,1.405822,103.822738
786216,12,0,12,1.299509,103.837
786217,0,4,4,1.299509,103.837
786218,6,4,10,1.299509,103.837
786219,15,11,26,1.400496,103.821971
786220,27,4,31,1.299509,103.837
786221,7,1,8,1.299509,103.837
786222,0,5,5,1.299509,103.837
786224,7,8,15,1.406282,103.821739
786225,28,0,28,1.299509,103.837
786226,3,3,6,1.299509,103.837
786227,1,2,3,1.299509,103.837
786228,7,0,7,1.299509,103.837
786241,0,12,12,1.405184,103.822038
786242,2,1,3,1.299509,103.837
786244,7,0,7,1.405323,103.821808
786245,9,0,9,1.405379,103.821716
786246,14,3,17,1.405435,103.821625
786248,42,4,46,1.405546,103.821441
786250,0,6,6,1.405648,103.821267
786251,2,7,9,1.405692,103.821312
786252,3,0,3,1.405212,103.821992
786253,0,14,14,1.405826,103.821449
786255,77,2,79,1.405968,103.821616
786256,2,1,3,1.405737,103.821358
786257,5,0,5,1.406099,103.821845
786258,1,0,1,1.405638,103.822226
786259,2,0,2,1.405755,103.822539
786260,1,0,1,1.406158,103.822
786262,15,0,15,1.406027,103.822348
786263,5,0,5,1.405998,103.822383
786265,4,0,4,1.299509,103.837
786266,3,3,6,1.406069,103.822552
786267,25,0,25,1.405681,103.821281
786268,11,0,11,1.405715,103.821315
786269,6,0,6,1.405782,103.821384
786270,4,10,14,1.405848,103.821452
786271,2,0,2,1.406206,103.822146
786272,0,4,4,1.406027,103.822519
786273,0,1,1,1.406303,103.822437
786274,2,3,5,1.40605,103.821726
786275,0,2,2,1.405915,103.82152
786276,36,2,38,1.299509,103.837
786277,0,1,1,1.406021,103.821671
786278,1,0,1,1.299509,103.837
786279,4,15,19,1.381552,103.833142
786280,3,66,69,1.381221,103.833119
786281,24,1,25,1.299509,103.837
786282,81,1,82,1.299509,103.837
786283,3,3,6,1.299509,103.837
786284,9,0,9,1.381268,103.833116
786285,8,1,9,1.381282,103.833116
786286,7,1,8,1.381303,103.83312
786287,9,0,9,1.381334,103.83312
786288,1,1,2,1.406109,103.821835
786289,3,0,3,1.406021,103.821691
786291,2,0,2,1.381366,103.833123
786292,2,0,2,1.381428,103.833132
786294,1,0,1,1.299509,103.837
786295,0,1,1,1.381488,103.833142
786298,0,1,1,1.381507,103.833141
786299,1,0,1,1.38205,103.832953
786300,2,0,2,1.381447,103.833132
786302,2,0,2,1.382155,103.833024
786304,7,3,10,1.381552,103.833142
786305,114,0,114,1.381552,103.833142
786306,2,0,2,1.382184,103.833122
786307,1,0,1,1.382152,103.832971
786311,9,0,9,1.381552,103.833142
786312,5,0,5,1.381552,103.833142
786313,4,4,8,1.381552,103.833142
786314,3,1,4,1.40595,103.82157
786315,2,140,142,1.381084,103.833114
786316,0,4,4,1.381552,103.833142
786317,1,3,4,1.381113,103.833116
786318,2,1,3,1.381392,103.833131
786320,1,0,1,1.381552,103.833142
786321,1,0,1,1.400974,103.823993
786324,21,0,21,1.400764,103.823961
786325,17,0,17,1.400714,103.823954
786326,7,1,8,1.400651,103.823986
786327,0,1,1,1.400953,103.823892
786328,29,0,29,1.400295,103.823911
786329,13,0,13,1.400519,103.82391
786330,20,1,21,1.400567,103.823867
786331,26,0,26,1.40063,103.823834
786332,24,0,24,1.40065,103.823841
786333,2,1,3,1.38118,103.83312
786334,1,0,1,1.400347,103.823994
786335,2,0,2,1.381552,103.833142
786336,5,3,8,1.400884,103.823706
786337,34,5,39,1.400833,103.823647
786338,14,2,16,1.400794,103.823637
786339,194,0,194,1.400753,103.823659
786340,52,0,52,1.400682,103.823689
786341,46,0,46,1.400638,103.823748
786342,13,0,13,1.400586,103.823747
786343,4,0,4,1.381146,103.833118
786344,2,2,4,1.400531,103.823794
786345,2,0,2,1.400831,103.823758
786347,2,0,2,1.400246,103.823868
786348,9,0,9,1.400155,103.823705
786349,17,0,17,1.400337,103.823702
786350,9,0,9,1.400404,103.823663
786351,9,0,9,1.400431,103.823638
786352,167,0,167,1.400497,103.823611
786353,9,0,9,1.400547,103.823565
786354,62,0,62,1.400631,103.823531
786355,46,1,47,1.400648,103.82351
786356,11,1,12,1.400719,103.82349
786357,1,9,10,1.400763,103.823484
786358,33,11,44,1.400749,103.822773
786359,8,0,8,1.400702,103.823398
786360,9,0,9,1.400641,103.823448
786361,14,0,14,1.400567,103.823473
786362,1,0,1,1.4008,103.82379
786363,2,0,2,1.400187,103.823784
786364,2,0,2,1.400476,103.823518
786365,1,0,1,1.400528,103.823501
786366,18,0,18,1.400268,103.823604
786367,14,1,15,1.400147,103.823682
786368,11,0,11,1.400096,103.823634
786369,2,7,9,1.405812,103.822748
786370,4,1,5,1.405769,103.822633
786371,38,0,38,1.405727,103.822518
786372,11,0,11,1.405684,103.822404
786373,7,1,8,1.405642,103.822289
786374,7,0,7,1.405599,103.822174
786375,1,0,1,1.400364,103.82357
786376,24,0,24,1.405407,103.822131
786377,5,0,5,1.405277,103.822112
786378,5,0,5,1.405211,103.822103
786379,19,3,22,1.405136,103.822084
786381,43,7,50,1.400342,103.824335
786382,1,3,4,1.40045,103.823821
786383,36,1,37,1.400334,103.824461
786384,7,1,8,1.400335,103.824528
786385,1,0,1,1.405538,103.822149
786386,1,0,1,1.400336,103.824596
786387,2,0,2,1.40041,103.823549
786388,22,0,22,1.405169,103.822029
786389,5,0,5,1.405203,103.821974
786390,7,1,8,1.405236,103.821919
786391,4,0,4,1.400333,103.824393
786392,13,0,13,1.405303,103.821808
786394,3,0,3,1.400753,103.823783
786395,1,0,1,1.400337,103.824664
786396,16,3,19,1.405437,103.821588
786397,2,0,2,1.405153,103.822056
786399,3,0,3,1.40537,103.821698
786400,2,2,4,1.40527,103.821863
786401,8,0,8,1.405605,103.821312
786402,0,1,1,1.405404,103.821643
786403,16,1,17,1.404518,103.82195
786404,6,19,25,1.404514,103.821926
786405,14,3,17,1.404534,103.821924
786406,2,0,2,1.405471,103.821533
786407,8,0,8,1.404551,103.821899
786408,2,0,2,1.40453,103.821901
786409,2,4,6,1.404584,103.821848
786410,1,0,1,1.405638,103.821257
786411,2,0,2,1.404561,103.821852
786412,129,0,129,1.404624,103.821754
786413,36,3,39,1.40465,103.821746
786414,12,0,12,1.404656,103.821705
786415,68,0,68,1.404683,103.821695
786416,35,0,35,1.404688,103.821656
786417,0,2,2,1.404617,103.821797
786419,8,0,8,1.404749,103.821592
786420,1,0,1,1.404593,103.821803
786421,7,6,13,1.404782,103.821541
786422,40,0,40,1.404782,103.821509
786423,30,0,30,1.404815,103.82149
786424,65,5,70,1.404814,103.82146
786425,26,8,34,1.404848,103.821439
786427,16,0,16,1.404881,103.821388
786428,4,0,4,1.405571,103.821367
786429,9,6,15,1.404913,103.821337
786430,1,0,1,1.404751,103.821558
786431,1,0,1,1.404909,103.821314
786432,33,0,33,1.40494,103.821265
786433,1,1,2,1.404716,103.821643
786435,2,0,2,1.404979,103.821235
786436,3,2,5,1.405003,103.821167
786437,82,3,85,1.405045,103.821133
786439,9,0,9,1.405078,103.821082
786440,5,3,8,1.405066,103.821069
786441,20,1,21,1.405111,103.82103
786442,5,0,5,1.405098,103.82102
786444,1,0,1,1.404946,103.821286
786445,11,1,12,1.405177,103.820928
786447,2,1,3,1.405538,103.821422
786448,36,2,38,1.405193,103.820873
786449,12,2,14,1.405243,103.820826
786450,9,0,9,1.405224,103.820824
786451,0,1,1,1.40513,103.820971
786452,1,2,3,1.40521,103.820877
786453,159,0,159,1.404541,103.821974
786454,37,4,41,1.404573,103.821988
786455,79,2,81,1.404643,103.822012
786456,5,2,7,1.404716,103.822033
786457,3,0,3,1.405128,103.820859
786458,0,2,2,1.405012,103.821184
786459,2,1,3,1.40479,103.822054
786460,3,0,3,1.404897,103.822066
786461,4,0,4,1.404877,103.821362
786462,1,0,1,1.405266,103.820785
786463,6,0,6,1.404482,103.821941
786464,7,2,9,1.404498,103.82195
786465,0,9,9,1.404174,103.821418
786467,11,7,18,1.404244,103.821311
786468,1,0,1,1.40511,103.82209
786469,6,2,8,1.404337,103.82117
786470,1,0,1,1.40429,103.82124
786471,20,4,24,1.40443,103.821028
786472,3,0,3,1.404968,103.822074
786473,0,3,3,1.404476,103.820957
786474,1,0,1,1.404383,103.821099
786475,3,1,4,1.405039,103.822082
786476,8,0,8,1.404662,103.820673
786477,1,0,1,1.404569,103.820815
786479,5,7,12,1.404802,103.820461
786480,4,0,4,1.404616,103.820744
786481,15,2,17,1.404895,103.820319
786482,25,0,25,1.404941,103.820248
786483,4,2,6,1.404988,103.820177
786485,5,0,5,1.405081,103.820036
786486,4,0,4,1.404848,103.82039
786487,7,5,12,1.404982,103.820519
786488,21,1,22,1.405028,103.820506
786489,2,0,2,1.404826,103.822058
786490,1,0,1,1.404709,103.820603
786491,0,1,1,1.404048,103.821311
786492,7,0,7,1.404131,103.821453
786493,3,1,4,1.405008,103.82057
786494,14,3,17,1.404159,103.821503
786496,11,0,11,1.404216,103.821604
786497,5,0,5,1.404245,103.821654
786498,3,0,3,1.404523,103.820886
786499,15,0,15,1.404302,103.821755
786500,14,2,16,1.40433,103.821805
786501,19,0,19,1.404368,103.821856
786502,4,4,8,1.40443,103.821904
786503,23,1,24,1.388345,103.838702
786504,0,12,12,1.388331,103.838637
786505,6,0,6,1.388289,103.838717
786506,12,10,22,1.388073,103.838696
786507,3,2,5,1.388196,103.838775
786508,16,7,23,1.388044,103.838648
786509,0,3,3,1.404273,103.821704
786510,0,4,4,1.404145,103.821478
786511,21,2,23,1.38813,103.838797
786512,4,0,4,1.387993,103.838582
786513,2,0,2,1.404006,103.82124
786514,16,2,18,1.387948,103.838529
786515,5,0,5,1.388011,103.838878
786516,166,0,166,1.388036,103.838345
786517,12,0,12,1.387986,103.838857
786518,75,47,122,1.38789,103.838435
786519,12,0,12,1.387917,103.838879
786520,2,33,35,1.38779,103.83848
786521,0,2,2,1.388087,103.838823
786522,4,2,6,1.387716,103.838546
786523,9,1,10,1.387812,103.838925
786524,1,0,1,1.40409,103.821382
786525,1,0,1,1.38781,103.838529
786526,3,0,3,1.388165,103.838782
786527,0,1,1,1.387716,103.838954
786528,5,1,6,1.387867,103.838629
786529,53,1,54,1.387673,103.838967
786530,159,3,162,1.387906,103.838717
786531,1,1,2,1.387851,103.838896
786532,0,24,24,1.387952,103.83876
786533,15,4,19,1.387482,103.83904
786534,14,9,23,1.387525,103.83893
786535,17,1,18,1.387441,103.839071
786536,4,1,5,1.38751,103.8389
786539,4,1,5,1.387349,103.839114
786540,3,2,5,1.387456,103.838845
786541,4,7,11,1.387315,103.839135
786542,6,0,6,1.38744,103.838785
786543,0,2,2,1.387644,103.838981
786544,0,43,43,1.387409,103.838727
786545,16,1,17,1.387155,103.839214
786546,3,23,26,1.387198,103.839079
786547,2,0,2,1.387225,103.839171
786548,22,9,31,1.38716,103.839107
786549,0,3,3,1.38787,103.838564
786550,9,6,15,1.387078,103.839147
786552,1,12,13,1.38704,103.839154
786553,5,2,7,1.386951,103.839298
786554,8,1,9,1.386998,103.839198
786555,6,3,9,1.386909,103.83931
786556,2,5,7,1.38694,103.839215
786557,0,13,13,1.386875,103.839327
786558,2,3,5,1.386904,103.839229
786559,8,228,236,1.386771,103.839469
786560,1,5,6,1.386865,103.839266
786561,7,17,24,1.386759,103.839451
786562,0,24,24,1.299509,103.837
786563,9,118,127,1.386742,103.839433
786564,2,2,4,1.387968,103.838545
786565,24,139,163,1.386716,103.839394
786566,27,0,27,1.386704,103.839375
786567,1,186,187,1.386696,103.839359
786568,60,183,243,1.398923,103.833254
786569,24,16,40,1.388557,103.837687
786570,10,0,10,1.388599,103.837662
786571,88,16,104,1.388657,103.837608
786572,3,3,6,1.403713,103.820736
786573,4,0,4,1.386726,103.839414
786574,2,0,2,1.387134,103.83922
786575,2,0,2,1.403799,103.820886
786576,9,0,9,1.40384,103.820957
786577,1,0,1,1.387776,103.838928
786578,1,2,3,1.387095,103.839234
786579,0,1,1,1.403882,103.821028
786580,9,1,10,1.404704,103.819559
786582,9,0,9,1.404652,103.819638
786583,0,2,2,1.40382,103.820921
786584,1,0,1,1.403965,103.82117
786586,1,1,2,1.404617,103.81969
786587,1,0,1,1.404582,103.819743
786588,5,6,11,1.404441,103.819952
786590,26,5,31,1.404371,103.820057
786591,50,0,50,1.404336,103.82011
786592,0,3,3,1.403924,103.821099
786594,34,8,42,1.40423,103.820267
786596,0,1,1,1.404476,103.8199
786598,0,1,1,1.40416,103.820372
786600,14,3,17,1.40402,103.820581
786601,5,0,5,1.403985,103.820634
786602,6,0,6,1.403949,103.820686
786603,3,1,4,1.403756,103.820811
786604,1,1,2,1.404511,103.819848
786605,2,0,2,1.403879,103.820791
786606,2,5,7,1.403819,103.820886
786607,0,4,4,1.403914,103.820739
786608,8,3,11,1.404169,103.821395
786609,17,0,17,1.404207,103.821337
786610,1,1,2,1.403844,103.820844
786611,1,0,1,1.40409,103.820477
786612,13,0,13,1.404322,103.821162
786613,5,0,5,1.40436,103.821104
786614,1,0,1,1.404284,103.82122
786615,1,0,1,1.404398,103.821046
786616,19,0,19,1.404475,103.820929
786617,10,0,10,1.404513,103.820871
786619,2,0,2,1.404246,103.821278
786620,3,0,3,1.404301,103.820162
786621,8,0,8,1.404666,103.820638
786622,23,0,23,1.404704,103.82058
786623,2,0,2,1.404589,103.820754
786624,0,1,1,1.404436,103.820987
786625,1,0,1,1.40478,103.820463
786626,5,2,7,1.404856,103.820347
786628,1,0,1,1.404818,103.820405
786629,1,5,6,1.404971,103.820172
786630,7,0,7,1.405009,103.820114
786635,3,93,96,1.4052,103.819823
786636,1,0,1,1.404933,103.820231
786638,0,2,2,1.404742,103.820522
786640,3,5,8,1.404639,103.819637
786641,1,0,1,1.38877,103.829633
786643,6,0,6,1.404514,103.819823
786644,2,6,8,1.404473,103.819885
786645,27,0,27,1.404432,103.819947
786646,0,5,5,1.40439,103.820009
786647,0,1,1,1.404598,103.819699
786648,9,0,9,1.404307,103.820133
786649,10,5,15,1.404266,103.820194
786651,0,14,14,1.404183,103.820318
786652,31,0,31,1.404141,103.82038
786654,0,1,1,1.404348,103.820071
786656,13,0,13,1.403975,103.820628
786657,42,3,45,1.403934,103.82069
786658,22,0,22,1.403892,103.820752
786659,2,1,3,1.404627,103.820696
786660,0,7,7,1.403809,103.820876
786661,2,2,4,1.40415,103.821424
786662,26,1,27,1.403531,103.820415
786663,1,0,1,1.404058,103.820504
786664,1,1,2,1.404701,103.819544
786666,2,1,3,1.403851,103.820814
786668,5,9,14,1.388209,103.833806
786669,35,5,40,1.388205,103.833825
786670,8,1,9,1.388248,103.833822
786671,4,1,5,1.388242,103.833839
786672,2,2,4,1.403496,103.820365
786673,17,0,17,1.388315,103.833868
786674,2,2,4,1.388328,103.833853
786675,10,0,10,1.388387,103.833896
786676,7,2,9,1.388487,103.833914
786677,11,4,15,1.38846,103.833924
786678,6,9,15,1.388566,103.833945
786679,0,2,2,1.403585,103.82051
786680,5,2,7,1.388646,103.833976
786681,3,3,6,1.388606,103.833981
786682,12,6,18,1.388725,103.834007
786683,2,1,3,1.403671,103.82066
786684,0,1,1,1.403558,103.820462
786685,0,2,2,1.388533,103.833952
786686,4,3,7,1.388884,103.834069
786687,8,9,17,1.388825,103.834066
786688,5,1,6,1.388964,103.834099
786689,2,4,6,1.388897,103.834094
786690,0,6,6,1.389043,103.83413
786691,13,11,24,1.38897,103.834122
786692,0,3,3,1.388679,103.834009
786693,5,0,5,1.389043,103.83415
786694,5,5,10,1.389202,103.834192
786695,11,5,16,1.389116,103.834179
786696,2,4,6,1.389281,103.834223
786697,5,1,6,1.389189,103.834207
786698,11,4,15,1.389361,103.834254
786699,5,4,9,1.389262,103.834235
786700,2,6,8,1.38944,103.834285
786701,1,1,2,1.388752,103.834037
786702,4,2,6,1.38948,103.8343
786703,22,1,23,1.389407,103.834292
786704,6,2,8,1.389539,103.834359
786705,8,1,9,1.38948,103.83432
786706,23,8,31,1.389599,103.834417
786707,0,4,4,1.388407,103.833884
786708,14,0,14,1.389658,103.834476
786709,3,0,3,1.389122,103.834161
786710,6,7,13,1.389717,103.834534
786711,8,4,12,1.389621,103.834459
786712,7,0,7,1.389777,103.834593
786713,9,1,10,1.389677,103.834514
786714,6,2,8,1.389836,103.834651
786715,2,5,7,1.389733,103.83457
786717,12,1,13,1.389789,103.834625
786718,1,2,3,1.389564,103.834403
786719,2,1,3,1.389955,103.834768
786720,0,1,1,1.388805,103.834038
786721,166,0,166,1.389902,103.834736
786722,5,2,7,1.389958,103.834792
786724,0,5,5,1.390022,103.834876
786726,4,1,5,1.390074,103.834992
786727,5,0,5,1.390109,103.83507
786728,120,0,120,1.390144,103.835148
786729,4,0,4,1.389508,103.834348
786730,1,0,1,1.390014,103.834827
786731,15,0,15,1.390249,103.83538
786732,3,7,10,1.390284,103.835458
786733,13,2,15,1.390071,103.83474
786734,0,14,14,1.390204,103.834857
786735,8,1,9,1.390166,103.834695
786737,0,1,1,1.390214,103.835303
786738,11,7,18,1.390323,103.834782
786739,3,8,11,1.390241,103.834647
786741,13,0,13,1.390272,103.834624
786742,0,4,4,1.390179,103.835225
786743,9,2,11,1.390327,103.834611
786744,10,1,11,1.390472,103.8347
786745,101,4,105,1.390396,103.83457
786747,3,0,3,1.389845,103.834681
786748,0,1,1,1.390196,103.834667
786749,13,0,13,1.390799,103.834552
786750,18,1,19,1.387956,103.833994
786751,17,0,17,1.38794,103.833927
786752,1,1,2,1.389334,103.834263
786753,20,0,20,1.388167,103.833712
786754,1,2,3,1.39062,103.834631
786755,8,0,8,1.388202,103.83355
786756,4,1,5,1.388245,103.833443
786757,2,0,2,1.388147,103.833787
786758,40,0,40,1.388271,103.833361
786759,2,0,2,1.388263,103.833383
786760,0,7,7,1.388434,103.833402
786761,23,0,23,1.388502,103.833424
786762,18,2,20,1.388594,103.833467
786763,3,0,3,1.388198,103.833576
786764,8,5,13,1.388805,103.833401
786765,55,5,60,1.388747,103.833527
786766,2,1,3,1.388667,103.833499
786767,2,0,2,1.38828,103.833342
786768,2,0,2,1.388907,103.833607
786770,6,0,6,1.389178,103.83371
786771,1,0,1,1.390695,103.834592
786774,14,0,14,1.389511,103.833859
786775,6,4,10,1.389551,103.833839
786776,3,0,3,1.388828,103.833565
786777,2,1,3,1.389582,103.83389
786778,0,2,2,1.388988,103.83364
786780,31,8,39,1.389938,103.834013
786781,2,1,3,1.389662,103.83393
786782,6,1,7,1.390105,103.834091
786783,3,1,4,1.390428,103.834728
786784,1,0,1,1.389266,103.83375
786785,1,3,4,1.390186,103.834128
786786,0,1,1,1.390276,103.834172
786787,0,1,1,1.390454,103.834249
786788,4,1,5,1.390604,103.834309
786789,0,1,1,1.390534,103.834276
786790,10,3,13,1.391041,103.834548
786791,26,0,26,1.390777,103.834372
786793,28,1,29,1.390855,103.834397
786794,55,3,58,1.39142,103.83468
786795,0,10,10,1.390957,103.834412
786796,6,9,15,1.391474,103.834705
786797,5,1,6,1.391032,103.834432
786798,38,5,43,1.391203,103.834973
786799,8,0,8,1.391119,103.83447
786800,9,0,9,1.391163,103.834993
786801,1,0,1,1.390671,103.834337
786802,0,9,9,1.391112,103.835013
786803,4,1,5,1.391283,103.834514
786804,2,0,2,1.389757,103.833956
786805,18,1,19,1.391362,103.834569
786806,122,3,125,1.390979,103.835066
786807,22,23,45,1.391458,103.834598
786809,7,1,8,1.391523,103.83462
786810,3,2,5,1.390886,103.835116
786811,2,0,2,1.391072,103.835036
786812,48,0,48,1.390862,103.835149
786814,30,6,36,1.39084,103.835181
786815,6,1,7,1.391783,103.834731
786816,1,0,1,1.391192,103.8345
786818,4,1,5,1.390622,103.835288
786819,3,1,4,1.390356,103.834207
786820,2,0,2,1.391623,103.83467
786821,5,429,434,1.392077,103.83484
786822,0,2,2,1.390512,103.835341
786823,0,16,16,1.391979,103.834885
786824,36,14,50,1.390294,103.835448
786825,6,5,11,1.391872,103.834849
786826,0,3,3,1.38999,103.834051
786827,3,1,4,1.391991,103.834806
786829,99,2,101,1.391511,103.834874
786830,1,0,1,1.390731,103.835235
786831,8,2,10,1.391376,103.83494
786832,1,4,5,1.391308,103.834973
786833,131,0,131,1.391241,103.835006
786834,0,5,5,1.391173,103.835039
786835,0,6,6,1.391105,103.835072
786836,18,0,18,1.391038,103.835105
786837,0,1,1,1.391444,103.834907
786838,22,1,23,1.390903,103.835171
786840,2,0,2,1.390403,103.835395
786841,1,2,3,1.39168,103.834792
786842,1,4,5,1.390632,103.835303
786843,0,2,2,1.390767,103.835237
786844,26,5,31,1.390497,103.835369
786845,1,2,3,1.3907,103.83527
786846,10,0,10,1.390362,103.835435
786847,0,1,1,1.39097,103.835138
786848,4,0,4,1.391646,103.834808
786850,5,0,5,1.390085,103.835608
786851,12,0,12,1.38998,103.835678
786852,4,68,72,1.389886,103.835738
786876,117,701,818,1.391676,103.837463
786877,7,28,35,1.387737,103.840642
786878,1,0,1,1.390304,103.835458
786879,11,2,13,1.387696,103.840596
786881,0,32,32,1.387653,103.840535
786882,0,2,2,1.390564,103.835336
786883,59,7,66,1.387586,103.840509
786884,4,4,8,1.387288,103.839946
786885,37,38,75,1.387568,103.840432
786886,9,4,13,1.387226,103.839888
786887,16,6,22,1.387514,103.840374
786888,9,1,10,1.387201,103.839838
786889,18,111,129,1.387488,103.840305
786890,0,8,8,1.387163,103.839801
786891,16,14,30,1.387451,103.840277
786892,0,71,71,1.387403,103.840237
786893,3,10,13,1.387324,103.840156
786894,0,80,80,1.387293,103.840117
786895,3,6,9,1.387219,103.840051
786896,0,99,99,1.387198,103.840022
786897,47,2,49,1.387172,103.839973
786898,11,62,73,1.387145,103.839878
786899,1,8,9,1.387092,103.839842
786900,2,10,12,1.387063,103.839791
786901,19,247,266,1.386998,103.839718
786902,4,0,4,1.390242,103.835503
786903,2,1,3,1.390429,103.835402
786904,1,0,1,1.387382,103.840091
786905,5,1,6,1.403606,103.819085
786907,0,1,1,1.403641,103.819032
786909,4,0,4,1.403724,103.81898
786911,7,0,7,1.403397,103.819406
786912,22,7,29,1.403714,103.81897
786913,10,0,10,1.403362,103.819459
786914,10,2,12,1.403658,103.818985
786915,0,2,2,1.387339,103.839999
786916,12,1,13,1.40359,103.819089
786917,2,0,2,1.403327,103.819513
786918,34,0,34,1.403522,103.819193
786919,2,3,5,1.403257,103.819619
786920,2,0,2,1.403292,103.819566
786921,5,0,5,1.403222,103.819673
786922,12,0,12,1.403387,103.819401
786923,0,1,1,1.403536,103.819192
786924,1,0,1,1.403187,103.819726
786925,4,0,4,1.403466,103.819299
786926,2,0,2,1.403455,103.819297
786927,2,0,2,1.403251,103.819608
786928,0,1,1,1.403319,103.819504
786930,1,0,1,1.403184,103.819712
786931,2,3,5,1.403065,103.819913
786932,6,4,10,1.403082,103.819868
786933,5,0,5,1.402961,103.820845
786934,66,0,66,1.402925,103.82067
786935,18,0,18,1.403033,103.820556
786936,65,6,71,1.403206,103.820467
786937,2,0,2,1.403118,103.819833
786938,0,4,4,1.403153,103.81978
786939,2,1,3,1.403658,103.819005
786940,5,0,5,1.403476,103.820324
786941,0,1,1,1.403116,103.819816
786942,1,0,1,1.403466,103.820314
786943,0,4,4,1.403466,103.820334
786944,0,2,2,1.403379,103.820378
786945,20,0,20,1.403548,103.820193
786947,34,4,38,1.403589,103.820133
786948,0,5,5,1.403625,103.820101
786949,11,0,11,1.40363,103.820073
786950,13,0,13,1.403664,103.820043
786951,0,1,1,1.403506,103.820276
786955,25,6,31,1.403754,103.819892
786956,1,5,6,1.403783,103.819868
786957,1,0,1,1.403671,103.820012
786958,9,0,9,1.403823,103.81981
786959,5,2,7,1.403836,103.819771
786960,1,1,2,1.403545,103.820217
786962,27,0,27,1.403902,103.819693
786963,0,2,2,1.403863,103.819751
786966,2,1,3,1.402951,103.820855
786969,22,0,22,1.404041,103.819469
786970,1,1,2,1.403918,103.81965
786973,2,0,2,1.404041,103.819489
786974,0,2,2,1.404124,103.819347
786975,7,4,11,1.404145,103.819317
786977,8,0,8,1.404196,103.819252
786979,32,38,70,1.404224,103.819224
786980,62,60,122,1.404224,103.819244
786981,46,0,46,1.403456,103.820324
786982,3,0,3,1.403982,103.819576
786983,4,0,4,1.403507,103.820254
786984,3,0,3,1.403348,103.820264
786985,7,0,7,1.403174,103.820148
786987,1,0,1,1.403795,103.819831
786988,1,0,1,1.403069,103.820021
786990,19,0,19,1.403029,103.819905
786992,10,0,10,1.402993,103.819803
786993,22,2,24,1.402975,103.819753
786996,44,0,44,1.40292,103.819601
786997,1,0,1,1.403054,103.819976
786998,9,1,10,1.402884,103.8195
786999,2,1,3,1.403257,103.820209
787001,8,0,8,1.402829,103.819315
787002,3,1,4,1.403348,103.820264
787003,3,0,3,1.402866,103.819449
787004,7,3,10,1.402849,103.819201
787005,27,1,28,1.40287,103.819152
787006,27,4,31,1.402891,103.819103
787007,1,0,1,1.402902,103.81955
787008,3,1,4,1.402829,103.819315
787009,23,9,32,1.403048,103.81992
787011,6,4,10,1.40285,103.819348
787012,1,0,1,1.402913,103.819055
787013,1,0,1,1.402965,103.818932
787056,1167,410,1577,1.38661,103.841258
787057,1065,377,1442,1.385832,103.841559
787058,1360,285,1645,1.38542,103.840744
787059,998,116,1114,1.386111,103.840413
787060,157,1998,2155,1.38606,103.840977
787066,1508,1545,3053,1.383047,103.837043
787067,1093,43,1136,1.382627,103.837333
787068,47,8,55,1.384411,103.836203
787069,31,23,54,1.384111,103.836256
787070,181,153,334,1.383549,103.836302
787071,293,119,412,1.383506,103.835882
787072,422,110,532,1.383985,103.835855
787073,391,127,518,1.384485,103.835797
787075,196,52,248,1.381241,103.833506
787076,42,9,51,1.381574,103.833436
787078,1062,310,1372,1.385558,103.83976
787079,468,303,771,1.38486,103.840236
787080,992,90,1082,1.384651,103.839775
787081,28,2,30,1.384881,103.839462
787082,1230,544,1774,1.385149,103.839261
787083,456,2,458,1.382368,103.837678
787084,429,3,432,1.38171,103.836892
787085,458,155,613,1.381639,103.83624
787086,273,601,874,1.382146,103.83632
787087,44,38,82,1.378764,103.829987
787101,14,555,569,1.349997,103.836269
787103,286,933,1219,1.384938,103.825698
787104,8,176,184,1.396321,103.817381
787110,126,151,277,1.397568,103.818627
787111,56,48,104,1.398419,103.818282
787112,20,100,120,1.398541,103.818256
787113,12,27,39,1.398911,103.81807
787114,7,9,16,1.398678,103.818209
787115,1,12,13,1.398979,103.818056
787116,0,1,1,1.402986,103.818918
787117,0,16,16,1.399164,103.818008
787118,4,9,13,1.399238,103.817966
787119,4,11,15,1.399296,103.81794
787120,3,6,9,1.399354,103.817908
787121,23,14,37,1.399449,103.817871
787122,9,28,37,1.399555,103.817792
787124,47,39,86,1.400022,103.817667
787126,2,6,8,1.399967,103.817613
787127,0,1,1,1.39908,103.81804
787128,0,463,463,1.400232,103.817533
787129,42,14,56,1.400929,103.817307
787130,1689,284,1973,1.378579,103.828188
787131,1297,2493,3790,1.380158,103.827661
787132,1189,8,1197,1.380776,103.827908
787133,673,801,1474,1.381257,103.827048
787134,130,77,207,1.299509,103.837
787135,82,241,323,1.299509,103.837
787136,13,1087,1100,1.299509,103.837
787149,95,11,106,1.381429,103.832418
787150,11,7,18,1.381392,103.83231
787151,9,3,12,1.381369,103.832161
787152,1,0,1,1.400126,103.817565
787153,13,5,18,1.381352,103.831927
787154,1,0,1,1.38136,103.832044
787155,0,16,16,1.381472,103.832395
787156,1,1,2,1.404124,103.819367
787157,1,5,6,1.381303,103.831667
787158,0,1,1,1.381336,103.831818
787159,14,7,21,1.381279,103.831568
787160,121,0,121,1.381446,103.832043
787161,169,2,171,1.381266,103.831474
787162,0,1,1,1.381452,103.83216
787163,1,0,1,1.381423,103.831917
787166,1,0,1,1.381289,103.831394
787167,47,0,47,1.381463,103.831269
787168,24,2,26,1.381369,103.831589
787169,5,0,5,1.381623,103.831249
787170,2,4,6,1.381869,103.831535
787172,5,0,5,1.381862,103.831653
787173,0,1,1,1.381396,103.831686
787174,4,11,15,1.381869,103.831787
787176,94,3,97,1.381882,103.831867
787177,0,2,2,1.381463,103.832275
787178,7,0,7,1.381909,103.832138
787179,0,4,4,1.402934,103.819006
787180,3,1,4,1.381922,103.832276
787181,1,0,1,1.381855,103.831229
787182,14,0,14,1.382017,103.832282
787184,1,0,1,1.382025,103.832376
787185,1,1,2,1.381894,103.832025
787186,2,0,2,1.381974,103.831866
787187,12,0,12,1.382029,103.831648
787188,3,1,4,1.381939,103.832348
787189,1,85,86,1.381207,103.832519
787192,0,2,2,1.381973,103.831773
787193,0,1,1,1.381986,103.832065
787194,0,2,2,1.381525,103.832498
787195,0,2,2,1.381696,103.832493
787209,1,5,6,1.379732,103.829227
787210,1,3,4,1.382,103.831545
787211,6,3,9,1.379756,103.829209
787212,96,4,100,1.379967,103.829452
787213,4,1,5,1.379845,103.829154
787215,2,0,2,1.381778,103.832487
787216,1,0,1,1.381602,103.83249
787217,3,0,3,1.402828,103.81925
787218,61,0,61,1.380134,103.829385
787219,1,3,4,1.379935,103.829469
787220,293,0,293,1.380187,103.829362
787221,1,0,1,1.3801,103.829418
787222,5,0,5,1.380037,103.829039
787223,0,1,1,1.380236,103.829308
787224,1,0,1,1.380241,103.829197
787225,3,1,4,1.379974,103.829103
787226,6,2,8,1.380228,103.829057
787227,3,0,3,1.379952,103.829127
787228,10,2,12,1.3803,103.829023
787230,1,0,1,1.380149,103.829107
787231,2,0,2,1.379864,103.829147
787233,0,4,4,1.380333,103.82916
787234,3,0,3,1.380417,103.829123
787235,5,2,7,1.380598,103.82898
787236,4,1,5,1.380491,103.828868
787237,1,2,3,1.380426,103.828924
787238,1,3,4,1.380559,103.829005
787239,3,0,3,1.380648,103.828966
787240,0,2,2,1.380502,103.82902
787241,9,0,9,1.380871,103.828993
787242,1,0,1,1.380329,103.828989
787243,0,6,6,1.380922,103.828974
787244,31,0,31,1.380704,103.82869
787245,4,0,4,1.380544,103.828833
787246,2,1,3,1.380695,103.82894
787247,17,1,18,1.381013,103.828899
787248,53,0,53,1.38084,103.828664
787249,15,0,15,1.381062,103.828908
787250,0,2,2,1.380598,103.828801
787251,1,1,2,1.380859,103.828629
787252,17,0,17,1.380909,103.828572
787253,0,3,3,1.380752,103.828666
787274,3,11,14,1.398006,103.818948
787275,2,0,2,1.381114,103.828869
787276,9,1,10,1.398096,103.818767
787277,48,10,58,1.397967,103.819045
787278,1,0,1,1.380621,103.828795
787279,8,0,8,1.398019,103.818942
787280,5,0,5,1.398089,103.818388
787281,2,0,2,1.397942,103.819096
787282,0,2,2,1.39807,103.818839
787284,0,2,2,1.398096,103.818787
787286,3,0,3,1.381,103.82858
787287,1,11,12,1.398005,103.819035
787307,1,0,1,1.398124,103.818671
787308,0,11,11,1.398984,103.818573
787309,10,2,12,1.398814,103.8187
787310,0,2,2,1.398134,103.818574
787311,5,0,5,1.398712,103.818865
787312,105,0,105,1.3989,103.81863
787314,16,6,22,1.398814,103.81868
787315,1,0,1,1.3989,103.81865
787316,3,5,8,1.398747,103.81875
787317,3,2,5,1.39859,103.819235
787319,1,0,1,1.39858,103.819234
787320,1,1,2,1.398942,103.818602
787321,1,1,2,1.398706,103.818859
787322,8,0,8,1.398679,103.818932
787325,0,2,2,1.398648,103.819269
787326,5,0,5,1.398624,103.819078
787329,1,1,2,1.398727,103.819314
787330,4,0,4,1.380959,103.828959
787332,6,0,6,1.39856,103.819234
787333,6,0,6,1.398883,103.819404
787334,0,2,2,1.398805,103.819359
787335,9,0,9,1.398923,103.819426
787336,62,2,64,1.398373,103.819469
787337,1,0,1,1.398609,103.819246
787339,38,6,44,1.399001,103.819471
787340,108,3,111,1.398337,103.8196
787341,1,6,7,1.398347,103.819794
787342,2,0,2,1.398385,103.819425
787343,135,1,136,1.398409,103.819835
787344,25,0,25,1.398938,103.820187
787345,1,2,3,1.398099,103.818378
787346,0,1,1,1.398962,103.819449
787347,8,0,8,1.398695,103.820038
787348,0,1,1,1.398965,103.820163
787349,1,5,6,1.398838,103.820139
787350,1,5,6,1.399041,103.820056
787351,10,0,10,1.39891,103.82019
787353,28,12,40,1.398952,103.820155
787354,6,3,9,1.399106,103.819944
787355,1,0,1,1.399009,103.820112
787356,0,2,2,1.398313,103.819687
787357,15,2,17,1.399037,103.820044
787358,0,4,4,1.39857,103.819224
787360,1,4,5,1.399203,103.819775
787361,3,1,4,1.39917,103.819831
787362,1,0,1,1.398993,103.82012
787363,10,1,11,1.399168,103.819815
787364,0,1,1,1.399235,103.819719
787365,29,7,36,1.399212,103.819738
787366,5,23,28,1.399299,103.819607
787367,0,1,1,1.399267,103.819663
787368,1,1,2,1.399138,103.819887
787369,1,2,3,1.398552,103.819936
787370,6,1,7,1.399364,103.819495
787371,15,0,15,1.399344,103.819509
787372,2,0,2,1.399331,103.819551
787373,1,2,3,1.3993,103.819586
787374,4,2,6,1.399428,103.819382
787376,18,0,18,1.39946,103.819326
787377,1,1,2,1.399396,103.819439
787378,4,0,4,1.399125,103.819891
787379,0,1,1,1.399256,103.819662
787380,1,0,1,1.399519,103.819204
787381,6,6,12,1.399553,103.819118
787382,11,17,28,1.399549,103.819154
787384,22,3,25,1.399565,103.819089
787385,0,2,2,1.399475,103.81928
787386,1,3,4,1.399493,103.81927
787387,6,0,6,1.399557,103.818891
787389,28,2,30,1.399533,103.818799
787390,10,0,10,1.39956,103.818904
787392,36,0,36,1.399549,103.818839
787393,3,0,3,1.399388,103.819433
787396,9,0,9,1.399515,103.818712
787397,0,11,11,1.399447,103.818477
787398,0,1,1,1.399525,103.819214
787399,4,0,4,1.399565,103.819036
787400,129,3,132,1.399464,103.818521
787401,2,1,3,1.399484,103.818615
787405,1,0,1,1.399498,103.818648
787406,4,0,4,1.399481,103.818584
787408,2,0,2,1.399565,103.81899
787409,0,2,2,1.399216,103.818515
787410,21,5,26,1.398984,103.818573
787416,1,1,2,1.3991,103.818544
787431,76,1046,1122,1.397498,103.818941
787432,1,145,146,1.397544,103.818962
787433,4,172,176,1.397637,103.819003
787434,11,47,58,1.39773,103.819045
787435,3,6,9,1.397498,103.818961
787436,21,16,37,1.397823,103.819086
787437,4,4,8,1.397544,103.818982
787438,4,23,27,1.397417,103.818749
787439,2,0,2,1.398755,103.818851
787440,0,1,1,1.399447,103.818457
787441,0,1,1,1.39773,103.819065
787442,6,0,6,1.397906,103.819138
787444,121,0,121,1.398033,103.819222
787445,14,2,16,1.39815,103.819297
787446,1,0,1,1.397823,103.819106
787447,1,0,1,1.398268,103.819371
787468,11,623,634,1.382555,103.826472
787469,2,2,4,1.399389,103.818472
787470,5,0,5,1.382733,103.826373
787471,12,1867,1879,1.382811,103.826328
787472,711,1040,1751,1.384019,103.826043
787473,7,755,762,1.382952,103.826284
787474,20,0,20,1.383021,103.826249
787475,16,891,907,1.383134,103.826218
787476,43,1797,1840,1.383186,103.826196
787477,13,127,140,1.38349,103.826817
787478,19,20,39,1.383342,103.826899
787479,274,180,454,1.384431,103.828099
787480,7,3,10,1.383209,103.826926
787482,35,0,35,1.3831,103.827022
787484,87,9,96,1.382889,103.827119
787485,0,86,86,1.382803,103.827159
787486,21,57,78,1.382935,103.827515
787488,3,31,34,1.383043,103.827257
787491,2,5,7,1.383335,103.827069
787492,3,7,10,1.383439,103.826986
787493,10,17,27,1.383632,103.827216
787494,561,116,677,1.383466,103.828428
787495,1,27,28,1.384481,103.828471
787496,15,21,36,1.388087,103.827724
787497,2,9,11,1.384418,103.828539
787498,5,14,19,1.384361,103.828608
787499,10,4,14,1.384304,103.82867
787500,6,74,80,1.384252,103.828727
787501,465,4,469,1.384195,103.82879
787502,292,47,339,1.386821,103.829284
787503,9,67,76,1.386821,103.829284
787504,0,17,17,1.386821,103.829284
787508,3,0,3,1.399457,103.818467
787509,1,0,1,1.398375,103.819435
787511,0,152,152,1.386821,103.829284
787512,0,2,2,1.397637,103.819023
787515,20,0,20,1.386821,103.829284
787524,351,14,365,1.384132,103.828853
787525,16,0,16,1.387413,103.82994
787526,25,59,84,1.384069,103.828915
787527,185,46,231,1.387503,103.829996
787528,3,20,23,1.384098,103.829058
787529,7,0,7,1.387645,103.830097
787531,9,11,20,1.387674,103.830054
787532,0,7,7,1.384222,103.828916
787533,0,11,11,1.38783,103.830215
787534,3,3,6,1.384286,103.828864
787535,2,2,4,1.382653,103.826403
787536,10,0,10,1.384394,103.828731
787537,19,40,59,1.388205,103.8303
787538,0,18,18,1.384447,103.828671
787540,13,44,57,1.384546,103.828508
787541,6,28,34,1.385183,103.828812
787542,0,3,3,1.386821,103.829284
787543,0,8,8,1.385034,103.828989
787544,0,2,2,1.386821,103.829284
787545,4,0,4,1.388015,103.83029
787546,1,1,2,1.384965,103.829074
787547,40,1,41,1.384759,103.829307
787548,5,18,23,1.38469,103.829381
787549,2,19,21,1.384745,103.829536
787550,1,3,4,1.384897,103.829154
787551,1,0,1,1.386821,103.829284
787552,0,4,4,1.38482,103.829451
787553,29,11,40,1.385043,103.829206
787554,2,3,5,1.385112,103.829121
787555,17,16,33,1.385192,103.829035
787556,1,45,46,1.385266,103.828944
787557,351,23,374,1.38584,103.829296
787559,0,28,28,1.385674,103.829484
787560,3,0,3,1.385108,103.828903
787562,1,0,1,1.384894,103.829366
787563,8,26,34,1.385423,103.829769
787564,0,38,38,1.385516,103.829878
787565,8,50,58,1.385567,103.829798
787566,1,0,1,1.385468,103.829717
787568,0,13,13,1.385767,103.829571
787569,29,1,30,1.385841,103.829486
787570,2,2,4,1.384969,103.829286
787571,104,27,131,1.38599,103.829315
787572,70,126,196,1.386142,103.830091
787573,0,21,21,1.386245,103.830148
787574,179,12,191,1.386343,103.830199
787575,6,3,9,1.38644,103.830251
787576,3,0,3,1.3856,103.829575
787577,1,0,1,1.385651,103.829713
787578,1,1,2,1.384828,103.829228
787579,2,11,13,1.386847,103.830472
787580,107,3,110,1.386944,103.830529
787581,4,5,9,1.387014,103.830475
787582,9,2,11,1.387014,103.830475
787583,15,3,18,1.386942,103.830452
787584,0,2,2,1.386744,103.830421
787585,10,1,11,1.386745,103.83033
787586,0,2,2,1.386854,103.830392
787587,33,2,35,1.386527,103.830188
787588,0,1,1,1.386641,103.830364
787589,0,1,1,1.386338,103.830074
787590,16,25,41,1.386143,103.829966
787591,4,32,36,1.386628,103.829546
787592,1,0,1,1.386241,103.830023
787593,23,3,26,1.38684,103.829689
787594,4,8,12,1.386934,103.82975
787595,1,1,2,1.386642,103.830256
787596,0,2,2,1.387052,103.829842
787597,1,2,3,1.386543,103.830313
787598,5,4,9,1.387345,103.829996
787600,385,5,390,1.387014,103.830475
787601,446,32,478,1.384996,103.828313
787602,1320,11,1331,1.385946,103.828933
787603,112,37,149,1.387953,103.830871
787621,1162,267,1429,1.389189,103.827952
787622,8,78,86,1.385933,103.827109
787623,734,600,1334,1.386085,103.826824
787624,1623,169,1792,1.387508,103.827352
787625,666,104,770,1.387844,103.827467
787643,3,3,6,1.381935,103.830212
787644,3,1,4,1.385945,103.829371
787645,2,1,3,1.387252,103.829935
787648,1,1,2,1.387156,103.829894
787649,1,0,1,1.386725,103.829611
787650,8,1,9,1.381545,103.830247
787651,0,1,1,1.381636,103.830241
787653,4,0,4,1.381879,103.830223
787654,18,1,19,1.381317,103.830241
787655,12,0,12,1.381268,103.830242
787656,1,0,1,1.381478,103.830259
787657,2,6,8,1.381155,103.830241
787658,1,3,4,1.381363,103.830237
787659,6,0,6,1.380872,103.830307
787661,35,0,35,1.380717,103.830395
787662,13,1,14,1.380639,103.830438
787663,1,0,1,1.381214,103.830243
787664,2,0,2,1.38137,103.830162
787665,24,1,25,1.380443,103.830562
787666,0,1,1,1.380562,103.830482
787667,1,0,1,1.380338,103.830633
787668,3,0,3,1.381821,103.830221
787669,2,13,15,1.380138,103.830748
787670,1,6,7,1.380033,103.830669
787671,4,0,4,1.38091,103.830285
787672,1,0,1,1.380291,103.830657
787673,4,5,9,1.379951,103.830555
787675,10,7,17,1.379877,103.830417
787676,8,0,8,1.379845,103.830369
787677,2,0,2,1.380484,103.830526
787678,0,2,2,1.379819,103.830315
787679,23,17,40,1.379726,103.830171
787680,9,10,19,1.379694,103.830131
787681,3,4,7,1.37967,103.830108
787682,0,7,7,1.379652,103.830048
787683,2,6,8,1.37962,103.830003
787684,13,0,13,1.379565,103.82992
787685,1,12,13,1.37956,103.829893
787686,0,4,4,1.38001,103.830642
787687,1,35,36,1.379489,103.829796
787688,22,7,29,1.37944,103.829681
787689,1,48,49,1.379368,103.829631
787690,1,2,3,1.380168,103.830737
787691,0,105,105,1.37991,103.830829
787693,1,0,1,1.379996,103.830569
787694,3,0,3,1.379347,103.829607
787698,1,299,300,1.379219,103.829368
787700,2,0,2,1.37975,103.830253
787702,5,0,5,1.379151,103.829301
787704,8,397,405,1.379119,103.829222
787706,3,7,10,1.379613,103.829035
787708,0,10,10,1.379656,103.829015
787709,0,2,2,1.379184,103.829327
787710,11,0,11,1.379734,103.828963
787711,0,27,27,1.379302,103.828755
787712,2,1,3,1.379281,103.829499
787713,2,0,2,1.379281,103.828766
787716,63,26,89,1.379873,103.828897
787718,151,2,153,1.379961,103.828872
787720,34,0,34,1.38001,103.828842
787722,4,4,8,1.38006,103.828783
787724,0,5,5,1.380146,103.828753
787728,2,0,2,1.379323,103.828744
787729,0,2,2,1.380262,103.828687
787730,31,1,32,1.380298,103.828691
787731,9,0,9,1.379511,103.828643
787732,0,8,8,1.380369,103.828629
787734,2,0,2,1.37949,103.828654
787736,5,14,19,1.380451,103.828595
787738,5,0,5,1.380541,103.828561
787739,0,5,5,1.379595,103.828598
787740,5,3,8,1.380591,103.828509
787741,0,24,24,1.379616,103.828587
787742,3,0,3,1.379794,103.828961
787743,1,247,248,1.379637,103.828576
787744,0,2,2,1.380421,103.828631
787745,4,0,4,1.379497,103.829816
787746,1,2,3,1.380687,103.828519
787748,4,1,5,1.380835,103.828417
787750,0,9,9,1.38086,103.828378
787752,24,12,36,1.381544,103.828368
787753,0,7,7,1.379778,103.828499
787754,1,738,739,1.379813,103.82848
787756,2,0,2,1.380729,103.828445
787759,0,48,48,1.37999,103.828385
787760,0,71,71,1.380025,103.828366
787761,0,12,12,1.38006,103.828346
787766,0,8,8,1.380207,103.828266
787771,2,0,2,1.379884,103.828442
787776,0,114,114,1.380622,103.828037
787786,0,52,52,1.380956,103.827852
787787,1,0,1,1.379123,103.82885
787796,11,83,94,1.381214,103.82771
787797,4,105,109,1.383171,103.828055
787798,3,11,14,1.383286,103.828009
787799,42,4,46,1.383387,103.827963
787800,2,0,2,1.380415,103.828151
787801,11,51,62,1.383566,103.827867
787802,1,0,1,1.380976,103.827841
787803,3,0,3,1.380782,103.828415
787804,97,72,169,1.383893,103.82773
787805,551,40,591,1.384602,103.827387
787806,7,96,103,1.385432,103.827291
787807,47,6,53,1.385659,103.827424
787808,88,27,115,1.385904,103.827539
787809,3,6,9,1.385951,103.827626
787810,3,13,16,1.386051,103.827716
787811,23,10,33,1.386128,103.827788
787812,53,10,63,1.386241,103.827833
787813,8,3,11,1.386321,103.827914
787814,42,0,42,1.386453,103.827971
787815,1,3,4,1.379655,103.828566
787816,11,0,11,1.386674,103.828087
787817,0,24,24,1.386782,103.828074
787818,0,1,1,1.383669,103.827821
787819,132,3,135,1.386889,103.828232
787820,155,1,156,1.386435,103.827624
787821,5,23,28,1.387051,103.828216
787822,7,0,7,1.387091,103.827799
787823,24,54,78,1.38711,103.828316
787824,115,21,136,1.387369,103.827932
787825,3,16,19,1.387853,103.828606
787826,4,9,13,1.388015,103.8286
787827,27,1,28,1.388036,103.828796
787828,66,16,82,1.388175,103.8287
787829,3,0,3,1.383772,103.827781
787830,92,7,99,1.388414,103.828931
787831,198,8,206,1.388532,103.829104
787832,6,0,6,1.3887,103.829092
787833,175,3,178,1.388619,103.82919
787834,26,29,55,1.388841,103.829176
787835,5,0,5,1.388805,103.829285
787836,20,0,20,1.388689,103.82928
787837,2,0,2,1.383463,103.827913
787838,0,1,1,1.386862,103.828119
787839,1,1,2,1.381336,103.830159
787840,5,0,5,1.381124,103.830177
787841,0,2,2,1.381204,103.830179
787842,1,6,7,1.381029,103.830213
787843,1,4,5,1.299509,103.837
787844,2,5,7,1.299509,103.837
787845,73,4,77,1.299509,103.837
787847,1,4,5,1.299509,103.837
787848,0,2,2,1.381089,103.83018
787849,0,2,2,1.299509,103.837
787850,0,2,2,1.299509,103.837
787851,13,9,22,1.299509,103.837
787852,1,25,26,1.299509,103.837
787853,0,19,19,1.435059,103.803222
787854,12,0,12,1.299509,103.837
787855,30,1,31,1.299509,103.837
787856,55,19,74,1.299509,103.837
787857,62,2222,2284,1.39633,103.819132
787858,3,22,25,1.396343,103.81918
787859,7,459,466,1.396316,103.819177
787860,2,3,5,1.39637,103.819276
787861,2,408,410,1.396345,103.819279
787862,1,21,22,1.396396,103.819373
787863,33,25,58,1.396374,103.819373
787864,0,4,4,1.386626,103.827983
787865,5,7,12,1.39641,103.819506
787866,47,0,47,1.396418,103.819544
787867,73,15,88,1.39643,103.819506
787869,0,1,1,1.381278,103.83017
787870,2,9,11,1.396451,103.819693
787871,2,9,11,1.396454,103.819618
787872,21,0,21,1.396467,103.819767
787873,13,0,13,1.396471,103.819693
787874,9,64,73,1.396483,103.819842
787875,1,5,6,1.396487,103.819767
787876,1,0,1,1.396438,103.819544
787877,3,1,4,1.396412,103.819459
787878,3,0,3,1.388341,103.828999
787879,0,2,2,1.396519,103.819917
787881,1,1,2,1.396519,103.819917
787882,3,5,8,1.396548,103.82014
787883,1,2,3,1.396515,103.819991
787884,9,6,15,1.396564,103.820215
787885,1,1,2,1.396535,103.819991
787907,1,6,7,1.397411,103.819942
787908,2,9,11,1.39739,103.819938
787909,27,1,28,1.397422,103.819994
787910,3,5,8,1.397401,103.819986
787911,11,1,12,1.397445,103.820098
787912,4,2,6,1.397421,103.820083
787913,7,1,8,1.397467,103.820202
787914,20,34,54,1.397442,103.820179
787915,14,4,18,1.397489,103.820305
787916,91,0,91,1.397463,103.820276
787918,19,3,22,1.397484,103.820372
787919,8,0,8,1.397504,103.820469
787920,0,3,3,1.396552,103.820066
787921,3,1,4,1.396503,103.819842
787922,2,0,2,1.396568,103.82014
787923,21,3,24,1.397546,103.820661
787924,0,1,1,1.396499,103.819917
787925,40,3,43,1.397566,103.820758
787926,1,1,2,1.397578,103.820721
787927,19,1,20,1.397587,103.820854
787928,6,0,6,1.397645,103.821032
787929,39,2,41,1.397608,103.820951
787930,6,3,9,1.397668,103.821136
787931,2,0,2,1.397623,103.820928
787932,26,1,27,1.39769,103.82124
787933,33,0,33,1.397649,103.821144
787934,45,0,45,1.39767,103.82124
787955,18,24,42,1.396977,103.819431
787956,8,0,8,1.396987,103.819485
787957,3,0,3,1.397556,103.820617
787958,10,3,13,1.397011,103.819638
787959,89,0,89,1.397033,103.819729
787960,8,4,12,1.397047,103.819795
787962,7,7,14,1.397444,103.821902
787965,0,7,7,1.299509,103.837
787981,10,2,12,1.399066,103.82531
787982,25,10,35,1.399085,103.825304
787983,5,0,5,1.39906,103.825256
787984,4,3,7,1.399078,103.825243
787985,106,2,108,1.399046,103.825146
787986,1,0,1,1.397601,103.820825
787987,2,3,5,1.399033,103.825037
787988,2,0,2,1.397629,103.821047
787989,47,2,49,1.399019,103.824928
787990,1,6,7,1.399033,103.824876
787992,119,5,124,1.399018,103.824754
787994,25,0,25,1.399003,103.824632
787995,28,0,28,1.398979,103.8246
787997,3,0,3,1.397007,103.819593
787998,2,3,5,1.398973,103.824388
787999,13,0,13,1.398952,103.824381
788000,14,4,18,1.398957,103.824265
788001,0,1,1,1.399063,103.825121
788002,9,1,10,1.398942,103.824143
788003,7,0,7,1.398925,103.824163
788004,0,1,1,1.398938,103.824272
788005,135,1,136,1.398911,103.824053
788006,1,0,1,1.398927,103.824021
788007,4,2,6,1.398898,103.823944
788008,4,0,4,1.397525,103.820565
788009,5,0,5,1.398884,103.823835
788011,5,3,8,1.398871,103.823725
788012,2,2,4,1.398897,103.823777
788014,75,2,77,1.398852,103.82341
788015,6,0,6,1.398844,103.823507
788016,6,4,10,1.398837,103.823288
788017,2,1,3,1.398965,103.82449
788018,15,1,16,1.398829,103.823213
788019,41,3,44,1.398817,103.823288
788020,1,0,1,1.398912,103.823899
788021,2,1,3,1.39883,103.823397
788022,15,3,18,1.398806,103.822987
788024,1,1,2,1.399048,103.824998
788025,2,0,2,1.39879,103.822836
788026,9,3,12,1.39877,103.822836
788047,8,1,9,1.396633,103.820497
788048,3,4,7,1.396613,103.820497
788049,9,1,10,1.396648,103.820573
788050,11,2,13,1.396628,103.820573
788051,27,1,28,1.396676,103.820725
788052,151,0,151,1.396656,103.820725
788053,3,5,8,1.396705,103.820877
788054,1,0,1,1.398821,103.823137
788055,14,4,18,1.396734,103.821029
788056,1,0,1,1.396685,103.820877
788057,1,4,5,1.39674,103.821062
788058,11,2,13,1.396721,103.821066
788059,9,22,31,1.396728,103.821103
788060,0,27,27,1.396759,103.821161
788061,0,12,12,1.396742,103.821178
788062,28,0,28,1.396771,103.821228
788063,24,66,90,1.396756,103.821252
788064,5,2,7,1.396783,103.821294
788066,0,1,1,1.396714,103.821029
788067,1,0,1,1.396796,103.82136
788068,0,3,3,1.398809,103.823213
788070,19,0,19,1.39682,103.821493
788071,6,0,6,1.396811,103.82155
788073,9,0,9,1.396825,103.821625
788095,23,5,28,1.398447,103.825558
788097,0,1,1,1.396783,103.821402
788098,19,2,21,1.39846,103.825495
788099,0,3,3,1.396808,103.821426
788100,19,5,24,1.398445,103.825374
788101,0,2,2,1.398786,103.822987
788102,36,16,52,1.398431,103.825254
788103,1,4,5,1.398399,103.825158
788104,9,0,9,1.398417,103.825134
788105,23,3,26,1.398386,103.825044
788106,7,0,7,1.398402,103.825014
788107,25,0,25,1.398372,103.82493
788108,16,0,16,1.398388,103.824893
788109,6,0,6,1.398358,103.824815
788110,4,0,4,1.398867,103.823532
788111,6,0,6,1.398345,103.824701
788112,19,0,19,1.398359,103.824653
788115,3,2,5,1.398317,103.824472
788116,8,2,10,1.39833,103.824412
788117,13,1,14,1.398304,103.824358
788118,2,1,3,1.398427,103.825386
788119,84,0,84,1.39829,103.824244
788120,5,4,9,1.398302,103.824172
788121,1,0,1,1.39844,103.825501
788122,1,1,2,1.398413,103.825272
788123,33,2,35,1.398263,103.824016
788124,12,1,13,1.398273,103.823931
788125,2,1,3,1.398316,103.824292
788126,10,0,10,1.398258,103.823811
788127,15,0,15,1.398236,103.823787
788128,2,2,4,1.398373,103.824773
788130,4,0,4,1.398244,103.823691
788131,7,4,11,1.398208,103.823558
788132,3,1,4,1.39823,103.823571
788134,10,5,15,1.398201,103.82333
788135,2,0,2,1.398287,103.824052
788136,20,0,20,1.398196,103.823279
788138,10,0,10,1.398191,103.823229
788139,8,3,11,1.398171,103.823229
788140,0,3,3,1.398249,103.823901
788141,3,3,6,1.398161,103.823127
788142,6,4,10,1.398171,103.823026
788143,12,9,21,1.398151,103.823026
788144,7,2,9,1.398466,103.825554
788145,30,0,30,1.398466,103.825554
788164,7,1,8,1.399081,103.820971
788166,1,0,1,1.398277,103.82413
788167,20,2,22,1.399023,103.821251
788169,0,1,1,1.399008,103.821054
788170,3,1,4,1.398215,103.82345
788171,33,0,33,1.399113,103.821624
788172,9,0,9,1.399035,103.821384
788173,3,2,5,1.399136,103.821717
788174,11,0,11,1.399068,103.821517
788176,13,4,17,1.399139,103.821734
788177,30,1,31,1.399116,103.821717
788178,17,0,17,1.399142,103.82175
788179,10,1,11,1.398506,103.82177
788180,5,8,13,1.399147,103.821783
788181,6,7,13,1.398503,103.821748
788183,6,0,6,1.398496,103.821706
788184,0,1,1,1.399068,103.821437
788185,12,7,19,1.399165,103.821883
788186,1,0,1,1.39849,103.821663
788187,110,0,110,1.39917,103.821916
788188,5,0,5,1.398477,103.821578
788189,90,2,92,1.399176,103.821949
788190,31,1,32,1.39847,103.821536
788191,3,0,3,1.398181,103.823127
788192,1,0,1,1.398483,103.821621
788193,36,0,36,1.399187,103.822016
788195,61,9,70,1.399193,103.822049
788196,1,1,2,1.398181,103.82333
788197,78,2,80,1.398526,103.821871
788198,5,1,6,1.397852,103.82181
788199,11,20,31,1.398543,103.821951
788200,1,1,2,1.398451,103.821408
788201,5,0,5,1.398576,103.822111
788202,25,1,26,1.397842,103.821748
788203,2,1,3,1.399182,103.821983
788204,21,11,32,1.397835,103.821707
788205,16,4,20,1.398643,103.822432
788206,9,0,9,1.397828,103.821666
788207,4,13,17,1.398677,103.822592
788208,29,3,32,1.397821,103.821625
788209,40,13,53,1.397814,103.821584
788210,10,1,11,1.397807,103.821543
788211,5,0,5,1.3978,103.821502
788212,3,8,11,1.397793,103.821461
788213,1,0,1,1.398464,103.821493
788214,8,0,8,1.396615,103.822123
788215,0,28,28,1.396643,103.822203
788216,1,0,1,1.397454,103.821892
788217,17,0,17,1.397048,103.821997
788218,0,4,4,1.399003,103.821251
788219,7,0,7,1.396952,103.822166
788220,14,1,15,1.39735,103.821939
788221,11,18,29,1.396973,103.822285
788222,6,0,6,1.397245,103.821966
788223,1,0,1,1.397164,103.821967
788224,21,6,27,1.397036,103.82202
788225,5,64,69,1.397006,103.822484
788226,11,0,11,1.396932,103.822027
788227,3,0,3,1.39861,103.822272
788228,9,4,13,1.397026,103.822484
788249,141,8,149,1.399422,103.82251
788250,20,8,28,1.399408,103.822563
788251,20,0,20,1.399431,103.822589
788252,1,0,1,1.396987,103.822355
788253,5,0,5,1.399447,103.822748
788254,47,2,49,1.399449,103.822959
788255,15,3,18,1.399464,103.822906
788256,33,2,35,1.399477,103.823223
788257,9,0,9,1.39948,103.823065
788259,1,1,2,1.397849,103.821789
788260,1,1,2,1.399497,103.823223
788261,2,1,3,1.396973,103.822265
788262,0,2,2,1.399488,103.823335
788263,3,0,3,1.399503,103.823279
788264,14,0,14,1.399511,103.823559
788265,11,0,11,1.399519,103.823447
788266,1,1,2,1.399499,103.823447
788267,6,1,7,1.399531,103.823559
788268,1,2,3,1.399508,103.823335
788269,38,4,42,1.399542,103.823671
788270,80,1,81,1.399544,103.823895
788271,4,2,6,1.399553,103.823783
788272,6,1,7,1.399556,103.824007
788273,9,3,12,1.399564,103.823895
788275,227,6,233,1.399576,103.824007
788276,8,1,9,1.399578,103.824231
788277,4,0,4,1.396932,103.822047
788278,23,0,23,1.399589,103.824343
788279,1,0,1,1.399422,103.822695
788280,1,2,3,1.399533,103.823783
788281,4,3,7,1.399609,103.824343
788282,1,0,1,1.399598,103.824231
788283,7,1,8,1.399621,103.824455
788284,3,0,3,1.399601,103.824455
788285,2,1,3,1.399623,103.824679
788286,54,33,87,1.399634,103.824791
788287,13,1,14,1.399643,103.824679
788288,7,14,21,1.399646,103.824903
788289,1,0,1,1.399612,103.824567
788290,9,0,9,1.399657,103.825015
788292,70,3,73,1.399668,103.825127
788293,5,1,6,1.399677,103.825015
788294,3,1,4,1.399587,103.824119
788316,15,219,234,1.398305,103.825685
788318,18,18,36,1.398464,103.825625
788320,5,0,5,1.398526,103.8256
788322,5,4,9,1.398588,103.825575
788324,2,0,2,1.399522,103.823671
788326,10,1,11,1.398835,103.825475
788328,17,0,17,1.398959,103.825425
788332,2,0,2,1.398712,103.825525
788336,8,66,74,1.399321,103.82528
788338,9,2,11,1.39944,103.825232
788342,9,0,9,1.399678,103.825137
788346,13,0,13,1.399742,103.825109
788348,17,1,18,1.399806,103.825081
788350,61,0,61,1.39987,103.825053
788354,21,0,21,1.399998,103.824996
788355,2,3,5,1.400076,103.824875
788356,27,0,27,1.400075,103.824781
788357,12,0,12,1.400085,103.824659
788358,2,1,3,1.399632,103.824567
788359,2,0,2,1.399142,103.825351
788360,1,6,7,1.400028,103.824412
788361,2,11,13,1.40001,103.824283
788362,18,1,19,1.400003,103.824223
788363,0,1,1,1.399654,103.824791
788364,5,6,11,1.40019,103.824028
788365,3,0,3,1.400074,103.824579
788366,21,0,21,1.40012,103.82389
788367,12,0,12,1.400066,103.823814
788368,1,0,1,1.400062,103.824968
788369,3,0,3,1.400135,103.823979
788370,3,0,3,1.39996,103.824027
788371,7,0,7,1.399962,103.823918
788372,5,0,5,1.399953,103.823846
788373,41,0,41,1.399933,103.823796
788374,2,0,2,1.400035,103.824459
788376,26,0,26,1.399924,103.823585
788378,13,0,13,1.40019,103.824912
788379,1,49,50,1.400254,103.824884
788380,43,171,214,1.400282,103.82485
788381,2,0,2,1.399945,103.823686
788382,1,0,1,1.399992,103.824078
788418,8,0,8,1.3975,103.819877
788419,20,0,20,1.397498,103.819876
788420,4,0,4,1.399688,103.825127
788421,144,1,145,1.397498,103.819876
788422,21,5,26,1.397609,103.819875
788423,5,4,9,1.397981,103.820131
788424,0,3,3,1.39997,103.823976
788425,5,0,5,1.39832,103.820364
788426,14,0,14,1.397973,103.820082
788427,2,0,2,1.400311,103.824815
788428,4,1,5,1.398154,103.820208
788429,3,0,3,1.397793,103.819955
788430,11,1,12,1.398334,103.820335
788431,10,0,10,1.398257,103.820512
788432,30,0,30,1.398245,103.820575
788433,4,0,4,1.397498,103.819876
788435,0,1,1,1.400328,103.82475
788436,7,0,7,1.398256,103.82069
788437,13,4,17,1.398531,103.820474
788438,4,0,4,1.398383,103.82037
788439,20,3,23,1.398629,103.820544
788440,18,0,18,1.39827,103.820816
788441,5,2,7,1.398728,103.820614
788442,2,3,5,1.398277,103.820879
788443,9,0,9,1.398826,103.820684
788444,13,5,18,1.398284,103.820942
788445,6,1,7,1.398924,103.820754
788447,45,0,45,1.399023,103.820823
788448,1,1,2,1.398306,103.820393
788449,41,2,43,1.399121,103.820893
788450,0,6,6,1.398306,103.821132
788451,8,2,10,1.399174,103.82093
788452,26,3,29,1.398303,103.821185
788453,15,1,16,1.399227,103.820967
788455,10,1,11,1.39944,103.821115
788456,45,0,45,1.399546,103.821189
788457,1,0,1,1.398432,103.820405
788458,2,1,3,1.398277,103.820452
788459,1,0,1,1.399652,103.821264
788461,2,0,2,1.398299,103.821069
788462,1,0,1,1.399864,103.821412
788464,12,1,13,1.399626,103.821265
788465,4,0,4,1.398263,103.820753
788469,2,10,12,1.400335,103.8218
788470,1,4,5,1.400486,103.821961
788471,7,5,12,1.400608,103.82214
788472,2,8,10,1.400658,103.822384
788473,5,5,10,1.400709,103.822628
788475,6,0,6,1.400064,103.822673
788476,1,1,2,1.399971,103.821486
788477,13,5,18,1.400009,103.822425
788478,33,22,55,1.400078,103.822824
788479,2,6,8,1.400085,103.822851
788480,28,7,35,1.400097,103.822905
788481,5,3,8,1.40011,103.822959
788482,156,0,156,1.400123,103.823013
788483,20,2,22,1.400136,103.823067
788484,6,2,8,1.400148,103.823121
788485,7,0,7,1.400161,103.823175
788486,34,14,48,1.40071,103.822631
788487,14,37,51,1.400711,103.822634
788488,1,5,6,1.3984,103.820402
788489,5,0,5,1.398465,103.820448
788490,2,0,2,1.400037,103.822549
788491,16,10,26,1.398728,103.820634
788492,1,0,1,1.399373,103.821089
788493,6,7,13,1.399372,103.821088
788494,173,3,176,1.400712,103.82264
788495,11,0,11,1.397608,103.819874
788496,50,1,51,1.400416,103.823863
788497,59,37,96,1.400715,103.822651
788498,3,0,3,1.399758,103.821338
788499,0,1,1,1.399372,103.821088
788500,11,0,11,1.400436,103.823327
788502,4,0,4,1.400193,103.821656
788503,6,0,6,1.400269,103.82341
788504,5,0,5,1.400231,103.823437
788505,7,0,7,1.400178,103.823483
788507,41,0,41,1.400049,103.823576
788508,188,48,236,1.396907,103.835203
788529,1,3,4,1.400352,103.823404
788530,1,0,1,1.400525,103.823298
788531,42,0,42,1.380493,103.830144
788532,0,3,3,1.400553,103.823279
788533,35,0,35,1.380656,103.83011
788534,1,0,1,1.380574,103.830112
788535,1,1,2,1.398596,103.820541
788536,42,0,42,1.380558,103.829939
788537,5,0,5,1.38053,103.829882
788538,1,1,2,1.380728,103.829941
788539,4,1,5,1.380467,103.829768
788540,2,3,5,1.380915,103.830078
788541,29,4,33,1.380896,103.83004
788542,1,0,1,1.380627,103.830053
788543,7,7,14,1.380843,103.829867
788544,0,2,2,1.380495,103.829831
788545,0,1,1,1.380806,103.829825
788546,187,2,189,1.380789,103.829801
788561,34,0,34,1.400024,103.821997
788562,6,2,8,1.399874,103.822154
788563,3,8,11,1.4,103.821865
788581,10,4,14,1.382826,103.830891
788582,2,3,5,1.382902,103.830981
788583,2,1,3,1.380685,103.830172
788584,2,1,3,1.382948,103.830827
788585,35,1,36,1.382988,103.830807
788586,2,1,3,1.383005,103.830946
788587,3,1,4,1.380492,103.830118
788588,198,3,201,1.383097,103.830886
788590,1,1,2,1.380816,103.829836
788592,2,0,2,1.383143,103.830855
788593,3,0,3,1.383056,103.830909
788594,7,0,7,1.383461,103.830682
788595,6,1,7,1.383352,103.830578
788596,1,0,1,1.380827,103.829851
788598,24,1,25,1.383621,103.830566
788602,12,0,12,1.383786,103.830579
788603,1,2,3,1.38334,103.830629
788604,46,6,52,1.383943,103.83041
788605,4,1,5,1.383841,103.83033
788606,9,2,11,1.384003,103.830441
788627,39,60,99,1.380438,103.83113
788628,3,0,3,1.383762,103.830335
788629,10,11,21,1.380601,103.831042
788631,5,3,8,1.380655,103.830991
788632,5,2,7,1.380721,103.830947
788633,3,0,3,1.38047,103.831088
788634,2,0,2,1.383277,103.830777
788635,0,9,9,1.380883,103.830892
788637,102,2,104,1.381013,103.83082
788639,3,2,5,1.381052,103.830811
788640,0,2,2,1.380849,103.830903
788641,3,16,19,1.381322,103.830734
788642,13,0,13,1.381367,103.830727
788643,4,0,4,1.383032,103.830709
788644,12,0,12,1.381501,103.830723
788645,3,8,11,1.381554,103.830722
788646,0,4,4,1.381425,103.830728
788647,3,2,5,1.381638,103.830725
788648,7,2,9,1.381715,103.830714
788649,16,0,16,1.381849,103.830693
788650,4,1,5,1.381891,103.830702
788651,57,0,57,1.381933,103.830701
788652,2,2,4,1.381664,103.830723
788653,2,12,14,1.382145,103.830686
788704,0,10,10,1.380031,103.829668
788705,71,1,72,1.380073,103.82967
788706,20,0,20,1.380119,103.829641
788707,4,0,4,1.381963,103.830679
788710,1,0,1,1.383545,103.830645
788711,3,0,3,1.380777,103.830934
788712,2,4,6,1.380707,103.829692
788713,2,0,2,1.38131,103.830745
788714,131,1,132,1.380777,103.829657
788715,0,1,1,1.380346,103.829513
788716,7,2,9,1.380805,103.829534
788717,38,0,38,1.380635,103.829453
788718,1,0,1,1.380581,103.829483
788719,2,0,2,1.380543,103.829499
788720,8,5,13,1.380894,103.829514
788721,2,2,4,1.380205,103.829584
788722,2,2,4,1.380744,103.829382
788723,47,0,47,1.380788,103.829361
788724,1,0,1,1.380859,103.829527
788725,0,2,2,1.380689,103.829436
788726,1,0,1,1.380957,103.829378
788727,81,1,82,1.380931,103.829288
788728,2,1,3,1.380465,103.829547
788729,129,0,129,1.380948,103.829209
788730,1,0,1,1.38109,103.829394
788731,0,1,1,1.381197,103.829354
788732,3,2,5,1.381263,103.829335
788733,9,0,9,1.381093,103.829131
788734,5,1,6,1.381445,103.82937
788735,13,0,13,1.381142,103.829094
788736,4,9,13,1.381412,103.829344
788737,1,1,2,1.380833,103.829326
788738,252,7,259,1.381248,103.82908
788759,6,2,8,1.389876,103.835748
788760,1,0,1,1.381041,103.829162
788761,1,0,1,1.389614,103.835856
788764,7,0,7,1.389159,103.836038
788765,39,0,39,1.389063,103.836074
788766,2,0,2,1.381204,103.829073
788768,0,1,1,1.389362,103.835954
788770,40,0,40,1.388668,103.83622
788771,10,0,10,1.388561,103.836256
788772,2,1,3,1.381158,103.829368
788773,1,1,2,1.388967,103.836111
788774,2,0,2,1.388348,103.836327
788775,5,0,5,1.388136,103.836398
788776,4,1,5,1.388029,103.836433
788777,2,0,2,1.388242,103.836362
788778,1,0,1,1.388784,103.836175
788779,3,2,5,1.38771,103.836539
788780,0,1,1,1.387816,103.836504
788782,1,2,3,1.388455,103.836291
788783,1,1,2,1.387923,103.836468
788785,6,0,6,1.387282,103.836697
788786,6,5,11,1.387221,103.836716
788807,14,5,19,1.388957,103.83847
788808,2,16,18,1.388385,103.838211
788809,3,0,3,1.387461,103.836624
788810,0,12,12,1.388416,103.838188
788811,4,1,5,1.38899,103.838488
788812,1,5,6,1.388477,103.838164
788813,1,0,1,1.387603,103.836575
788814,5,6,11,1.388558,103.838148
788815,0,5,5,1.389035,103.838513
788816,38,0,38,1.38859,103.838145
788817,1,0,1,1.389011,103.838501
788818,5,5,10,1.388631,103.838149
788819,0,2,2,1.387426,103.836639
788820,7,0,7,1.388656,103.838166
788821,1,7,8,1.388675,103.838185
788822,1,2,3,1.388976,103.838479
788823,2,0,2,1.389075,103.838535
788824,1,2,3,1.388732,103.838216
788825,2,6,8,1.388902,103.83833
788826,168,0,168,1.388951,103.838353
788827,7,0,7,1.388987,103.838387
788828,6,0,6,1.38901,103.838401
788829,1,0,1,1.389054,103.838524
788830,11,0,11,1.389081,103.838445
788831,2,2,4,1.38096,103.829467
788832,1,0,1,1.389034,103.838416
788833,1,1,2,1.388789,103.838254
788834,84,0,84,1.389269,103.83856
788855,89,5,94,1.387511,103.836531
788856,7,1,8,1.387525,103.836473
788857,3,5,8,1.387553,103.836356
788858,4,1,5,1.38758,103.836238
788859,1,0,1,1.389175,103.838502
788860,3,0,3,1.388845,103.838292
788861,8,2,10,1.387664,103.835887
788864,89,1,90,1.387747,103.835535
788865,5,0,5,1.387775,103.835418
788866,3,0,3,1.387636,103.836004
788868,7,2,9,1.387828,103.8352
788869,6,0,6,1.387853,103.835099
788870,6,0,6,1.387878,103.834998
788871,2,0,2,1.389222,103.838531
788873,1,0,1,1.387608,103.836121
788874,3,2,5,1.38793,103.834695
788875,10,0,10,1.38801,103.834473
788876,7,7,14,1.388057,103.83426
788897,2,19,21,1.387603,103.837457
788898,4,1,5,1.387589,103.837407
788900,14,1,15,1.387618,103.83737
788901,6,0,6,1.387668,103.837385
788903,3,5,8,1.387716,103.837347
788905,7,0,7,1.387752,103.83731
788906,10,0,10,1.387752,103.83729
788907,0,3,3,1.387793,103.835311
788909,9,1,10,1.387873,103.837245
788910,41,1,42,1.387916,103.83721
788911,1,1,2,1.387902,103.834898
788912,34,1,35,1.387997,103.837183
788913,8,2,10,1.38802,103.837195
788914,1,1,2,1.387947,103.83722
788916,1,0,1,1.387942,103.834706
788918,26,4,30,1.388238,103.8371
788919,4,0,4,1.389128,103.838473
788920,280,3,283,1.388318,103.837072
788921,7,0,7,1.388315,103.837093
788922,108,0,108,1.388399,103.837044
788923,5,5,10,1.388389,103.837068
788924,0,4,4,1.388241,103.837118
788925,1,0,1,1.388158,103.837127
788926,1,4,5,1.38856,103.836989
788929,0,3,3,1.387794,103.837284
788930,4,0,4,1.388479,103.837017
788931,3,4,7,1.388684,103.836966
788932,9,0,9,1.388801,103.836906
788933,1,6,7,1.388757,103.836941
788934,8,14,22,1.388881,103.836878
788935,5,0,5,1.388831,103.836916
788936,49,0,49,1.388962,103.836851
788937,0,1,1,1.388462,103.837042
788938,1,0,1,1.388905,103.83689
788939,16,0,16,1.388978,103.836865
788940,6,0,6,1.389122,103.836795
788943,1,2,3,1.38861,103.836992
788945,1,0,1,1.389042,103.836823
788947,9,11,20,1.389273,103.836763
788949,0,2,2,1.388077,103.837155
788950,14,1,15,1.389524,103.836657
788951,0,1,1,1.389199,103.836789
788952,54,6,60,1.389605,103.836629
788953,7,2,9,1.389494,103.836687
788954,2,0,2,1.389347,103.836738
788955,6,5,11,1.389568,103.836662
788956,1,2,3,1.389126,103.836814
788957,0,19,19,1.389642,103.836637
788958,16,7,23,1.389846,103.836546
788959,1,3,4,1.38872,103.836934
788960,2,1,3,1.389766,103.836574
788961,3,30,33,1.389789,103.836586
788963,4,17,21,1.389863,103.83656
788964,2,51,53,1.389982,103.836484
788965,21,13,34,1.389936,103.836535
788966,0,28,28,1.389978,103.836527
788967,20,264,284,1.390024,103.836508
788988,11,6,17,1.389334,103.835913
788989,1,8,9,1.389353,103.8359
788990,0,2,2,1.389685,103.836602
788992,32,0,32,1.38931,103.835789
788994,2,0,2,1.389326,103.835872
788995,3,0,3,1.389926,103.836519
788996,5,0,5,1.389277,103.835624
788997,1,0,1,1.389421,103.836713
788998,10,2,12,1.389256,103.835579
788999,362,1,363,1.389308,103.835586
789000,1,3,4,1.389715,103.836611
789001,1,2,3,1.389333,103.835725
789002,0,1,1,1.389321,103.835638
789003,0,6,6,1.389252,103.835491
789004,1,1,2,1.389293,103.835706
789005,1,0,1,1.389186,103.835447
789006,10,8,18,1.389073,103.835324
789007,14,0,14,1.389193,103.835394
789008,92,0,92,1.38901,103.835268
789010,1,16,17,1.388948,103.835213
789011,1,3,4,1.38921,103.83549
789012,9,2,11,1.388886,103.835158
789013,89,0,89,1.389235,103.835142
789014,1,1,2,1.389135,103.835379
789015,0,11,11,1.389187,103.835108
789016,0,4,4,1.389238,103.835158
789017,34,0,34,1.389132,103.835054
789018,0,2,2,1.388823,103.835102
789019,3,8,11,1.3891,103.835011
789020,15,2,17,1.388638,103.834963
789022,0,2,2,1.388721,103.835018
789023,0,2,2,1.388595,103.834938
789024,17,9,26,1.388515,103.83491
789025,2,0,2,1.389001,103.834933
789026,2,3,5,1.388434,103.834882
789027,20,0,20,1.388905,103.834882
789028,1,1,2,1.388985,103.834883
789029,31,0,31,1.388769,103.834786
789031,2,3,5,1.388714,103.834771
789032,92,5,97,1.388193,103.834799
789033,9,1,10,1.3887,103.834749
789034,31,3,34,1.388162,103.834797
789035,1,3,4,1.388761,103.835047
789036,3,3,6,1.388097,103.834785
789037,6,3,9,1.388568,103.834696
789038,8,1,9,1.388027,103.83477
789040,2,1,3,1.389282,103.835547
789041,2,1,3,1.38839,103.834663
789043,0,1,1,1.389228,103.835449
789044,1,1,2,1.388354,103.834855
789045,5,10,15,1.388148,103.834527
789066,8,19,27,1.385673,103.836238
789067,1,0,1,1.388262,103.834602
789069,1,0,1,1.385636,103.836219
789070,2,0,2,1.388181,103.834545
789071,1,0,1,1.385699,103.836257
789072,3,5,8,1.385868,103.83639
789074,47,5,52,1.386,103.836481
789075,66,0,66,1.38606,103.836529
789077,4,0,4,1.388634,103.834728
789078,9,7,16,1.386143,103.83621
789079,7,1,8,1.386255,103.836673
789080,6,0,6,1.386204,103.836227
789083,5,0,5,1.386392,103.836766
789084,0,20,20,1.386192,103.836383
789085,5,0,5,1.386447,103.836811
789086,26,0,26,1.38623,103.836405
789087,1,3,4,1.386182,103.836627
789088,2,0,2,1.385751,103.836304
789089,4,2,6,1.386302,103.836458
789090,3,0,3,1.388333,103.834652
789091,14,0,14,1.386489,103.836623
789092,0,13,13,1.386555,103.836657
789094,1157,250,1407,1.39082,103.837049
789095,1027,122,1149,1.39086,103.836531
789096,853,115,968,1.391002,103.836156
789097,990,172,1162,1.391327,103.835925
789098,1538,77,1615,1.391942,103.835699
789099,1841,812,2653,1.392371,103.835544
789100,59,232,291,1.391603,103.836722
789101,16,4,20,1.387186,103.837139
789102,34,0,34,1.387246,103.837189
789103,1,0,1,1.385813,103.836345
789104,18,9,27,1.387393,103.837302
789105,172,14,186,1.385649,103.836278
789121,64,10,74,1.388737,103.836125
789122,2,6,8,1.388787,103.836087
789124,1,1,2,1.386262,103.836428
789125,6,0,6,1.388682,103.835967
789126,0,2,2,1.388766,103.835994
789127,16,10,26,1.388656,103.835897
789128,0,1,1,1.387308,103.837247
789129,102,26,128,1.388611,103.835792
789131,121,0,121,1.388581,103.835725
789132,1,0,1,1.38873,103.835882
789133,1,2,3,1.38635,103.83652
789134,1,1,2,1.38876,103.83595
789136,145,1,146,1.388595,103.835667
789137,24,1,25,1.388336,103.835555
789138,0,3,3,1.388508,103.835657
789139,4,2,6,1.388229,103.835508
789140,53,0,53,1.388619,103.835504
789141,0,1,1,1.388707,103.835828
789142,5,0,5,1.388548,103.835439
789143,0,3,3,1.388636,103.835535
789145,17,0,17,1.38791,103.835368
789146,0,7,7,1.388355,103.835339
789147,8,9,17,1.387855,103.835351
789148,7,0,7,1.388327,103.835312
789149,10,2,12,1.388278,103.835324
789150,17,0,17,1.388221,103.835295
789151,2,2,4,1.386522,103.836861
789152,60,0,60,1.388117,103.835264
789153,1,2,3,1.388016,103.835415
789154,6,4,10,1.388012,103.835223
789175,2,2,4,1.388137,103.835286
789176,5,3,8,1.387165,103.837392
789177,0,1,1,1.388123,103.835461
789178,26,0,26,1.38713,103.837461
789179,2,0,2,1.388638,103.835713
789180,3,0,3,1.388036,103.835241
789181,0,1,1,1.387105,103.837672
789182,5,0,5,1.386942,103.837644
789183,9,1,10,1.387265,103.837818
789184,30,0,30,1.38688,103.837685
789186,2,0,2,1.387134,103.837711
789187,3,0,3,1.387003,103.837603
789190,0,1,1,1.387199,103.837764
789191,11,1,12,1.387527,103.838033
789192,5,1,6,1.386475,103.837967
789193,0,13,13,1.387592,103.838087
789194,6,0,6,1.386438,103.838002
789195,22,1,23,1.387563,103.838083
789196,0,1,1,1.386513,103.837933
789197,6,0,6,1.387533,103.838059
789199,1,7,8,1.387474,103.83801
789201,5,0,5,1.387415,103.837962
789202,5,0,5,1.386136,103.838278
789203,3,0,3,1.387396,103.837926
789204,0,1,1,1.386362,103.838071
789205,1,1,2,1.386758,103.837768
789206,3,0,3,1.387356,103.837913
789207,10,0,10,1.387239,103.837817
789209,5,0,5,1.387121,103.83772
789210,7,1,8,1.387082,103.837691
789211,1,0,1,1.38606,103.838347
789212,4,11,15,1.386615,103.838
789214,1,1,2,1.387297,103.837865
789215,1,0,1,1.387033,103.837662
789216,3,2,5,1.386784,103.838158
789217,1,0,1,1.386716,103.838102
789218,54,3,57,1.386919,103.83827
789220,2,1,3,1.386017,103.83838
789221,13,0,13,1.387122,103.838439
789222,13,14,27,1.387078,103.838423
789223,11,0,11,1.387035,103.838387
789224,17,3,20,1.386948,103.838314
789225,2,0,2,1.386693,103.83806
789226,0,4,4,1.387078,103.837642
789227,16,1,17,1.38673,103.83815
789228,4,1,5,1.386675,103.838101
789229,1,0,1,1.386851,103.838214
789230,1,10,11,1.386764,103.837815
789250,17,14,31,1.386674,103.83695
789251,117,1,118,1.386124,103.83739
789254,5,5,10,1.386583,103.837035
789255,134,4,138,1.386026,103.837326
789256,6,0,6,1.386522,103.837092
789257,2,0,2,1.386861,103.838242
789258,1,0,1,1.386622,103.838059
789260,7,0,7,1.3864,103.837205
789261,3,0,3,1.387054,103.838383
789262,2,0,2,1.385961,103.837282
789263,0,1,1,1.386461,103.837149
789264,17,0,17,1.386278,103.837319
789265,1,0,1,1.385767,103.837153
789266,1,0,1,1.385702,103.837109
789267,2,0,2,1.386339,103.837262
789268,18,0,18,1.386166,103.837422
789269,14,3,17,1.385582,103.837033
789270,2,2,4,1.386774,103.83817
789272,0,3,3,1.385832,103.837196
789273,1,0,1,1.386217,103.837375
789274,3,0,3,1.386088,103.837491
789276,0,1,1,1.385514,103.836972
789277,17,7,24,1.385398,103.83687
789278,13,0,13,1.385883,103.837668
789279,4,0,4,1.386122,103.837462
789281,3,9,12,1.385281,103.836767
789282,18,5,23,1.385747,103.837786
789283,4,0,4,1.385339,103.836818
789285,1,13,14,1.385175,103.836675
789287,6,7,13,1.385542,103.837069
789289,5,0,5,1.385512,103.837095
789290,6,0,6,1.385527,103.837986
789291,1,5,6,1.385452,103.837146
789293,0,3,3,1.38602,103.83755
789294,3,0,3,1.385333,103.837249
789295,45,0,45,1.385213,103.837352
789296,162,15,177,1.385163,103.837394
789297,32,2,34,1.386118,103.837445
789299,1,0,1,1.385951,103.837609
789300,36,0,36,1.385929,103.837609
789302,14,0,14,1.385777,103.83774
789303,4,0,4,1.385223,103.836716
789306,1,3,4,1.385701,103.837805
789307,16,6,22,1.384949,103.836966
789308,1,98,99,1.384962,103.836995
789309,19,0,19,1.384988,103.837052
789311,1,0,1,1.386004,103.837543
789312,15,7,22,1.385065,103.837223
789313,50,0,50,1.385091,103.83728
789314,7,27,34,1.385117,103.837337
789315,29,47,76,1.385143,103.837394
789317,1,0,1,1.38504,103.837166
789318,0,7,7,1.385222,103.837581
789319,1,1,2,1.385637,103.837066
789320,0,6,6,1.385284,103.837712
789321,0,2,2,1.385262,103.837674
789322,0,1,1,1.385198,103.837542
789323,10,27,37,1.385419,103.837937
789324,0,13,13,1.385464,103.838012
789325,0,3,3,1.385273,103.837301
789326,7,56,63,1.385559,103.838091
789327,0,39,39,1.385558,103.83809
789328,9,92,101,1.385733,103.8383
789329,17,1695,1712,1.385815,103.838298
789330,0,43,43,1.385975,103.838426
789331,1,33,34,1.386025,103.838468
789332,4,2,6,1.386065,103.8385
789333,3,397,400,1.386145,103.838563
789334,0,1,1,1.385374,103.837862
789335,2,0,2,1.385329,103.837787
789336,0,13,13,1.386386,103.838576
789337,0,19,19,1.386474,103.838538
789338,70,2,72,1.386554,103.838483
789339,1,4,5,1.386595,103.838456
789360,2,20,22,1.38525,103.836301
789381,4,3,7,1.381831,103.830098
789382,9,8,17,1.382325,103.830617
789383,3,2,5,1.381807,103.830053
789384,5,0,5,1.382246,103.830567
789385,1,0,1,1.386192,103.838573
789386,1,1,2,1.38629,103.838586
789387,2,0,2,1.382308,103.83051
789388,1,0,1,1.381784,103.830004
789389,4,0,4,1.385514,103.837949
789390,7,0,7,1.382163,103.830375
789392,1,0,1,1.382248,103.830423
789393,85,1,86,1.382196,103.830289
789394,57,4,61,1.381678,103.829774
789395,1,1,2,1.381758,103.829952
789396,10,5,15,1.381667,103.82972
789397,11,2,13,1.382039,103.830191
789398,81,7,88,1.381646,103.829646
789399,4,1,5,1.382025,103.830137
789400,48,2,50,1.381627,103.829585
789401,3,4,7,1.381981,103.830088
789402,88,3,91,1.381574,103.829495
789403,4,3,7,1.381937,103.830011
789404,10,4,14,1.38153,103.829474
789405,2,15,17,1.381914,103.829954
789406,0,5,5,1.381891,103.829903
789407,5,2,7,1.381868,103.829846
789408,8,2,10,1.381482,103.829134
789410,9,0,9,1.381422,103.829023
789411,6,0,6,1.381398,103.828963
789412,1,0,1,1.382097,103.830309
789413,10,0,10,1.381332,103.828868
789414,2,1,3,1.385463,103.838011
789416,14,2,16,1.38125,103.828645
789417,1,0,1,1.381365,103.828904
789418,4,0,4,1.38173,103.829895
789420,9,4,13,1.381171,103.828502
789421,0,1,1,1.381212,103.828568
789422,79,0,79,1.381092,103.828315
789423,9,5,14,1.381062,103.828251
789444,2,0,2,1.382107,103.830197
789445,3,5,8,1.380548,103.83043
789448,4,0,4,1.381192,103.828527
789450,1,0,1,1.38112,103.828366
789451,2,0,2,1.380194,103.830542
789452,1,0,1,1.380147,103.830427
789453,1,0,1,1.380102,103.830362
789454,6,0,6,1.379924,103.83042
789455,49,0,49,1.380399,103.830144
789456,8,8,16,1.380356,103.830075
789457,3,0,3,1.381318,103.828804
789458,117,0,117,1.380358,103.830036
789459,93,2,95,1.380106,103.830173
789461,6,0,6,1.379964,103.830153
789462,1,0,1,1.380429,103.830211
789463,0,2,2,1.38044,103.830273
789464,86,5,91,1.380278,103.829859
789465,0,1,1,1.380306,103.829916
789467,1,2,3,1.380144,103.830249
789468,4,0,4,1.38016,103.830462
789469,0,2,2,1.379963,103.830074
789470,22,1,23,1.379783,103.82977
789472,2,1,3,1.379865,103.829938
789473,5,0,5,1.37967,103.829586
789474,0,2,2,1.379806,103.829817
789475,22,1,23,1.37963,103.829558
789476,9,0,9,1.37959,103.829484
789477,7,3,10,1.379544,103.829421
789479,66,0,66,1.379464,103.829291
789481,3,0,3,1.379707,103.829668
789482,5,6,11,1.379355,103.829097
789503,1,12,13,1.389352,103.837234
789504,38,6,44,1.38941,103.837263
789505,4,0,4,1.379833,103.829873
789506,15,1,16,1.389519,103.837322
789507,2,0,2,1.379639,103.829522
789508,4,2,6,1.389645,103.837395
789509,2,0,2,1.389583,103.837355
789510,3,3,6,1.389765,103.837453
789511,1,0,1,1.379916,103.830026
789512,13,5,18,1.389897,103.837506
789513,11,3,14,1.389982,103.83754
789514,0,1,1,1.389827,103.837476
789535,16,13,29,1.389056,103.837525
789537,19,0,19,1.38913,103.837538
789538,29,0,29,1.388865,103.837844
789540,0,1,1,1.390034,103.83758
789541,15,0,15,1.389227,103.837681
789542,29,0,29,1.389057,103.83785
789543,1,0,1,1.388991,103.837791
789546,8,0,8,1.389244,103.837889
789547,11,1,12,1.389368,103.837768
789548,1,1,2,1.389704,103.837419
789549,1,0,1,1.389257,103.837694
789550,3,1,4,1.389467,103.837292
789551,9,0,9,1.3895,103.837852
789552,1,0,1,1.389391,103.83782
789553,2,2,4,1.389428,103.83799
789554,69,2,71,1.389506,103.838209
789555,0,4,4,1.389535,103.83787
789556,5,5,10,1.389596,103.838212
789557,2,2,4,1.389578,103.837886
789559,19,13,32,1.389749,103.837868
789560,4,6,10,1.389746,103.83833
789561,32,2,34,1.389776,103.837921
789562,3,4,7,1.389813,103.837948
789563,1,3,4,1.389665,103.837924
789585,6,19,25,1.38672,103.836875
789586,0,3,3,1.379384,103.82916
789587,2,9,11,1.386734,103.836828
789588,2,2,4,1.389899,103.837982
789590,1,0,1,1.389414,103.83813
789591,2,4,6,1.386792,103.836641
789592,0,4,4,1.386819,103.836095
789593,32,0,32,1.386821,103.836548
789594,8,0,8,1.386643,103.835978
789595,0,5,5,1.38685,103.836454
789596,18,0,18,1.386584,103.835939
789597,3,0,3,1.386878,103.836134
789598,27,4,31,1.386525,103.8359
789600,3,0,3,1.386879,103.83636
789602,33,1,34,1.386662,103.835971
789603,1,7,8,1.386944,103.836141
789605,1,0,1,1.38676,103.836056
789606,25,1,26,1.386883,103.836105
789607,6,2,8,1.386965,103.836043
789608,11,3,14,1.387066,103.835383
789609,1,0,1,1.386951,103.836108
789611,0,2,2,1.389316,103.837939
789612,71,0,71,1.386955,103.835351
789613,9,1,10,1.387006,103.835848
789614,78,1,79,1.386881,103.83533
789615,0,1,1,1.386979,103.835978
789616,20,1,21,1.386836,103.83531
789619,17,3,20,1.387048,103.835654
789621,1,1,2,1.386992,103.835913
789623,3,0,3,1.386594,103.835926
789624,11,0,11,1.386704,103.835099
789625,4,0,4,1.386702,103.836017
789626,5,3,8,1.386701,103.835064
789627,0,5,5,1.387113,103.835384
789628,1,0,1,1.38702,103.835784
789630,34,4,38,1.386748,103.834924
789631,7,3,10,1.387124,103.8353
789632,8,0,8,1.386786,103.834864
789633,1,2,3,1.387075,103.835524
789634,1,2,3,1.387144,103.835206
789635,5,9,14,1.387165,103.835111
789636,29,0,29,1.386863,103.834743
789637,7,0,7,1.387185,103.835017
789638,5,7,12,1.386901,103.834683
789639,6,2,8,1.387206,103.834923
789640,5,1,6,1.386939,103.834623
789642,4,0,4,1.387089,103.835459
789643,1,0,1,1.386724,103.834967
789644,27,3,30,1.387016,103.834502
789645,12,0,12,1.387268,103.83464
789646,7,0,7,1.387054,103.834472
789647,0,5,5,1.387288,103.834546
789648,7,0,7,1.387139,103.834424
789649,13,0,13,1.387319,103.834442
789650,10,1,11,1.387186,103.834431
789651,0,6,6,1.387334,103.834414
789652,9,2,11,1.387244,103.834427
789653,1,0,1,1.387247,103.834735
789654,4,4,8,1.387279,103.834419
789655,1,0,1,1.387339,103.834369
789656,2,2,4,1.386978,103.834562
789657,2,0,2,1.387062,103.835589
789658,58,4,62,1.387103,103.834739
789659,70,0,70,1.387391,103.834078
789680,11,16,27,1.390296,103.837748
789681,15,1,16,1.390246,103.837801
789682,2,23,25,1.39044,103.837764
789683,7,0,7,1.390418,103.837867
789684,4,0,4,1.387229,103.834474
789685,19,2,21,1.390454,103.83788
789686,1,0,1,1.387345,103.83427
789687,17,3,20,1.390477,103.837893
789688,4,0,4,1.390455,103.837782
789689,5,1,6,1.390517,103.83791
789690,7,1,8,1.390639,103.83783
789691,0,1,1,1.390503,103.837785
789692,7,2,9,1.390704,103.83784
789693,3,1,4,1.39056,103.837803
789694,7,0,7,1.390747,103.837858
789695,10,1,11,1.390801,103.837862
789696,0,5,5,1.39089,103.837882
789717,0,5,5,1.388406,103.840428
789718,72,1,73,1.388498,103.840431
789719,3,2,5,1.388365,103.84037
789720,15,4,19,1.388464,103.840389
789721,0,1,1,1.390577,103.837928
789723,6,0,6,1.388241,103.840253
789724,1,0,1,1.388302,103.84029
789725,2,0,2,1.387363,103.834179
789726,4,0,4,1.39063,103.837941
789727,1,0,1,1.388341,103.840276
789728,7,2,9,1.38829,103.84019
789729,10,0,10,1.387992,103.83994
789730,5,0,5,1.388258,103.840125
789731,1,1,2,1.388112,103.840107
789732,3,0,3,1.386825,103.834803
789733,2,2,4,1.388343,103.84023
789734,6,0,6,1.388154,103.840045
789735,0,1,1,1.388062,103.840017
789737,2,1,3,1.38823,103.840093
789739,4,0,4,1.387857,103.83978
789740,1,1,2,1.387939,103.839891
789742,15,0,15,1.387927,103.83973
789743,22,0,22,1.387898,103.839681
789744,19,7,26,1.387853,103.839646
789767,4,0,4,1.387661,103.839527
789768,1,50,51,1.390864,103.837388
789769,10,5,15,1.39126,103.837341
789770,1,0,1,1.387808,103.839714
789771,21,8,29,1.391247,103.837398
789772,9,2,11,1.390879,103.837519
789773,1,1,2,1.388034,103.839815
789774,1,4,5,1.390499,103.838529
789776,7,0,7,1.390464,103.838547
789778,1,3,4,1.391264,103.837246
789779,39,1,40,1.391297,103.837705
789780,35,0,35,1.390494,103.83867
789781,0,141,141,1.391298,103.837756
789782,0,2,2,1.39129,103.837434
789783,25,0,25,1.391242,103.837852
789784,1,0,1,1.390841,103.837451
789785,11,0,11,1.391257,103.837897
789786,4,3,7,1.390398,103.838819
789787,2,0,2,1.390459,103.838723
789788,3,0,3,1.387724,103.839603
789789,12,91,103,1.391209,103.838022
789790,6,17,23,1.390352,103.838938
789791,34,247,281,1.391075,103.838255
789793,5,3,8,1.391016,103.838329
789794,6,0,6,1.390227,103.83909
789795,9,59,68,1.390979,103.838362
789796,1,0,1,1.390422,103.838788
789797,3,6,9,1.390957,103.838426
789798,0,2,2,1.391216,103.837942
789799,7,151,158,1.390916,103.838464
789800,1,0,1,1.390178,103.839169
789801,2,0,2,1.390115,103.839247
789803,9,59,68,1.390851,103.838599
789804,81,4,85,1.39003,103.839375
789805,28,1,29,1.3908,103.83864
789806,2,58,60,1.390791,103.838769
789807,7,8,15,1.390721,103.838812
789808,1,73,74,1.390558,103.838757
789809,12,2,14,1.390527,103.838826
789810,16,16,32,1.390503,103.838875
789811,12,4,16,1.39047,103.838903
789812,0,29,29,1.390426,103.838975
789813,1,2,3,1.390373,103.83887
789814,0,13,13,1.390358,103.839086
789815,1,0,1,1.389959,103.8392
789816,9,9,18,1.390278,103.839198
789817,8,1,9,1.390229,103.839282
789818,0,4,4,1.390525,103.838622
789819,5,3,8,1.390149,103.839385
789820,0,8,8,1.390124,103.839415
789821,11,8,19,1.390086,103.839476
789822,2,11,13,1.390036,103.839533
789823,12,4,16,1.389994,103.839583
789824,5,7,12,1.389917,103.839611
789825,1,0,1,1.390327,103.839125
789826,0,10,10,1.389823,103.839707
789828,8,9,17,1.389777,103.839743
789829,12,4,16,1.389732,103.839775
789830,4,7,11,1.389625,103.839886
789831,0,1,1,1.389865,103.839657
789832,6,6,12,1.389523,103.839981
789833,7,0,7,1.389422,103.840011
789834,4,12,16,1.389376,103.840042
789835,2,0,2,1.390885,103.838529
789836,15,15,30,1.389283,103.840077
789837,1,1,2,1.389346,103.840082
789838,6,59,65,1.389149,103.840217
789839,4,0,4,1.390185,103.839307
789840,8,117,125,1.389009,103.840272
789841,15,2,17,1.388979,103.840287
789842,2,68,70,1.388927,103.840342
789843,8,0,8,1.388883,103.840367
789844,1,27,28,1.388811,103.840401
789845,0,1,1,1.389555,103.839946
789846,50,16,66,1.388758,103.840426
789847,5,0,5,1.388721,103.840442
789848,1,30,31,1.388685,103.840474
789849,5,1,6,1.388537,103.840618
789850,30,26,56,1.388446,103.840667
789851,2,2,4,1.38909,103.840245
789852,26,2,28,1.387997,103.840749
789854,51,23,74,1.388347,103.840679
789855,24,0,24,1.387893,103.840641
789856,6,3,9,1.388266,103.840742
789857,1,1,2,1.389228,103.840134
789858,1,33,34,1.388194,103.840817
789859,5,1,6,1.387795,103.840492
789860,0,189,189,1.388007,103.840878
789861,6,3,9,1.387716,103.840492
789862,1,71,72,1.387967,103.840869
789863,0,2,2,1.38815,103.840758
789864,98,236,334,1.387892,103.840839
789865,0,3,3,1.390384,103.839041
789866,2,3,5,1.387847,103.840806
789867,22,0,22,1.387526,103.840259
789868,1,2,3,1.387633,103.840365
789869,0,4,4,1.38838,103.840668
789870,222,6,228,1.387778,103.84066
789871,2,1,3,1.387787,103.840729
789872,0,4,4,1.387509,103.840231
789873,0,5,5,1.38896,103.840089
789874,16,0,16,1.388896,103.840093
789875,199,1,200,1.388934,103.840058
789876,1,3,4,1.38892,103.840129
789877,18,0,18,1.388905,103.840027
789878,1,0,1,1.388792,103.840412
789879,2,3,5,1.388875,103.839984
789880,1,5,6,1.388815,103.839989
789881,2,0,2,1.387679,103.840408
789882,9,0,9,1.388748,103.83994
789883,14,2,16,1.388791,103.839891
789884,0,6,6,1.388712,103.839909
789885,1,0,1,1.388828,103.840011
789886,12,0,12,1.388688,103.839865
789887,117,9,126,1.3887,103.839774
789888,34,3,37,1.388649,103.839822
789889,2,0,2,1.388833,103.839937
789890,27,1,28,1.388588,103.839765
789891,0,1,1,1.388751,103.839834
789892,0,1,1,1.388615,103.839671
789893,2,0,2,1.38866,103.839722
789894,2,0,2,1.388582,103.839618
789895,0,1,1,1.388518,103.83968
789896,0,4,4,1.388863,103.840057
789897,1,0,1,1.388538,103.839568
789898,2,0,2,1.388502,103.839652
789899,45,2,47,1.388397,103.839374
789900,0,2,2,1.388406,103.839534
789902,1,0,1,1.388426,103.83942
789903,25,5,30,1.388304,103.839203
789904,72,0,72,1.388306,103.839371
789905,0,2,2,1.38835,103.839458
789926,5,10,15,1.389424,103.839001
789927,34,10,44,1.389461,103.839043
789928,7,0,7,1.389519,103.839093
789929,2,6,8,1.389551,103.839151
789931,8,0,8,1.389624,103.839258
789932,5,0,5,1.389693,103.839329
789933,1,1,2,1.388274,103.839336
789934,2,0,2,1.389727,103.83939
789935,4,5,9,1.389846,103.83949
789956,6,5,11,1.389407,103.839861
789957,27,4,31,1.389445,103.839795
789959,0,1,1,1.388323,103.839414
789960,51,5,56,1.389296,103.839722
789961,9,0,9,1.389393,103.839699
789962,6,0,6,1.389261,103.83968
789963,1,4,5,1.38935,103.839636
789964,0,5,5,1.389234,103.839647
789966,12,1,13,1.389194,103.8396
789967,0,6,6,1.38931,103.83959
789968,8,1,9,1.389121,103.839497
789969,7,0,7,1.389224,103.839462
789971,3,0,3,1.387464,103.840181
789972,2,4,6,1.389081,103.839406
789973,9,0,9,1.389164,103.839353
789974,1,0,1,1.389423,103.839729
789975,2,1,3,1.389186,103.839398
789976,1,1,2,1.389787,103.839426
789978,1,1,2,1.388746,103.839307
789979,1,0,1,1.389049,103.839372
790000,3,2,5,1.39908,103.864857
790403,90,83,173,1.388645,103.873022
790404,35,195,230,1.387858,103.87331
790405,32,157,189,1.38927,103.874057
790406,12,136,148,1.388168,103.874817
790407,74,61,135,1.38863,103.875065
790408,23,84,107,1.38915,103.876675
790410,77,10729,10806,1.390381,103.87654
790411,26,345,371,1.389821,103.876868
790412,62,16,78,1.389433,103.87795
790413,10,41,51,1.389901,103.87825
790414,27,73,100,1.299509,103.837
790415,102,87,189,1.299509,103.837
790416,146,73,219,1.390644,103.879877
790417,13,85,98,1.299509,103.837
790418,3,11,14,1.299509,103.837
790430,30,39,69,1.299509,103.837
790431,23,613,636,1.299509,103.837
790432,37,44,81,1.394407,103.877214
790433,35,10,45,1.394399,103.877671
790434,113,155,268,1.393849,103.875957
790435,53,125,178,1.393205,103.876964
790436,37,11,48,1.392561,103.876648
790437,63,1666,1729,1.392594,103.875931
790438,22,40,62,1.392204,103.877995
790439,138,67,205,1.392205,103.877601
790440,258,24,282,1.299509,103.837
790441,28,201,229,1.391686,103.87511
790442,9,41,50,1.391714,103.874787
790443,17,138,155,1.391762,103.874104
790445,40,122,162,1.391917,103.874281
790446,18,117,135,1.392082,103.873227
790448,23,1099,1122,1.39318,103.873117
790449,79,1968,2047,1.393725,103.873133
790450,26,134,160,1.394036,103.873408
790451,19,51,70,1.394591,103.874088
790452,63,167,230,1.299509,103.837
790453,16,350,366,1.299509,103.837
790454,7,212,219,1.299509,103.837
790467,54,416,470,1.299509,103.837
790468,23,415,438,1.299509,103.837
790469,47,145,192,1.396199,103.87759
790470,93,307,400,1.39699,103.879369
790472,12,222,234,1.299509,103.837
790473,305,518,823,1.299509,103.837
790488,7,38,45,1.299509,103.837
791403,1797,1042,2839,1.389016,103.873145
791404,821,291,1112,1.388398,103.87391
791405,705,293,998,1.388873,103.873955
791406,1042,343,1385,1.387884,103.874335
791407,1239,278,1517,1.388276,103.875337
791408,1197,270,1467,1.388662,103.876277
791409,918,369,1287,1.389043,103.877238
791410,1235,1108,2343,1.389504,103.875965
791411,1249,21635,22884,1.390423,103.876943
791412,1605,283,1888,1.389048,103.878021
791413,1190,274,1464,1.389292,103.878841
791414,1140,326,1466,1.389164,103.879883
791415,1700,1605,3305,1.389371,103.87977
791416,2006,802,2808,1.390427,103.879808
791417,5,84,89,1.299509,103.837
791418,73,941,1014,1.299509,103.837
791430,1854,442,2296,1.394325,103.878306
791431,14,542,556,1.299509,103.837
791432,1139,2778,3917,1.394748,103.877108
791433,684,601,1285,1.394758,103.877477
791434,1197,959,2156,1.393849,103.875957
791435,929,1922,2851,1.393704,103.875984
791436,699,135,834,1.392749,103.876501
791438,401,159,560,1.392754,103.877419
791439,978,4523,5501,1.391792,103.877743
791440,1113,917,2030,1.3935,103.878498
791441,629,1194,1823,1.39115,103.875193
791443,467,1728,2195,1.39117,103.874321
791445,815,155,970,1.392091,103.87442
791446,966,374,1340,1.391935,103.872866
791447,1798,3313,5111,1.392224,103.87261
791448,786,3035,3821,1.392809,103.873013
791450,893,878,1771,1.394337,103.873502
791451,996,1106,2102,1.394414,103.874341
791452,959,30,989,1.394414,103.874341
791453,798,1296,2094,1.393683,103.875314
791467,1430,1118,2548,1.299509,103.837
791468,993,206,1199,1.395993,103.878214
791469,1507,1518,3025,1.395993,103.878214
791470,1376,957,2333,1.396928,103.879444
791471,1321,1596,2917,1.396632,103.880516
791472,1195,228,1423,1.397813,103.881471
791473,1425,213,1638,1.398076,103.881034
792403,552,459,1011,1.388881,103.872916
792404,1257,33,1290,1.38826,103.873649
792405,614,57,671,1.389088,103.873745
792406,932,313,1245,1.388635,103.87429
792407,1370,2266,3636,1.389005,103.874971
792408,1185,1194,2379,1.389042,103.876003
792409,864,41,905,1.389585,103.876883
792410,1436,906,2342,1.389584,103.87615
792411,1516,305,1821,1.39004,103.877083
792412,900,291,1191,1.389861,103.878021
792413,1064,489,1553,1.389736,103.878789
792414,1222,1160,2382,1.389739,103.879749
792415,1190,403,1593,1.299509,103.837
792416,872,107,979,1.390123,103.880299
792418,9,137,146,1.299509,103.837
792430,1266,94,1360,1.394325,103.878306
792432,604,327,931,1.393957,103.877224
792433,939,321,1260,1.39388,103.87759
792434,1389,1100,2489,1.394516,103.876609
792435,968,367,1335,1.393283,103.876665
792436,551,27,578,1.392742,103.876881
792438,465,130,595,1.39278,103.877718
792439,468,2858,3326,1.39183,103.877987
792440,1418,171,1589,1.393313,103.879028
792441,737,1527,2264,1.391155,103.874775
792443,464,3320,3784,1.391173,103.873939
792445,986,282,1268,1.39225,103.874024
792446,1253,656,1909,1.391792,103.873344
792447,626,310,936,1.392464,103.873094
792448,797,328,1125,1.393396,103.873174
792450,735,436,1171,1.393948,103.873277
792451,1339,880,2219,1.394722,103.874264
792452,983,90,1073,1.394414,103.874341
792453,972,1285,2257,1.393683,103.875314
792467,1319,618,1937,1.397462,103.877918
792468,927,289,1216,1.395993,103.878214
792469,1161,3166,4327,1.395909,103.878023
792470,740,146,886,1.396632,103.880516
792471,1061,313,1374,1.396632,103.880516
792472,1013,220,1233,1.397659,103.881232
793403,470,305,775,1.388367,103.872843
793405,950,2710,3660,1.389259,103.873532
793406,1033,50,1083,1.388757,103.874587
793407,21,437,458,1.388904,103.874943
793408,1171,136,1307,1.389387,103.87639
793410,711,529,1240,1.389838,103.876485
793415,1390,272,1662,1.390443,103.880501
793416,520,366,886,1.389641,103.880831
793418,11,95,106,1.299509,103.837
793430,1114,411,1525,1.394325,103.878306
793435,742,161,903,1.393486,103.876906
793436,735,200,935,1.392317,103.876947
793439,340,1242,1582,1.391989,103.8784
793440,1240,68,1308,1.3935,103.878498
793441,1060,92,1152,1.392071,103.874883
793443,488,2468,2956,1.391231,103.873545
793446,431,209,640,1.39228,103.873566
793450,670,192,862,1.393753,103.873475
793453,1643,160,1803,1.393683,103.875314
793468,794,250,1044,1.395993,103.878214
793469,684,197,881,1.395993,103.878214
793470,787,950,1737,1.299509,103.837
793471,2045,273,2318,1.396945,103.88016
793472,1631,1670,3301,1.396508,103.881345
794403,976,28,1004,1.38825,103.873063
794418,5,19,24,1.299509,103.837
794430,1612,1188,2800,1.39477,103.877785
794436,739,152,891,1.39208,103.876613
794440,32,985,1017,1.299509,103.837
794441,963,1373,2336,1.392411,103.875486
794453,1257,1146,2403,1.393683,103.875314
794470,38,459,497,1.299509,103.837
794472,17,92,109,1.299509,103.837
797415,1,1,2,1.388785,103.839271
797416,1,18,19,1.299509,103.837
797417,6,177,183,1.299509,103.837
797418,0,3,3,1.389121,103.839303
797419,3,220,223,1.299509,103.837
797420,0,1,1,1.389007,103.839197
797422,0,1,1,1.299509,103.837
797424,4,0,4,1.388464,103.839592
797427,1,0,1,1.299509,103.837
797430,1,0,1,1.299509,103.837
797431,0,1,1,1.299509,103.837
797435,42,45,87,1.407046,103.860022
797436,3,22,25,1.299509,103.837
797437,3,0,3,1.299509,103.837
797438,2,132,134,1.299509,103.837
797439,2,43,45,1.299509,103.837
797440,226,9,235,1.407109,103.859746
797445,5,0,5,1.299509,103.837
797446,4,0,4,1.299509,103.837
797447,1,0,1,1.299509,103.837
797448,3,0,3,1.299509,103.837
797449,5,0,5,1.299509,103.837
797451,1,0,1,1.299509,103.837
797452,1,0,1,1.299509,103.837
797454,1,93,94,1.299509,103.837
797455,186,83,269,1.299509,103.837
797460,9,0,9,1.299509,103.837
797461,7,25,32,1.299509,103.837
797462,24,2,26,1.299509,103.837
797463,5,8,13,1.299509,103.837
797464,2,0,2,1.299509,103.837
797465,8,2,10,1.299509,103.837
797466,1,0,1,1.299509,103.837
797468,1,0,1,1.299509,103.837
797469,3,0,3,1.299509,103.837
797472,0,1,1,1.299509,103.837
797475,31,11,42,1.299509,103.837
797476,36,338,374,1.299509,103.837
797477,5,41,46,1.299509,103.837
797478,3,1,4,1.299509,103.837
797479,9,133,142,1.299509,103.837
797485,500,93,593,1.394534,103.879909
797486,740,120,860,1.394534,103.879909
797487,318,304,622,1.394534,103.879909
797488,487,351,838,1.394534,103.879909
797489,85,19,104,1.299509,103.837
797490,267,559,826,1.299509,103.837
797495,1188,220,1408,1.388447,103.871937
797496,900,1375,2275,1.388447,103.871937
797497,522,137,659,1.388447,103.871937
797498,178,468,646,1.388447,103.871937
797499,306,67,373,1.388677,103.872111
797500,301,394,695,1.38759,103.872437
797501,480,85,565,1.388447,103.871937
797502,704,30,734,1.388447,103.871937
797505,1587,281,1868,1.412501,103.869048
797506,3774,19,3793,1.411482,103.870985
797507,165,9,174,1.299509,103.837
797509,105,0,105,1.412681,103.869925
797510,28,1,29,1.299509,103.837
797511,0,3,3,1.299509,103.837
797520,1083,302,1385,1.422105,103.86616
797521,324,133,457,1.423506,103.866918
797522,0,90,90,1.299509,103.837
797523,623,486,1109,1.419958,103.863761
797525,9,0,9,1.299509,103.837
797526,8,24,32,1.299509,103.837
797530,1077,193,1270,1.392495,103.879928
797531,924,38,962,1.392766,103.879232
797532,622,1117,1739,1.392766,103.879232
797533,924,175,1099,1.392766,103.879232
797534,794,269,1063,1.392766,103.879232
797535,378,887,1265,1.299509,103.837
797536,59,1068,1127,1.395192,103.878741
797545,1202,104,1306,1.406175,103.865846
797546,1200,0,1200,1.405422,103.864309
797547,122,2,124,1.405224,103.865581
797550,94,42,136,1.405114,103.85997
797551,105,308,413,1.405075,103.860441
797552,80,9,89,1.405256,103.859628
797553,1134,552,1686,1.405071,103.857901
797554,516,55,571,1.299509,103.837
797555,10,1,11,1.299509,103.837
797556,1,1,2,1.299509,103.837
797557,0,2,2,1.299509,103.837
797558,4,5,9,1.299509,103.837
797560,1996,12,2008,1.382128,103.973003
797561,217,30,247,1.413338,103.868904
797562,1267,198,1465,1.410451,103.869065
797563,109,36,145,1.412123,103.868475
797564,157,60,217,1.41107,103.868888
797565,7864,122,7986,1.403221,103.864558
797566,4053,169,4222,1.403318,103.857222
797567,72,117,189,1.299509,103.837
797570,852,164,1016,1.405815,103.858993
797571,3,85,88,1.299509,103.837
797572,1,7,8,1.299509,103.837
797573,89,67,156,1.406422,103.858309
797574,6,54,60,1.299509,103.837
797575,743,70,813,1.403221,103.864558
797580,5,6,11,1.420032,103.893753
797581,0,6,6,1.420305,103.893192
797582,0,5,5,1.420594,103.892674
797583,1,3,4,1.394587,103.880945
797584,0,5,5,1.421255,103.891662
797585,3,4,7,1.421553,103.891138
797586,0,3,3,1.299509,103.837
797587,1,7,8,1.42221,103.89007
797588,1,4,5,1.422513,103.889537
797589,1,30,31,1.422862,103.888934
797590,1,4,5,1.423894,103.889671
797591,4,0,4,1.420934,103.892144
797595,0,1,1,1.299509,103.837
797596,0,1,1,1.422372,103.89218
797597,2,1,3,1.42187,103.890576
797599,0,3,3,1.421882,103.892962
797601,768,262,1030,1.416508,103.895319
797602,177,115,292,1.299509,103.837
797603,6,0,6,1.299509,103.837
797604,7,875,882,1.414995,103.8963
797605,8,654,662,1.416725,103.894341
797606,5,1,6,1.420652,103.89569
797607,54,5,59,1.419698,103.895214
797608,3,6,9,1.418662,103.895204
797609,4,3,7,1.418198,103.894797
797610,3,2,5,1.417831,103.894333
797611,10,50,60,1.4177,103.893816
797612,53,15,68,1.418765,103.894067
797613,4,94,98,1.424318,103.88846
797614,25,108,133,1.414666,103.896649
797615,0,10,10,1.422815,103.892388
797616,4,186,190,1.41811,103.895852
797617,11,69,80,1.417526,103.895656
797618,2,605,607,1.41713,103.895266
797619,1,224,225,1.416806,103.894857
797630,0,54,54,1.394063,103.869453
797635,112,2261,2373,1.389903,103.874414
797636,341,225,566,1.392534,103.875117
797637,2,4,6,1.299509,103.837
797638,2,8,10,1.299509,103.837
797640,74,90,164,1.402501,103.871306
797641,40,16,56,1.40283,103.871298
797642,27,30,57,1.402493,103.871463
797643,25,526,551,1.402797,103.871455
797645,4,3,7,1.402757,103.870446
797646,0,3,3,1.421396,103.893805
797647,14,50,64,1.420415,103.864932
797648,75,178,253,1.424289,103.867521
797649,565,345,910,1.420385,103.86407
797650,32,2234,2266,1.391536,103.87696
797651,51,1019,1070,1.391227,103.872263
797652,24,3713,3737,1.391255,103.872117
797653,4696,9111,13807,1.391294,103.876295
797654,3464,800,4264,1.417431,103.864152
797655,28,248,276,1.416126,103.863217
797656,2,1,3,1.402593,103.870424
797657,0,4,4,1.423576,103.890176
797658,1,20,21,1.387145,103.874772
797659,7,10,17,1.387079,103.874287
797661,9,4,13,1.386057,103.878174
797662,0,1,1,1.422143,103.892575
797663,3,6,9,1.385904,103.878048
797664,5,5,10,1.385839,103.878
797665,4,0,4,1.387103,103.874791
797666,12,33,45,1.385183,103.877634
797667,5,1,6,1.385183,103.877634
797668,2,0,2,1.299509,103.837
797669,24,0,24,1.385235,103.877638
797673,6,1,7,1.385358,103.877668
797674,10,0,10,1.38542,103.877682
797675,1,0,1,1.386017,103.878126
797676,4,0,4,1.414266,103.872253
797677,2,0,2,1.385235,103.877638
797678,2,0,2,1.385469,103.877697
797681,10,0,10,1.385306,103.877142
797683,8,0,8,1.385613,103.877785
797684,2,0,2,1.385509,103.877718
797685,8,6,14,1.385664,103.877818
797686,1,0,1,1.38542,103.877682
797687,6,4,10,1.385716,103.877852
797688,37,2,39,1.385768,103.877885
797689,2,3,5,1.385768,103.877885
797690,0,7,7,1.385794,103.877902
797691,0,5,5,1.385794,103.877902
797692,34,515,549,1.418406,103.863049
797695,74,107,181,1.413536,103.863343
797696,5,0,5,1.386187,103.878296
797697,116,723,839,1.398218,103.881467
797698,463,1519,1982,1.391947,103.876262
797699,30,37,67,1.397413,103.87562
797700,197,995,1192,1.392116,103.880065
797701,297,1056,1353,1.389948,103.873919
797702,462,173,635,1.390273,103.878474
797703,193,22,215,1.387188,103.877839
797724,21,9,30,1.38431,103.877023
797726,71,0,71,1.387205,103.876785
797727,5,2,7,1.387184,103.876718
797728,4,0,4,1.385469,103.877697
797729,2,1,3,1.387071,103.87482
797730,4,2,6,1.387097,103.876507
797731,6,0,6,1.387067,103.87647
797732,1,3,4,1.387162,103.876663
797733,1,0,1,1.385716,103.877852
797734,10,23,33,1.387944,103.876563
797735,68,13,81,1.387909,103.876598
797737,0,3,3,1.38713,103.876592
797738,2,1,3,1.387841,103.876614
797739,15,2,17,1.387735,103.876646
797740,7,0,7,1.387694,103.876671
797742,0,4,4,1.387039,103.876431
797744,5,1,6,1.38754,103.876415
797745,5,1,6,1.38753,103.876392
797746,17,0,17,1.387523,103.876376
797747,7,0,7,1.387515,103.876358
797748,33,31,64,1.387919,103.876359
797749,4,6,10,1.387919,103.876359
797750,8,6,14,1.387862,103.876232
797751,5,5,10,1.387862,103.876232
797752,2,5,7,1.387748,103.875979
797753,12,4,16,1.387748,103.875979
797756,0,1,1,1.387004,103.876364
797757,1,2,3,1.387792,103.876618
797758,8,0,8,1.386576,103.876166
797759,39,2,41,1.386625,103.876136
797760,3,1,4,1.387564,103.876507
797761,4,2,6,1.386736,103.876102
797763,1809,0,1809,1.418642,103.864279
797764,8,22,30,1.388226,103.877756
797765,8,46,54,1.388158,103.877928
797768,5,14,19,1.411067,103.872673
797769,6,129,135,1.410861,103.872714
797770,1388,958,2346,1.409565,103.871118
797771,45,3,48,1.411423,103.873407
797776,1,0,1,1.386448,103.876255
797778,3,0,3,1.386526,103.876211
797781,7,0,7,1.40954,103.871145
797783,6,0,6,1.418099,103.863942
797785,4,1,5,1.409062,103.864258
797789,5,0,5,1.413785,103.865048
797790,182,41,223,1.419514,103.864264
797791,32,11,43,1.419438,103.864232
797792,245,175,420,1.418909,103.864522
797793,238,119,357,1.41924,103.864546
797794,37,28,65,1.418735,103.864268
797795,13,22,35,1.418756,103.864056
797796,24,11,35,1.423611,103.870478
797797,1,49,50,1.423512,103.870858
797799,1224,110,1334,1.417616,103.863487
797800,428,0,428,1.417868,103.863696
797805,6,2,8,1.407179,103.873222
797806,4,2,6,1.41025,103.867971
797808,1,3,4,1.386663,103.876131
797811,81,96,177,1.416736,103.871897
797812,0,1,1,1.409567,103.871154
797859,39,34,73,1.407673,103.867609
797860,14,4,18,1.408306,103.867505
797862,0,1,1,1.299509,103.837
797863,0,1,1,1.408888,103.866743
797864,0,3,3,1.409532,103.871151
797865,0,1,1,1.408661,103.86643
797866,0,1,1,1.408063,103.866599
797872,0,156,156,1.407856,103.867327
797873,3,7,10,1.408624,103.867307
797874,2,3,5,1.408449,103.867508
797875,5,13,18,1.407653,103.867761
797890,0,33,33,1.405674,103.864021
797892,0,55,55,1.405885,103.864235
797893,0,38,38,1.406,103.864273
797910,1,1,2,1.385664,103.877818
797911,0,1,1,1.408052,103.866858
797912,0,2,2,1.403669,103.870021
797913,4,0,4,1.412869,103.872525
797914,3,0,3,1.408245,103.866516
797915,19,2,21,1.404128,103.869266
797917,0,2,2,1.403729,103.86997
797918,4,0,4,1.40383,103.870023
797919,2,0,2,1.40412,103.869064
797921,0,5,5,1.403973,103.868887
797922,0,3,3,1.403922,103.869739
797940,12,10,22,1.409141,103.873607
797959,2,86,88,1.402073,103.862362
797960,12,93,105,1.401901,103.86289
797961,8,183,191,1.403895,103.856675
797977,3,45,48,1.398044,103.862245
797978,3,1,4,1.404005,103.869418
797996,2,1,3,1.403992,103.868626
797997,3,55,58,1.399383,103.864825
798014,0,1,1,1.403699,103.870143
798015,0,1,1,1.397325,103.870808
798016,1,29,30,1.398946,103.868683
798017,2,17,19,1.399504,103.86605
798018,2,9,11,1.399535,103.865854
798019,3,38,41,1.399632,103.865579
798036,7,0,7,1.397607,103.864331
798037,1,24,25,1.397216,103.868039
798038,1,2,3,1.398387,103.864762
798039,1,2,3,1.397741,103.865757
798040,1,2,3,1.397866,103.865219
798041,1,49,50,1.396303,103.868143
798043,0,2,2,1.40401,103.86928
798044,0,1,1,1.398525,103.869961
798049,28,22,50,1.396611,103.867959
798057,1,4,5,1.394727,103.867128
798058,6,8,14,1.394974,103.865156
798060,4,2,6,1.396654,103.863412
798061,281,148,429,1.396272,103.86343
798078,1,66,67,1.391855,103.868931
798079,1,55,56,1.392077,103.868679
798080,1,4,5,1.391952,103.867482
798081,1,2,3,1.397805,103.864322
798098,141,61,202,1.391374,103.868231
798099,27,10,37,1.390048,103.867586
798100,0,2,2,1.394657,103.870787
798101,22,14,36,1.390173,103.866896
798119,4,345,349,1.390537,103.869993
798120,3,286,289,1.390883,103.869572
798121,1,377,378,1.391057,103.869052
798122,9,44,53,1.39116,103.868582
798123,2,8,10,1.39101,103.867835
798124,0,5,5,1.391066,103.867418
798125,13,3,16,1.391126,103.866534
798126,92,11,103,1.391411,103.866471
798127,7,1,8,1.390585,103.866024
798128,4,0,4,1.398235,103.862795
798129,24,0,24,1.391296,103.865738
798130,0,2,2,1.390086,103.86727
798131,10,592,602,1.389864,103.869433
798132,1,1,2,1.3909,103.864655
798133,32,41,73,1.391121,103.867056
798217,5,260,265,1.394184,103.875052
798220,4,289,293,1.299729,103.857084
798222,13,216,229,1.299729,103.857084
798243,6,6,12,1.388879,103.873065
798273,2389,455,2844,1.409643,103.858065
798291,4,4,8,1.405442,103.864039
798292,0,22,22,1.405304,103.86417
798293,2,30,32,1.405304,103.86419
798294,2,162,164,1.405027,103.864473
798295,0,23,23,1.405027,103.864493
798296,0,369,369,1.40475,103.864777
798298,1,2,3,1.392072,103.86659
798300,0,2,2,1.391292,103.867185
798301,0,1,1,1.395846,103.869765
798322,0,1,1,1.404206,103.865393
798324,0,1,1,1.402794,103.867873
798330,0,19,19,1.402697,103.868337
798332,0,20,20,1.402667,103.868476
798333,0,2,2,1.404196,103.865383
798334,0,13,13,1.402607,103.868756
798335,0,4,4,1.391242,103.866116
798336,0,21,21,1.402547,103.869035
798338,0,6,6,1.402488,103.869314
798339,6,0,6,1.402428,103.869614
798340,5,2,7,1.402428,103.869594
798341,2,0,2,1.402652,103.868566
798342,4,3,7,1.402368,103.869873
798343,4,0,4,1.402577,103.868915
798344,0,5,5,1.402308,103.870152
798345,57,0,57,1.402493,103.869931
798346,0,5,5,1.402278,103.870399
798347,1,6,7,1.402392,103.870613
798364,3,1,4,1.402278,103.870312
798365,22,10,32,1.40595,103.871736
798367,3,30,33,1.412041,103.872839
798368,30,19,49,1.413107,103.873402
798369,3,2,5,1.413585,103.872829
798370,0,2,2,1.402353,103.869963
798371,1,0,1,1.402717,103.868207
798373,22,2,24,1.416784,103.871832
798374,5,1,6,1.416628,103.872383
798375,2,1,3,1.404473,103.86508
798377,1,0,1,1.416651,103.8715
798379,1,0,1,1.415037,103.871843
798382,2,0,2,1.41726,103.870743
798385,10,33,43,1.41052,103.867924
798386,1134,321,1455,1.40962,103.86819
798387,530,233,763,1.407956,103.868533
798404,2,0,2,1.414297,103.873438
798406,4,0,4,1.405266,103.871146
798407,0,2,2,1.408974,103.871322
798408,35,9,44,1.408295,103.870937
798409,15,4,19,1.408312,103.870868
798410,15,1,16,1.408761,103.870958
798411,67,5,72,1.408203,103.870776
798412,1,2,3,1.416581,103.870597
798413,0,2,2,1.408505,103.871197
798414,3,3,6,1.408318,103.870562
798415,3,11,14,1.408174,103.870227
798416,4,59,63,1.408066,103.870114
798417,0,1,1,1.414588,103.8727
798418,0,4,4,1.408499,103.871228
798420,10,461,471,1.407667,103.869135
798421,0,10,10,1.409513,103.872289
798422,5,293,298,1.409354,103.872233
798423,0,8,8,1.409192,103.871927
798468,1,0,1,1.407992,103.869998
798473,1,0,1,1.410057,103.8711
798483,1,31,32,1.41008,103.870137
798484,10,5,15,1.410066,103.870517
798485,5,3,8,1.410061,103.870896
798486,13,1,14,1.410058,103.871291
798497,7,96,103,1.386391,103.878785
798498,9,45,54,1.386326,103.878722
798499,4,1,5,1.386348,103.878798
798500,10,2,12,1.386285,103.878729
798501,0,1,1,1.410057,103.8711
798502,1,0,1,1.386291,103.878851
798504,1,0,1,1.386204,103.878753
798506,1,0,1,1.386121,103.878796
798507,149,3,152,1.38615,103.879005
798508,30,3,33,1.386065,103.879025
798509,4,3,7,1.386038,103.879081
798526,2,0,2,1.408399,103.870699
798528,20,0,20,1.385079,103.878062
798529,1,1,2,1.385024,103.878008
798530,1,2,3,1.408032,103.870426
798531,19,0,19,1.38553,103.878303
798532,3,0,3,1.385142,103.878101
798533,3,0,3,1.385176,103.878115
798534,1,0,1,1.386117,103.878933
798535,14,1,15,1.385652,103.878557
798536,3,1,4,1.407925,103.869867
798537,9,2,11,1.385695,103.878637
798538,8,7,15,1.385403,103.878381
798539,68,2,70,1.38573,103.878694
798540,4,0,4,1.385352,103.878284
798541,14,0,14,1.385788,103.878863
798542,5,0,5,1.385455,103.878486
798543,0,6,6,1.385812,103.878943
798546,0,5,5,1.385509,103.878566
798548,0,2,2,1.385484,103.878242
798549,6,0,6,1.386075,103.879397
798550,0,1,1,1.385222,103.878144
798551,1,1,2,1.38554,103.878596
798552,115,3,118,1.385597,103.878718
798553,12,0,12,1.386181,103.879601
798554,1,3,4,1.385423,103.878437
798555,1,1,2,1.386136,103.879485
798556,10,3,13,1.385668,103.878865
798558,35,8,43,1.385692,103.878913
798559,4,2,6,1.386328,103.879746
798560,1,0,1,1.385558,103.878626
798561,0,3,3,1.38561,103.878487
798562,3,0,3,1.386382,103.879805
798563,7,7,14,1.386756,103.879964
798564,9,1,10,1.385789,103.879073
798565,3,21,24,1.386828,103.879779
798566,17,2,19,1.385818,103.879127
798567,3,5,8,1.386787,103.879585
798568,1,0,1,1.385722,103.878976
798569,3,6,9,1.386765,103.879481
798571,2,24,26,1.386746,103.879379
798572,0,1,1,1.385844,103.879171
798573,218,2,220,1.386724,103.879331
798574,40,5,45,1.38596,103.879365
798575,5,29,34,1.386707,103.879235
798576,13,3,16,1.386004,103.87944
798577,0,8,8,1.386672,103.879139
798578,0,3,3,1.385763,103.87904
798579,0,31,31,1.38665,103.87908
798581,19,28,47,1.386597,103.878999
798583,25,22,47,1.386576,103.878957
798584,2,0,2,1.386217,103.879648
798585,17,2,19,1.386226,103.879786
798586,0,3,3,1.386015,103.879473
798587,1,0,1,1.385915,103.879314
798588,5,0,5,1.386358,103.879898
798589,1,0,1,1.386308,103.879865
798590,9,3,12,1.386452,103.87998
798592,464,83,547,1.388199,103.878493
798593,590,128,718,1.388165,103.879181
798594,761,132,893,1.387997,103.879813
798595,691,16,707,1.387613,103.87934
798608,47,24,71,1.384813,103.877642
798609,4,23,27,1.384717,103.877647
798610,1,4,5,1.384779,103.877702
798611,0,3,3,1.386265,103.879812
798612,2,0,2,1.386136,103.87966
798613,16,0,16,1.384643,103.877771
798614,1,1,2,1.384736,103.877761
798615,11,3,14,1.384607,103.877816
798616,30,0,30,1.384659,103.877872
798617,4,2,6,1.384649,103.877913
798618,11,0,11,1.384637,103.877943
798635,11,12,23,1.406736,103.871348
798636,1,1,2,1.384693,103.877813
798637,71,0,71,1.406488,103.871625
798638,2,1,3,1.384674,103.8777
798639,17,3,20,1.406566,103.871515
798640,3,3,6,1.406616,103.87159
798641,7,1,8,1.406637,103.871403
798642,24,1,25,1.406786,103.871414
798643,1,0,1,1.386404,103.879947
798644,13,0,13,1.406995,103.871286
798646,27,2,29,1.407214,103.871247
798647,4,2,6,1.407277,103.871164
798650,299,1,300,1.407701,103.871252
798651,1,1,2,1.40644,103.871704
798652,1,0,1,1.406897,103.871229
798655,0,1,1,1.407929,103.871535
798657,2,0,2,1.407873,103.871354
798658,1,51,52,1.40811,103.871995
798659,0,2,2,1.408216,103.872083
798676,1,8,9,1.403978,103.871098
798677,0,1,1,1.4081,103.87183
798679,1,0,1,1.404066,103.870801
798680,7,2,9,1.404382,103.870778
798681,1,30,31,1.405626,103.869795
798682,0,1,1,1.405415,103.869948
798683,13,0,13,1.405228,103.869945
798684,132,0,132,1.404812,103.870581
798685,25,0,25,1.406102,103.869505
798686,175,1,176,1.404939,103.870494
798687,43,6,49,1.406049,103.869715
798688,176,0,176,1.405137,103.870351
798689,10,3,13,1.40662,103.86921
798690,6,0,6,1.405233,103.870266
798691,10,0,10,1.405813,103.870401
798692,28,0,28,1.407004,103.868982
798694,0,2,2,1.40706,103.871781
798695,55,0,55,1.405797,103.869915
798696,0,8,8,1.406188,103.869482
798697,27,0,27,1.406306,103.869378
798698,0,5,5,1.406,103.869773
798699,193,1,194,1.406561,103.869919
798700,1,5,6,1.406333,103.869744
798701,38,0,38,1.40638,103.869538
798702,0,3,3,1.406578,103.871669
798703,39,0,39,1.406569,103.869397
798704,0,4,4,1.385623,103.878764
798705,25,0,25,1.406823,103.869267
798706,0,4,4,1.406657,103.869366
798707,6,1,7,1.407086,103.869064
798708,1,2,3,1.406445,103.869492
798725,1,65,66,1.398545,103.873458
798726,5,514,519,1.398634,103.873391
798727,2,1,3,1.407195,103.86883
798728,10,17,27,1.398396,103.873543
798729,82,112,194,1.398784,103.873768
798730,7,5,12,1.398321,103.873566
798731,0,1,1,1.404483,103.870692
798732,10,0,10,1.398247,103.873606
798733,3,6,9,1.398153,103.873809
798734,0,4,4,1.406879,103.869205
798735,10,2,12,1.398391,103.873707
798736,3,2,5,1.397945,103.873889
798737,33,1,34,1.398062,103.873849
798738,1,2,3,1.398476,103.873498
798739,2,0,2,1.405688,103.869981
798740,4,0,4,1.398509,103.8739
798741,97,3,100,1.397966,103.873731
798742,2,8,10,1.3979,103.874125
798744,0,3,3,1.397854,103.873911
798745,5,5,10,1.39758,103.873786
798747,1,18,19,1.397223,103.873724
798748,1,0,1,1.398729,103.873823
798750,2,1,3,1.397743,103.874154
798751,6,7,13,1.396749,103.87369
798752,3,3,6,1.397076,103.873883
798753,9,0,9,1.396845,103.873708
798755,0,1,1,1.397148,103.873719
798756,1,1,2,1.398029,103.873692
798757,0,9,9,1.396875,103.873872
798758,3,0,3,1.397144,103.873889
798759,1,7,8,1.396795,103.873872
798760,9,1,10,1.39668,103.873855
798761,1,14,15,1.396594,103.873849
798762,15,0,15,1.396272,103.873668
798763,1,1,2,1.39665,103.873691
798764,0,5,5,1.396088,103.87364
798765,1,51,52,1.396461,103.873815
798766,2,2,4,1.398268,103.873736
798767,0,24,24,1.396329,103.87381
798768,0,1,1,1.396938,103.873872
798769,0,10,10,1.396215,103.873774
798770,3,1,4,1.39602,103.87364
798771,1,4,5,1.396097,103.873781
798773,21,3,24,1.39571,103.8736
798774,12,1,13,1.395914,103.873784
798775,18,2,20,1.395826,103.873749
798776,5,1,6,1.396003,103.87378
798777,1,2,3,1.396553,103.873685
798778,3,5,8,1.395753,103.873728
798779,1,4,5,1.39562,103.873752
798780,1,0,1,1.395865,103.873634
798781,1,5,6,1.395533,103.873746
798782,11,0,11,1.395498,103.873577
798783,2,0,2,1.396197,103.873657
798784,16,153,169,1.395378,103.87356
798785,5,0,5,1.398098,103.873663
798787,10,6,16,1.397479,103.873779
798788,6,694,700,1.395397,103.873747
798801,10,7,17,1.39724,103.874072
798802,9,1,10,1.39725,103.873947
798807,2,0,2,1.39543,103.873566
798911,0,3,3,1.395647,103.873594
798912,0,1,1,1.395573,103.873594
798913,0,1,1,1.405238,103.867066
798914,1,3,4,1.39579,103.873611
798915,0,18,18,1.405152,103.866749
798916,0,8,8,1.405121,103.866667
798917,0,10,10,1.405082,103.866563
798934,70,4,74,1.40491,103.871372
798935,3,3,6,1.405025,103.871288
798936,68,2,70,1.405814,103.871021
798937,1,0,1,1.405224,103.866959
798938,14,0,14,1.405496,103.871055
798939,15,1,16,1.405643,103.870936
798940,25,0,25,1.405819,103.870827
798944,26,0,26,1.406457,103.870409
798946,3,1,4,1.405189,103.866864
798947,1,1,2,1.299509,103.837
798948,0,5,5,1.407089,103.870009
798949,1,0,1,1.40536,103.871105
798950,24,4,28,1.407296,103.869873
798951,2,1,3,1.405288,103.867152
798968,0,3,3,1.407378,103.869811
798978,0,1,1,1.407242,103.869921
798980,0,15,15,1.404772,103.866866
798982,0,7,7,1.404742,103.866705
798987,1,2,3,1.404855,103.868178
798988,0,1,1,1.40481,103.867047
798989,0,3,3,1.404597,103.866674
799005,22,9,31,1.386015,103.877985
799006,2,3,5,1.386083,103.878035
799007,9,2,11,1.386251,103.878214
799008,0,1,1,1.404622,103.866805
799009,5,1,6,1.386372,103.878317
799010,29,0,29,1.386441,103.878385
799011,5,0,5,1.386534,103.878416
799012,2,3,5,1.386667,103.878424
799013,28,11,39,1.386761,103.878433
799014,15,224,239,1.386847,103.878433
799015,15,11,26,1.388082,103.877876
799016,1,6,7,1.384118,103.877563
799017,1,9,10,1.38426,103.87747
799018,5,9,14,1.388228,103.877367
799019,7,0,7,1.384368,103.877535
799020,1,21,22,1.388222,103.877075
799021,2,0,2,1.406928,103.870105
799022,11,10,21,1.387986,103.876495
799023,1,0,1,1.386312,103.878266
799024,9,7,16,1.386101,103.878221
799026,5,6,11,1.386121,103.878261
799027,12,9,21,1.387601,103.875752
799029,1,12,13,1.387066,103.874456
799030,20,5,25,1.387099,103.874339
799031,22,255,277,1.387049,103.8742
799032,4,2,6,1.388056,103.877927
799033,7,5,12,1.387316,103.875107
799035,1074,99,1173,1.387117,103.879105
799036,712,82,794,1.387572,103.878472
799048,82,21,103,1.397863,103.871974
799049,3,11,14,1.397837,103.87192
799050,7,1,8,1.397831,103.871984
799051,2,10,12,1.397788,103.871933
799052,135,0,135,1.397778,103.872002
799053,39,1,40,1.397743,103.87196
799054,15,3,18,1.397727,103.872028
799055,2,0,2,1.388222,103.877075
799056,318,1,319,1.397685,103.872038
799058,7,0,7,1.397631,103.872056
799059,221,1,222,1.397597,103.872013
799060,27,0,27,1.397548,103.872025
799061,6,0,6,1.397597,103.872074
799062,1,0,1,1.387986,103.876495
799063,8,0,8,1.397514,103.872098
799065,2,0,2,1.397688,103.871968
799066,4,0,4,1.406814,103.870174
799067,14,0,14,1.397344,103.872095
799068,4,0,4,1.397387,103.872105
799069,5,0,5,1.39727,103.872081
799070,0,1,1,1.397553,103.872085
799089,2,1,3,1.404887,103.868251
799090,1,2,3,1.397862,103.872437
799091,2,1,3,1.397961,103.872322
799092,0,3,3,1.397838,103.872454
799093,2,0,2,1.397425,103.872098
799094,0,1,1,1.39724,103.872075
799095,14,0,14,1.397765,103.872485
799096,2,2,4,1.397305,103.87209
799097,54,3,57,1.397716,103.872505
799098,0,7,7,1.397595,103.872453
799100,1,10,11,1.397479,103.872451
799101,15,1,16,1.397388,103.872425
799102,0,2,2,1.397801,103.872468
799103,1,0,1,1.397801,103.872402
799104,3,5,8,1.397489,103.872507
799105,0,1,1,1.397308,103.872425
799106,24,3,27,1.397431,103.872498
799108,1,0,1,1.397222,103.872425
799109,3,0,3,1.397898,103.872368
799110,1,0,1,1.397357,103.872498
799112,5,4,9,1.397225,103.872485
799113,15,1,16,1.396844,103.872357
799114,4,0,4,1.397711,103.872441
799116,12,0,12,1.397102,103.87248
799117,2,3,5,1.396661,103.872346
799118,2,0,2,1.397546,103.872507
799119,1,0,1,1.397283,103.872492
799120,0,2,2,1.397027,103.872463
799121,0,2,2,1.396958,103.872452
799122,4,0,4,1.397162,103.87248
799123,0,1,1,1.39658,103.872351
799124,4,0,4,1.396908,103.872442
799126,6,0,6,1.396742,103.872432
799128,1,1,2,1.396517,103.872337
799129,1,0,1,1.396477,103.872335
799131,1,0,1,1.396555,103.872413
799133,1,0,1,1.396433,103.872397
799135,4,1,5,1.39626,103.872387
799136,5,1,6,1.396135,103.872367
799137,47,0,47,1.396097,103.872352
799138,9,2,11,1.39604,103.872339
799139,2,1,3,1.397027,103.872385
799140,10,15,25,1.397943,103.872416
799155,7,11,18,1.398203,103.872261
799156,10,248,258,1.398265,103.872303
799157,19,4,23,1.398347,103.872211
799158,1,3,4,1.396845,103.872446
799159,1,0,1,1.396316,103.87238
799160,1,2,3,1.39799,103.872396
799161,24,4,28,1.398481,103.872136
799162,9,45,54,1.398591,103.87217
799163,2,1,3,1.398467,103.872221
799164,4,0,4,1.398344,103.872261
799165,28,0,28,1.398567,103.872102
799166,1,10,11,1.398871,103.872059
799167,0,1,1,1.398452,103.872153
799168,20,0,20,1.398647,103.872068
799169,0,50,50,1.399052,103.871997
799171,1,23,24,1.399086,103.871991
799172,20,0,20,1.398788,103.872023
799173,1,0,1,1.399012,103.872008
799174,9,1,10,1.398846,103.872003
799175,2,1,3,1.398521,103.872125
799176,11,0,11,1.398886,103.871991
799177,49,36,85,1.399189,103.87194
799178,1,3,4,1.398691,103.872127
799179,1,2,3,1.399149,103.871968
799180,2,0,2,1.396619,103.872419
799181,3,27,30,1.399252,103.871906
799182,22,1,23,1.399035,103.871912
799183,5,3,8,1.399281,103.871894
799184,0,1,1,1.399115,103.871974
799185,5,48,53,1.399309,103.871877
799187,0,20,20,1.399344,103.871871
799188,4,1,5,1.399206,103.871832
799189,3,7,10,1.399378,103.871849
799191,1,117,118,1.399413,103.871832
799192,0,4,4,1.398932,103.871969
799193,1,4,5,1.399441,103.87182
799194,10,0,10,1.399373,103.871769
799195,2,49,51,1.399481,103.871797
799197,5,89,94,1.399521,103.871786
799198,1,1,2,1.398989,103.87194
799199,2,0,2,1.399458,103.871729
799200,8,0,8,1.39951,103.871724
799201,2,90,92,1.399596,103.871763
799202,2,1,3,1.399224,103.871923
799203,1,2,3,1.399539,103.871701
799204,2,0,2,1.399556,103.87178
799205,10,82,92,1.399659,103.871735
799206,1,0,1,1.399092,103.871883
799207,10,13,23,1.399705,103.871718
799208,15,3,18,1.399693,103.871638
799209,3,29,32,1.399913,103.871704
799210,2,2,4,1.399321,103.871786
799211,3,6,9,1.399971,103.871687
799212,0,2,2,1.39959,103.871684
799213,3,8,11,1.400034,103.871653
799215,1,0,1,1.399642,103.871667
799217,1,99,100,1.400154,103.871596
799218,10,0,10,1.400071,103.87149
799220,1,1,2,1.399917,103.871581
799221,1,4,5,1.400269,103.871533
799223,3,5,8,1.400303,103.87151
799225,106,50,156,1.400349,103.871488
799226,12,1,13,1.400298,103.871398
799227,6,71,77,1.400406,103.871448
799228,29,0,29,1.400358,103.871373
799229,19,0,19,1.400408,103.87135
799231,0,13,13,1.400354,103.871334
799248,3,1,4,1.39986,103.871593
799249,5,2,7,1.398171,103.871846
799250,4,2,6,1.398033,103.87181
799251,3,0,3,1.39963,103.871752
799252,7,0,7,1.398099,103.871777
799253,3,1,4,1.397976,103.871842
799254,8,0,8,1.398153,103.871755
799255,4,8,12,1.398614,103.871668
799256,6,1,7,1.398234,103.871725
799258,10,1,11,1.398292,103.871686
799259,2,1,3,1.398359,103.871772
799260,1,1,2,1.400129,103.871467
799261,1,0,1,1.400091,103.871624
799262,5,7,12,1.39925,103.871371
799263,20,2,22,1.39856,103.871565
799264,2,1,3,1.398976,103.8715
799265,6,2,8,1.39867,103.871512
799266,5,0,5,1.399776,103.871169
799267,215,1,216,1.398797,103.871439
799268,2,3,5,1.399959,103.871101
799269,3,2,5,1.398925,103.871386
799270,1,1,2,1.39909,103.871462
799271,13,3,16,1.399053,103.871334
799272,0,4,4,1.39848,103.871716
799273,10,3,13,1.399166,103.871261
799274,3,1,4,1.400412,103.870878
799276,0,2,2,1.400151,103.870989
799277,8,0,8,1.400003,103.870937
799278,3,0,3,1.399389,103.871326
799280,15,9,24,1.400474,103.870741
799281,2,3,5,1.399687,103.871096
799282,3,0,3,1.400138,103.87085
799283,2,3,5,1.399824,103.870981
799284,5,0,5,1.400008,103.870927
799285,5,0,5,1.400148,103.870839
799287,10,0,10,1.400182,103.870974
799288,3,1,4,1.399317,103.871207
799289,1,1,2,1.399813,103.870996
799291,3,0,3,1.399694,103.871083
799292,3,0,3,1.398674,103.871506
799293,8,2,10,1.398932,103.871381
799294,21,0,21,1.399057,103.871329
799295,4,0,4,1.398867,103.871546
799296,0,4,4,1.399185,103.871256
799317,109,13,122,1.400474,103.870163
799318,1,126,127,1.4005,103.870065
799319,0,1,1,1.39846,103.87162
799320,1,2,3,1.398803,103.871436
799321,1,0,1,1.400411,103.870191
799322,0,1,1,1.400359,103.870214
799323,11,0,11,1.400296,103.870265
799324,0,1,1,1.40038,103.870139
799325,36,3,39,1.400233,103.870305
799326,6,1,7,1.400214,103.870225
799327,4,0,4,1.399456,103.871292
799328,13,1,14,1.400133,103.870259
799329,0,3,3,1.400431,103.870105
799330,38,0,38,1.40005,103.870385
799331,3,6,9,1.399962,103.870339
799332,33,0,33,1.399976,103.870414
799333,22,0,22,1.399893,103.870384
799334,23,2,25,1.399895,103.870454
799335,1,3,4,1.400159,103.870334
799337,1,2,3,1.40007,103.870293
799338,2,0,2,1.398405,103.871648
799341,0,1,1,1.4003,103.870173
799342,2,0,2,1.399735,103.870533
799343,6,1,7,1.399527,103.870557
799358,2,46,48,1.386465,103.874909
799359,0,22,22,1.386449,103.874927
799360,19,1,20,1.386528,103.87495
799361,31,2,33,1.3865,103.87498
799362,61,6,67,1.386621,103.87504
799363,549,6,555,1.386591,103.875065
799364,1,9,10,1.386709,103.875125
799365,1,2,3,1.399755,103.870453
799366,2,0,2,1.399608,103.870516
799367,1,0,1,1.399575,103.870619
799368,2,5,7,1.386509,103.875419
799369,0,3,3,1.386687,103.87515
799371,1,46,47,1.386556,103.875392
799372,42,112,154,1.386359,103.875514
799373,2,3,5,1.386391,103.875729
799374,106,14,120,1.386325,103.875796
799375,21,9,30,1.386288,103.875612
799376,5,5,10,1.386164,103.875977
799377,7,0,7,1.386121,103.876032
799378,0,6,6,1.386214,103.875695
799379,0,2,2,1.386672,103.875428
799380,1,5,6,1.385905,103.876248
799381,0,80,80,1.386239,103.875652
799384,42,56,98,1.386167,103.875753
799385,0,1,1,1.386628,103.875465
799386,1,0,1,1.385376,103.8766
799387,13,7,20,1.386085,103.875842
799388,54,1,55,1.385171,103.876794
799389,5,0,5,1.38519,103.876776
799391,14,13,27,1.384776,103.876957
799392,0,30,30,1.386062,103.875882
799393,14,1,15,1.384712,103.876998
799394,0,7,7,1.385916,103.876018
799395,4,0,4,1.39983,103.870407
799396,2,3,5,1.385903,103.876085
799397,2,0,2,1.385883,103.87628
799398,3,1,4,1.384593,103.877038
799399,22,2,24,1.384307,103.877084
799400,0,22,22,1.38569,103.876265
799401,12,5,17,1.384164,103.877107
799402,4,26,30,1.385609,103.876333
799403,1,27,28,1.384031,103.87712
799404,2,2,4,1.385742,103.876202
799405,1,2,3,1.386571,103.875539
799406,1,5,6,1.38539,103.876527
799407,1,8,9,1.385145,103.876671
799408,4,4,8,1.385172,103.876657
799409,2,2,4,1.385587,103.87639
799410,9,2,11,1.384731,103.876642
799411,7,14,21,1.384657,103.876688
799413,1,0,1,1.385375,103.876599
799414,163,9,172,1.384397,103.877032
799415,6,9,15,1.384175,103.877067
799416,14,62,76,1.38403,103.877108
799417,1,8,9,1.384502,103.877013
799418,8,0,8,1.386442,103.875669
799419,6,36,42,1.38714,103.874866
799420,3,4,7,1.387108,103.874908
799421,8,1,9,1.387082,103.874939
799422,0,1,1,1.384571,103.876999
799423,0,1,1,1.387049,103.874967
799424,1,0,1,1.38702,103.875002
799426,0,1,1,1.38699,103.875027
799427,4,0,4,1.384947,103.876783
799429,0,1,1,1.386888,103.875134
799430,12,10,22,1.384751,103.876829
799431,0,3,3,1.385468,103.876457
799432,13,4,17,1.386253,103.875633
799433,3,401,404,1.389031,103.869011
799434,1,142,143,1.389134,103.868757
799436,228,120,348,1.394195,103.872078
799439,0,214,214,1.39507,103.872627
799440,4,267,271,1.395588,103.873056
799441,0,70,70,1.3955,103.87305
799442,13,87,100,1.395731,103.872901
799443,1,15,16,1.395657,103.873067
799444,1,26,27,1.395762,103.873073
799445,2,31,33,1.395799,103.872895
799446,3,37,40,1.395847,103.873084
799447,0,20,20,1.395836,103.872903
799448,57,91,148,1.395998,103.87311
799449,1,78,79,1.395931,103.872906
799450,42,86,128,1.396163,103.873129
799451,3,39,42,1.396,103.872912
799452,18,260,278,1.396377,103.873165
799453,13,42,55,1.396057,103.872912
799454,32,116,148,1.396478,103.873176
799455,1,32,33,1.396098,103.872923
799456,11,17,28,1.396579,103.87318
799457,4,80,84,1.396177,103.872929
799458,8,113,121,1.39679,103.873205
799459,10,102,112,1.396242,103.872935
799460,1,107,108,1.39702,103.873209
799461,27,129,156,1.39628,103.872929
799462,7,400,407,1.397105,103.87322
799463,18,0,18,1.396349,103.872935
799464,48,17,65,1.397254,103.873197
799465,10,165,175,1.396402,103.872968
799466,64,372,436,1.397613,103.873217
799467,7,0,7,1.396464,103.872935
799468,5,23,28,1.397665,103.873212
799469,7,127,134,1.396521,103.87294
799470,15,125,140,1.397716,103.873212
799471,14,158,172,1.39657,103.872938
799472,18,94,112,1.397768,103.873212
799473,12,202,214,1.396636,103.872952
799475,109,23,132,1.397814,103.8732
799476,8,108,116,1.396693,103.872957
799478,10,409,419,1.397865,103.873195
799479,4,89,93,1.396739,103.872969
799481,13,148,161,1.397911,103.873189
799482,3,0,3,1.385121,103.8767
799484,14,449,463,1.397965,103.873174
799485,1,165,166,1.396873,103.87299
799487,149,976,1125,1.398012,103.873157
799488,11,57,68,1.396905,103.872989
799490,6,118,124,1.396965,103.872972
799491,12,142,154,1.397034,103.872979
799493,25,171,196,1.397105,103.87298
799495,19,128,147,1.397146,103.872991
799497,36,166,202,1.397188,103.872992
799499,8,95,103,1.397443,103.872866
799501,12,182,194,1.3973,103.873008
799503,16,152,168,1.397335,103.873017
799505,60,111,171,1.397399,103.873014
799507,6,278,284,1.397484,103.873025
799508,1,122,123,1.397541,103.873031
799509,2,175,177,1.39761,103.873037
799510,1,53,54,1.397673,103.873042
799511,10,570,580,1.397712,103.873046
799512,159,53,212,1.402264,103.871224
799529,3,59,62,1.407265,103.868374
799530,1,0,1,1.385992,103.875955
799531,313,205,518,1.407153,103.867638
799533,0,4,4,1.386036,103.876113
799534,5,25,30,1.407187,103.866892
799539,1,0,1,1.406827,103.866796
799541,1,0,1,1.407633,103.865541
799543,1,0,1,1.408011,103.865524
799548,1,0,1,1.408372,103.865564
799549,0,1,1,1.410419,103.866381
799552,2,0,2,1.38445,103.877061
799554,0,1,1,1.410594,103.866518
799557,3,26,29,1.41008,103.86425
799573,0,65,65,1.406175,103.865955
799574,0,5,5,1.406291,103.86588
799575,0,1,1,1.411051,103.867378
799595,1,0,1,1.406405,103.865701
799632,1,1,2,1.410972,103.867148
799635,0,1,1,1.409538,103.871145
799636,0,1,1,1.410004,103.867028
799652,57,52,109,1.387419,103.877585
799653,1,36,37,1.387464,103.877473
799654,8,0,8,1.387454,103.877653
799655,4,1,5,1.38749,103.877516
799656,3,1,4,1.407068,103.86691
799657,1,1,2,1.410916,103.866996
799659,3,0,3,1.396787,103.872968
799660,14,0,14,1.387531,103.877815
799661,26,0,26,1.38761,103.877772
799662,3,2,5,1.387557,103.877858
799663,38,12,50,1.38765,103.877888
799664,14,0,14,1.387583,103.877892
799665,104,6,110,1.3877,103.878005
799666,0,6,6,1.387591,103.877935
799667,8,0,8,1.387617,103.877969
799668,6,1,7,1.387284,103.877501
799669,11,0,11,1.387256,103.877464
799686,3,5,8,1.386391,103.877453
799687,3,4,7,1.386359,103.877444
799688,46,1,47,1.386239,103.877398
799690,1,0,1,1.409789,103.866833
799691,36,0,36,1.386182,103.877372
799692,3,0,3,1.387558,103.877635
799693,0,1,1,1.386124,103.877311
799694,20,0,20,1.385934,103.876641
799695,153,2,155,1.386038,103.876772
799696,4,0,4,1.387494,103.87771
799697,7,0,7,1.387215,103.877078
799698,196,0,196,1.38724,103.877031
799699,61,2,63,1.387252,103.877002
799700,1,1,2,1.387515,103.87755
799701,25,2,27,1.386293,103.877065
799703,4,0,4,1.387131,103.877162
799704,56,0,56,1.386896,103.877171
799705,1,2,3,1.386023,103.877051
799706,1,0,1,1.387093,103.877209
799707,5,0,5,1.387027,103.877033
799708,1,0,1,1.387012,103.877057
799709,4,3,7,1.38705,103.876875
799711,25,0,25,1.386936,103.876726
799713,9,1,10,1.386402,103.876266
799714,1,3,4,1.386933,103.87686
799716,8,1,9,1.387011,103.876026
799718,1,1,2,1.387266,103.876951
799719,8,1,9,1.387139,103.875895
799720,20,10,30,1.387218,103.875808
799721,11,0,11,1.387296,103.875722
799722,0,13,13,1.387374,103.875636
799723,29,13,42,1.386937,103.876159
799724,8,1,9,1.387453,103.875549
799725,0,1,1,1.387072,103.876916
799726,3,13,16,1.387473,103.875509
799728,2,0,2,1.387061,103.875981
799729,9,7,16,1.387139,103.875915
799731,68,10,78,1.387296,103.875742
799732,25,0,25,1.387374,103.875656
799733,56,25,81,1.387453,103.875569
799734,6,6,12,1.387492,103.875546
799735,6,2,8,1.386696,103.877452
799736,5,1,6,1.386789,103.877394
799737,13,0,13,1.386894,103.877325
799738,18,1,19,1.386998,103.877287
799739,6,1,7,1.385871,103.876729
799740,1,0,1,1.386973,103.876114
799741,56,1,57,1.385776,103.876546
799742,25,15,40,1.385743,103.876483
799743,4,0,4,1.386913,103.876135
799744,1,1,2,1.387061,103.876001
799745,6,0,6,1.386921,103.876464
799746,4,4,8,1.386906,103.87642
799747,2,23,25,1.38688,103.87637
799748,1,0,1,1.385817,103.876609
799749,0,4,4,1.386998,103.876586
799750,4,2,6,1.386597,103.876451
799751,0,2,2,1.386953,103.876505
799752,1,3,4,1.386651,103.876425
799753,4,1,5,1.403194,103.87043
799754,7,1,8,1.40339,103.869437
799759,2,2,4,1.403073,103.870894
799761,71,0,71,1.403234,103.869624
799763,2,0,2,1.403392,103.870691
799764,0,1,1,1.386729,103.876402
799766,0,1,1,1.404011,103.867019
799767,0,3,3,1.386949,103.877115
799768,0,4,4,1.403195,103.8699
799769,0,2,2,1.403246,103.869477
799772,0,1,1,1.404888,103.866066
799778,0,1,1,1.405412,103.865479
799780,0,1,1,1.403738,103.867306
799787,0,2,2,1.403389,103.868661
799789,1,0,1,1.403921,103.866947
799791,1,20,21,1.405668,103.864931
799808,5,16,21,1.38757,103.877172
799810,8,0,8,1.387708,103.877214
799811,4,1,5,1.387851,103.877188
799812,1,1,2,1.405016,103.865696
799813,1,2,3,1.403327,103.869053
799814,1,3,4,1.404992,103.865961
799815,4,2,6,1.387897,103.877265
799816,1,1,2,1.387794,103.877231
799817,1,0,1,1.405278,103.865371
799818,1,2,3,1.387909,103.877204
799819,3,1,4,1.387845,103.877248
799836,0,2,2,1.387949,103.877291
799838,0,1,1,1.387992,103.877308
799840,0,1,1,1.404414,103.865578
799841,10,0,10,1.404632,103.865793
799842,15,23,38,1.40485,103.865968
799843,3,409,412,1.40484,103.865978
799860,17,0,17,1.386006,103.87759
799861,2,0,2,1.404305,103.86548
799862,36,0,36,1.386518,103.877889
799863,0,5,5,1.386526,103.877676
799865,23,3,26,1.386543,103.877633
799882,0,2,2,1.386051,103.877593
799883,0,1,1,1.404632,103.865773
799884,22,2,24,1.404521,103.870005
799885,0,2,2,1.404509,103.870176
799886,76,11,87,1.404592,103.869834
799887,0,1,1,1.405366,103.86867
799888,0,4,4,1.388086,103.877342
799889,0,1,1,1.405763,103.868487
799890,5,0,5,1.404711,103.869472
799891,0,1,1,1.405879,103.868444
799892,4,0,4,1.404626,103.869689
799893,0,2,2,1.4056,103.86855
799894,16,5,21,1.404961,103.869172
799895,0,12,12,1.406396,103.868243
799897,1,32,33,1.406522,103.868212
799898,4,0,4,1.404778,103.869336
799899,84,0,84,1.405301,103.868838
799900,14,0,14,1.405415,103.868793
799901,9,1,10,1.40562,103.868679
799902,14,1,15,1.405716,103.868641
799903,6,4,10,1.405907,103.868598
799904,3,7,10,1.406056,103.868534
799905,11,3,14,1.406188,103.86846
799906,3,12,15,1.4063,103.868434
799940,0,31,31,1.406327,103.866959
799941,1,128,129,1.406221,103.866585
799977,5,1,6,1.409136,103.87009
799979,0,4,4,1.405185,103.868953
799981,0,10,10,1.408828,103.871068
799983,0,16,16,1.409199,103.871181
799984,1,2,3,1.388035,103.877325
804527,3,0,3,1.40912,103.871209
804536,0,4,4,1.408576,103.870215
804540,3,0,3,1.299509,103.837
804552,6,1,7,1.387944,103.856665
804563,0,4,4,1.299509,103.837
804564,0,1,1,1.406137,103.86833
804567,1,0,1,1.299509,103.837
804571,0,1,1,1.299509,103.837
804572,0,1,1,1.299509,103.837
804573,0,1,1,1.299509,103.837
804574,0,2,2,1.406277,103.868287
804577,0,1,1,1.299509,103.837
804581,0,5,5,1.299509,103.837
804708,0,1,1,1.299509,103.837
804709,0,2,2,1.299509,103.837
804721,2,0,2,1.299509,103.837
804732,1,0,1,1.299509,103.837
804758,1,4,5,1.299509,103.837
804788,1,0,1,1.299509,103.837
804797,0,38,38,1.299509,103.837
804805,0,5,5,1.299509,103.837
804807,0,1,1,1.299509,103.837
804808,0,1,1,1.299509,103.837
804815,3,6,9,1.299509,103.837
804816,10,2,12,1.299509,103.837
804817,1,4,5,1.299509,103.837
804818,0,2,2,1.299509,103.837
804819,1,7,8,1.299509,103.837
804820,0,7,7,1.299509,103.837
804821,1,0,1,1.299509,103.837
804822,1,1,2,1.299509,103.837
804823,0,1,1,1.299509,103.837
804824,7,0,7,1.299509,103.837
804825,0,1,1,1.299509,103.837
804826,1,2,3,1.299509,103.837
804827,7,1,8,1.299509,103.837
804828,6,0,6,1.299509,103.837
804830,0,1,1,1.299509,103.837
804831,2,1,3,1.299509,103.837
804832,0,1,1,1.299509,103.837
804833,16,0,16,1.299509,103.837
804834,0,2,2,1.299509,103.837
804835,5,2,7,1.299509,103.837
804836,29,4,33,1.299509,103.837
804837,6,1,7,1.299509,103.837
804838,1,1,2,1.299509,103.837
804839,5,7,12,1.299509,103.837
804840,1,1,2,1.299509,103.837
804841,8,3,11,1.299509,103.837
804842,2,0,2,1.299509,103.837
804843,0,4,4,1.299509,103.837
804844,0,2,2,1.299509,103.837
804845,1,4,5,1.299509,103.837
804846,18,1,19,1.299509,103.837
804847,14,0,14,1.299509,103.837
804848,3,2,5,1.299509,103.837
804849,5,0,5,1.299509,103.837
804850,1,2,3,1.299509,103.837
804851,6,0,6,1.299509,103.837
804852,23,0,23,1.299509,103.837
804853,9,0,9,1.299509,103.837
804854,17,0,17,1.299509,103.837
804855,5,0,5,1.299509,103.837
804856,3,1,4,1.299509,103.837
804857,0,1,1,1.299509,103.837
804858,5,1,6,1.299509,103.837
804859,2,1,3,1.299509,103.837
804860,13,1,14,1.299509,103.837
804861,3,0,3,1.299509,103.837
804862,2,1,3,1.299509,103.837
804863,6,0,6,1.299509,103.837
804864,2,0,2,1.299509,103.837
804865,2,2,4,1.299509,103.837
804866,2,0,2,1.299509,103.837
804867,7,1,8,1.299509,103.837
804868,1,0,1,1.299509,103.837
804869,8,1,9,1.380583,103.870648
804870,1,0,1,1.299509,103.837
804871,18,1,19,1.299509,103.837
804872,6,2,8,1.299509,103.837
804873,0,2,2,1.299509,103.837
804874,4,3,7,1.299509,103.837
804875,2,6,8,1.299509,103.837
804876,4,3,7,1.299509,103.837
804877,2,4,6,1.299509,103.837
804878,6,1,7,1.299509,103.837
804879,2,8,10,1.299509,103.837
804880,81,4,85,1.299509,103.837
804881,1,0,1,1.299509,103.837
804882,2,0,2,1.299509,103.837
804884,0,2,2,1.299509,103.837
804885,0,1,1,1.299509,103.837
804886,8,0,8,1.299509,103.837
804887,40,0,40,1.299509,103.837
804889,12,1,13,1.299509,103.837
804890,4,0,4,1.299509,103.837
804891,2,1,3,1.299509,103.837
804892,0,3,3,1.299509,103.837
804893,9,3,12,1.299509,103.837
804894,1,1,2,1.299509,103.837
804895,4,1,5,1.299509,103.837
804896,6,3,9,1.379771,103.869877
804897,21,2,23,1.299509,103.837
804898,0,1,1,1.299509,103.837
804899,4,7,11,1.299509,103.837
804900,2,2,4,1.299509,103.837
804901,2,4,6,1.299509,103.837
804902,18,4,22,1.299509,103.837
804903,4,0,4,1.299509,103.837
804904,6,2,8,1.299509,103.837
804905,9,3,12,1.299509,103.837
804907,11,5,16,1.299509,103.837
804909,0,1,1,1.299509,103.837
804910,0,3,3,1.299509,103.837
804911,4,2,6,1.299509,103.837
804912,5,4,9,1.299509,103.837
804913,6,6,12,1.299509,103.837
804914,0,3,3,1.299509,103.837
804915,7,0,7,1.299509,103.837
804916,8,1,9,1.299509,103.837
804917,2,2,4,1.299509,103.837
804918,19,0,19,1.299509,103.837
804919,4,2,6,1.299509,103.837
804920,2,1,3,1.299509,103.837
804921,2,2,4,1.299509,103.837
804922,3,0,3,1.299509,103.837
804923,90,2,92,1.299509,103.837
804924,2,2,4,1.299509,103.837
804925,5,0,5,1.299509,103.837
804926,0,1,1,1.299509,103.837
804927,0,2,2,1.299509,103.837
804928,3,2,5,1.299509,103.837
804929,0,1,1,1.299509,103.837
804930,9,1,10,1.299509,103.837
804931,1,4,5,1.299509,103.837
804932,88,1,89,1.299509,103.837
804933,0,1,1,1.299509,103.837
804935,44,1,45,1.299509,103.837
804936,4,8,12,1.299509,103.837
804945,256,8,264,1.299509,103.837
804950,22,0,22,1.299509,103.837
804952,2,1,3,1.299509,103.837
804960,0,1,1,1.299509,103.837
804961,7,0,7,1.299509,103.837
804963,5,0,5,1.299509,103.837
804964,5,0,5,1.299509,103.837
804965,2,0,2,1.299509,103.837
804967,53,1,54,1.299509,103.837
804968,1,0,1,1.299509,103.837
804969,11,1,12,1.299509,103.837
804970,4,0,4,1.299509,103.837
804971,5,0,5,1.299509,103.837
804972,67,0,67,1.382246,103.863749
804973,2,0,2,1.299509,103.837
804974,21,0,21,1.299509,103.837
804975,32,0,32,1.299509,103.837
804976,3,0,3,1.299509,103.837
804977,221,0,221,1.299509,103.837
804978,9,0,9,1.299509,103.837
804979,15,0,15,1.299509,103.837
804980,7,0,7,1.299509,103.837
804981,17,0,17,1.299509,103.837
804982,8,0,8,1.299509,103.837
804983,6,0,6,1.299509,103.837
804984,4,0,4,1.299509,103.837
804985,5,0,5,1.299509,103.837
804986,64,0,64,1.299509,103.837
804987,26,0,26,1.299509,103.837
804988,3,0,3,1.299509,103.837
804990,8,0,8,1.299509,103.837
804992,125,0,125,1.299509,103.837
804993,1,0,1,1.299509,103.837
804994,7,0,7,1.299509,103.837
804996,2,0,2,1.299509,103.837
804997,4,0,4,1.299509,103.837
804998,2,0,2,1.299509,103.837
804999,27,0,27,1.299509,103.837
805000,1,0,1,1.299509,103.837
805001,1,1,2,1.299509,103.837
805002,1,0,1,1.299509,103.837
805004,2,1,3,1.299509,103.837
805006,3,0,3,1.299509,103.837
805007,2,0,2,1.299509,103.837
805008,11,0,11,1.299509,103.837
805009,6,0,6,1.299509,103.837
805010,4,0,4,1.299509,103.837
805012,3,0,3,1.299509,103.837
805013,0,1,1,1.299509,103.837
805014,37,1,38,1.299509,103.837
805031,3,0,3,1.299509,103.837
805032,1,0,1,1.299509,103.837
805033,92,0,92,1.299509,103.837
805034,32,0,32,1.299509,103.837
805035,2,0,2,1.299509,103.837
805036,30,10,40,1.299509,103.837
805037,12,0,12,1.299509,103.837
805038,4,1,5,1.299509,103.837
805039,1,0,1,1.299509,103.837
805040,15,0,15,1.299509,103.837
805041,7,0,7,1.299509,103.837
805042,4,0,4,1.299509,103.837
805068,17,0,17,1.299509,103.837
805069,8,0,8,1.299509,103.837
805070,2,0,2,1.299509,103.837
805071,6,0,6,1.299509,103.837
805072,16,0,16,1.299509,103.837
805073,0,4,4,1.299509,103.837
805074,3,4,7,1.299509,103.837
805075,14,0,14,1.299509,103.837
805076,1,0,1,1.299509,103.837
805077,13,0,13,1.299509,103.837
805078,7,3,10,1.380183,103.870921
805079,6,0,6,1.380213,103.87086
805080,4,2,6,1.380181,103.870778
805081,0,2,2,1.299509,103.837
805082,38,3,41,1.380183,103.870708
805083,2,10,12,1.380198,103.870616
805084,0,1,1,1.299509,103.837
805085,2,2,4,1.299509,103.837
805086,8,4,12,1.380195,103.870429
805087,2,2,4,1.380188,103.870505
805088,5,1,6,1.380156,103.870318
805089,1,2,3,1.299509,103.837
805090,54,1,55,1.380157,103.870207
805091,0,2,2,1.380206,103.870733
805092,0,3,3,1.380179,103.870257
805093,2,2,4,1.380183,103.870395
805094,1,2,3,1.380183,103.870133
805095,24,5,29,1.380174,103.869957
805096,33,11,44,1.379854,103.870947
805097,32,4,36,1.37987,103.870917
805098,13,2,15,1.379858,103.870822
805099,1,3,4,1.380153,103.870071
805100,49,2,51,1.379823,103.870666
805101,3,3,6,1.379857,103.870582
805102,0,1,1,1.380202,103.870591
805103,8,7,15,1.379816,103.870471
805104,23,7,30,1.379823,103.870389
805105,13,1,14,1.379847,103.870365
805106,3,1,4,1.379826,103.870731
805107,14,2,16,1.379835,103.87025
805108,43,1,44,1.379803,103.870203
805109,136,1,137,1.379798,103.870115
805110,5,1,6,1.379822,103.87006
805111,27,1,28,1.379798,103.870039
805112,8,26,34,1.379823,103.869981
805113,70,0,70,1.299509,103.837
805114,53,0,53,1.299509,103.837
805115,29,0,29,1.299509,103.837
805116,42,0,42,1.299509,103.837
805117,66,2,68,1.299509,103.837
805118,3,3,6,1.3803,103.873042
805119,0,6,6,1.380272,103.872995
805120,3,6,9,1.380298,103.872967
805121,246,8,254,1.380297,103.872888
805122,2,6,8,1.380274,103.872829
805123,3,1,4,1.379808,103.870308
805124,2,0,2,1.380178,103.870183
805125,2,0,2,1.380293,103.872747
805126,3,1,4,1.380264,103.872812
805127,2,2,4,1.380284,103.87262
805128,59,6,65,1.380258,103.872467
805129,0,2,2,1.380287,103.872673
805130,7,4,11,1.380278,103.872367
805131,12,2,14,1.380248,103.872309
805132,8,0,8,1.380245,103.872288
805133,16,2,18,1.380271,103.872207
805134,4,4,8,1.38023,103.872144
805135,9,3,12,1.380234,103.872094
805136,2,4,6,1.380254,103.872038
805137,3,3,6,1.380231,103.871987
805138,9,2,11,1.380253,103.871959
805139,22,4,26,1.380251,103.871884
805140,5,4,9,1.380251,103.871846
805141,0,2,2,1.380247,103.87244
805142,3,2,5,1.380219,103.871702
805143,2,2,4,1.380287,103.872518
805144,4,1,5,1.38024,103.871573
805145,5,2,7,1.380239,103.871509
805146,6,2,8,1.380226,103.871464
805147,0,2,2,1.380216,103.871752
805148,2,1,3,1.380175,103.869993
805149,45,2,47,1.380194,103.871295
805150,1,3,4,1.380237,103.871617
805151,1,5,6,1.380218,103.871186
805152,45,2,47,1.380224,103.871134
805153,10,1,11,1.380185,103.871107
805154,16,1,17,1.380209,103.871035
805155,24,50,74,1.379957,103.873528
805156,8,19,27,1.379961,103.873482
805157,2,5,7,1.379954,103.873398
805158,3,6,9,1.379973,103.873336
805159,40,7,47,1.379977,103.873319
805160,0,7,7,1.379979,103.873258
805161,8,2,10,1.379967,103.873207
805162,1,4,5,1.379937,103.87316
805163,1,3,4,1.380201,103.871251
805164,17,6,23,1.379969,103.873018
805165,4,13,17,1.379932,103.87293
805166,3,16,19,1.379935,103.872873
805167,3,3,6,1.379934,103.872845
805168,0,12,12,1.379931,103.872797
805169,0,5,5,1.379928,103.872707
805170,1,3,4,1.379944,103.873078
805171,1,2,3,1.380205,103.87138
805172,1,2,3,1.379946,103.872599
805173,38,9,47,1.379943,103.872528
805174,24,3,27,1.379944,103.87247
805175,14,4,18,1.379937,103.872352
805176,3,7,10,1.379927,103.872317
805177,60,11,71,1.379896,103.872186
805178,18,14,32,1.379921,103.872169
805179,15,10,25,1.379925,103.872067
805180,61,20,81,1.379896,103.872013
805181,24,39,63,1.37989,103.871912
805182,0,28,28,1.379887,103.871864
805183,16,25,41,1.379905,103.87174
805184,15,12,27,1.379906,103.87171
805185,0,7,7,1.37988,103.871636
805186,1,7,8,1.379875,103.871577
805187,0,7,7,1.379872,103.87155
805188,9,14,23,1.379895,103.871463
805189,41,21,62,1.379895,103.871418
805190,19,10,29,1.379882,103.871358
805191,2,24,26,1.379855,103.871339
805192,7,17,24,1.379879,103.871284
805193,2,17,19,1.37985,103.8712
805194,8,12,20,1.379878,103.871174
805195,2,4,6,1.379846,103.871089
805196,18,0,18,1.379849,103.871066
805197,43,5,48,1.380194,103.870941
805198,0,8,8,1.380323,103.873322
805199,4,2,6,1.380316,103.873263
805200,4,5,9,1.38029,103.873205
805201,2,2,4,1.379948,103.872658
805203,104,19,123,1.380337,103.873744
805204,0,1,1,1.379808,103.870517
805205,2,7,9,1.380319,103.873887
805206,1,3,4,1.38031,103.873182
805207,1,1,2,1.380228,103.87144
805208,17,1,18,1.380351,103.874013
805209,1,0,1,1.380321,103.873832
805210,0,2,2,1.380351,103.873965
805211,4,2,6,1.380357,103.874182
805212,0,1,1,1.380331,103.874074
805213,2,1,3,1.379944,103.872573
805215,10,0,10,1.380346,103.874462
805216,2,2,4,1.380316,103.873916
805217,2,0,2,1.380326,103.874122
805218,9,1,10,1.380378,103.874616
805219,0,1,1,1.380337,103.87426
805221,4,1,5,1.38039,103.874783
805222,15,2,17,1.380363,103.874809
805223,1,1,2,1.380355,103.874563
805224,1,4,5,1.380374,103.874978
805225,90,1,91,1.380367,103.87501
805226,4,0,4,1.380348,103.874487
805228,4,0,4,1.380398,103.875095
805229,10,2,12,1.380374,103.875252
805230,2,1,3,1.380336,103.874324
805231,3,6,9,1.380384,103.875356
805232,11,8,19,1.380421,103.875416
805233,0,4,4,1.380376,103.875193
805234,0,4,4,1.380396,103.875513
805235,20,0,20,1.380395,103.875592
805236,3,2,5,1.380403,103.875638
805237,7,4,11,1.380425,103.875696
805238,10,1,11,1.380402,103.875774
805239,1,0,1,1.380353,103.874679
805240,1,7,8,1.380433,103.875852
805241,0,3,3,1.380414,103.87528
805242,11,178,189,1.379996,103.873793
805243,3,29,32,1.379991,103.873819
805244,16,26,42,1.379994,103.873904
805245,1,21,22,1.37997,103.873923
805246,4,30,34,1.380007,103.874014
805247,1,35,36,1.380011,103.874059
805248,2,30,32,1.380016,103.874084
805251,6,537,543,1.380003,103.874279
805252,18,5,23,1.380018,103.874365
805253,4,43,47,1.380003,103.874393
805254,13,52,65,1.379995,103.874477
805255,7,33,40,1.380028,103.874535
805256,1,13,14,1.380002,103.874578
805257,10,7,17,1.380011,103.874643
805258,7,6,13,1.380029,103.874659
805259,13,0,13,1.380014,103.874725
805260,3,1,4,1.380395,103.875559
805261,0,11,11,1.380001,103.874861
805262,1,2,3,1.380439,103.875964
805263,0,5,5,1.380024,103.874996
805264,1,2,3,1.380023,103.874916
805265,21,3,24,1.380058,103.875102
805266,0,1,1,1.380413,103.875806
805267,0,3,3,1.380024,103.875024
805268,2,4,6,1.380056,103.875272
805269,6,1,7,1.380032,103.875289
805270,0,10,10,1.380039,103.875348
805271,1,5,6,1.38003,103.875406
805272,13,1,14,1.38005,103.875531
805273,0,2,2,1.380368,103.874922
805274,1,4,5,1.380053,103.875606
805275,18,1,19,1.380073,103.875664
805276,1,0,1,1.380032,103.875158
805277,0,2,2,1.380048,103.875557
805278,42,1,43,1.380081,103.875851
805279,0,1,1,1.380077,103.875747
805280,80,205,285,1.380077,103.875953
805281,2,1,3,1.380037,103.875213
805282,44,3,47,1.299509,103.837
805283,2,5,7,1.299509,103.837
805285,1,0,1,1.380063,103.875876
805287,17,0,17,1.299509,103.837
805288,1,0,1,1.299509,103.837
805289,122,0,122,1.299509,103.837
805291,8,0,8,1.299509,103.837
805292,0,1,1,1.299509,103.837
805293,2,16,18,1.385471,103.86147
805294,4,2,6,1.385443,103.861476
805295,5,8,13,1.385375,103.861478
805296,18,1,19,1.299509,103.837
805297,0,1,1,1.299509,103.837
805298,8,0,8,1.382645,103.864961
805299,2,0,2,1.380086,103.875789
805300,3,0,3,1.299509,103.837
805301,1,0,1,1.299509,103.837
805302,9,2,11,1.382645,103.864961
805303,0,6,6,1.383413,103.865524
805304,6,0,6,1.383404,103.865558
805305,1,0,1,1.382645,103.864961
805306,1,0,1,1.382546,103.866304
805307,4,2,6,1.299509,103.837
805310,101,1,102,1.388956,103.854252
805311,1,12,13,1.388908,103.854288
805312,12,0,12,1.388888,103.854309
805313,0,1,1,1.382572,103.866231
805314,2,1,3,1.382645,103.864961
805317,22,7,29,1.388683,103.854514
805318,21,2,23,1.388642,103.854556
805319,10,4,14,1.388601,103.854597
805320,87,2,89,1.38856,103.854638
805321,6,4,10,1.388519,103.854679
805322,38,0,38,1.388477,103.854726
805323,236,1,237,1.388456,103.854749
805324,0,32,32,1.388445,103.854782
805325,48,3,51,1.388435,103.854792
805326,3,2,5,1.388435,103.854812
805327,24,0,24,1.388435,103.854831
805328,6,0,6,1.388435,103.854851
805329,5,1,6,1.388435,103.854871
805330,2,1,3,1.388806,103.854391
805331,12,0,12,1.388435,103.854911
805332,27,0,27,1.388435,103.854931
805333,12,0,12,1.388435,103.85495
805334,0,2,2,1.382645,103.864961
805335,2,0,2,1.387801,103.854966
805337,225,1,226,1.387682,103.855073
805338,30,0,30,1.387648,103.855084
805340,2,0,2,1.38778,103.854997
805341,5,0,5,1.387532,103.855206
805342,10,0,10,1.387521,103.855243
805343,84,0,84,1.387456,103.855247
805344,4,9,13,1.387427,103.855287
805345,26,0,26,1.387412,103.855313
805346,2,22,24,1.388402,103.854818
805347,12,3,15,1.388402,103.854853
805348,171,0,171,1.388399,103.854898
805349,5,0,5,1.3884,103.854942
805351,1,0,1,1.388847,103.85435
805352,1,1,2,1.387598,103.855173
805353,3,0,3,1.388435,103.854891
805354,50,2,52,1.388385,103.855173
805355,50,0,50,1.388408,103.855256
805356,1,0,1,1.388395,103.855035
805357,9,0,9,1.388407,103.855366
805358,16,0,16,1.388407,103.85541
805360,78,0,78,1.388403,103.855478
805361,35,1,36,1.388402,103.855541
805362,2,1,3,1.388379,103.855129
805364,0,1,1,1.388409,103.855308
805365,51,0,51,1.38839,103.855616
805367,157,0,157,1.388387,103.85558
805368,8,0,8,1.38838,103.855553
805369,6,0,6,1.388384,103.855509
805370,132,0,132,1.388376,103.855391
805371,62,0,62,1.388379,103.855364
805372,2,0,2,1.388402,103.855092
805373,70,0,70,1.388368,103.855313
805374,6,0,6,1.388152,103.855206
805375,11,0,11,1.388168,103.855163
805376,24,0,24,1.38815,103.855106
805378,23,0,23,1.388137,103.855014
805379,5,2,7,1.388136,103.85493
805380,16,0,16,1.388135,103.85487
805381,4,0,4,1.380016,103.8748
805383,2,0,2,1.388373,103.85534
805384,35,0,35,1.387988,103.855265
805385,2,0,2,1.387995,103.855187
805386,22,0,22,1.388023,103.855364
805387,1,0,1,1.388396,103.855689
805388,20,0,20,1.387995,103.855428
805389,2,0,2,1.387991,103.855281
805390,7,0,7,1.387988,103.855553
805391,57,0,57,1.388001,103.855609
805393,3,0,3,1.388396,103.855571
805394,2,0,2,1.387995,103.855478
805395,7,0,7,1.387895,103.855414
805396,1,0,1,1.388019,103.855405
805397,172,0,172,1.387888,103.855282
805398,2,0,2,1.387889,103.855463
805399,16,0,16,1.387892,103.855193
805400,2,0,2,1.387884,103.855272
805401,4,0,4,1.387988,103.855075
805402,3,1,4,1.387712,103.855263
805403,37,0,37,1.387735,103.855347
805404,38,0,38,1.387711,103.855396
805406,25,1,26,1.387719,103.855523
805407,5,0,5,1.387333,103.855502
805408,7,1,8,1.387379,103.855545
805409,44,0,44,1.387426,103.855552
805410,27,1,28,1.387476,103.855579
805411,101,0,101,1.38753,103.855566
805412,30,0,30,1.38757,103.855601
805413,7,0,7,1.38762,103.855587
805414,5,1,6,1.38767,103.855607
805415,1,5,6,1.385969,103.857286
805417,55,17,72,1.382475,103.866772
805418,10,3,13,1.382486,103.866709
805420,2,0,2,1.387866,103.855147
805421,44,38,82,1.382977,103.861968
805422,5,0,5,1.384584,103.872627
805423,24,1,25,1.384632,103.872587
805424,95,7,102,1.384668,103.872545
805426,10,2,12,1.383166,103.859467
805427,17,0,17,1.383166,103.859467
805428,1,2,3,1.387888,103.85551
805429,50,2,52,1.383166,103.859467
805430,5,4,9,1.383166,103.859467
805431,0,1,1,1.387891,103.85534
805432,9,1,10,1.383166,103.859467
805433,0,1,1,1.383166,103.859467
805434,173,10,183,1.383728,103.859341
805435,0,1,1,1.383166,103.859467
805436,34,5,39,1.383793,103.859472
805437,4,0,4,1.387716,103.85529
805438,62,0,62,1.3841,103.859192
805439,0,10,10,1.383776,103.859589
805440,43,4,47,1.384058,103.859276
805442,3,0,3,1.383166,103.859467
805443,3,7,10,1.383818,103.859687
805444,2,2,4,1.383778,103.859531
805445,8,0,8,1.383776,103.859713
805446,10,0,10,1.384134,103.859416
805447,26,5,31,1.383804,103.859792
805448,1,5,6,1.384096,103.859492
805449,6,16,22,1.383822,103.859844
805451,183,0,183,1.383166,103.859467
805452,0,16,16,1.38411,103.859577
805453,5,2,7,1.383166,103.859467
805454,1,2,3,1.384085,103.859305
805455,33,2,35,1.383166,103.859467
805456,13,1,14,1.384144,103.859738
805457,1,0,1,1.383737,103.859414
805458,7,0,7,1.384154,103.859832
805460,35,7,42,1.384166,103.859856
805462,12,7,19,1.38418,103.859963
805463,7,0,7,1.384198,103.860088
805464,11,0,11,1.384164,103.860116
805465,26,26,52,1.383917,103.860108
805466,16,1,17,1.383895,103.860106
805467,9,0,9,1.383802,103.86009
805468,6,1,7,1.383779,103.860119
805469,1,18,19,1.385772,103.858794
805470,2,6,8,1.385697,103.858789
805471,0,9,9,1.385448,103.858765
805472,62,3,65,1.385379,103.858761
805473,106,0,106,1.385333,103.85877
805474,4,6,10,1.385296,103.858767
805475,8,12,20,1.385228,103.858765
805476,127,9,136,1.385147,103.858776
805477,6,8,14,1.385114,103.858772
805478,2,14,16,1.385077,103.858772
805479,6,9,15,1.385026,103.858776
805480,4,8,12,1.384974,103.858779
805481,10,1,11,1.384873,103.858779
805482,0,3,3,1.384135,103.859658
805483,0,5,5,1.384756,103.858776
805484,1,5,6,1.384695,103.858778
805485,29,5,34,1.384645,103.858783
805486,1,6,7,1.384607,103.858778
805487,2,9,11,1.384526,103.858778
805488,3,6,9,1.384478,103.858767
805489,1,3,4,1.384112,103.859359
805490,0,3,3,1.38479,103.858781
805491,2,10,12,1.384313,103.85877
805492,4,1,5,1.38426,103.858779
805493,1,0,1,1.383567,103.859675
805494,2,13,15,1.384196,103.858777
805495,3,7,10,1.384083,103.858781
805496,14,10,24,1.384033,103.858778
805497,61,6,67,1.383979,103.858793
805498,10,14,24,1.383914,103.858774
805499,0,3,3,1.384364,103.858767
805500,31,4,35,1.384002,103.858778
805502,3,0,3,1.383944,103.85877
805503,14,8,22,1.383676,103.858768
805504,0,1,1,1.384155,103.858776
805505,10,5,15,1.383573,103.858769
805506,1,4,5,1.383545,103.858774
805507,5,5,10,1.383529,103.858769
805508,113,7,120,1.383492,103.858766
805509,1,4,5,1.383452,103.858768
805510,0,2,2,1.38322,103.861858
805511,4,13,17,1.383327,103.858772
805512,4,0,4,1.384427,103.858774
805513,24,1,25,1.383282,103.858772
805514,66,8,74,1.383241,103.858775
805515,5,5,10,1.383066,103.858805
805516,10,2,12,1.38317,103.859182
805517,88,0,88,1.383137,103.859086
805518,4,2,6,1.383141,103.859105
805520,4,15,19,1.383042,103.858781
805521,2,12,14,1.383069,103.858772
805522,85,13,98,1.38295,103.858759
805523,33,86,119,1.38288,103.858774
805524,5,0,5,1.384504,103.859419
805525,3,0,3,1.383591,103.858767
805526,2,2,4,1.383385,103.858768
805527,35,10,45,1.384682,103.860886
805528,21,7,28,1.384589,103.860725
805529,195,0,195,1.38468,103.860832
805530,33,0,33,1.38458,103.860657
805531,12,9,21,1.384678,103.860751
805532,81,16,97,1.384582,103.860633
805533,10,0,10,1.384673,103.860709
805534,4,0,4,1.384584,103.860784
805535,22,13,35,1.384668,103.860661
805537,4,0,4,1.38457,103.860559
805538,1,0,1,1.383619,103.858774
805539,1,2,3,1.384503,103.8594
805540,2,2,4,1.384652,103.860581
805543,7,1,8,1.384635,103.860413
805544,3,0,3,1.384646,103.860519
805546,52,11,63,1.384528,103.860189
805547,4,3,7,1.384628,103.860298
805548,43,0,43,1.384521,103.860132
805549,11,0,11,1.384622,103.86023
805550,6,3,9,1.384516,103.860066
805551,2,5,7,1.384604,103.860122
805552,18,0,18,1.384516,103.860028
805553,1,0,1,1.384568,103.86046
805554,5,3,8,1.384502,103.859959
805555,15,5,20,1.384587,103.860059
805556,4,0,4,1.384553,103.860399
805557,9,0,9,1.38459,103.860038
805558,22,7,29,1.384502,103.859854
805559,7,5,12,1.38458,103.859983
805560,111,0,111,1.384498,103.859802
805561,1,0,1,1.384606,103.860143
805562,12,14,26,1.384495,103.85975
805563,0,5,5,1.384561,103.85983
805564,24,0,24,1.384487,103.859624
805565,9,4,13,1.384562,103.859801
805566,4,2,6,1.384483,103.859573
805567,4,6,10,1.384535,103.859618
805570,56,1,57,1.384481,103.859506
805571,4,7,11,1.384512,103.8595
805572,32,0,32,1.384482,103.859477
805573,308,0,308,1.384509,103.859485
805574,1,7,8,1.384478,103.859453
805575,4,10,14,1.384508,103.859471
805576,0,6,6,1.384475,103.859429
805577,1,0,1,1.384568,103.859888
805579,29,4,33,1.384505,103.859438
805580,20,1,21,1.384474,103.8594
805581,0,1,1,1.384507,103.859456
805582,17,18,35,1.385247,103.860856
805583,8,3,11,1.385139,103.860766
805584,22,0,22,1.385239,103.860796
805585,2,0,2,1.383356,103.858772
805586,1,19,20,1.385229,103.860745
805587,0,2,2,1.385132,103.86072
805588,3,0,3,1.384532,103.860231
805589,7,0,7,1.385122,103.860597
805590,6,9,15,1.385226,103.860648
805591,1,4,5,1.385114,103.860539
805592,13,0,13,1.385231,103.860587
805593,1,0,1,1.385143,103.860799
805594,8,19,27,1.385213,103.860541
805595,152,21,173,1.385096,103.860412
805596,3,0,3,1.385224,103.860696
805597,2,0,2,1.385124,103.860626
805598,38,2,40,1.385185,103.860426
805599,4,6,10,1.385083,103.860322
805600,4,0,4,1.384502,103.859908
805601,8,0,8,1.385072,103.860245
805602,40,6,46,1.385176,103.860305
805603,0,3,3,1.385208,103.860489
805604,79,0,79,1.385176,103.860257
805606,9,1,10,1.385159,103.860182
805608,5,0,5,1.385151,103.860112
805610,2,5,7,1.385146,103.860056
805611,7,4,11,1.38505,103.859936
805612,8,0,8,1.385138,103.859999
805613,72,0,72,1.38504,103.859902
805614,10,5,15,1.385128,103.859924
805615,20,4,24,1.385037,103.85987
805616,1,0,1,1.385104,103.860468
805617,6,0,6,1.385029,103.859816
805618,43,2,45,1.38512,103.859861
805619,6,3,9,1.385028,103.859769
805620,7,1,8,1.385082,103.859746
805621,2,1,3,1.385063,103.860158
805622,0,5,5,1.385078,103.859689
805623,9,2,11,1.384996,103.859524
805624,3,0,3,1.385005,103.859565
805626,8,6,14,1.385062,103.859601
805627,20,0,20,1.384996,103.859467
805628,9,0,9,1.385053,103.859565
805629,2,0,2,1.385088,103.860355
805630,1,1,2,1.384999,103.859432
805631,11,2,13,1.385,103.859414
805632,8,0,8,1.38504,103.85943
805634,3,1,4,1.385182,103.860357
805635,5,0,5,1.384994,103.859358
805636,2,0,2,1.38504,103.859487
805637,36,1,37,1.384851,103.859104
805638,22,1,23,1.385184,103.859123
805639,11,0,11,1.385219,103.859082
805640,11,1,12,1.381809,103.866369
805641,5,0,5,1.381999,103.865565
805642,1,0,1,1.38513,103.859895
805643,1,3,4,1.385035,103.859398
805644,1,0,1,1.381861,103.866317
805645,1,0,1,1.381901,103.866283
805646,2,0,2,1.385026,103.859365
805647,6,6,12,1.382029,103.86543
805648,2,0,2,1.381941,103.866243
805650,6,1,7,1.382015,103.866192
805651,0,2,2,1.381981,103.866215
805652,0,7,7,1.382038,103.866147
805653,1,0,1,1.382023,103.865467
805655,130,5,135,1.38208,103.865194
805656,64,8,72,1.382061,103.866061
805657,9,2,11,1.38208,103.865109
805658,3,0,3,1.385067,103.859639
805659,0,2,2,1.382055,103.865281
805660,4,9,13,1.382078,103.86597
805661,3,0,3,1.382067,103.866016
805662,6,0,6,1.382084,103.86593
805663,4,1,5,1.3822,103.864847
805664,1,4,5,1.382101,103.865879
805666,3,0,3,1.382183,103.86491
805668,21,4,25,1.382113,103.865782
805669,9,0,9,1.382217,103.864705
805670,28,0,28,1.382124,103.865737
805671,3,0,3,1.382118,103.865828
805672,6,2,8,1.382147,103.86568
805673,4,0,4,1.382018,103.865497
805675,3,1,4,1.382234,103.864603
805676,8,0,8,1.382135,103.865526
805677,1,4,5,1.382153,103.865475
805678,3,0,3,1.382229,103.864654
805679,1,4,5,1.382181,103.865327
805680,2,1,3,1.382164,103.865395
805681,10,3,13,1.382236,103.864959
805683,1,1,2,1.382177,103.864967
805684,1,0,1,1.382074,103.865221
805685,14,0,14,1.382276,103.864759
805686,11,0,11,1.382282,103.864697
805687,12,1,13,1.382304,103.864651
805688,63,0,63,1.382587,103.866155
805689,16,1,17,1.382576,103.866194
805690,28,3,31,1.382645,103.864961
805691,9,0,9,1.382645,103.864961
805692,77,0,77,1.382645,103.864961
805693,6,0,6,1.385558,103.860506
805694,1,1,2,1.382253,103.864862
805695,4,0,4,1.382141,103.865572
805697,5,0,5,1.385561,103.860272
805698,1,3,4,1.385548,103.860378
805700,0,1,1,1.382264,103.864816
805701,2,0,2,1.385604,103.860453
805702,4,0,4,1.385552,103.860221
805703,0,2,2,1.385533,103.860015
805704,1,0,1,1.385555,103.860101
805705,0,2,2,1.385523,103.859888
805706,20,0,20,1.385498,103.859698
805707,61,2,63,1.385472,103.859672
805708,17,0,17,1.38547,103.859538
805709,0,2,2,1.385523,103.859779
805710,5,0,5,1.385462,103.859425
805711,2,5,7,1.385442,103.859411
805712,1,0,1,1.385501,103.859807
805713,11,2,13,1.38543,103.859293
805715,1,0,1,1.385445,103.859324
805717,2,1,3,1.382258,103.864998
805718,4,8,12,1.382915,103.859534
805719,3,0,3,1.385405,103.859058
805720,7,0,7,1.385512,103.86093
805721,4,0,4,1.385491,103.859913
805722,22,1,23,1.385393,103.860928
805724,8,2,10,1.385288,103.86093
805725,18,1,19,1.385212,103.860941
805726,37,0,37,1.385113,103.860948
805727,1,3,4,1.385457,103.860932
805729,11,2,13,1.384934,103.86097
805730,2,0,2,1.385491,103.859487
805732,0,4,4,1.385041,103.860956
805733,16,5,21,1.384684,103.861013
805734,5,5,10,1.384618,103.86102
805735,4,0,4,1.384756,103.861005
805736,2,0,2,1.384873,103.860981
805737,0,1,1,1.385411,103.859191
805738,1,0,1,1.38441,103.861045
805739,13,5,18,1.384062,103.860901
805740,26,8,34,1.384034,103.860874
805741,15,0,15,1.383956,103.860837
805742,4,7,11,1.383915,103.860811
805743,18,0,18,1.383871,103.860779
805744,14,4,18,1.383844,103.860759
805746,0,1,1,1.384334,103.861054
805747,10,1,11,1.383713,103.860628
805748,0,1,1,1.383773,103.860682
805750,2,6,8,1.383575,103.8605
805751,6,2,8,1.383541,103.860473
805752,0,1,1,1.383646,103.860565
805753,1,1,2,1.38446,103.861049
805754,27,1,28,1.383438,103.860223
805755,2,10,12,1.383427,103.860361
805756,0,12,12,1.383402,103.860191
805757,64,1,65,1.383392,103.860333
805758,1,5,6,1.383343,103.860155
805759,2,10,12,1.383335,103.860295
805760,1,1,2,1.383467,103.860395
805761,9,6,15,1.383287,103.86026
805762,3,0,3,1.382962,103.859512
805763,0,6,6,1.383233,103.860199
805764,6,5,11,1.383235,103.860056
805765,16,1,17,1.383188,103.860142
805766,2,0,2,1.383315,103.860127
805767,3,2,5,1.383147,103.860094
805768,2,2,4,1.384523,103.861039
805769,4,2,6,1.383115,103.860069
805770,31,0,31,1.383115,103.859939
805771,18,1,19,1.383078,103.860048
805772,11,1,12,1.383069,103.859909
805773,1,1,2,1.383199,103.860024
805774,13,3,16,1.382766,103.85978
805775,0,1,1,1.383507,103.860438
805776,21,0,21,1.382712,103.859817
805777,15,0,15,1.383002,103.859956
805778,20,0,20,1.382666,103.859847
805779,10,2,12,1.382974,103.859908
805780,1,0,1,1.383023,103.859986
805781,1,2,3,1.383285,103.860098
805782,53,3,56,1.382541,103.859917
805783,4,28,32,1.386264,103.857919
805784,2,2,4,1.383149,103.859978
805785,4,0,4,1.386226,103.85789
805786,47,0,47,1.386237,103.857768
805787,0,1,1,1.382618,103.859875
805788,1,2,3,1.382569,103.859901
805789,0,66,66,1.386586,103.861874
805790,5,45,50,1.386787,103.861823
805791,5,1,6,1.386625,103.861805
805792,3,1,4,1.386262,103.857821
805793,2,5,7,1.386653,103.861753
805794,45,1,46,1.386835,103.861725
805795,13,2,15,1.386756,103.861594
805796,3,6,9,1.386852,103.861665
805797,67,8,75,1.386782,103.861517
805798,2,4,6,1.386865,103.86161
805799,5,2,7,1.386805,103.861445
805800,8,3,11,1.386876,103.861568
805801,5,6,11,1.386831,103.861353
805802,16,2,18,1.386893,103.861506
805803,4,1,5,1.386855,103.861296
805805,50,13,63,1.386868,103.861184
805806,1,5,6,1.386908,103.861412
805807,39,9,48,1.386884,103.861105
805808,1,0,1,1.386236,103.857704
805809,2,1,3,1.386227,103.857649
805810,17,8,25,1.386951,103.861246
805811,5,2,7,1.386981,103.861155
805812,5,8,13,1.387,103.861088
805813,0,4,4,1.38684,103.861801
805814,11,1,12,1.387033,103.86095
805816,20,5,25,1.38707,103.860812
805817,14,54,68,1.386222,103.861664
805818,2,4,6,1.386302,103.86174
805819,20,11,31,1.386217,103.8616
805820,27,1,28,1.386308,103.861657
805821,5,23,28,1.386213,103.861536
805822,6,0,6,1.3863,103.861582
805823,11,9,20,1.386208,103.861472
805824,4,0,4,1.387023,103.861009
805825,2,0,2,1.38305,103.860007
805826,18,0,18,1.386291,103.861412
805827,3,4,7,1.386198,103.861345
805828,9,0,9,1.386288,103.861336
805829,2,2,4,1.3863,103.861495
805830,8,1,9,1.386275,103.861276
805831,1,3,4,1.386194,103.861281
805832,1,4,5,1.384224,103.872844
805833,1,1,2,1.386203,103.861409
805834,0,3,3,1.38694,103.861313
805835,3,2,5,1.384036,103.872802
805836,10,2,12,1.383973,103.872788
805837,0,2,2,1.384161,103.87283
805838,10,4,14,1.383848,103.87276
805839,2,2,4,1.384287,103.872858
805840,1,0,1,1.386925,103.86136
805841,2,3,5,1.383659,103.872718
805842,7,1,8,1.383596,103.872704
805844,2,0,2,1.38391,103.872774
805846,2,0,2,1.383471,103.872676
805847,15,3,18,1.383479,103.872834
805848,2,1,3,1.384099,103.872816
805849,26,1,27,1.38359,103.872777
805850,5,1,6,1.383649,103.872795
805851,3,0,3,1.383503,103.872846
805852,4,1,5,1.383806,103.872812
805853,109,2,111,1.383864,103.872813
805854,23,2,25,1.383978,103.872832
805855,13,1,14,1.38402,103.872843
805856,1,1,2,1.38341,103.872864
805857,17,8,25,1.384112,103.872861
805858,17,0,17,1.384538,103.872673
805859,1,9,10,1.383806,103.873296
805860,2,1,3,1.383587,103.873237
805861,21,4,25,1.383765,103.873289
805863,4,1,5,1.383725,103.873279
805864,3,0,3,1.384481,103.872722
805865,2,2,4,1.383785,103.872746
805866,2,0,2,1.38406,103.87285
805867,1,3,4,1.383685,103.873271
805868,2,13,15,1.384403,103.872982
805869,1,2,3,1.38437,103.872824
805871,4,6,10,1.383498,103.873214
805872,1,5,6,1.384343,103.873065
805873,9,0,9,1.38345,103.873209
805875,0,1,1,1.383722,103.872732
805876,0,1,1,1.383393,103.873201
805877,54,0,54,1.383352,103.873183
805879,8,12,20,1.383341,103.873247
805880,12,0,12,1.384121,103.873227
805881,5,0,5,1.383394,103.873262
805882,152,0,152,1.384094,103.873267
805883,25,0,25,1.383438,103.873273
805884,0,1,1,1.384258,103.873164
805885,4,0,4,1.383639,103.873257
805886,52,0,52,1.384024,103.873341
805887,11,0,11,1.383522,103.873285
805888,4,4,8,1.383997,103.873375
805889,1,0,1,1.384074,103.873291
805890,12,0,12,1.383954,103.873429
805891,21,4,25,1.383635,103.873329
805892,0,7,7,1.383919,103.873479
805893,9,0,9,1.383576,103.873642
805895,2,0,2,1.38448,103.872949
805896,6,4,10,1.383839,103.873572
805899,16,1,17,1.383558,103.873881
805900,2,5,7,1.383804,103.873711
805901,4,0,4,1.383478,103.873282
805902,4,4,8,1.383752,103.873751
805903,1,0,1,1.383577,103.873303
805904,10,0,10,1.39179,103.853177
805906,2,5,7,1.391646,103.852956
805907,2,0,2,1.383554,103.873705
805908,20,219,239,1.383554,103.877055
805909,36,277,313,1.381787,103.876655
805910,318,1181,1499,1.382312,103.876623
805911,24,12,36,1.388563,103.866516
805912,2,25,27,1.388598,103.866383
805913,3,11,14,1.388637,103.866248
805914,46,10,56,1.388658,103.866181
805915,2,56,58,1.388672,103.866114
805916,4,1,5,1.388692,103.86605
805917,3,145,148,1.388707,103.865916
805918,0,72,72,1.388725,103.865858
805919,0,41,41,1.388757,103.865755
805920,10,107,117,1.388788,103.865656
805922,6,204,210,1.388824,103.865492
805923,4,0,4,1.383559,103.873969
805924,66,177,243,1.388853,103.865366
805925,123,166,289,1.388866,103.865326
805926,2,0,2,1.391804,103.852938
805927,1,0,1,1.383539,103.874084
805928,23,148,171,1.38892,103.865049
805929,4,0,4,1.388842,103.86543
805930,0,27,27,1.388972,103.86483
805932,47,68,115,1.389014,103.864696
805933,3,0,3,1.383545,103.873216
805935,0,28,28,1.389054,103.86451
805936,4,0,4,1.388948,103.864946
805937,56,0,56,1.38913,103.864266
805938,5,123,128,1.389145,103.864222
805939,15,125,140,1.389166,103.864095
805940,1,77,78,1.389187,103.864033
805942,4,172,176,1.391516,103.861471
805946,200,532,732,1.391042,103.854427
805947,51,0,51,1.390521,103.854009
805948,11,587,598,1.391514,103.854073
805960,89,2101,2190,1.387591,103.870377
805965,32,38,70,1.387475,103.865301
805966,4,0,4,1.38909,103.864405
805967,1,7,8,1.387465,103.865364
805968,1,1,2,1.388892,103.865168
805969,3,0,3,1.389035,103.864631
805970,4,7,11,1.387643,103.865164
805972,0,2,2,1.387793,103.865238
805973,4,1,5,1.387437,103.865575
805974,19,7,26,1.387412,103.865229
805975,0,1,1,1.388903,103.865108
805976,8,0,8,1.38739,103.865334
805977,145,0,145,1.387367,103.86547
805978,3,10,13,1.387411,103.865743
805979,0,1,1,1.38741,103.865668
805980,5,0,5,1.387394,103.865814
805981,1,4,5,1.387307,103.865734
805982,33,3,36,1.387367,103.865915
805983,5,0,5,1.38712,103.865703
805984,1,4,5,1.387358,103.86604
805985,15,0,15,1.387132,103.86581
805986,5,3,8,1.387335,103.866125
805988,5,0,5,1.387301,103.866228
805990,4,6,10,1.387267,103.86633
805992,15,0,15,1.387238,103.866427
805993,21,2,23,1.387098,103.866187
805994,0,4,4,1.387881,103.865228
805995,0,6,6,1.387037,103.866417
805996,1,2,3,1.387454,103.865435
806011,27,64,91,1.389921,103.86058
806012,21,265,286,1.390102,103.860459
806014,80,944,1024,1.390253,103.860077
806015,4,113,117,1.389876,103.860778
806016,22,0,22,1.389715,103.861022
806017,11,7,18,1.389859,103.860844
806018,17,0,17,1.389701,103.861121
806019,4,5,9,1.389836,103.860945
806020,3,0,3,1.386973,103.866459
806021,0,10,10,1.38981,103.861015
806023,3,6,9,1.389592,103.861457
806024,1,8,9,1.389774,103.861142
806026,0,6,6,1.389748,103.861198
806028,39,5,44,1.38983,103.861367
806029,40,4,44,1.389202,103.861499
806030,3,7,10,1.389811,103.861416
806031,10,1,11,1.389093,103.861566
806032,0,7,7,1.389812,103.861532
806033,9,12,21,1.389152,103.86157
806034,3,6,9,1.389787,103.861587
806035,3,0,3,1.389658,103.86125
806036,1,17,18,1.389729,103.861714
806037,2,6,8,1.389459,103.861644
806038,1,14,15,1.389729,103.861803
806039,2,0,2,1.387578,103.865005
806040,10,12,22,1.389704,103.861925
806041,48,2,50,1.389184,103.86157
806042,1,9,10,1.389652,103.861962
806043,5,13,18,1.389614,103.862082
806044,8,16,24,1.389623,103.862175
806045,2,14,16,1.389568,103.86229
806046,4,125,129,1.389555,103.862347
806047,11,137,148,1.389519,103.862477
806048,1,30,31,1.389492,103.86251
806049,2,7,9,1.388924,103.8614
806051,1,2,3,1.389283,103.861601
806052,13,4,17,1.38918,103.860989
806053,2,12,14,1.389213,103.860867
806054,6,0,6,1.38926,103.860796
806055,10,2,12,1.389361,103.860645
806057,20,3,23,1.389455,103.86049
806058,4,2,6,1.389508,103.86044
806059,2,1,3,1.388993,103.861069
806060,5,18,23,1.38989,103.859861
806061,7,3,10,1.38995,103.859774
806063,2,0,2,1.389339,103.861628
806064,103,0,103,1.389457,103.860058
806065,157,2,159,1.389344,103.859915
806066,1,0,1,1.387355,103.865559
806067,13,2,15,1.389195,103.860117
806068,11,1,12,1.389216,103.860356
806069,2,0,2,1.389484,103.859696
806070,10,5,15,1.388947,103.86047
806071,12,3,15,1.38896,103.860718
806072,2,1,3,1.390049,103.859942
806073,13,0,13,1.388865,103.860887
806074,2,1,3,1.388883,103.860903
806075,0,1,1,1.389355,103.860157
806076,6,0,6,1.388336,103.860825
806077,3,0,3,1.388736,103.861004
806078,6,2,8,1.388409,103.860542
806079,52,1,53,1.388929,103.860775
806081,4,3,7,1.389006,103.860661
806082,2,8,10,1.388667,103.860044
806083,50,0,50,1.388919,103.860092
806084,1,0,1,1.388719,103.861095
806085,2,0,2,1.389063,103.860272
806086,13,0,13,1.388903,103.859703
806087,3,3,6,1.389179,103.859711
806088,0,1,1,1.388745,103.85993
806089,6,0,6,1.389344,103.859505
806090,6,31,37,1.38905,103.859466
806091,1,12,13,1.388747,103.859645
806092,8,2,10,1.388685,103.859939
806093,37,16,53,1.388525,103.860016
806094,4,7,11,1.388472,103.860233
806095,0,5,5,1.388243,103.860381
806096,9,4,13,1.388205,103.860602
806097,0,7,7,1.387937,103.860431
806099,19,6,25,1.388214,103.860032
806101,8,2,10,1.388577,103.859737
806102,0,2,2,1.389043,103.859898
806103,0,37,37,1.388704,103.859411
806104,10,23,33,1.388698,103.859224
806105,24,32,56,1.38824,103.858756
806106,329,45,374,1.388764,103.859134
806107,419,108,527,1.388944,103.859246
806108,16,181,197,1.39015,103.859046
806109,190,213,403,1.3903,103.859468
806110,218,32,250,1.389632,103.85945
806111,135,25,160,1.389065,103.859338
806112,1,0,1,1.38906,103.859476
806113,1,0,1,1.388537,103.859124
806114,3,0,3,1.388819,103.860937
806115,14,0,14,1.388571,103.859459
806116,11,1,12,1.388359,103.859349
806117,6,0,6,1.388475,103.859595
806118,1,13,14,1.388436,103.85964
806119,9,2,11,1.38838,103.859731
806120,2,0,2,1.388695,103.859588
806121,1,3,4,1.387096,103.866244
806122,1,0,1,1.388666,103.859323
806123,6,1,7,1.388213,103.859966
806124,9,0,9,1.388174,103.860008
806125,3,1,4,1.388285,103.859866
806126,11,0,11,1.387951,103.859984
806129,1,0,1,1.388251,103.859868
806130,32,0,32,1.387749,103.860239
806131,1,0,1,1.387904,103.86041
806133,4,0,4,1.388095,103.860138
806134,1,13,14,1.389437,103.861628
806135,1,3,4,1.389311,103.861599
806136,8,185,193,1.389509,103.862662
806137,2,56,58,1.38949,103.862737
806138,3,1,4,1.389283,103.862291
806139,0,2,2,1.388353,103.859789
806140,11,14,25,1.389781,103.860558
806147,3,1,4,1.389794,103.860735
806148,8,2,10,1.387915,103.856552
806149,98,7,105,1.387732,103.856476
806150,1,1,2,1.389757,103.860835
806151,6,2,8,1.387726,103.85642
806153,1,1,2,1.387886,103.856501
806154,14,0,14,1.387852,103.856385
806155,14,2,16,1.387715,103.85631
806156,5,1,6,1.387844,103.856309
806157,1,1,2,1.387719,103.856365
806158,11,9,20,1.387841,103.856252
806159,5,2,7,1.38769,103.856084
806160,17,1,18,1.387847,103.856184
806161,8,0,8,1.387688,103.85603
806163,20,0,20,1.387684,103.855986
806165,0,1,1,1.387809,103.860546
806166,27,1,28,1.387824,103.856001
806167,10,0,10,1.38768,103.855895
806169,16,0,16,1.387688,103.855857
806171,9,1,10,1.387671,103.855808
806173,0,1,1,1.387684,103.855942
806175,6,0,6,1.3877105,103.8562335
806181,1,3,4,1.387737,103.856525
806183,0,7,7,1.38773025,103.8564563
806185,0,1,1,1.3877235,103.8563875
806187,0,1,1,1.38771675,103.8563188
806189,0,2,2,1.38771,103.85625
806191,0,1,1,1.43649,103.755256
806193,0,1,1,1.43649,103.755256
806195,1,0,1,1.3679995,103.796128
806197,0,1,1,1.299509,103.837
806198,2,0,2,1.299509,103.837
806199,2,0,2,1.299509,103.837
806203,0,1,1,1.299509,103.837
806204,0,1,1,1.299509,103.837
806206,0,1,1,1.299509,103.837
806207,2,0,2,1.299509,103.837
806209,1,6,7,1.299509,103.837
806210,0,8,8,1.299509,103.837
806211,1,16,17,1.299509,103.837
806212,1,24,25,1.299509,103.837
806213,0,10,10,1.299509,103.837
806214,1,11,12,1.299509,103.837
806215,1,1,2,1.299509,103.837
806216,3,5,8,1.299509,103.837
806217,2,6,8,1.299509,103.837
806221,3,0,3,1.388438,103.859261
806222,2,0,2,1.299509,103.837
806223,18,1,19,1.389139,103.854245
806224,86,0,86,1.389199,103.854254
806225,7,4,11,1.389256,103.854268
806226,41,1,42,1.389314,103.854282
806227,10,3,13,1.389372,103.854296
806228,10,1,11,1.389429,103.854309
806229,61,3,64,1.389487,103.854323
806230,1,4,5,1.389544,103.854337
806231,20,6,26,1.389602,103.854351
806232,2,6,8,1.389634,103.854362
806233,2,8,10,1.389665,103.854373
806234,6,3,9,1.389729,103.854396
806235,1,5,6,1.389792,103.854418
806236,33,0,33,1.390049,103.85457
806237,9,3,12,1.389856,103.854441
806239,2,3,5,1.389919,103.854463
806241,4,2,6,1.389982,103.854485
806242,1,1,2,1.389108,103.854243
806243,0,3,3,1.38907,103.854245
806244,0,1,1,1.299509,103.837
806245,5,4,9,1.390172,103.854552
806246,72,3,75,1.390236,103.854575
806247,5,5,10,1.390299,103.854597
806248,3,0,3,1.390046,103.854508
806249,0,3,3,1.390363,103.85462
806250,29,2,31,1.390489,103.854664
806251,3,2,5,1.390553,103.854687
806252,8,1,9,1.390616,103.854709
806254,1,1,2,1.390313,103.854685
806255,0,8,8,1.390788,103.854767
806256,0,3,3,1.390426,103.854642
806258,14,0,14,1.391014,103.854832
806259,0,2,2,1.390743,103.854754
806260,0,1,1,1.390109,103.85453
806261,11,4,15,1.391167,103.854848
806262,2,189,191,1.391229,103.85486
806264,0,3,3,1.390833,103.85478
806265,1,8,9,1.299509,103.837
806266,0,19,19,1.299509,103.837
806268,2,97,99,1.299509,103.837
806269,1,70,71,1.299509,103.837
806270,0,2,2,1.391039,103.854825
806271,0,3,3,1.3910735,103.854825
806272,0,1,1,1.391108,103.854825
806273,0,1,1,1.389456,103.855376
806274,0,8,8,1.38863,103.8556515
806275,0,3,3,1.387804,103.855927
806278,0,1,1,1.389064,103.856024
806283,0,1,1,1.389064,103.856024
806292,0,1,1,1.388958,103.855892
806295,1,0,1,1.38903,103.855598
806316,0,2,2,1.299509,103.837
806317,6,5,11,1.388907,103.854877
806318,0,7,7,1.389077,103.854863
806319,1,6,7,1.388909,103.854824
806320,0,2,2,1.389071,103.85491
806321,0,6,6,1.388907,103.854792
806322,20,4,24,1.389069,103.854735
806323,3,1,4,1.388907,103.854725
806324,2,2,4,1.388907,103.854725
806325,2,2,4,1.389066,103.854684
806326,6,0,6,1.389055,103.854591
806327,2,0,2,1.389058,103.854787
806329,7,3,10,1.389067,103.854516
806330,10,1,11,1.389058,103.854459
806331,2,3,5,1.388998,103.854555
806332,2,4,6,1.388997,103.854499
806333,26,29,55,1.389005,103.854456
806334,1,12,13,1.389062,103.854408
806345,3,0,3,1.387804,103.855927
806346,18,23,41,1.387678,103.857098
806349,1,0,1,1.388869,103.855564
806351,0,3,3,1.387649,103.857118
806352,1,0,1,1.387773,103.856995
806353,11,2,13,1.387916,103.856793
806354,1,0,1,1.387889,103.856851
806355,1,2,3,1.387873,103.856875
806356,11,1,12,1.388177,103.856719
806357,18,2,20,1.388185,103.856706
806358,5,1,6,1.388225,103.856677
806359,40,1,41,1.388294,103.856607
806360,1,0,1,1.388027,103.856862
806361,5,8,13,1.38836,103.856545
806362,19,1,20,1.388397,103.85654
806363,2,0,2,1.3889,103.854607
806364,124,0,124,1.388555,103.856373
806365,8,1,9,1.388546,103.856333
806366,7,0,7,1.388624,103.856297
806367,1,0,1,1.38834,103.856575
806368,4,0,4,1.388989,103.854659
806369,0,1,1,1.388624,103.856278
806370,4,0,4,1.388687,103.856242
806390,0,1,1,1.388684,103.856151
806391,1,1,2,1.388514,103.856418
806392,0,1,1,1.299509,103.837
806393,9,3,12,1.387781,103.85524
806394,5,0,5,1.388284,103.85583
806395,2,0,2,1.388211,103.855792
806396,24,0,24,1.388183,103.855777
806400,4,0,4,1.388733,103.85614
806402,2,0,2,1.388211,103.855792
806403,17,1,18,1.387858,103.855695
806404,1,0,1,1.299509,103.837
806405,1,0,1,1.387811,103.855651
806406,4,1,5,1.387712,103.855619
806407,0,6,6,1.386563,103.857407
806408,21,1,22,1.38667,103.857601
806409,1,0,1,1.387733,103.855669
806410,1,0,1,1.386536,103.857356
806414,19,0,19,1.386659,103.857389
806415,9,0,9,1.386536,103.857195
806418,0,1,1,1.386668,103.857558
806420,16,2,18,1.386646,103.857135
806421,45,4,49,1.386508,103.857028
806422,1,2,3,1.388127,103.85678
806423,20,0,20,1.386497,103.856887
806424,0,2,2,1.38788,103.855683
806425,39,5,44,1.386448,103.856856
806426,0,2,2,1.386637,103.856965
806427,2,0,2,1.386633,103.85688
806428,5,0,5,1.386628,103.856796
806429,37,9,46,1.386446,103.856754
806430,7,1,8,1.386624,103.856711
806431,6,0,6,1.386446,103.856697
806432,0,3,3,1.386641,103.85705
806433,5,2,7,1.386445,103.856664
806434,0,1,1,1.38665,103.857219
806435,27,0,27,1.386432,103.856622
806436,0,1,1,1.386615,103.856541
806437,34,2,36,1.386481,103.856494
806438,3,3,6,1.386606,103.856372
806439,11,0,11,1.386423,103.856447
806442,1,0,1,1.386611,103.856457
806443,5,1,6,1.38646,103.856262
806444,1,4,5,1.386593,103.856118
806445,2,0,2,1.386488,103.856763
806446,11,0,11,1.386589,103.856033
806447,23,2,25,1.386474,103.856205
806462,1,1,2,1.386483,103.856285
806463,6,3,9,1.389679,103.855722
806464,8,0,8,1.389657,103.855692
806465,6,0,6,1.389676,103.855657
806466,1,0,1,1.386598,103.856202
806467,26,0,26,1.389669,103.855528
806468,0,1,1,1.389653,103.855597
806469,2,1,3,1.38662,103.856626
806471,1,0,1,1.389648,103.855502
806472,16,0,16,1.389639,103.855312
806473,4,0,4,1.387993,103.855708
806474,1,0,1,1.389657,103.855268
806475,38,5,43,1.389655,103.855074
806477,18,0,18,1.389658,103.854974
806478,2,0,2,1.38966,103.855739
806479,2,7,9,1.389655,103.854887
806480,3,0,3,1.389663,103.855398
806481,13,1,14,1.389658,103.854838
806482,6,0,6,1.389615,103.854836
806483,2,5,7,1.389658,103.854684
806484,9,6,15,1.389608,103.854805
806485,1,2,3,1.38962,103.854931
806486,1,0,1,1.389634,103.855217
806487,0,2,2,1.389625,103.855026
806488,18,3,21,1.389584,103.854511
806489,2,6,8,1.38957,103.854462
806504,3,26,29,1.387887,103.857766
806505,7,1,8,1.388459,103.85733
806506,11,1,12,1.387887,103.857723
806507,9,0,9,1.388566,103.857304
806508,1,0,1,1.389597,103.854714
806511,4,1,5,1.388687,103.857182
806512,3,0,3,1.389649,103.854607
806513,4,1,5,1.388803,103.857108
806514,7,0,7,1.387893,103.857501
806515,3,1,4,1.389659,103.855172
806516,19,0,19,1.387935,103.857426
806517,11,10,21,1.388726,103.856898
806518,59,1,60,1.38797,103.857383
806519,7,0,7,1.388778,103.856825
806520,0,1,1,1.387887,103.857649
806521,8,1,9,1.388825,103.85677
806522,2,1,3,1.387889,103.857556
806523,32,0,32,1.388882,103.856686
806524,7,0,7,1.388094,103.857263
806525,0,9,9,1.388948,103.856594
806526,3,3,6,1.388188,103.857229
806529,21,4,25,1.38903,103.856471
806530,0,2,2,1.389597,103.854633
806531,9,0,9,1.38904,103.856408
806532,2,2,4,1.388851,103.857052
806533,16,0,16,1.389132,103.856285
806534,5,0,5,1.388397,103.857065
806535,17,2,19,1.389178,103.856223
806536,13,5,18,1.388452,103.857027
806537,5,0,5,1.389346,103.856093
806539,2,2,4,1.388343,103.857104
806541,11,0,11,1.389554,103.855885
806542,0,7,7,1.388613,103.856908
806544,7,1,8,1.388662,103.856863
806545,1,5,6,1.389721,103.855784
806546,1,1,2,1.388291,103.857146
806547,1,1,2,1.388705,103.856813
806548,3,0,3,1.38807,103.857283
806549,0,1,1,1.388004,103.857334
806550,2,6,8,1.388792,103.856712
806551,1,1,2,1.38977,103.855771
806553,24,2,26,1.390065,103.855692
806554,0,1,1,1.389869,103.855744
806556,10,0,10,1.388916,103.856553
806557,4,0,4,1.389358,103.856034
806558,47,1,48,1.388956,103.856499
806559,3,2,5,1.390306,103.855616
806560,10,0,10,1.388996,103.856445
806561,16,1,17,1.390392,103.855565
806563,2,1,3,1.388749,103.856762
806564,56,0,56,1.389032,103.856378
806565,2,3,5,1.39054,103.855438
806566,26,2,28,1.389051,103.85634
806567,7,0,7,1.390589,103.855351
806569,1,3,4,1.390262,103.855639
806570,53,1,54,1.389112,103.856259
806571,14,0,14,1.390661,103.855216
806572,26,3,29,1.390063,103.855644
806573,1,5,6,1.390685,103.855113
806574,4,4,8,1.390106,103.855632
806575,14,0,14,1.390703,103.855029
806576,14,0,14,1.390281,103.85559
806577,1,1,2,1.389967,103.855718
806578,7,1,8,1.39035,103.855572
806579,0,4,4,1.39063,103.855261
806580,1,3,4,1.390737,103.854837
806581,8,1,9,1.390655,103.855054
806582,15,3,18,1.390711,103.854901
806583,8,11,19,1.390714,103.85483
806598,1,2,3,1.390474,103.85551
806599,3,7,10,1.387338,103.857753
806600,1,2,3,1.38724,103.85721
806601,1,1,2,1.390727,103.854907
806603,3,0,3,1.38724,103.857144
806604,10,0,10,1.387231,103.857075
806605,26,1,27,1.387321,103.857586
806607,1,0,1,1.388875,103.856607
806608,19,4,23,1.387225,103.856981
806609,2,1,3,1.387328,103.857653
806610,3,1,4,1.390633,103.855145
806611,8,10,18,1.387301,103.857384
806612,2,0,2,1.387334,103.85772
806613,3,0,3,1.387308,103.857451
806615,0,2,2,1.387218,103.856899
806616,1,3,4,1.387218,103.856943
806617,14,3,17,1.387293,103.857211
806618,4,0,4,1.387203,103.856751
806619,3,0,3,1.387294,103.857317
806620,23,0,23,1.387174,103.856441
806621,19,2,21,1.38727,103.856797
806622,1,1,2,1.387294,103.85727
806623,17,3,20,1.387275,103.856704
806625,3,1,4,1.387072,103.856449
806626,6,2,8,1.38717,103.856238
806627,3,1,4,1.387266,103.856654
806629,23,0,23,1.387259,103.856533
806630,1,0,1,1.387314,103.857519
806631,1,2,3,1.387272,103.856862
806633,4,0,4,1.387259,103.856581
806634,0,1,1,1.387157,103.856067
806635,1,1,2,1.387178,103.856324
806636,0,1,1,1.387152,103.855962
806637,7,2,9,1.387229,103.856305
806638,6,1,7,1.387159,103.855822
806639,1,1,2,1.387231,103.856382
806640,9,4,13,1.38715,103.855698
806641,3,2,5,1.387225,103.856155
806642,9,2,11,1.387211,103.8561
806643,5,0,5,1.387206,103.856037
806644,3,1,4,1.387253,103.856441
806645,19,1,20,1.387186,103.855913
806646,16,1,17,1.38718,103.855828
806647,2,4,6,1.387174,103.855743
806648,0,1,1,1.387152,103.855876
806650,0,1,1,1.387167,103.855659
806664,5,184,189,1.391333,103.855033
806665,1,102,103,1.391322,103.855082
806666,43,1,44,1.391283,103.85523
806667,0,87,87,1.391276,103.855267
806668,21,0,21,1.391242,103.855376
806669,0,145,145,1.391226,103.855469
806670,3,303,306,1.39117,103.855612
806671,1,0,1,1.387141,103.855574
806672,10,679,689,1.390945,103.855748
806673,7,1,8,1.39092,103.855817
806674,23,241,264,1.390807,103.855897
806675,42,0,42,1.39074,103.855913
806676,19,7,26,1.390627,103.856007
806677,3,5,8,1.390553,103.856004
806678,2,3,5,1.390448,103.85608
806679,7,3,10,1.390412,103.856082
806680,0,9,9,1.39028,103.856153
806681,12,0,12,1.390247,103.856153
806682,3,12,15,1.390104,103.856184
806683,3,13,16,1.39005,103.856227
806684,17,16,33,1.389927,103.856285
806685,21,1,22,1.389825,103.856306
806686,0,10,10,1.389667,103.856441
806687,8,8,16,1.389589,103.856463
806688,1,0,1,1.391158,103.855654
806689,6,9,15,1.389466,103.856594
806690,2,17,19,1.389419,103.856687
806691,2,0,2,1.38722,103.856194
806692,51,8,59,1.389308,103.856829
806693,0,5,5,1.389285,103.856898
806694,43,0,43,1.389213,103.856982
806695,8,10,18,1.38917,103.857008
806696,4,7,11,1.389114,103.857143
806698,3,15,18,1.388955,103.857257
806699,2,32,34,1.38892,103.857329
806700,17,31,48,1.388835,103.857416
806701,21,53,74,1.388792,103.85745
806702,1,10,11,1.388657,103.857497
806703,11,4,15,1.388604,103.85753
806705,0,10,10,1.388415,103.857626
806706,6,9,15,1.388318,103.857656
806708,1,7,8,1.388105,103.857667
806709,19,12,31,1.388036,103.857653
806710,1,5,6,1.386316,103.857366
806711,1,2,3,1.387256,103.856501
806712,51,1,52,1.386267,103.857252
806713,2,0,2,1.389359,103.856744
806714,2,1,3,1.386291,103.857275
806715,3,0,3,1.386262,103.85711
806716,13,8,21,1.38625,103.857
806717,2,0,2,1.386298,103.857163
806718,10,9,19,1.386234,103.856875
806719,10,0,10,1.386265,103.85678
806720,23,4,27,1.38625,103.85675
806721,29,0,29,1.386246,103.856704
806722,9,3,12,1.386216,103.856644
806723,3,0,3,1.386272,103.857089
806724,5,10,15,1.386225,103.856503
806725,9,1,10,1.386225,103.856451
806727,1,0,1,1.389548,103.856558
806728,21,7,28,1.385917,103.856933
806729,18,0,18,1.385911,103.857017
806730,1,0,1,1.385893,103.856809
806731,2,2,4,1.387193,103.855997
806732,23,2,25,1.385649,103.857105
806733,5,0,5,1.385601,103.857108
806734,6,4,10,1.385588,103.857153
806735,15,0,15,1.385543,103.857173
806736,7,5,12,1.38602,103.857553
806737,6,4,10,1.385998,103.857625
806738,2,7,9,1.386018,103.857699
806739,68,0,68,1.386026,103.857725
806740,105,14,119,1.386026,103.857819
806741,12,34,46,1.385709,103.857654
806742,0,1,1,1.385935,103.857077
806743,2,0,2,1.386268,103.856969
806744,4,0,4,1.385894,103.857157
806745,664,112,776,1.389729,103.856689
806746,1138,15,1153,1.389729,103.856689
806747,244,1069,1313,1.389729,103.856689
806748,770,168,938,1.389729,103.856689
806749,0,24,24,1.38715,103.857906
806750,3,5,8,1.387039,103.857901
806751,2,15,17,1.38691,103.857866
806752,31,7,38,1.386851,103.857858
806753,7,5,12,1.386759,103.857836
806754,12,0,12,1.386707,103.857865
806755,9,6,15,1.38656,103.857743
806756,10,0,10,1.386591,103.857806
806757,5,2,7,1.386554,103.857875
806758,8,18,26,1.38658,103.857907
806759,2,2,4,1.385346,103.857324
806760,13,0,13,1.379552,103.867135
806761,1,2,3,1.386234,103.85659
806762,0,2,2,1.38563,103.857496
806763,7,3,10,1.379546,103.866845
806766,0,1,1,1.385655,103.857551
806768,1,3,4,1.379535,103.867204
806769,25,0,25,1.379534,103.866481
806770,14,5,19,1.379523,103.866441
806771,4,0,4,1.379534,103.866538
806786,1,10,11,1.38078,103.867499
806787,9,0,9,1.380781,103.867421
806788,0,2,2,1.379547,103.867004
806789,36,0,36,1.380792,103.867176
806790,3,0,3,1.379547,103.867073
806792,19,5,24,1.380816,103.866727
806793,8,0,8,1.380824,103.866656
806794,1,1,2,1.380792,103.86729
806795,9,1,10,1.38083,103.866582
806797,1,0,1,1.379534,103.866674
806798,56,1,57,1.38084,103.866452
806799,6,0,6,1.38084,103.866378
806814,3,8,11,1.38013,103.867295
806815,3,1,4,1.379517,103.866378
806816,8,0,8,1.380135,103.867238
806817,1,8,9,1.380185,103.86738
806818,3,0,3,1.380798,103.867062
806819,1,0,1,1.380834,103.866526
806820,4,1,5,1.380128,103.867122
806821,5,3,8,1.380191,103.867254
806822,2,0,2,1.380903,103.866683
806823,0,1,1,1.380185,103.867323
806824,40,3,43,1.380145,103.867014
806825,0,1,1,1.380185,103.867175
806828,9,1,10,1.380127,103.866827
806829,0,7,7,1.380202,103.866987
806830,1,2,3,1.380137,103.867182
806831,0,2,2,1.380134,103.867059
806833,0,2,2,1.380182,103.866843
806834,12,1,13,1.380127,103.866662
806835,6,0,6,1.380167,103.866711
806838,1,0,1,1.380197,103.867112
806839,2,2,4,1.380179,103.867442
806840,4,0,4,1.380179,103.866603
806841,3,1,4,1.380138,103.866497
806842,3,0,3,1.380139,103.866771
806843,10,2,12,1.380182,103.866504
806844,1,0,1,1.380133,103.86656
806845,53,0,53,1.380177,103.866448
806846,3,1,4,1.380184,103.866546
806861,7,4,11,1.38109,103.867068
806862,6,16,22,1.380882,103.867302
806863,0,1,1,1.380133,103.866366
806864,6,7,13,1.380948,103.867335
806865,1,0,1,1.381124,103.867063
806866,27,2,29,1.381022,103.867323
806867,6,0,6,1.381182,103.866923
806868,0,1,1,1.38121,103.866891
806869,2,0,2,1.380173,103.866774
806870,7,0,7,1.381141,103.867283
806871,3,1,4,1.380172,103.866385
806872,4,0,4,1.381382,103.866686
806873,62,0,62,1.381427,103.866623
806874,1,1,2,1.381307,103.866754
806875,6,0,6,1.381467,103.866572
806877,3,4,7,1.381347,103.867004
806878,2,0,2,1.381244,103.867158
806879,17,6,23,1.381397,103.86687
806881,1,3,4,1.381204,103.867226
806882,72,2,74,1.381472,103.86675
806883,72,0,72,1.381506,103.866699
806884,7,2,9,1.381546,103.866648
806885,20,0,20,1.381586,103.866597
806886,4,3,7,1.38162,103.866551
806887,8,0,8,1.381655,103.866505
806888,4,3,7,1.381605,103.866439
806889,3,0,3,1.380127,103.866429
806890,9,1,10,1.38177,103.866278
806891,2,3,5,1.381843,103.866198
806893,0,3,3,1.381664,103.866395
806895,65,15,80,1.381947,103.865874
806896,1,0,1,1.381078,103.867346
806897,2,6,8,1.381977,103.865729
806899,5,0,5,1.381984,103.865677
806900,31,0,31,1.381758,103.866414
806901,47,9,56,1.381999,103.865606
806902,3,3,6,1.381106,103.868207
806903,3,2,5,1.381046,103.867834
806905,2,1,3,1.381906,103.866008
806906,4,3,7,1.381101,103.868349
806907,0,1,1,1.381962,103.865826
806910,6,2,8,1.381076,103.86845
806912,1,0,1,1.381078,103.868515
806913,8,4,12,1.380972,103.868215
806914,17,10,27,1.381066,103.868566
806915,2,0,2,1.381387,103.866947
806916,114,0,114,1.381055,103.868617
806917,0,1,1,1.380966,103.868375
806918,17,1,18,1.381049,103.868674
806919,8,0,8,1.380966,103.868443
806920,0,5,5,1.381055,103.868714
806922,13,4,17,1.381055,103.868765
806923,1,0,1,1.380938,103.868597
806924,1,0,1,1.381675,103.868997
806925,4,1,5,1.380926,103.868659
806926,10,6,16,1.381809,103.869049
806927,14,0,14,1.380921,103.868733
806928,2,0,2,1.380966,103.868295
806929,2,0,2,1.381908,103.869077
806930,7,0,7,1.382019,103.869127
806931,15,3,18,1.380909,103.868864
806933,30,0,30,1.380904,103.868932
806934,34,36,70,1.382342,103.869194
806935,11,9,20,1.380904,103.869006
806937,13,1,14,1.380892,103.869137
806938,27,0,27,1.380892,103.869206
806939,10,5,15,1.380885,103.869248
806940,10,0,10,1.380883,103.869309
806941,110,13,123,1.380865,103.869369
806942,3,0,3,1.381023,103.867908
806943,39,6,45,1.381268,103.869052
806944,2,0,2,1.380915,103.868802
806945,7,2,9,1.381394,103.869092
806946,2,0,2,1.381331,103.869075
806949,4,3,7,1.381243,103.869062
806950,22,0,22,1.381648,103.869234
806951,1,1,2,1.381285,103.869086
806952,6,0,6,1.381633,103.869352
806953,3,0,3,1.381211,103.869046
806954,3,14,17,1.381611,103.869425
806955,12,0,12,1.381598,103.869471
806957,10,0,10,1.381578,103.869567
806961,1,0,1,1.3817,103.86951
806962,6,0,6,1.381695,103.869456
806964,12,1,13,1.381734,103.869381
806966,30,7,37,1.381751,103.869215
806967,29,10,39,1.382337,103.869327
806968,15,3,18,1.382324,103.869391
806969,3,0,3,1.38162,103.869383
806970,0,1,1,1.38229,103.869518
806972,36,3,39,1.382278,103.869585
806973,2,0,2,1.381649,103.869285
806974,27,0,27,1.382242,103.869722
806975,1,0,1,1.382325,103.869808
806976,0,2,2,1.382267,103.869653
806977,3,0,3,1.382309,103.869464
806978,2,1,3,1.382359,103.869748
806980,0,3,3,1.382388,103.869674
806982,0,10,10,1.382474,103.869361
806983,10,1,11,1.382502,103.869264
806984,0,2,2,1.382327,103.869763
806999,11,247,258,1.387185,103.868397
807000,20,1,21,1.386694,103.868408
807001,5,0,5,1.386702,103.868435
807002,10,402,412,1.386692,103.868442
807003,19,285,304,1.386703,103.868439
807008,560,603,1163,1.385969,103.868548
807009,11,14,25,1.385916,103.868595
807010,4,4,8,1.385787,103.868574
807011,1660,1123,2783,1.387483,103.869357
807012,457,140,597,1.387527,103.869312
807013,366,7,373,1.415487,103.861252
807014,186,4,190,1.386978,103.868635
807015,956,6,962,1.38698,103.868809
807016,361,14,375,1.38698,103.868809
807017,63,9,72,1.299509,103.837
807018,384,814,1198,1.38698,103.868809
807019,1113,7,1120,1.386597,103.868603
807020,281,11,292,1.299509,103.837
807021,519,1,520,1.386597,103.868603
807022,476,4,480,1.299509,103.837
807023,22,210,232,1.383169,103.876443
807024,37,22,59,1.383241,103.876448
807025,0,24,24,1.383363,103.876432
807026,13,24,37,1.383438,103.876457
807027,1,2,3,1.382434,103.869532
807028,5,11,16,1.383626,103.876401
807029,20,8,28,1.383767,103.876271
807030,3,4,7,1.383708,103.875935
807031,6,5,11,1.383852,103.87626
807035,5,4,9,1.384037,103.876182
807036,8,1,9,1.384018,103.87589
807039,2,0,2,1.382531,103.869185
807040,0,2,2,1.384239,103.876115
807041,3,12,15,1.384389,103.875965
807042,6,1,7,1.38417,103.875594
807043,0,3,3,1.383547,103.876432
807044,1,5,6,1.384221,103.875578
807045,0,8,8,1.384622,103.875568
807046,2,0,2,1.384133,103.875794
807047,6,0,6,1.384655,103.875746
807048,0,3,3,1.384514,103.87567
807049,0,1,1,1.384779,103.875697
807050,15,0,15,1.384579,103.875416
807051,2,3,5,1.384791,103.875592
807052,1,0,1,1.384651,103.87535
807053,0,6,6,1.38491,103.875604
807054,8,7,15,1.384702,103.875283
807056,4,0,4,1.381878,103.866103
807057,10,2,12,1.385014,103.875435
807058,20,1,21,1.384823,103.875162
807059,6,3,9,1.385079,103.875312
807060,1,1,2,1.384325,103.875458
807061,3,12,15,1.385156,103.875307
807062,5,11,16,1.385087,103.874656
807063,4,3,7,1.385171,103.875174
807064,1,0,1,1.385183,103.874647
807065,26,12,38,1.385237,103.875123
807066,0,17,17,1.385189,103.874606
807067,0,19,19,1.385427,103.874826
807068,18,31,49,1.385315,103.874622
807069,14,16,30,1.385502,103.874749
807070,63,0,63,1.385354,103.874556
807071,25,4,29,1.385578,103.874657
807072,17,1,18,1.385399,103.874498
807073,2,5,7,1.385639,103.874593
807075,28,7,35,1.385707,103.874528
807076,2,53,55,1.385495,103.874396
807077,130,5,135,1.385755,103.874481
807078,11,0,11,1.385528,103.874376
807079,3,3,6,1.385836,103.874384
807080,1,0,1,1.385565,103.874356
807081,0,6,6,1.385871,103.874312
807082,1,42,43,1.385602,103.874329
807083,1,6,7,1.386097,103.874279
807084,126,19,145,1.385678,103.874274
807085,0,8,8,1.386091,103.874222
807086,0,5,5,1.385724,103.874235
807087,2,3,5,1.38616,103.874114
807088,1,8,9,1.385687,103.874072
807089,1,20,21,1.386197,103.874031
807090,4,0,4,1.384734,103.87526
807091,14,14,28,1.386262,103.873887
807092,4,1,5,1.385763,103.873985
807093,14,115,129,1.386345,103.87383
807094,0,7,7,1.385803,103.873938
807095,29,200,229,1.386487,103.873638
807096,0,8,8,1.386344,103.873217
807097,1,0,1,1.386345,103.873147
807098,15,19,34,1.386518,103.873545
807099,56,0,56,1.386376,103.873088
807100,2,118,120,1.386651,103.873492
807101,5,1,6,1.38652,103.873097
807102,6,66,72,1.386687,103.873391
807103,6,0,6,1.386527,103.873059
807104,3,355,358,1.386724,103.873305
807105,1,7,8,1.386542,103.873012
807106,0,96,96,1.38666,103.873165
807107,0,7,7,1.386581,103.872914
807108,5,25,30,1.386716,103.873069
807109,1,0,1,1.386616,103.87286
807110,2,433,435,1.386746,103.872989
807111,0,4,4,1.385725,103.873995
807112,15,190,205,1.386758,103.872951
807113,0,1,1,1.386655,103.872784
807114,2,94,96,1.386835,103.872793
807116,13,553,566,1.386958,103.872724
807117,6,0,6,1.386546,103.872601
807118,0,10,10,1.386956,103.872672
807119,0,17,17,1.386756,103.872274
807120,8,77,85,1.387024,103.872506
807121,4,1,5,1.38666,103.872263
807122,6,6,12,1.386928,103.872406
807123,1,4,5,1.38656,103.87225
807124,5,8,13,1.386963,103.872276
807125,0,2,2,1.384857,103.875114
807126,1,10,11,1.386984,103.872202
807127,33,0,33,1.386394,103.872252
807128,33,15,48,1.38701,103.8721
807129,17,1,18,1.386292,103.872238
807130,32,29,61,1.387023,103.872018
807131,5,0,5,1.38617,103.872054
807133,18,2,20,1.386324,103.872078
807134,2,1,3,1.384363,103.875464
807135,9,13,22,1.386514,103.872112
807136,4,2,6,1.386631,103.872141
807137,4,6,10,1.386703,103.872133
807138,0,9,9,1.386837,103.872161
807139,0,1,1,1.386127,103.872092
807140,2,4,6,1.38658,103.872525
807141,15,0,15,1.299509,103.837
807142,3,1,4,1.38663,103.872832
807143,8,3,11,1.299509,103.837
807144,7,0,7,1.299509,103.837
807146,2,0,2,1.386502,103.872225
807147,3,0,3,1.386456,103.872099
807148,9,0,9,1.299509,103.837
807149,0,1,1,1.299509,103.837
807150,1,7,8,1.299509,103.837
807151,0,5,5,1.299509,103.837
807152,2,10,12,1.299509,103.837
807153,4,5,9,1.386968,103.871739
807154,2,65,67,1.387059,103.871742
807155,16,0,16,1.387002,103.871602
807156,1,14,15,1.387057,103.871682
807157,2,3,5,1.387025,103.871488
807158,5,14,19,1.38708,103.871579
807159,2,0,2,1.299509,103.837
807160,1,12,13,1.387109,103.871471
807161,36,7,43,1.38654,103.871282
807162,12,27,39,1.387126,103.871368
807163,1,2,3,1.299509,103.837
807164,9,13,22,1.387124,103.871312
807165,1,2,3,1.386512,103.871396
807166,14,0,14,1.386458,103.871252
807167,3,3,6,1.38646,103.871669
807168,4,3,7,1.386446,103.871321
807169,1,0,1,1.386435,103.871412
807170,2,0,2,1.387048,103.871363
807171,19,0,19,1.386389,103.871577
807172,0,4,4,1.299509,103.837
807187,22,0,22,1.386097,103.871747
807188,55,2,57,1.386047,103.871735
807189,69,0,69,1.386002,103.871714
807191,12,0,12,1.385747,103.871675
807192,1,0,1,1.385698,103.871666
807193,4,0,4,1.38639,103.871643
807194,32,7,39,1.385619,103.871665
807209,24,2,26,1.382724,103.868385
807210,0,1,1,1.382435,103.868531
807211,1,1,2,1.386412,103.871486
807212,6,8,14,1.382309,103.868514
807213,3,2,5,1.382668,103.868754
807214,2,0,2,1.382722,103.868521
807215,10,0,10,1.382638,103.868893
807216,10,2,12,1.381675,103.868426
807217,14,5,19,1.382411,103.868637
807218,1,0,1,1.381537,103.868411
807219,9,2,11,1.382302,103.868643
807220,0,2,2,1.381959,103.868411
807221,6,0,6,1.381947,103.868569
807222,1,5,6,1.381804,103.868541
807223,8,0,8,1.381672,103.868524
807224,1,0,1,1.382115,103.86849
807238,3,2,5,1.38649,103.860686
807239,18,3,21,1.386513,103.860709
807240,9,1,10,1.386481,103.860621
807241,50,2,52,1.386507,103.860667
807242,10,0,10,1.386465,103.860492
807243,6,0,6,1.386496,103.860582
807244,1,0,1,1.386448,103.860362
807245,0,1,1,1.386486,103.860498
807246,1,1,2,1.382067,103.868592
807249,126,5,131,1.386464,103.860329
807250,4,1,5,1.386398,103.859973
807251,6,0,6,1.386453,103.860245
807252,3,1,4,1.385661,103.871667
807253,15,0,15,1.386442,103.860161
807254,7,4,11,1.386365,103.859713
807255,8,0,8,1.386432,103.860077
807256,35,1,36,1.386348,103.859584
807257,0,4,4,1.386382,103.859843
807259,5,0,5,1.38641,103.859908
807261,7,6,13,1.386399,103.859824
807262,0,2,2,1.386432,103.860232
807263,6,0,6,1.386388,103.859739
807264,1,3,4,1.386421,103.859992
807265,2,4,6,1.386378,103.859655
807267,1,1,2,1.386299,103.859195
807268,1,0,1,1.386345,103.859402
807269,1,2,3,1.386483,103.871526
807271,4,8,12,1.386313,103.859149
807272,2,7,9,1.386307,103.859099
807287,15,13,28,1.386017,103.860829
807291,3,5,8,1.386508,103.860761
807292,1,2,3,1.386334,103.859318
807293,3,0,3,1.386544,103.860765
807294,2,0,2,1.386356,103.859486
807295,3,1,4,1.386281,103.859125
807296,17,1,18,1.387101,103.860673
807298,0,1,1,1.387146,103.860532
807300,1,1,2,1.386947,103.860877
807301,43,2,45,1.387173,103.860418
807302,5,1,6,1.387296,103.860135
807303,3,0,3,1.386778,103.860734
807304,17,2,19,1.387383,103.85999
807305,10,0,10,1.387414,103.859941
807306,29,0,29,1.387477,103.859863
807307,4,3,7,1.38731,103.859984
807308,23,0,23,1.38751,103.859811
807309,1,3,4,1.387088,103.860708
807313,5,3,8,1.387521,103.859707
807314,2,4,6,1.387665,103.859558
807315,4,2,6,1.387621,103.859567
807316,4,0,4,1.38736,103.85992
807317,8,13,21,1.387661,103.859519
807318,1,4,5,1.387721,103.859482
807319,2,11,13,1.387751,103.859396
807320,37,0,37,1.38775,103.859443
807321,4,4,8,1.387803,103.859323
807322,7,11,18,1.387778,103.859404
807323,3,0,3,1.38732,103.860102
807324,5,2,7,1.387835,103.859328
807325,1,0,1,1.387863,103.859289
807326,22,8,30,1.38788,103.859265
807327,3,0,3,1.387806,103.859366
807328,2,0,2,1.387159,103.860463
807330,1,3,4,1.387693,103.85952
807331,10,0,10,1.388037,103.859048
807332,7,1,8,1.388071,103.858999
807333,0,1,1,1.388106,103.858951
807348,4,6,10,1.384054,103.868039
807349,6,39,45,1.384452,103.867991
807351,1,8,9,1.384322,103.86768
807352,7,0,7,1.384262,103.867434
807353,1,0,1,1.384363,103.867458
807354,40,2,42,1.384284,103.867325
807355,3,5,8,1.384378,103.867393
807356,16,0,16,1.384302,103.867212
807357,4,0,4,1.388002,103.859096
807358,1,2,3,1.387898,103.859241
807359,1,4,5,1.384411,103.867111
807360,41,5,46,1.384487,103.866965
807361,7,1,8,1.384334,103.867
807362,7,5,12,1.384495,103.866884
807363,11,2,13,1.384357,103.866909
807364,25,7,32,1.384745,103.866638
807365,21,2,23,1.384386,103.866767
807366,211,5,216,1.384738,103.866516
807367,16,0,16,1.384414,103.866619
807368,3,9,12,1.384704,103.866301
807369,5,0,5,1.384449,103.866442
807370,1,6,7,1.384405,103.867153
807371,13,1,14,1.384471,103.866254
807372,1,6,7,1.384849,103.865747
807373,8,0,8,1.384511,103.866049
807374,3,2,5,1.384894,103.86552
807375,5,2,7,1.38454,103.865839
807376,4,11,15,1.384888,103.865297
807377,3,6,9,1.384586,103.865622
807378,1,4,5,1.384995,103.86508
807379,19,0,19,1.384606,103.865476
807380,1,3,4,1.384419,103.867215
807381,53,0,53,1.384649,103.865222
807382,1,3,4,1.385031,103.86488
807383,0,1,1,1.384666,103.86508
807384,17,12,29,1.385264,103.864325
807385,5,23,28,1.384648,103.86461
807386,1,3,4,1.385115,103.864557
807388,0,2,2,1.387932,103.859192
807389,2,1,3,1.384312,103.867135
807390,1,1,2,1.385466,103.863961
807391,140,2,142,1.384837,103.864222
807392,2,1,3,1.384778,103.864317
807393,3,1,4,1.385351,103.864164
807394,3,1,4,1.38494,103.86401
807395,79,1,80,1.385147,103.863731
807396,22,18,40,1.385267,103.863577
807397,1,1,2,1.385508,103.863901
807398,8,6,14,1.38549,103.863247
807399,0,1,1,1.385582,103.863064
807400,2,1,3,1.384928,103.864102
807401,19,2,21,1.385679,103.862632
807402,2,1,3,1.385627,103.862831
807403,6,3,9,1.385764,103.862222
807404,6,5,11,1.38577,103.862011
807405,61,1,62,1.385759,103.861823
807406,4,2,6,1.385687,103.863633
807407,1,5,6,1.385731,103.863591
807408,29,2,31,1.385693,103.863363
807409,9,2,11,1.385778,103.863181
807410,7,1,8,1.385816,103.863012
807411,1,5,6,1.385845,103.862838
807412,2,2,4,1.385074,103.863834
807413,2,1,3,1.38573,103.862444
807414,20,0,20,1.386286,103.862512
807415,8,7,15,1.385973,103.862264
807416,0,6,6,1.385791,103.860759
807417,1,3,4,1.385543,103.859995
807418,0,3,3,1.3859,103.862621
807419,1,1,2,1.385378,103.863441
807420,5,6,11,1.385736,103.860295
807421,21,0,21,1.385721,103.860163
807423,5,2,7,1.385689,103.859898
807424,16,20,36,1.385673,103.859765
807425,14,6,20,1.385658,103.859633
807426,24,12,36,1.385642,103.8595
807427,1,0,1,1.385626,103.859368
807428,3,0,3,1.385768,103.86056
807429,7,10,17,1.385626,103.859196
807430,15,5,20,1.386081,103.861221
807431,14,5,19,1.386083,103.861185
807432,1,14,15,1.3858,103.861391
807433,77,0,77,1.385787,103.861324
807434,4,0,4,1.385783,103.860693
807435,8,1,9,1.385778,103.861193
807436,9,0,9,1.385767,103.861081
807437,1,5,6,1.385762,103.861025
807438,9,0,9,1.385757,103.860968
807439,1,10,11,1.385753,103.860911
807440,9,4,13,1.385594,103.860689
807441,29,3,32,1.385595,103.86067
807442,2,0,2,1.385752,103.860428
807443,19,3,22,1.38561,103.860536
807444,7,1,8,1.387093,103.860381
807445,0,4,4,1.385781,103.861247
807446,3,0,3,1.385637,103.859291
807447,3,1,4,1.387088,103.860349
807448,1,3,4,1.387071,103.86022
807449,1,0,1,1.387054,103.860091
807450,7,6,13,1.387049,103.860051
807451,18,0,18,1.387045,103.860011
807452,13,0,13,1.387035,103.859932
807454,0,1,1,1.387016,103.859773
807455,7,2,9,1.387007,103.859693
807456,2,1,3,1.38708,103.860284
807457,8,1,9,1.386988,103.859534
807458,1,0,1,1.386979,103.859454
807459,1,0,1,1.387004,103.859448
807460,31,0,31,1.38697,103.859374
807462,4,0,4,1.387063,103.860155
807463,13,1,14,1.387,103.859319
807464,24,1,25,1.386951,103.859215
807465,1,2,3,1.386998,103.859613
807466,1,0,1,1.386941,103.859136
807467,15,18,33,1.387175,103.859187
807468,15,5,20,1.386921,103.85909
807483,0,5,5,1.385196,103.864673
807485,2,1,3,1.386986,103.859244
807486,11,0,11,1.385447,103.86486
807487,1,0,1,1.385459,103.864746
807489,13,0,13,1.385751,103.86477
807490,12,0,12,1.385945,103.864965
807491,51,18,69,1.385506,103.864852
807492,14,3,17,1.385646,103.864903
807493,2,0,2,1.385572,103.860615
807505,13,5,18,1.38598,103.858997
807506,12,2,14,1.386292,103.859037
807507,4,2,6,1.386357,103.859054
807508,0,8,8,1.386422,103.859053
807509,0,3,3,1.385328,103.864701
807510,3,3,6,1.386682,103.85905
807511,18,0,18,1.386812,103.859048
807513,10,2,12,1.387014,103.85905
807514,11,4,15,1.387086,103.859053
807515,6,4,10,1.38723,103.859061
807516,0,6,6,1.387327,103.859058
807517,10,1,11,1.387462,103.859079
807518,6,4,10,1.387536,103.859082
807519,4,4,8,1.387661,103.859137
807520,5,1,6,1.387766,103.859201
807535,2,1,3,1.386552,103.859051
807536,257,0,257,1.384307,103.864697
807537,2,0,2,1.385592,103.864883
807538,5,11,16,1.38405,103.864657
807539,0,3,3,1.38381,103.864778
807541,14,1,15,1.383145,103.8648
807542,5,3,8,1.383557,103.864535
807543,4,0,4,1.38696,103.859295
807544,1,3,4,1.382924,103.864826
807545,18,6,24,1.382509,103.864304
807546,18,10,28,1.382611,103.864296
807547,35,263,298,1.382611,103.864296
807548,4,6,10,1.381808,103.86262
807549,17,0,17,1.382611,103.864296
807550,4,2,6,1.381642,103.86273
807551,47,4,51,1.382279,103.863744
807552,3,3,6,1.381406,103.86263
807553,64,0,64,1.382246,103.863749
807554,1,2,3,1.383362,103.864654
807555,25,122,147,1.382455,103.863775
807556,11,8,19,1.3812,103.862561
807557,11,0,11,1.382455,103.863775
807558,2,0,2,1.383579,103.864721
807559,5,35,40,1.382455,103.863775
807560,24,4,28,1.381028,103.862505
807561,5,0,5,1.382455,103.863775
807562,1,1,2,1.38112,103.862539
807563,1,4,5,1.382455,103.863775
807564,5,28,33,1.380873,103.862459
807565,4,0,4,1.383203,103.864329
807566,8,8,16,1.380787,103.862436
807567,126,0,126,1.381817,103.863599
807569,0,1,1,1.38178,103.863588
807572,1,0,1,1.381594,103.863967
807583,328,11,339,1.381673,103.862796
807584,670,93,763,1.380798,103.863015
807585,362,76,438,1.380523,103.863656
807586,434,57,491,1.381045,103.863822
807587,18,7,25,1.299509,103.837
807588,21,4,25,1.299509,103.837
807589,94,0,94,1.299509,103.837
807590,4,0,4,1.382455,103.863775
807591,22,0,22,1.299509,103.837
807592,1,0,1,1.299509,103.837
807594,16,0,16,1.299509,103.837
807595,3,0,3,1.381309,103.862601
807596,3,0,3,1.299509,103.837
807597,8,1,9,1.299509,103.837
807598,1,0,1,1.299509,103.837
807599,8,0,8,1.299509,103.837
807600,2,0,2,1.380948,103.862476
807601,1,25,26,1.383415,103.865494
807602,79,0,79,1.383696,103.865337
807603,0,1,1,1.383404,103.865625
807604,3,0,3,1.299509,103.837
807605,0,2,2,1.299509,103.837
807606,23,0,23,1.383236,103.865211
807607,32,3,35,1.383368,103.865812
807608,4,0,4,1.299509,103.837
807609,1,0,1,1.383351,103.865945
807610,0,3,3,1.383502,103.865266
807611,0,1,1,1.38333,103.86605
807612,5,1,6,1.383301,103.866227
807613,10,1,11,1.383254,103.866436
807615,0,1,1,1.383214,103.866224
807617,61,0,61,1.383275,103.865965
807618,1,1,2,1.383386,103.86571
807619,8,0,8,1.383308,103.86577
807621,5,2,7,1.383378,103.865414
807622,9,4,13,1.382509,103.866467
807623,73,10,83,1.382878,103.865384
807624,11,24,35,1.382851,103.865509
807625,2,0,2,1.383293,103.865875
807626,19,43,62,1.38281,103.865729
807627,11,3,14,1.382793,103.865839
807628,2,2,4,1.383027,103.865098
807629,0,2,2,1.382833,103.865625
807630,9,1,10,1.382699,103.866356
807631,0,13,13,1.382791,103.865325
807632,1,8,9,1.382763,103.865405
807633,62,0,62,1.38275,103.865445
807634,4,13,17,1.382732,103.8655
807635,69,0,69,1.382728,103.865549
807636,5,16,21,1.382706,103.86559
807638,4,1,5,1.382676,103.865742
807639,23,0,23,1.38265,103.865824
807640,0,1,1,1.382628,103.865869
807641,15,0,15,1.38262,103.865921
807642,19,1,20,1.38262,103.86598
807643,28,0,28,1.382605,103.86603
807644,12,4,16,1.382598,103.866084
807645,0,4,4,1.382758,103.86599
807646,0,14,14,1.383694,103.867515
807647,4,3,7,1.383728,103.866653
807648,1,1,2,1.382734,103.866141
807649,2,2,4,1.383712,103.866738
807650,2,0,2,1.383723,103.867402
807651,21,0,21,1.383789,103.866314
807652,3,5,8,1.383763,103.86714
807653,36,5,41,1.383819,103.866144
807654,29,13,42,1.383791,103.866975
807655,4,2,6,1.383849,103.865974
807656,2,0,2,1.38374,103.867288
807657,1,0,1,1.383837,103.866713
807658,7,0,7,1.383877,103.865864
807659,2,0,2,1.383814,103.866832
807660,0,1,1,1.383928,103.86566
807661,6,1,7,1.383917,103.86632
807663,3,1,4,1.383758,103.866483
807664,6,7,13,1.383982,103.86497
807666,0,12,12,1.38406,103.865711
807667,2,0,2,1.383877,103.866525
807668,20,8,28,1.384117,103.865244
807669,9,4,13,1.384163,103.864999
807670,5,2,7,1.383917,103.86632
807684,4,3,7,1.381565,103.867647
807685,0,1,1,1.382261,103.866911
807686,1,6,7,1.381773,103.867355
807688,9,0,9,1.381793,103.867302
807689,12,6,18,1.382738,103.867013
807690,11,0,11,1.381864,103.867167
807691,3,1,4,1.383968,103.866121
807692,9,0,9,1.381901,103.867122
807693,3,0,3,1.38293,103.865058
807694,0,1,1,1.381975,103.867032
807695,3,3,6,1.383374,103.867127
807696,14,2,16,1.383563,103.867144
807697,36,3,39,1.382123,103.866852
807699,60,9,69,1.381564,103.867646
807700,17,0,17,1.381564,103.867646
807701,1,0,1,1.382479,103.866743
807702,3,0,3,1.383162,103.867098
807703,1,5,6,1.381792,103.867301
807713,8,4,12,1.387297,103.866684
807714,0,9,9,1.386955,103.866604
807715,4,0,4,1.382933,103.867053
807716,0,10,10,1.386911,103.866679
807717,3,0,3,1.382492,103.866629
807718,0,5,5,1.386909,103.866706
807719,12,0,12,1.387258,103.866817
807720,29,0,29,1.386923,103.866788
807721,2,4,6,1.387243,103.866909
807722,0,21,21,1.386926,103.866839
807723,47,15,62,1.387256,103.866959
807724,1,0,1,1.386895,103.866897
807725,8,10,18,1.386877,103.866926
807726,44,5,49,1.387234,103.867072
807727,16,2,18,1.386874,103.866983
807728,1,0,1,1.387234,103.867135
807729,6,0,6,1.386888,103.867028
807730,2,3,5,1.38722,103.867156
807731,1,2,3,1.387265,103.866773
807732,3,6,9,1.387174,103.867244
807733,10,5,15,1.386696,103.867403
807734,1,5,6,1.387197,103.86729
807735,30,0,30,1.386672,103.867428
807736,3,0,3,1.386684,103.867325
807737,8,8,16,1.386673,103.867509
807738,1,2,3,1.387157,103.867343
807739,1,0,1,1.386615,103.86756
807740,2,1,3,1.386966,103.867578
807741,2,1,3,1.386958,103.867642
807742,3,0,3,1.386623,103.867587
807743,8,2,10,1.386642,103.867644
807745,12,0,12,1.386604,103.867759
807746,0,1,1,1.386969,103.867798
807747,12,2,14,1.386612,103.867819
807748,13,0,13,1.386953,103.86788
807750,28,11,39,1.386929,103.867907
807751,1,0,1,1.386592,103.86795
807752,4,0,4,1.38727,103.866712
807753,2,1,3,1.386984,103.867681
807754,6,0,6,1.387015,103.868023
807755,3,4,7,1.386554,103.868034
807756,2,4,6,1.386879,103.868062
807757,0,2,2,1.384088,103.865483
807758,1,0,1,1.386859,103.86827
807760,6,5,11,1.386573,103.868296
807761,1,61,62,1.386505,103.868315
807762,4,29,33,1.386293,103.868297
807763,4,120,124,1.386223,103.868256
807764,401,28,429,1.385983,103.868282
807765,31,19,50,1.385892,103.868276
807766,2,22,24,1.385688,103.868257
807767,6,31,37,1.385585,103.868231
807768,1,18,19,1.385405,103.868178
807769,0,14,14,1.385206,103.868182
807770,6,3,9,1.384972,103.868124
807771,21,8,29,1.384811,103.86809
807772,14,7,21,1.38466,103.868079
807773,27,9,36,1.38347,103.867623
807774,3,2,5,1.383775,103.867773
807775,37,2,39,1.383286,103.8676
807776,42,6,48,1.383674,103.867754
807777,5,3,8,1.383114,103.867583
807778,3,2,5,1.383461,103.867743
807779,8,0,8,1.382954,103.867549
807780,3,6,9,1.383324,103.867721
807782,16,3,19,1.383186,103.867704
807784,10,9,19,1.38302,103.867675
807785,3,0,3,1.386568,103.868002
807786,6,2,8,1.382859,103.867653
807788,17,3,20,1.382699,103.867619
807789,7,0,7,1.382095,103.867396
807790,9,9,18,1.38251,103.867579
807791,0,2,2,1.386889,103.868112
807792,0,7,7,1.382023,103.867505
807793,7,39,46,1.386847,103.867132
807794,5,1,6,1.38734,103.866635
807795,7,13,20,1.299509,103.837
807807,2,3,5,1.385464,103.867844
807808,3,4,7,1.385589,103.867823
807809,13,0,13,1.385481,103.867719
807810,4,0,4,1.386932,103.867982
807811,31,0,31,1.385504,103.867571
807812,2,3,5,1.385625,103.867578
807813,1,0,1,1.385538,103.867423
807814,8,2,10,1.385654,103.867445
807815,2,0,2,1.382287,103.86755
807816,22,0,22,1.38566,103.867336
807817,26,1,27,1.385607,103.867115
807818,0,3,3,1.382519,103.867481
807820,6,4,10,1.38567,103.866813
807821,0,5,5,1.385795,103.866709
807822,2,0,2,1.385578,103.867252
807823,38,5,43,1.385808,103.866594
807824,1,5,6,1.385732,103.866523
807825,4,5,9,1.385126,103.866438
807826,6,2,8,1.385233,103.866427
807827,2,0,2,1.385692,103.866671
807828,85,5,90,1.385198,103.866586
807829,8,1,9,1.385112,103.866586
807830,1,2,3,1.385695,103.867167
807832,3,5,8,1.385136,103.866911
807833,0,1,1,1.385026,103.866921
807835,1,0,1,1.384991,103.867086
807836,5,1,6,1.385061,103.867252
807837,32,6,38,1.384951,103.86728
807839,8,1,9,1.384923,103.867451
807841,5,1,6,1.384883,103.867616
807842,6,2,8,1.384964,103.867759
807843,15,3,18,1.384878,103.867698
807845,12,4,16,1.385149,103.866097
807846,4,0,4,1.385601,103.867704
807847,240,0,240,1.384869,103.866059
807848,22,10,32,1.384733,103.866021
807861,1,5,6,1.382501,103.861747
807862,5,4,9,1.382711,103.861223
807863,1,5,6,1.383178,103.861207
807864,7,2,9,1.382662,103.861149
807865,0,1,1,1.383208,103.861138
807866,3,0,3,1.385153,103.866734
807868,19,0,19,1.382502,103.860984
807869,2,0,2,1.385113,103.866501
807870,24,1,25,1.382416,103.860904
807871,2,5,7,1.383215,103.860958
807872,24,1,25,1.38236,103.86089
807873,6,2,8,1.383164,103.861009
807874,4,7,11,1.382293,103.860845
807875,0,6,6,1.382772,103.861195
807876,22,0,22,1.382221,103.86078
807877,7,5,12,1.382733,103.861125
807878,7,3,10,1.382155,103.860742
807879,5,3,8,1.382684,103.861051
807880,4,0,4,1.385017,103.866078
807881,57,14,71,1.382614,103.860977
807882,0,2,2,1.383512,103.861193
807883,1,0,1,1.382555,103.860907
807885,3,0,3,1.382575,103.861036
807886,11,3,14,1.381848,103.8605
807887,1,0,1,1.382389,103.860801
807888,11,1,12,1.381811,103.86047
807889,4,6,10,1.382304,103.860737
807890,36,2,38,1.381705,103.860351
807891,10,0,10,1.382229,103.860681
807892,19,0,19,1.381662,103.860312
807893,17,4,21,1.382172,103.860624
807894,6,1,7,1.381551,103.8602
807895,1,0,1,1.382081,103.860534
807896,38,0,38,1.381522,103.860168
807897,126,1,127,1.382022,103.860464
807898,4,0,4,1.382085,103.860675
807899,1,7,8,1.381928,103.860405
807900,4,0,4,1.381483,103.860134
807901,7,0,7,1.381856,103.860358
807902,1,2,3,1.382461,103.860848
807903,9,2,11,1.381771,103.860294
807904,2,11,13,1.381308,103.860003
807905,12,0,12,1.381696,103.860238
807906,5,2,7,1.381639,103.860181
807907,47,24,71,1.381582,103.860135
807908,4,0,4,1.381447,103.860108
807909,0,14,14,1.38145,103.860022
807910,4,2,6,1.382776,103.861808
807911,6,1,7,1.382737,103.861713
807924,5,1,6,1.38338,103.860733
807925,20,0,20,1.383393,103.86087
807926,1,0,1,1.38332,103.860685
807927,24,0,24,1.383442,103.860826
807928,26,3,29,1.383272,103.860644
807929,10,0,10,1.383356,103.860946
807930,6,0,6,1.383212,103.860582
807931,1,1,2,1.381983,103.860586
807934,11,4,15,1.383009,103.860407
807935,2,1,3,1.381339,103.860059
807936,3,0,3,1.382967,103.860378
807937,15,1,16,1.382881,103.860295
807938,2,0,2,1.383158,103.860542
807939,5,0,5,1.382763,103.860196
807940,7,0,7,1.382727,103.860158
807941,2,0,2,1.382834,103.860246
807942,1,0,1,1.38254,103.86009
807943,0,1,1,1.38246,103.860075
807944,7,0,7,1.382416,103.860043
807945,15,0,15,1.382352,103.860011
807946,1,0,1,1.382298,103.860014
807947,4,0,4,1.381507,103.860079
807948,2,3,5,1.382184,103.859938
807949,2,2,4,1.382247,103.859989
807950,9,6,15,1.382044,103.859874
807951,27,5,32,1.381977,103.859846
807952,2,0,2,1.382616,103.860122
807953,16,85,101,1.38185,103.85975
807954,5,7,12,1.382373,103.859924
807968,2,11,13,1.385117,103.861645
807970,3,2,5,1.384919,103.861651
807971,4,10,14,1.385405,103.861478
807972,0,2,2,1.381888,103.859776
807973,22,9,31,1.385032,103.861508
807974,2,0,2,1.384746,103.861653
807975,47,15,62,1.384825,103.861558
807976,11,6,17,1.384326,103.861699
807977,0,4,4,1.382117,103.859916
807978,19,11,30,1.384362,103.861586
807979,7,1,8,1.383994,103.862178
807980,0,13,13,1.383937,103.862201
807981,9,0,9,1.383891,103.862235
807983,2,13,15,1.383851,103.862263
807984,10,12,22,1.383985,103.861622
807985,11,0,11,1.383805,103.862281
807986,19,2,21,1.383847,103.861653
807987,81,0,81,1.383759,103.862298
807988,2,3,5,1.383672,103.861605
807989,1,1,2,1.384515,103.861675
807990,8,0,8,1.383518,103.861764
807991,8,1,9,1.383654,103.862212
807992,13,3,16,1.383432,103.861796
807993,15,1,16,1.38376,103.862169
807994,4,5,9,1.383292,103.861836
807995,14,2,16,1.383794,103.862151
807996,16,12,28,1.383185,103.861877
807997,7,4,11,1.383823,103.862134
807998,10,2,12,1.383109,103.861912
807999,4,0,4,1.384569,103.861532
808000,15,6,21,1.383053,103.861933
808001,1,1,2,1.383607,103.862228
808002,2,17,19,1.382822,103.86215
808003,9,11,20,1.383926,103.8621
808004,1,1,2,1.383886,103.862112
808005,542,85,627,1.383626,103.862363
808006,2,1,3,1.382922,103.860339
808007,2,0,2,1.382754,103.862204
808008,34,14,48,1.382447,103.862428
808009,5,4,9,1.382361,103.862478
808010,158,5,163,1.383614,103.862973
808011,2,15,17,1.38228,103.862536
808012,292,84,376,1.382975,103.863113
808013,0,5,5,1.382199,103.862608
808014,290,72,362,1.3827,103.862375
808015,377,20,397,1.382502,103.862543
808016,20,0,20,1.384507,103.861559
808017,19,4,23,1.384593,103.861501
808018,2,13,15,1.384538,103.861519
808019,6,0,6,1.385118,103.862521
808020,34,5,39,1.384383,103.861581
808021,2,0,2,1.382542,103.86237
808022,4,0,4,1.383852,103.862129
808023,5,4,9,1.384339,103.861587
808024,31,1,32,1.383907,103.86163
808025,35,13,48,1.383947,103.861626
808026,9,1,10,1.383767,103.861678
808027,1,3,4,1.384319,103.861591
808028,21,6,27,1.383492,103.861663
808030,1,1,2,1.384294,103.861578
808031,0,1,1,1.383237,103.863972
808032,11,1,12,1.383209,103.863921
808033,0,1,1,1.383178,103.863879
808034,7,2,9,1.38316,103.863824
808035,15,1,16,1.383139,103.863778
808036,408,25,433,1.382952,103.863188
808037,24,7,31,1.383031,103.863241
808038,31,31,62,1.383081,103.863298
808039,5,18,23,1.383104,103.863361
808040,23,11,34,1.383117,103.863416
808041,8,15,23,1.38312,103.863456
808042,0,17,17,1.383155,103.863545
808043,23,17,40,1.383183,103.863617
808044,20,8,28,1.383225,103.863635
808045,8,1,9,1.383279,103.86374
808046,18,3,21,1.383247,103.863799
808047,8,5,13,1.383336,103.863858
808048,0,4,4,1.383665,103.861702
808049,5,7,12,1.383726,103.864084
808050,1,0,1,1.383895,103.863957
808051,17,0,17,1.383869,103.864123
808052,25,7,32,1.384289,103.863965
808053,0,1,1,1.384025,103.864138
808054,172,1,173,1.384496,103.863701
808055,2,4,6,1.384248,103.864156
808056,4,0,4,1.383658,103.863935
808057,7,3,10,1.384614,103.863455
808058,8,6,14,1.384476,103.863956
808059,73,4,77,1.384711,103.86335
808060,5,8,13,1.384615,103.863745
808061,13,0,13,1.384896,103.863079
808062,11,5,16,1.384751,103.863592
808063,10,4,14,1.385005,103.862909
808064,1,0,1,1.384819,103.863485
808065,6,0,6,1.385076,103.862687
808066,7,6,13,1.384926,103.863308
808067,71,2,73,1.38514,103.862401
808068,12,3,15,1.385083,103.8631
808069,3,0,3,1.382605,103.862312
808070,1,0,1,1.385215,103.862792
808071,18,7,25,1.385237,103.86268
808072,4,4,8,1.385341,103.862261
808073,27,1,28,1.385369,103.862172
808074,0,2,2,1.383305,103.86418
808075,55,1,56,1.385354,103.861786
808076,12,0,12,1.384371,103.863898
808134,5,4,9,1.381652,103.862122
808135,1,2,3,1.385189,103.862125
808136,0,3,3,1.381786,103.86213
808137,0,2,2,1.385353,103.861915
808138,3,1,4,1.384298,103.864125
808139,1,0,1,1.381682,103.862063
808140,0,2,2,1.381751,103.862108
808141,1,0,1,1.381612,103.862017
808143,2,1,3,1.381572,103.86206
808144,11,3,14,1.38128,103.8619
808146,1,0,1,1.38124,103.861872
808147,9,5,14,1.381403,103.861882
808148,2,6,8,1.381194,103.861849
808149,17,1,18,1.381334,103.861837
808150,11,0,11,1.381114,103.861787
808152,5,2,7,1.381068,103.861764
808153,32,2,34,1.381194,103.861746
808154,0,2,2,1.381423,103.861974
808155,7,0,7,1.381125,103.861701
808173,25,2,27,1.382091,103.861922
808174,38,5,43,1.381997,103.862003
808175,28,0,28,1.381904,103.862083
808176,3,2,5,1.381821,103.862153
808177,5,5,10,1.382444,103.861647
808191,0,6,6,1.382235,103.861724
808192,13,2,15,1.382251,103.861718
808193,24,0,24,1.382193,103.861685
808194,0,1,1,1.382225,103.861695
808195,64,0,64,1.382109,103.861608
808197,4,0,4,1.381498,103.862003
808198,2,0,2,1.381034,103.861724
808199,0,2,2,1.382122,103.8616
808200,6,0,6,1.38207,103.861553
808201,6,0,6,1.3819,103.86145
808202,3,0,3,1.381542,103.861972
808203,2,2,4,1.382025,103.861532
808204,5,0,5,1.381967,103.861459
808205,8,0,8,1.381769,103.861332
808206,0,1,1,1.381915,103.861411
808207,1,0,1,1.381711,103.861292
808208,0,1,1,1.381863,103.861364
808209,9,0,9,1.381676,103.861257
808210,22,0,22,1.381811,103.861317
808211,0,14,14,1.381629,103.861232
808212,0,1,1,1.38176,103.86127
808213,1,3,4,1.381828,103.861369
808214,0,5,5,1.381708,103.861222
808216,183,3,186,1.381656,103.861175
808217,17,1,18,1.381488,103.861116
808218,6,0,6,1.381604,103.861128
808219,2,0,2,1.381965,103.861506
808220,4,0,4,1.38158,103.861189
808221,0,1,1,1.381391,103.861043
808222,1,0,1,1.381501,103.861034
808224,5,2,7,1.381449,103.860986
808225,12,3,15,1.381398,103.860939
808226,5,0,5,1.381346,103.860892
808229,0,1,1,1.381191,103.86075
808230,1,0,1,1.381139,103.860703
808233,0,3,3,1.382018,103.861506
808234,9,0,9,1.380942,103.860524
808249,8,46,54,1.386075,103.867914
808250,1,11,12,1.386109,103.868052
808251,12,1,13,1.386096,103.867831
808252,13,2,15,1.386121,103.867986
808253,3,6,9,1.386113,103.867704
808254,3,0,3,1.380984,103.860561
808255,17,2,19,1.386141,103.867618
808256,10,6,16,1.386166,103.867724
808257,0,1,1,1.386169,103.867489
808258,73,2,75,1.386189,103.867593
808259,0,3,3,1.386144,103.867855
808260,89,1,90,1.386212,103.867462
808261,4,1,5,1.386266,103.867321
808263,18,5,23,1.386281,103.867241
808264,0,2,2,1.381417,103.861064
808265,68,52,120,1.386305,103.867057
808266,1,3,4,1.381553,103.861081
808267,1,3,4,1.386238,103.867055
808268,15,0,15,1.38626,103.866947
808269,0,1,1,1.386338,103.866867
808270,18,1,19,1.386278,103.86685
808271,0,1,1,1.386372,103.866761
808272,2,0,2,1.386198,103.867169
808273,12,7,19,1.386391,103.8666
808274,1,1,2,1.386295,103.866748
808275,1,0,1,1.386403,103.866517
808276,12,3,15,1.386307,103.86623
808277,0,2,2,1.386329,103.866623
808278,3,1,4,1.386316,103.866988
808279,3,2,5,1.386413,103.866361
808280,5,0,5,1.386396,103.865837
808281,4,0,4,1.386361,103.866046
808282,1,0,1,1.386438,103.865657
808283,29,0,29,1.386447,103.866183
808284,3,2,5,1.386467,103.86548
808285,3,5,8,1.386464,103.866094
808286,1,2,3,1.386182,103.867395
808288,1,4,5,1.38648,103.865244
808290,0,1,1,1.386459,103.865134
808291,0,1,1,1.386564,103.865728
808292,7,4,11,1.386393,103.864973
808293,4,0,4,1.38643,103.866272
808294,21,0,21,1.386361,103.864922
808295,0,3,3,1.386477,103.865417
808296,15,3,18,1.386327,103.864874
808297,2,0,2,1.386448,103.866412
808298,1,3,4,1.386592,103.865594
808299,3,2,5,1.38664,103.865308
808300,8,0,8,1.386271,103.864796
808301,2,0,2,1.38663,103.865391
808302,0,1,1,1.386212,103.864723
808303,2,1,3,1.38661,103.865513
808305,0,2,2,1.386634,103.865213
808306,1,0,1,1.386172,103.864659
808308,4,1,5,1.386129,103.864605
808310,2,1,3,1.386637,103.865144
808311,2,5,7,1.386519,103.864966
808312,78,0,78,1.386015,103.864465
808313,2,2,4,1.386299,103.864828
808314,2,0,2,1.386595,103.865071
808315,0,1,1,1.386441,103.864863
808316,6,0,6,1.385934,103.864366
808318,6,1,7,1.385881,103.864308
808319,6,2,8,1.38634,103.864718
808320,7,0,7,1.385837,103.864261
808321,10,0,10,1.386289,103.864646
808322,4,0,4,1.386491,103.864935
808323,9,1,10,1.386239,103.864573
808324,1,2,3,1.386079,103.864537
808325,8,0,8,1.386188,103.864501
808326,4,0,4,1.38579,103.864255
808327,26,1,27,1.386138,103.864429
808328,14,1,15,1.385659,103.864056
808329,53,0,53,1.386087,103.864356
808330,3,0,3,1.385813,103.864221
808331,2,2,4,1.385739,103.864141
808334,2,0,2,1.385986,103.864429
808335,6,1,7,1.385909,103.864095
808336,119,2,121,1.385901,103.864062
808337,48,0,48,1.385877,103.864019
808338,5,0,5,1.385829,103.863949
808339,2,1,3,1.385661,103.864031
808340,0,4,4,1.386037,103.864284
808341,6,0,6,1.385743,103.86383
808342,23,1,24,1.385708,103.863802
808357,8,0,8,1.383224,103.872347
808358,0,3,3,1.385809,103.863919
808359,16,1,17,1.383201,103.87245
808361,14,5,19,1.383226,103.87254
808362,11,3,14,1.383121,103.872351
808363,3,0,3,1.383167,103.87217
808364,1,1,2,1.385936,103.864139
808365,26,1,27,1.383192,103.872706
808367,4,1,5,1.383164,103.872848
808368,2,2,4,1.385774,103.86388
808369,1,0,1,1.38302,103.87277
808370,1,4,5,1.383141,103.873013
808371,6,1,7,1.383003,103.872861
808372,6,0,6,1.383112,103.87311
808373,47,1,48,1.382991,103.872974
808374,68,4,72,1.383089,103.873218
808375,3,0,3,1.383204,103.872637
808376,25,2,27,1.383072,103.873326
808377,16,0,16,1.382957,103.873162
808378,0,1,1,1.383055,103.87344
808379,1,2,3,1.382974,103.873088
808380,8,1,9,1.383015,103.873548
808381,4,0,4,1.383049,103.872639
808382,10,4,14,1.383009,103.873651
808383,10,0,10,1.382917,103.873504
808384,3,3,6,1.383015,103.873753
808385,24,8,32,1.382906,103.873595
808386,10,3,13,1.382992,103.873873
808387,74,6,80,1.3829,103.873709
808388,15,8,23,1.382975,103.874021
808389,2,0,2,1.383083,103.872445
808390,5,3,8,1.382939,103.874406
808391,4,5,9,1.382866,103.873936
808392,19,2,21,1.382944,103.874464
808393,5,1,6,1.382837,103.874062
808394,1,0,1,1.382935,103.874592
808395,5,0,5,1.38282,103.874198
808396,1,1,2,1.382877,103.873834
808397,0,1,1,1.38282,103.874301
808399,13,0,13,1.382809,103.874403
808400,0,1,1,1.382835,103.874891
808401,6,0,6,1.382774,103.874574
808402,3,6,9,1.382778,103.875005
808403,0,4,4,1.382929,103.873401
808404,6,9,15,1.382744,103.875096
808405,3,3,6,1.382651,103.875079
808406,8,1,9,1.382709,103.875187
808407,1,2,3,1.382934,103.873322
808408,12,0,12,1.382658,103.875278
808410,1,1,2,1.382904,103.874709
808411,2,3,5,1.38253,103.875318
808412,11,0,11,1.382572,103.875483
808413,1,15,16,1.382505,103.875403
808414,7,1,8,1.382515,103.875603
808415,0,6,6,1.382479,103.875497
808416,6,1,7,1.382486,103.875705
808417,0,13,13,1.382462,103.875582
808418,54,6,60,1.382423,103.875637
808420,31,0,31,1.383146,103.872923
808421,0,3,3,1.382608,103.875155
808433,112,57,169,1.386204,103.873553
808434,140,38,178,1.386153,103.873516
808435,3,4,7,1.386114,103.873479
808436,93,29,122,1.386068,103.873437
808437,14,7,21,1.386012,103.873394
808438,16,17,33,1.385957,103.873353
808439,1,3,4,1.382757,103.874708
808440,15,28,43,1.385834,103.873237
808441,4,1,5,1.385618,103.873074
808442,2,14,16,1.385574,103.873042
808443,4,4,8,1.385518,103.872997
808444,0,24,24,1.385476,103.872956
808445,14,8,22,1.385413,103.872906
808446,19,14,33,1.385342,103.872854
808447,1,6,7,1.385282,103.872799
808448,55,17,72,1.385219,103.872757
808449,50,1,51,1.385184,103.872712
808450,13,52,65,1.38513,103.872673
808452,8,1,9,1.384749,103.872391
808453,1,7,8,1.384538,103.872442
808454,40,2,42,1.38464,103.872341
808455,15,0,15,1.384453,103.872421
808456,0,3,3,1.382946,103.873242
808457,1,13,14,1.384297,103.87246
808460,3,17,20,1.384405,103.872258
808461,3,1,4,1.385882,103.87329
808462,2,5,7,1.384291,103.872123
808463,8,1,9,1.383978,103.872411
808464,3,0,3,1.384501,103.872256
808465,2,0,2,1.382612,103.875381
808466,1,2,3,1.384238,103.872229
808468,11,1,12,1.384063,103.872201
808469,10,2,12,1.38364,103.872332
808471,2,0,2,1.3839,103.872289
808472,1,2,3,1.384148,103.872211
808473,3,1,4,1.384066,103.872409
808474,11,0,11,1.383779,103.872132
808475,0,2,2,1.383554,103.872193
808476,0,1,1,1.383703,103.872124
808477,0,2,2,1.383364,103.87225
808478,0,1,1,1.383463,103.872057
808480,6,4,10,1.383315,103.872025
808481,9,0,9,1.383224,103.872022
808482,4,0,4,1.383446,103.872235
808484,12,1,13,1.383027,103.871962
808485,18,1,19,1.384052,103.872322
808486,17,0,17,1.382938,103.871948
808487,11,0,11,1.382865,103.871935
808488,50,4,54,1.382824,103.871914
808499,1,1,2,1.383639,103.872101
808500,10,15,25,1.382459,103.876136
808503,5,6,11,1.381894,103.87618
808504,1,14,15,1.381805,103.876173
808505,1,1,2,1.382525,103.876142
808506,2,1,3,1.383859,103.872159
808521,3,0,3,1.381614,103.876148
808522,0,4,4,1.383144,103.872
808523,2,7,9,1.385141,103.871339
808524,2,0,2,1.381723,103.876166
808525,3,1,4,1.3853,103.871381
808526,2,1,3,1.385076,103.87154
808528,69,0,69,1.38534,103.871137
808529,6,0,6,1.385199,103.871077
808530,16,7,23,1.38534,103.871057
808531,5,1,6,1.385199,103.870957
808532,45,0,45,1.385363,103.870971
808547,25,5,30,1.38305,103.870188
808548,0,3,3,1.385323,103.871222
808549,0,1,1,1.383131,103.870204
808550,14,3,17,1.383151,103.870327
808551,18,3,21,1.383239,103.870206
808552,0,2,2,1.385306,103.871296
808553,2,5,7,1.383319,103.870212
808554,0,2,2,1.383264,103.870348
808555,0,4,4,1.385143,103.871222
808556,3,0,3,1.383055,103.870317
808557,3,0,3,1.383457,103.870371
808558,16,0,16,1.383536,103.870373
808559,3,4,7,1.383632,103.870286
808560,2,0,2,1.383338,103.870359
808561,43,3,46,1.383715,103.870289
808562,14,0,14,1.383716,103.870417
808563,12,0,12,1.383808,103.870299
808564,0,5,5,1.383823,103.870426
808565,1,1,2,1.383642,103.870396
808566,2,0,2,1.383903,103.870323
808567,1,0,1,1.384015,103.870338
808568,2,0,2,1.383907,103.870452
808569,4,0,4,1.38344,103.870236
808570,0,1,1,1.384097,103.870475
808571,13,1,14,1.384209,103.87037
808573,2,2,4,1.384101,103.870347
808574,7,0,7,1.384298,103.870501
808575,1,4,5,1.384367,103.870392
808576,4,1,5,1.384415,103.870515
808578,0,1,1,1.384494,103.870527
808579,1,1,2,1.384019,103.870465
808580,1,1,2,1.384574,103.870433
808581,12,7,19,1.384668,103.870449
808582,6,7,13,1.384684,103.870548
808583,2,1,3,1.383529,103.870244
808584,37,1,38,1.384905,103.870573
808585,1,1,2,1.384606,103.870537
808586,29,0,29,1.385003,103.870603
808587,0,2,2,1.384858,103.870495
808588,5,0,5,1.385161,103.870633
808589,213,14,227,1.385032,103.870518
808590,4,0,4,1.384281,103.870381
808591,2,4,6,1.385485,103.870591
808592,6,2,8,1.385552,103.870681
808593,79,4,83,1.38557,103.870604
808594,2,0,2,1.384956,103.870509
808595,5,2,7,1.385672,103.870632
808596,2,0,2,1.385617,103.870696
808597,5,2,7,1.38576,103.870643
808598,6,0,6,1.385795,103.870729
808599,2,1,3,1.384772,103.870485
808600,3,3,6,1.386047,103.870765
808602,1,1,2,1.385726,103.870719
808604,41,0,41,1.38622,103.870783
808605,5,2,7,1.386119,103.870692
808606,72,1,73,1.386277,103.87079
808607,0,5,5,1.386231,103.870696
808608,0,2,2,1.386125,103.870772
808609,0,27,27,1.386316,103.870707
808610,8,2,10,1.386511,103.870821
808611,4,2,6,1.386435,103.870732
808612,4,2,6,1.386619,103.87083
808613,0,2,2,1.386422,103.870805
808614,1,0,1,1.386824,103.870856
808615,18,3,21,1.38664,103.870746
808616,8,1,9,1.387002,103.870871
808617,1,3,4,1.385251,103.870652
808618,13,1,14,1.387129,103.870885
808619,1,2,3,1.385851,103.870667
808620,0,20,20,1.387232,103.870899
808621,0,2,2,1.386511,103.870737
808622,93,5,98,1.387283,103.870905
808623,2,7,9,1.387023,103.870784
808624,10,0,10,1.387328,103.870911
808625,2,8,10,1.387115,103.870787
808626,2,1,3,1.386844,103.870766
808627,0,8,8,1.38722,103.870806
808628,16,184,200,1.387466,103.870923
808629,1,0,1,1.387304,103.870815
808630,4,3,7,1.38741,103.870836
808631,82,359,441,1.387478,103.870836
808632,40,1,41,1.386335,103.870797
808633,38,3,41,1.386734,103.870843
808634,1,0,1,1.386905,103.870866
808636,5,0,5,1.387181,103.870892
808646,116,2,118,1.383254,103.869024
808647,1,4,5,1.383242,103.869126
808649,2,2,4,1.386744,103.870754
808650,6,0,6,1.383491,103.869069
808651,3,0,3,1.387399,103.87092
808652,4,1,5,1.383586,103.869084
808653,10,0,10,1.383556,103.869184
808654,0,1,1,1.383724,103.869099
808655,0,1,1,1.383705,103.869208
808657,2,0,2,1.386909,103.87078
808658,2,0,2,1.383939,103.869147
808659,1,1,2,1.383802,103.869225
808661,0,1,1,1.384014,103.869275
808664,3,2,5,1.384272,103.869205
808665,3,0,3,1.38347,103.869167
808666,14,3,17,1.384418,103.869213
808667,2,3,5,1.384384,103.869337
808669,1,0,1,1.384479,103.869349
808670,28,5,33,1.384647,103.86927
808672,1,0,1,1.38474,103.869283
808673,21,0,21,1.384718,103.869397
808674,6,1,7,1.384893,103.869315
808675,2,1,3,1.384252,103.869309
808676,2,3,5,1.384976,103.86933
808677,11,5,16,1.384947,103.869434
808678,2,0,2,1.383929,103.869254
808679,41,2,43,1.385091,103.869445
808680,6,4,10,1.385198,103.869361
808681,22,10,32,1.385168,103.869455
808696,7,10,17,1.385788,103.871504
808697,23,14,37,1.385861,103.871496
808698,7,0,7,1.385805,103.871429
808699,11,0,11,1.385872,103.871433
808700,8,0,8,1.385823,103.87135
808701,1,8,9,1.385889,103.871359
808702,8,2,10,1.38584,103.871276
808703,29,0,29,1.385895,103.871291
808704,0,3,3,1.384865,103.869426
808705,1,6,7,1.385912,103.871206
808706,2,0,2,1.385106,103.869338
808707,6,1,7,1.385941,103.871115
808722,18,5,23,1.382987,103.87078
808723,4,4,8,1.382979,103.870931
808726,0,2,2,1.385863,103.871128
808727,0,1,1,1.383167,103.870955
808728,4,6,10,1.383289,103.870822
808729,4,0,4,1.383346,103.869146
808730,2,0,2,1.383187,103.870808
808731,0,1,1,1.383341,103.870996
808732,8,0,8,1.383468,103.870841
808733,3,0,3,1.385857,103.87119
808734,33,0,33,1.383562,103.870869
808736,2,1,3,1.383426,103.871006
808737,2,4,6,1.383632,103.871027
808738,2,0,2,1.383381,103.870832
808739,5,1,6,1.383731,103.871046
808740,6,0,6,1.383847,103.870914
808741,3,0,3,1.383658,103.870868
808742,49,0,49,1.383953,103.870939
808743,4,5,9,1.383919,103.871078
808744,90,0,90,1.384027,103.87095
808745,2,0,2,1.383765,103.870903
808746,5,12,17,1.384137,103.870964
808747,8,1,9,1.384118,103.871099
808748,1,0,1,1.384223,103.870987
808749,4,2,6,1.384205,103.871115
808750,0,2,2,1.384017,103.871092
808751,0,1,1,1.384297,103.871129
808752,0,1,1,1.384429,103.871022
808753,1,1,2,1.384339,103.870999
808754,1,0,1,1.384529,103.871044
808755,3,2,5,1.384497,103.871167
808756,0,3,3,1.383809,103.871063
808757,2,3,5,1.384589,103.871183
808772,3,2,5,1.383344,103.868503
808773,29,7,36,1.38332,103.868597
808774,5,8,13,1.383431,103.868518
808775,184,0,184,1.383403,103.868618
808776,9,0,9,1.383562,103.868542
808778,9,0,9,1.38365,103.86855
808779,4,0,4,1.383248,103.870968
808780,2,2,4,1.383639,103.868659
808781,9,8,17,1.383779,103.86869
808782,10,2,12,1.383884,103.868589
808783,3,4,7,1.38405,103.868607
808784,4,0,4,1.383787,103.868572
808785,0,1,1,1.384016,103.868723
808786,18,0,18,1.384147,103.868623
808787,66,3,69,1.384118,103.868751
808788,0,2,2,1.384393,103.871145
808789,4,0,4,1.38386,103.868699
808790,3,0,3,1.384609,103.871052
808791,3,0,3,1.384354,103.868682
808792,14,1,15,1.384492,103.868709
808793,2,0,2,1.384272,103.868658
808794,68,0,68,1.384594,103.86873
808795,9,0,9,1.384569,103.868831
808796,8,8,16,1.384746,103.868752
808798,19,2,21,1.384815,103.868765
808799,3,1,4,1.384229,103.868778
808800,2,3,5,1.384975,103.868784
808801,3,0,3,1.384335,103.868792
808802,15,2,17,1.385068,103.868803
808803,22,0,22,1.385032,103.868919
808804,0,1,1,1.385214,103.868819
808806,0,7,7,1.385284,103.868834
808807,2,4,6,1.385265,103.868956
808822,3,7,10,1.385371,103.871773
808823,7,0,7,1.38534,103.871706
808825,2,4,6,1.385224,103.871833
808826,9,7,16,1.385426,103.872028
808827,101,2,103,1.385252,103.87193
808828,1,1,2,1.384465,103.868814
808829,2,1,3,1.384943,103.868899
808831,0,2,2,1.385391,103.872074
808832,0,1,1,1.385132,103.872065
808833,58,1,59,1.385534,103.872263
808834,54,11,65,1.385154,103.872102
808835,1,1,2,1.385167,103.871969
808836,3,6,9,1.385061,103.872209
808837,103,3,106,1.385277,103.872275
808838,0,1,1,1.385068,103.872262
808839,0,3,3,1.385228,103.871945
808840,2,0,2,1.385311,103.872214
808841,0,1,1,1.385212,103.872383
808842,29,4,33,1.384944,103.872235
808843,5,0,5,1.38491,103.872286
808844,2,1,3,1.385249,103.872333
808845,1,0,1,1.385449,103.871983
808846,47,4,51,1.299509,103.837
808859,17,0,17,1.38378,103.875332
808860,8,26,34,1.383836,103.875318
808861,3,2,5,1.383912,103.875293
808862,1,1,2,1.385046,103.872286
808865,3,1,4,1.384817,103.868872
808866,10,0,10,1.384201,103.875067
808867,36,0,36,1.384101,103.874972
808868,4,1,5,1.384251,103.875011
808869,12,2,14,1.384192,103.874891
808870,7,0,7,1.38431,103.87492
808871,2,0,2,1.383985,103.875256
808872,3,0,3,1.384876,103.872332
808873,2,0,2,1.384257,103.874817
808875,5,0,5,1.384393,103.874678
808877,3,4,7,1.384728,103.874287
808878,2,6,8,1.384807,103.874375
808880,7,5,12,1.384766,103.874244
808881,126,3,129,1.384888,103.874289
808882,20,4,24,1.384799,103.874194
808883,1,11,12,1.38493,103.87424
808884,7,5,12,1.384829,103.874152
808885,5,4,9,1.384974,103.874199
808886,24,0,24,1.384872,103.874104
808887,1,1,2,1.384321,103.874758
808888,5,1,6,1.384908,103.87405
808889,73,0,73,1.38505,103.874108
808890,5,6,11,1.384961,103.873981
808891,4,2,6,1.385085,103.874069
808892,10,0,10,1.38501,103.873927
808893,3,2,5,1.385128,103.874032
808894,3,3,6,1.385067,103.87387
808895,14,0,14,1.38517,103.873982
808896,0,2,2,1.38501,103.874156
808897,3,3,6,1.385209,103.873937
808898,1,2,3,1.384366,103.874863
808899,19,0,19,1.385245,103.873895
808900,0,1,1,1.3852,103.873725
808901,11,0,11,1.385275,103.873851
808902,1,3,4,1.38413,103.875131
808903,0,10,10,1.385305,103.873814
808904,2,0,2,1.385115,103.873813
808905,2,3,5,1.385337,103.873773
808906,3,2,5,1.3853,103.873603
808907,88,1,89,1.385366,103.873732
808908,49,0,49,1.385348,103.873563
808909,2,1,3,1.385156,103.873771
808910,1,0,1,1.385391,103.873525
808911,2,1,3,1.385407,103.873684
808926,2,26,28,1.385055,103.872898
808927,1,6,7,1.385015,103.872943
808928,1,0,1,1.384975,103.872977
808929,1,0,1,1.384929,103.873023
808930,24,5,29,1.384986,103.873158
808931,14,0,14,1.384889,103.873063
808932,4,0,4,1.385236,103.873678
808933,15,4,19,1.384849,103.873103
808934,0,6,6,1.384809,103.873148
808935,4,1,5,1.384923,103.873226
808937,3,4,7,1.384894,103.87326
808938,63,5,68,1.384757,103.873205
808939,0,10,10,1.384848,103.873294
808940,9,0,9,1.38474,103.873228
808941,12,0,12,1.384791,103.873334
808942,14,0,14,1.38448,103.875032
808943,0,3,3,1.385447,103.873633
808944,3,4,7,1.384589,103.8749
808945,2,0,2,1.385268,103.87365
808946,4,5,9,1.384643,103.874901
808947,36,7,43,1.384629,103.874189
808948,0,9,9,1.3849,103.87448
808949,1,0,1,1.384979,103.874433
808950,5,10,15,1.38471,103.874148
808951,31,0,31,1.385001,103.874372
808953,1,0,1,1.384997,103.874318
808954,9,3,12,1.384781,103.87407
808955,0,1,1,1.385039,103.874304
808956,0,2,2,1.384347,103.874549
808957,1,0,1,1.385068,103.874245
808960,1,0,1,1.384946,103.873908
808961,8,4,12,1.385176,103.874182
808962,13,0,13,1.384983,103.873845
808964,7,0,7,1.385205,103.874142
808968,6,1,7,1.385271,103.874095
808970,1,0,1,1.385037,103.873786
808974,5,0,5,1.385072,103.87371
808975,2,0,2,1.384813,103.874041
808977,15,0,15,1.385383,103.873937
808978,2,0,2,1.385344,103.873996
808979,12,1,13,1.385403,103.873863
808980,0,1,1,1.385187,103.873557
808981,3,0,3,1.38417,103.874631
808984,11,4,15,1.385256,103.873489
808998,12,0,12,1.385525,103.873761
808999,0,11,11,1.385286,103.873431
809000,32,2,34,1.385606,103.873772
809001,9,0,9,1.384986,103.872758
809002,1,2,3,1.385467,103.873849
809005,0,4,4,1.384957,103.873192
809008,4,0,4,1.385056,103.873239
809010,8,0,8,1.384983,103.873332
809011,34,0,34,1.384709,103.873019
809012,28,0,28,1.384943,103.873377
809013,14,1,15,1.384661,103.873128
809014,3,0,3,1.384922,103.872819
809022,10,733,743,1.384594,103.873187
809024,8,1,9,1.384857,103.873467
809025,3,2,5,1.384561,103.873238
809026,4,14,18,1.384812,103.873532
809027,1,28,29,1.384524,103.873282
809028,34,38,72,1.384793,103.873571
809029,56,9,65,1.384519,103.873321
809030,98,0,98,1.384707,103.873655
809031,3,0,3,1.384884,103.873442
809032,2,11,13,1.384678,103.8737
809033,47,62,109,1.384436,103.873387
809034,2,0,2,1.385144,103.873582
809035,38,0,38,1.384357,103.873422
809036,3,5,8,1.384625,103.873778
809037,12,34,46,1.384305,103.87351
809038,5,0,5,1.384556,103.873787
809039,17,0,17,1.384266,103.873535
809040,13,2,15,1.384524,103.873835
809041,322,78,400,1.384237,103.873573
809042,4,0,4,1.384803,103.872986
809043,41,8,49,1.384223,103.873648
809044,0,1,1,1.384486,103.873977
809045,6,0,6,1.384184,103.87369
809046,1,0,1,1.384116,103.873718
809047,3,15,18,1.384083,103.873739
809048,0,4,4,1.384512,103.87387
809049,22,5,27,1.383981,103.873895
809050,21,0,21,1.383959,103.873919
809051,33,30,63,1.383884,103.873978
809052,1,1,2,1.384673,103.873739
809053,0,10,10,1.383874,103.873981
809054,58,0,58,1.384071,103.874435
809055,84,0,84,1.383812,103.874009
809056,37,3,40,1.383758,103.874091
809057,4,13,17,1.383468,103.874096
809058,6,0,6,1.383432,103.874063
809060,58,1,59,1.383218,103.874059
809061,1,5,6,1.383725,103.874116
809062,3,1,4,1.384056,103.873765
809064,1,2,3,1.384485,103.873361
809065,6,2,8,1.383551,103.874584
809066,3,0,3,1.383481,103.874478
809067,0,6,6,1.383565,103.874501
809068,12,10,22,1.383582,103.874407
809083,1,0,1,1.385198,103.870365
809084,1,3,4,1.383462,103.874589
809086,1,3,4,1.385211,103.870286
809087,4,0,4,1.385244,103.870083
809088,5,2,7,1.385281,103.869857
809089,0,1,1,1.385296,103.869746
809090,8,1,9,1.385307,103.869641
809091,35,0,35,1.385319,103.86954
809092,55,4,59,1.385328,103.869452
809093,2,2,4,1.385262,103.869961
809094,27,0,27,1.385358,103.869262
809095,2,1,3,1.383487,103.874394
809096,19,2,21,1.38539,103.869059
809097,0,3,3,1.385372,103.86916
809098,6,0,6,1.385409,103.868885
809099,1,0,1,1.385424,103.868794
809100,3,32,35,1.385448,103.868699
809101,4,8,12,1.38516,103.870453
809115,91,10,101,1.383175,103.869544
809116,0,17,17,1.383135,103.869688
809117,5,4,9,1.383253,103.86955
809118,0,1,1,1.383211,103.8697
809119,7,2,9,1.383378,103.869583
809120,5,4,9,1.383325,103.869722
809121,3,0,3,1.385397,103.868967
809122,8,0,8,1.383406,103.869729
809123,2,0,2,1.384143,103.87435
809125,56,2,58,1.383734,103.869639
809126,6,2,8,1.383869,103.869664
809127,3,0,3,1.383483,103.86959
809129,2,2,4,1.38534,103.869357
809130,11,4,15,1.383788,103.869796
809131,1,0,1,1.384095,103.869714
809132,0,1,1,1.383882,103.869812
809134,1,0,1,1.383963,103.869823
809135,4,0,4,1.383963,103.869684
809136,3,0,3,1.383589,103.869765
809137,0,1,1,1.384415,103.869774
809138,4,0,4,1.384314,103.869752
809139,0,4,4,1.384166,103.869871
809141,27,0,27,1.384629,103.869814
809143,1,0,1,1.384792,103.86983
809144,3,0,3,1.384076,103.869847
809146,10,3,13,1.384531,103.86992
809147,1,0,1,1.385032,103.869877
809149,2,3,5,1.385128,103.869888
809150,0,1,1,1.384732,103.869948
809151,4,1,5,1.384849,103.869975
809152,2,0,2,1.383627,103.869617
809154,9,3,12,1.38513,103.870012
809169,0,2,2,1.384926,103.869983
809171,9,0,9,1.382051,103.87583
809172,1,0,1,1.382087,103.875737
809173,2,0,2,1.38199,103.876037
809174,4,0,4,1.384551,103.869799
809176,3,0,3,1.384459,103.869915
809177,1,0,1,1.382282,103.875096
809178,5,5,10,1.382285,103.874966
809179,0,7,7,1.38235,103.874716
809180,10,0,10,1.382283,103.874874
809181,16,4,20,1.382345,103.874619
809182,3,0,3,1.38227,103.875169
809183,0,4,4,1.3822,103.875395
809184,13,1,14,1.38226,103.874665
809185,104,2,106,1.38232,103.87442
809186,12,1,13,1.382254,103.874558
809187,1,3,4,1.38232,103.87451
809188,1,0,1,1.382249,103.874472
809189,0,1,1,1.382328,103.874228
809190,0,4,4,1.382317,103.874291
809191,8,0,8,1.382341,103.87412
809192,0,1,1,1.382241,103.874295
809193,0,8,8,1.382353,103.874034
809194,1,0,1,1.382252,103.874199
809195,1,0,1,1.382375,103.873932
809196,6,0,6,1.382256,103.874099
809197,7,0,7,1.382384,103.873845
809198,1,0,1,1.382274,103.874014
809199,18,10,28,1.382399,103.873728
809200,0,2,2,1.382125,103.875627
809201,12,0,12,1.382405,103.873644
809202,4,0,4,1.38224,103.874362
809204,5,2,7,1.382298,103.873731
809205,0,1,1,1.382442,103.873462
809206,11,5,16,1.382308,103.873635
809208,0,7,7,1.382333,103.873525
809209,4,0,4,1.382292,103.873838
809210,65,5,70,1.382341,103.873411
809211,1,0,1,1.382494,103.873131
809212,2,2,4,1.382479,103.873239
809216,4,2,6,1.382503,103.873045
809217,0,1,1,1.382357,103.873212
809219,1,2,3,1.382269,103.874753
809220,8,3,11,1.382374,103.873101
809222,10,0,10,1.382534,103.872859
809223,5,1,6,1.382377,103.872996
809224,3,1,4,1.382355,103.873308
809225,0,2,2,1.382284,103.873927
809226,3,0,3,1.382512,103.872974
809227,2,0,2,1.382395,103.872878
809228,1,3,4,1.382546,103.872739
809229,2,1,3,1.382567,103.872658
809230,1,0,1,1.38261,103.872473
809232,2,3,5,1.382653,103.872328
809233,1,0,1,1.382473,103.872524
809236,3,3,6,1.382694,103.872159
809237,19,3,22,1.38254,103.872322
809238,6,14,20,1.382717,103.872087
809239,1,1,2,1.382416,103.872785
809240,0,5,5,1.382587,103.872144
809241,3,0,3,1.38243,103.872696
809242,28,0,28,1.382638,103.871959
809243,36,0,36,1.382665,103.87184
809244,1,0,1,1.382676,103.871752
809245,3,0,3,1.382613,103.872044
809246,2,0,2,1.382561,103.87223
809247,1,3,4,1.382586,103.872556
809248,6,0,6,1.382749,103.871348
809250,3,0,3,1.382701,103.871651
809251,2,0,2,1.38272,103.871499
809252,3,0,3,1.38278,103.871153
809253,1,1,2,1.382792,103.871048
809254,6,0,6,1.382847,103.870776
809255,2,0,2,1.382835,103.870853
809256,14,0,14,1.382871,103.870581
809257,1,0,1,1.382884,103.870491
809258,3,2,5,1.382896,103.870396
809260,2,0,2,1.382865,103.870677
809262,6,0,6,1.382948,103.870002
809263,23,3,26,1.382957,103.869913
809264,28,2,30,1.382969,103.869818
809265,2,2,4,1.382738,103.871431
809266,0,7,7,1.382994,103.869632
809267,3,0,3,1.382819,103.870946
809268,14,1,15,1.38301,103.86948
809270,66,1,67,1.383032,103.869357
809271,8,2,10,1.383045,103.869287
809273,0,1,1,1.38307,103.869004
809276,3,1,4,1.382985,103.869719
809277,5,0,5,1.383124,103.868761
809278,1,0,1,1.383135,103.868693
809280,3,0,3,1.383004,103.869524
809281,10,0,10,1.383227,103.868532
809283,11,1,12,1.382712,103.871566
809284,11,126,137,1.382094,103.876059
809285,2,6,8,1.382105,103.875996
809286,1,1,2,1.382923,103.870192
809287,0,2,2,1.382116,103.875937
809288,6,4,10,1.382368,103.875118
809312,0,4,4,1.383107,103.868839
809313,0,6,6,1.385918,103.872914
809314,0,1,1,1.385877,103.872657
809315,0,1,1,1.385937,103.87286
809316,13,0,13,1.385897,103.872629
809317,12,2,14,1.385963,103.872773
809319,15,0,15,1.385981,103.872721
809321,17,8,25,1.386002,103.872639
809322,3,3,6,1.385946,103.87245
809323,2,0,2,1.382138,103.875878
809324,0,1,1,1.38605,103.872549
809325,0,2,2,1.386018,103.872603
809326,27,0,27,1.386072,103.872494
809328,2,1,3,1.383175,103.868572
809329,1,0,1,1.385894,103.872193
809330,3,0,3,1.386085,103.872421
809331,24,4,28,1.385988,103.872117
809332,2,0,2,1.38597,103.872424
809346,13,6,19,1.382906,103.871404
809347,0,3,3,1.385897,103.872138
809348,3,2,5,1.382981,103.871427
809349,10,0,10,1.382992,103.871511
809350,45,1,46,1.383082,103.871444
809351,93,3,96,1.383096,103.871524
809352,6,3,9,1.383172,103.871451
809353,7,0,7,1.383171,103.871536
809354,0,1,1,1.383292,103.871478
809355,1,0,1,1.383282,103.871563
809356,0,2,2,1.385858,103.872681
809357,0,1,1,1.383365,103.871587
809358,4,0,4,1.38584,103.872743
809359,1,0,1,1.383493,103.871603
809360,0,2,2,1.383368,103.871489
809361,1,0,1,1.383571,103.871626
809362,3,1,4,1.383476,103.871512
809364,1,2,3,1.382887,103.871483
809365,1,9,10,1.383753,103.871677
809366,1,1,2,1.383556,103.871521
809367,21,0,21,1.383829,103.871676
809368,1,0,1,1.383948,103.87157
809369,7,3,10,1.383936,103.871693
809370,3,0,3,1.38375,103.871542
809371,25,4,29,1.384033,103.871719
809372,6,1,7,1.384133,103.871613
809373,22,11,33,1.384108,103.871732
809374,1,0,1,1.384235,103.871629
809375,9,5,14,1.384187,103.871746
809376,4,9,13,1.384331,103.871644
809377,3,0,3,1.384048,103.8716
809379,35,0,35,1.384353,103.871781
809380,3,12,15,1.384514,103.87168
809381,1,2,3,1.384266,103.871759
809382,4,1,5,1.384532,103.871823
809383,54,68,122,1.384617,103.871827
809398,23,2,25,1.384328,103.87403
809399,6,0,6,1.384374,103.874084
809400,1,0,1,1.384447,103.874169
809401,2,0,2,1.38386,103.871566
809402,1,1,2,1.384492,103.874219
809403,6,3,9,1.38461,103.874346
809405,16,0,16,1.384828,103.87457
809406,28,0,28,1.384894,103.874649
809407,33,2,35,1.384934,103.874694
809408,2,0,2,1.384568,103.874301
809409,7,8,15,1.385071,103.874842
809424,16,0,16,1.387937,103.866592
809425,3,0,3,1.384436,103.871797
809426,0,1,1,1.387957,103.866495
809427,1,9,10,1.387884,103.866534
809428,36,2,38,1.387994,103.866388
809430,63,4,67,1.388009,103.866317
809431,1,0,1,1.387927,103.866363
809432,3,0,3,1.387864,103.866639
809433,0,4,4,1.383676,103.87153
809434,0,2,2,1.385028,103.874794
809435,2,4,6,1.387978,103.866175
809436,1,1,2,1.388064,103.866142
809437,16,0,16,1.387986,103.866084
809438,2,11,13,1.388103,103.865941
809439,1,1,2,1.388066,103.866047
809440,5,10,15,1.388143,103.865724
809441,23,0,23,1.388037,103.865889
809442,21,4,25,1.388166,103.865661
809443,14,4,18,1.388052,103.865822
809444,42,6,48,1.388192,103.865548
809445,3,2,5,1.38808,103.865698
809446,2,7,9,1.388211,103.865481
809447,2,0,2,1.388029,103.865982
809448,0,7,7,1.388229,103.865373
809449,2,0,2,1.388083,103.865611
809450,51,1,52,1.388258,103.865292
809451,1,4,5,1.38813,103.865402
809452,14,41,55,1.388293,103.865184
809453,0,15,15,1.388181,103.865217
809454,1,0,1,1.388319,103.865099
809455,2,0,2,1.388121,103.865515
809456,2,2,4,1.387947,103.866266
809457,0,1,1,1.388244,103.865037
809459,4,0,4,1.388338,103.864988
809460,11,0,11,1.388385,103.864797
809461,19,1,20,1.388289,103.864868
809462,13,1,14,1.388409,103.864724
809463,2,1,3,1.388027,103.866213
809464,2,0,2,1.388209,103.865144
809467,6,0,6,1.388364,103.864588
809468,0,5,5,1.388483,103.864411
809470,10,0,10,1.388507,103.864344
809472,3,0,3,1.388311,103.864763
809473,37,0,37,1.38843,103.86431
809474,3,3,6,1.388566,103.864154
809475,0,1,1,1.388446,103.864227
809476,6,1,7,1.388581,103.864054
809477,2,0,2,1.388425,103.864618
809478,12,0,12,1.388607,103.863971
809479,0,2,2,1.388469,103.864118
809481,32,0,32,1.388512,103.863939
809482,19,3,22,1.38865,103.863786
809483,3,5,8,1.388522,103.863848
809484,6,0,6,1.388683,103.863657
809485,3,6,9,1.38872,103.863547
809486,2,3,5,1.38863,103.86358
809500,51,58,109,1.38806,103.867137
809501,2,3,5,1.387764,103.867669
809502,9,103,112,1.388033,103.867231
809503,0,3,3,1.388536,103.864239
809504,9,3,12,1.388015,103.86732
809505,8,0,8,1.387644,103.867656
809506,6,307,313,1.387984,103.867427
809507,3,6,9,1.387581,103.867644
809508,44,12,56,1.387962,103.867513
809509,2,0,2,1.388485,103.86404
809510,5,130,135,1.387933,103.86762
809511,0,4,4,1.388266,103.864949
809512,4,58,62,1.387904,103.867711
809513,1,5,6,1.387404,103.86763
809514,4,6,10,1.387876,103.867807
809515,3,0,3,1.387713,103.867662
809516,7,41,48,1.387847,103.86791
809517,26,3,29,1.387375,103.867685
809518,1,174,175,1.387817,103.868
809519,72,8,80,1.387424,103.867697
809520,4,3,7,1.38778,103.86814
809521,9,0,9,1.387519,103.867715
809522,4,487,491,1.387739,103.868245
809523,27,0,27,1.387572,103.867727
809524,11,1,12,1.38764,103.867733
809525,0,1,1,1.387711,103.867741
809526,1,0,1,1.38775,103.868002
809527,11,0,11,1.387734,103.868055
809528,18,2,20,1.387723,103.868107
809529,3,2,5,1.387705,103.868162
809530,0,1,1,1.387695,103.868227
809531,4,271,275,1.387674,103.868278
809546,9,13,22,1.387917,103.867039
809547,1,55,56,1.388308,103.867013
809548,22,0,22,1.387842,103.867031
809550,14,1,15,1.387771,103.867025
809551,0,2,2,1.387518,103.867642
809552,6,1,7,1.387701,103.867027
809553,0,3,3,1.387404,103.867686
809554,1,0,1,1.387636,103.867007
809555,0,2,2,1.388066,103.866995
809556,1,0,1,1.387543,103.867006
809557,0,2,2,1.387703,103.866942
809558,6,0,6,1.387498,103.866991
809560,1,1,2,1.387632,103.866938
809561,3,1,4,1.387471,103.867638
809563,4,0,4,1.387504,103.866929
809578,12,282,294,1.391911,103.851341
809579,1,94,95,1.391958,103.851317
809580,0,32,32,1.391888,103.851116
809581,1,56,57,1.391949,103.851086
809583,1,0,1,1.391866,103.850741
809587,0,2,2,1.387431,103.866982
809588,1,3,4,1.387433,103.866909
809589,2,0,2,1.391384,103.850504
809590,51,0,51,1.390979,103.85067
809591,16,0,16,1.390886,103.850559
809592,0,4,4,1.391149,103.850482
809593,1,2,3,1.387968,103.866978
809594,5,1,6,1.390766,103.850705
809595,3,0,3,1.390787,103.850696
809596,3,2,5,1.390612,103.850724
809597,11,10,21,1.390525,103.850745
809598,1,0,1,1.39046,103.850753
809599,7,0,7,1.390393,103.850762
809600,2,0,2,1.390999,103.850509
809601,11,0,11,1.390286,103.850784
809604,23,1,24,1.390086,103.850815
809605,11,0,11,1.39001,103.85083
809606,0,1,1,1.389948,103.850842
809609,2,3,5,1.389781,103.85088
809610,0,1,1,1.389697,103.850906
809611,0,1,1,1.38965,103.850906
809612,1,1,2,1.390361,103.85077
809613,0,4,4,1.390869,103.850675
809614,1,7,8,1.389483,103.850984
809615,1,38,39,1.389508,103.851152
809616,24,0,24,1.389515,103.851185
809617,2,0,2,1.389528,103.850926
809618,0,22,22,1.38954,103.851309
809619,40,6,46,1.389572,103.851441
809620,18,7,25,1.389582,103.851511
809621,2,83,85,1.389598,103.851577
809622,112,1,113,1.389718,103.851148
809623,5,2,7,1.389651,103.851014
809624,1,0,1,1.389715,103.850997
809625,23,0,23,1.389777,103.850982
809626,46,0,46,1.389838,103.85098
809627,4,0,4,1.389498,103.85095
809628,0,1,1,1.389969,103.850952
809629,106,0,106,1.39003,103.850945
809630,3,0,3,1.390682,103.850718
809631,8,3,11,1.390199,103.85091
809633,1,2,3,1.390101,103.850929
809634,1,0,1,1.390408,103.850859
809636,3,0,3,1.390336,103.85087
809638,0,1,1,1.390703,103.850813
809640,49,0,49,1.390835,103.850791
809641,0,10,10,1.390883,103.850771
809642,8,0,8,1.39094,103.850765
809644,2,5,7,1.391055,103.85073
809645,107,14,121,1.391655,103.851299
809646,9,2,11,1.391141,103.851182
809647,27,0,27,1.391107,103.851186
809650,6,20,26,1.390988,103.851395
809651,5,0,5,1.390895,103.851418
809652,14,0,14,1.390782,103.851449
809653,1,0,1,1.390705,103.851469
809654,2,0,2,1.389528,103.851265
809655,31,10,41,1.390573,103.851495
809657,5,7,12,1.390459,103.851511
809658,12,0,12,1.390405,103.851527
809659,4,0,4,1.389905,103.850964
809660,1,8,9,1.390333,103.851361
809661,12,1,13,1.390259,103.851542
809662,4,12,16,1.390193,103.851412
809663,5,0,5,1.390101,103.851437
809664,1,4,5,1.389998,103.851618
809666,1,5,6,1.38988,103.851641
809667,4,5,9,1.389822,103.851656
809668,4,18,22,1.389774,103.851642
809669,6,6,12,1.391655,103.851226
809670,20,40,60,1.391335,103.851358
809671,2,0,2,1.390635,103.851485
809683,192,78,270,1.388797,103.852029
809684,185,10,195,1.388326,103.852244
809685,277,26,303,1.388229,103.852498
809686,72,44,116,1.388485,103.852559
809687,543,91,634,1.388777,103.853181
809688,444,70,514,1.388495,103.853678
809689,318,56,374,1.387975,103.854118
809690,257,36,293,1.387969,103.853603
809691,106,29,135,1.387872,103.853032
809692,223,327,550,1.387871,103.852414
809693,165,33,198,1.387808,103.851906
809694,1305,274,1579,1.388553,103.851667
809695,100,50,150,1.387959,103.851931
809710,9,308,317,1.391811,103.851571
809711,2,17,19,1.391662,103.851611
809712,7,130,137,1.391811,103.851699
809713,6,0,6,1.391662,103.851681
809714,3,47,50,1.391813,103.851823
809715,4,0,4,1.390354,103.851533
809716,22,12,34,1.391806,103.851918
809717,4,0,4,1.391655,103.851791
809718,21,0,21,1.391625,103.851998
809719,67,0,67,1.391624,103.852073
809720,3,3,6,1.391633,103.852205
809721,2,1,3,1.390545,103.850845
809722,0,1,1,1.391615,103.852399
809723,2,0,2,1.391325,103.85127
809724,16,5,21,1.391075,103.852525
809725,0,3,3,1.391615,103.85228
809726,2,1,3,1.391419,103.852686
809727,2,0,2,1.391602,103.852491
809728,2,0,2,1.391482,103.852819
809729,0,3,3,1.391212,103.852409
809730,3,0,3,1.391106,103.852655
809731,3,5,8,1.390994,103.852558
809732,2,0,2,1.391104,103.852304
809733,7,0,7,1.390919,103.852462
809734,1,7,8,1.391072,103.851995
809735,158,7,165,1.390913,103.852273
809736,1,0,1,1.391081,103.85188
809737,9,0,9,1.390924,103.852092
809738,0,16,16,1.391086,103.851766
809739,2,0,2,1.391061,103.852108
809740,20,20,40,1.391081,103.851695
809741,32,6,38,1.390831,103.851694
809742,4,5,9,1.391249,103.851623
809743,1,22,23,1.391789,103.852019
809744,4,10,14,1.391782,103.852078
809745,94,4,98,1.391789,103.852179
809746,0,78,78,1.391785,103.852221
809747,12,5,17,1.391795,103.85232
809748,3,20,23,1.391783,103.85237
809749,3,51,54,1.391782,103.852464
809750,2,118,120,1.391778,103.852516
809751,27,38,65,1.391763,103.852649
809752,4,82,86,1.39175,103.85271
809753,28,1,29,1.391725,103.852808
809754,0,8,8,1.391703,103.852886
809757,18,5,23,1.388706,103.86228
809758,25,1,26,1.388826,103.862076
809759,6,0,6,1.38866,103.86202
809760,4,5,9,1.388761,103.861879
809761,6,1,7,1.388486,103.861783
809762,0,2,2,1.390948,103.851887
809763,4,0,4,1.391639,103.851892
809764,6,2,8,1.388568,103.861636
809765,0,2,2,1.388644,103.861728
809767,3,0,3,1.391055,103.85223
809768,1,0,1,1.388491,103.86157
809771,3,5,8,1.388355,103.8615
809772,1,0,1,1.38814,103.861469
809773,2,1,3,1.388252,103.861588
809774,1,5,6,1.388061,103.861411
809775,23,2,25,1.388159,103.861329
809777,4,4,8,1.388072,103.861236
809778,14,2,16,1.387857,103.861255
809779,1,2,3,1.388255,103.861407
809780,8,2,10,1.387752,103.861199
809781,1,2,3,1.387976,103.861152
809782,27,3,30,1.387772,103.860962
809797,47,13,60,1.386302,103.861904
809798,2,1,3,1.387854,103.86107
809799,0,4,4,1.388431,103.861739
809800,61,6,67,1.387192,103.862542
809801,3,7,10,1.387304,103.862612
809802,8,0,8,1.387416,103.862682
809803,7,71,78,1.387275,103.86237
809804,1,9,10,1.387528,103.862752
809805,0,7,7,1.387378,103.862427
809806,4,1,5,1.387639,103.862823
809807,2,13,15,1.387481,103.862483
809808,2,3,5,1.387751,103.862893
809809,4,9,13,1.387584,103.86254
809810,12,42,54,1.38785,103.862868
809811,0,22,22,1.387687,103.862596
809812,9,46,55,1.38779,103.862653
809813,5,90,95,1.388212,103.862891
809814,5,30,35,1.388469,103.863012
809815,1,41,42,1.388726,103.863134
809816,1,1,2,1.38835,103.861666
809817,59,12,71,1.386548,103.862069
809830,6,3,9,1.38764,103.863844
809831,1,2,3,1.386482,103.862033
809832,44,0,44,1.387632,103.863932
809834,29,0,29,1.387859,103.863987
809835,16,0,16,1.387859,103.863987
809836,3,0,3,1.38764,103.863844
809837,14,0,14,1.387859,103.863987
809838,0,3,3,1.387859,103.863987
809839,3,17,20,1.387572,103.864083
809840,1,0,1,1.387572,103.864083
809842,277,0,277,1.387795,103.864248
809843,2,12,14,1.387795,103.864248
809844,9,0,9,1.387795,103.864248
809846,57,0,57,1.387527,103.864243
809847,1,0,1,1.387527,103.864243
809848,36,0,36,1.387755,103.864527
809849,47,6,53,1.387755,103.864527
809850,6,0,6,1.387755,103.864527
809851,3,39,42,1.387486,103.864448
809852,6,0,6,1.387486,103.864448
809853,15,0,15,1.387486,103.864448
809854,1,0,1,1.387719,103.86471
809855,0,4,4,1.386618,103.862132
809856,3,0,3,1.387859,103.863987
809857,6,9,15,1.387719,103.86471
809858,4,3,7,1.387427,103.864825
809859,19,0,19,1.387246,103.864831
809860,5,0,5,1.387393,103.864539
809861,4,0,4,1.387719,103.86471
809862,3,2,5,1.387455,103.8646
809863,2,3,5,1.386727,103.864311
809864,1,0,1,1.386751,103.864339
809865,18,0,18,1.386771,103.864361
809866,9,0,9,1.38683,103.864416
809867,37,1,38,1.386864,103.864481
809868,1,0,1,1.38691,103.864541
809869,17,2,19,1.386942,103.864591
809871,13,0,13,1.386703,103.864274
809872,1,0,1,1.386612,103.864154
809873,0,3,3,1.387719,103.86471
809874,313,2,315,1.386577,103.864094
809875,2,0,2,1.386515,103.862069
809876,1,0,1,1.386535,103.86402
809877,1,3,4,1.387455,103.8646
809878,0,4,4,1.386947,103.864248
809879,25,0,25,1.386981,103.864146
809880,19,0,19,1.386402,103.863859
809881,2,1,3,1.386894,103.864367
809882,0,6,6,1.386329,103.863753
809883,2,0,2,1.386917,103.864314
809885,13,3,16,1.387081,103.863838
809886,17,0,17,1.386251,103.863661
809887,16,1,17,1.387114,103.863736
809888,42,5,47,1.386232,103.863539
809889,2,0,2,1.387047,103.863941
809890,3,1,4,1.386469,103.863926
809891,13,4,17,1.387181,103.863531
809892,3,0,3,1.387014,103.864043
809893,11,0,11,1.387214,103.863428
809894,9,2,11,1.386371,103.863323
809895,2,0,2,1.387147,103.863633
809896,5,21,26,1.386414,103.863261
809897,8,0,8,1.3871,103.863243
809900,8,3,11,1.386526,103.863117
809901,11,0,11,1.386902,103.863099
809902,0,1,1,1.386592,103.863024
809903,133,5,138,1.386803,103.863027
809904,9,0,9,1.386637,103.862941
809905,0,5,5,1.387081,103.863412
809906,3,0,3,1.386316,103.863396
809907,70,0,70,1.387044,103.863507
809908,33,0,33,1.386749,103.862797
809909,33,0,33,1.387006,103.863602
809910,23,1,24,1.386811,103.862694
809911,4,0,4,1.386278,103.863471
809912,1,0,1,1.386847,103.862632
809913,45,0,45,1.386932,103.863793
809914,3,8,11,1.386913,103.862534
809915,4,1,5,1.386895,103.863888
809916,10,47,57,1.387132,103.862168
809917,11,0,11,1.386857,103.863983
809919,23,3,26,1.38682,103.864078
809920,3,0,3,1.386706,103.862862
809921,24,4,28,1.386403,103.863596
809922,59,6,65,1.387192,103.861939
809923,1,0,1,1.386463,103.863506
809924,0,4,4,1.386969,103.863697
809925,42,3,45,1.386524,103.863415
809926,29,0,29,1.387342,103.861798
809927,118,0,118,1.386584,103.863325
809928,5,1,6,1.38736,103.861719
809929,5,0,5,1.386645,103.863234
809931,2,12,14,1.386705,103.863144
809932,1,0,1,1.387429,103.86156
809933,0,3,3,1.38722,103.862006
809934,12,0,12,1.387478,103.861436
809935,0,1,1,1.387614,103.861908
809936,9,0,9,1.387478,103.861372
809937,4,0,4,1.387305,103.861916
809940,2,0,2,1.387199,103.863315
809941,0,1,1,1.387806,103.862074
809942,6,1,7,1.387583,103.861079
809943,4,0,4,1.387678,103.861963
809944,3,0,3,1.38755,103.861852
809945,33,0,33,1.387979,103.861924
809946,12,0,12,1.387615,103.860868
809947,4,2,6,1.387921,103.861878
809949,4,1,5,1.387863,103.861831
809950,1,0,1,1.387651,103.860694
809951,134,9,143,1.387805,103.861785
809952,4,0,4,1.38787,103.86213
809953,9,5,14,1.38769,103.861693
809954,1,4,5,1.387632,103.861646
809955,12,3,15,1.387574,103.8616
809956,3,0,3,1.387597,103.861001
809970,1,54,55,1.388205,103.862614
809971,28,3,31,1.388561,103.862663
809972,0,6,6,1.388327,103.862441
809973,3,0,3,1.387214,103.863428
809974,2,1,3,1.388418,103.862553
809975,4,3,7,1.389006,103.862642
809976,6,2,8,1.388816,103.86228
809977,4,2,6,1.389076,103.8627
809978,1,0,1,1.388883,103.862441
809979,31,77,108,1.389039,103.863164
809980,3,45,48,1.389268,103.862906
809981,3,50,53,1.389234,103.863023
809982,9,6,15,1.3892,103.863139
809983,0,6,6,1.389166,103.863256
809984,103,33,136,1.389132,103.863372
809985,3,424,427,1.389098,103.863489
818947,21,7994,8015,1.299509,103.837
819116,1,1,2,1.387565,103.861171
819117,5,11,16,1.382885,103.997476
819118,92,95,187,1.382501,103.997074
819285,11,1990,2001,1.362168,103.990039
819454,3978,153,4131,1.37386,103.995146
819456,165,76,241,1.382508,103.99939
819457,112,3,115,1.370381,103.993799
819458,162,40,202,1.370641,103.992666
819459,444,14,458,1.374536,103.994016
819460,27,4,31,1.374539,103.99401
819461,912,105,1017,1.374539,103.994009
819462,607,0,607,1.37454,103.994006
819463,73,0,73,1.374528,103.994032
819464,4,0,4,1.387748,103.861739
819465,1,0,1,1.374529,103.994014
819466,1925,123,2048,1.374325,103.996108
819470,1,0,1,1.374231,103.99448
819471,1,0,1,1.374292,103.994502
819472,0,14,14,1.375703,103.994996
819473,0,22,22,1.374529,103.994033
819477,61,146,207,1.375107,103.996328
819478,855,130,985,1.371802,103.9961
819479,7,125,132,1.369887,103.994454
819480,583,53,636,1.371293,103.994493
819481,0,20,20,1.299509,103.837
819642,1128,605032,606160,1.362159,103.990051
819643,514,1000381,1000895,1.355322,103.988337
819645,122,14,136,1.343207,103.98081
819646,21,2208,2229,1.3485,103.986113
819658,636,8449,9085,1.348601,103.986032
819659,1895,0,1895,1.341223,103.984833
819660,21,1321,1342,1.343325,103.981431
819661,0,222078,222078,1.357373,103.98807
819662,0,2,2,1.383406,103.99676
819663,12,127017,127029,1.356716,103.98651
819664,5003,37690,42693,1.358695,103.987985
819665,5,1811,1816,1.36442,103.991531
819825,490,1822,2312,1.385571,103.999615
819826,324,568,892,1.384,103.999103
819827,1474,106,1580,1.382831,103.999542
819828,241,152,393,1.379542,103.998174
819829,13800,1504,15304,1.377201,103.997269
819830,3288,382,3670,1.377178,103.997296
819831,742,1,743,1.375297,103.997594
819833,100,38,138,1.379536,103.996416
819834,3179,37,3216,1.384182,104.000033
819835,46,1,47,1.378178,103.998489
819836,3,39,42,1.375344,103.999892
819837,9,3,12,1.374478,104.000018
819838,15,4,19,1.376137,103.999906
820101,26,21,47,1.39887,103.906288
820102,32,97,129,1.398683,103.905831
820103,38,47,85,1.39747,103.904819
820105,23,7,30,1.396902,103.906039
820106,47,39,86,1.396518,103.908722
820107,37,66,103,1.3972,103.907937
820108,63,4903,4966,1.396578,103.908996
820109,14,31,45,1.395643,103.909982
820110,23,28,51,1.396025,103.909312
820111,1452,401,1853,1.396765,103.906848
820112,827,449,1276,1.396289,103.907121
820113,403,394,797,1.396308,103.907053
820114,1620,75,1695,1.396126,103.907187
820115,962,251,1213,1.395059,103.907364
820116,854,201,1055,1.395244,103.906758
820117,636,134,770,1.395671,103.906299
820118,1603,387,1990,1.395987,103.906013
820119,21,382,403,1.395408,103.906399
820120,78,381,459,1.299509,103.837
820121,105,102,207,1.39389,103.908518
820122,38,40,78,1.393912,103.909055
820125,9,11,20,1.394025,103.911414
820126,41,48,89,1.394269,103.910914
820127,15,39,54,1.393155,103.911987
820128,26,129,155,1.393077,103.91268
820129,6,38,44,1.393155,103.91038
820130,1279,814,2093,1.393643,103.910046
820131,11,267,278,1.393619,103.910391
820132,1205,491,1696,1.393082,103.910813
820133,1597,188,1785,1.392839,103.910506
820134,2185,390,2575,1.392315,103.910173
820135,1423,67,1490,1.392098,103.90987
820136,48,406,454,1.391593,103.909919
820137,10,97,107,1.392385,103.909374
820138,1116,294,1410,1.393336,103.909711
820160,15,15,30,1.395575,103.915484
820162,18,34,52,1.396177,103.913906
820164,8,31,39,1.395713,103.914476
820166,34,12,46,1.394965,103.915066
820167,17,316,333,1.394895,103.914114
820168,2433,4357,6790,1.394214,103.91291
820169,20,47,67,1.393702,103.914385
820171,25,104,129,1.394895,103.912581
820172,29,72,101,1.395559,103.911808
820173,55,294,349,1.397103,103.909187
820174,4,184,188,1.396613,103.909775
820175,10,111,121,1.397873,103.908287
820176,32,113,145,1.398033,103.909119
820178,698,1415,2113,1.399347,103.908472
820179,11,101,112,1.399063,103.908652
820180,17,244,261,1.398607,103.909348
820181,666,227,893,1.398761,103.908913
820182,494,121,615,1.39864,103.909173
820183,776,128,904,1.398317,103.909461
820184,394,147,541,1.398107,103.909755
820185,851,163,1014,1.397788,103.910018
820186,800,391,1191,1.398586,103.911126
820187,830,163,993,1.398706,103.910779
820188,620,201,821,1.399395,103.910606
820189,9,10,19,1.399351,103.910423
820190,447,147,594,1.399713,103.910387
820191,561,194,755,1.399907,103.910054
820192,532,905,1437,1.400101,103.909795
820193,544,1184,1728,1.399846,103.908859
820194,51,1713,1764,1.401947,103.90607
820195,59,313,372,1.401824,103.906406
820196,33,113,146,1.399395,103.907031
820197,13,43,56,1.399661,103.906615
820198,124,1408,1532,1.39946,103.90634
820199,45,195,240,1.400203,103.905994
820200,17,164,181,1.399225,103.902954
820201,20,10,30,1.399789,103.903708
820203,78,15,93,1.399008,103.903875
820204,13,151,164,1.398493,103.903069
820207,88,18,106,1.400546,103.901646
820208,113,88,201,1.400546,103.901646
820209,52,69,121,1.299509,103.837
820210,24,83,107,1.299509,103.837
820211,112,589,701,1.299444,103.858272
820212,86,100,186,1.299509,103.837
820213,39,30,69,1.299509,103.837
820217,120,152,272,1.402505,103.895916
820218,221,124,345,1.402688,103.895393
820219,9,125,134,1.299509,103.837
820220,0,1,1,1.299509,103.837
820221,1,170,171,1.299509,103.837
820222,1,65,66,1.299509,103.837
820223,1,81,82,1.299509,103.837
820226,1,24,25,1.299509,103.837
820231,0,2,2,1.33838,103.984533
820232,1,0,1,1.299509,103.837
820233,0,33,33,1.299509,103.837
820256,142,284,426,1.299509,103.837
820257,2,49,51,1.299509,103.837
820258,16,32,48,1.299509,103.837
820259,58,324,382,1.299509,103.837
820261,427,668,1095,1.405538,103.897047
820264,23,659,682,1.299509,103.837
820265,23,186,209,1.40824,103.898338
820266,32,25,57,1.405495,103.898144
820267,31,214,245,1.392625,103.913822
820268,32,709,741,1.403556,103.897134
820269,39,289,328,1.404161,103.898546
820270,29,148,177,1.403416,103.899445
820271,34,29,63,1.403432,103.900686
820272,47,61,108,1.402867,103.900786
820273,122,21,143,1.40272,103.901869
820274,52,712,764,1.403054,103.902472
820275,11,457,468,1.401925,103.902084
820288,10,122,132,1.401793,103.903283
820289,109,255,364,1.402527,103.90289
820292,16,17,33,1.40245,103.905053
820293,858,567,1425,1.403091,103.904967
820294,859,39,898,1.402564,103.90465
820295,715,83,798,1.401903,103.904852
820296,1234,401,1635,1.401593,103.905263
820297,528,632,1160,1.402215,103.905466
820298,518,887,1405,1.403089,103.905371
820299,1189,105,1294,1.40272,103.9053
820301,104,716,820,1.403302,103.905807
820302,40,162,202,1.299509,103.837
820303,98,134,232,1.403743,103.906084
820305,22,176,198,1.405936,103.906183
820308,148,48,196,1.299509,103.837
820310,76,370,446,1.299509,103.837
820312,181,503,684,1.299509,103.837
820313,41,30,71,1.410375,103.901289
820314,40,26,66,1.299509,103.837
820315,18,158,176,1.299509,103.837
820316,32,48,80,1.299509,103.837
820321,1,9,10,1.299509,103.837
820322,3,8,11,1.299509,103.837
820324,0,1,1,1.299509,103.837
820325,1,121,122,1.299509,103.837
820326,1,99,100,1.299509,103.837
820327,0,1,1,1.299509,103.837
820405,1,15,16,1.296696,103.854317
820409,0,4,4,1.374529,103.994036
820601,141,255,396,1.402411,103.907231
820602,41,130,171,1.403215,103.907386
820603,50,109,159,1.403872,103.907988
820604,17,100,117,1.404524,103.907224
820612,324,1065,1389,1.404638,103.908667
820613,234,466,700,1.404943,103.907762
820614,16,91,107,1.403299,103.909674
820615,469,1375,1844,1.403995,103.909761
820616,10,29,39,1.402124,103.911726
820621,16,471,487,1.400953,103.910472
820622,43,97,140,1.399459,103.911705
820623,21,186,207,1.399459,103.911705
820624,37,118,155,1.399459,103.911705
820632,6,60,66,1.40421,103.909873
820633,3,13,16,1.401503,103.913509
820635,5,16,21,1.401065,103.913881
820636,10,6,16,1.401104,103.914064
820637,27,311,338,1.399816,103.91578
820638,27,19,46,1.399816,103.91578
820639,236,1880,2116,1.399345,103.915923
820642,27,20,47,1.398569,103.916413
820643,928,222,1150,1.397167,103.915931
820644,36,64,100,1.397892,103.915962
820645,731,222,953,1.397858,103.916159
820646,344,112,456,1.398027,103.915759
820647,746,61,807,1.397996,103.91531
820648,423,189,612,1.397757,103.915134
820649,1682,2576,4258,1.397202,103.914795
820650,18,45,63,1.397067,103.915203
820651,927,2985,3912,1.396732,103.915399
820652,560,168,728,1.39697,103.915662
820655,45,70,115,1.299509,103.837
820658,0,13,13,1.299509,103.837
820659,7,3,10,1.299509,103.837
820660,73,742,815,1.341936,103.837522
820661,81,227,308,1.299509,103.837
820662,66,300,366,1.299509,103.837
820663,172,628,800,1.299509,103.837
820665,51,250,301,1.400556,103.912224
820666,54,348,402,1.299509,103.837
820667,15,3,18,1.299509,103.837
820668,118,53,171,1.299509,103.837
820669,30,88,118,1.299509,103.837
820670,101,159,260,1.299509,103.837
820671,239,852,1091,1.405519,103.911996
820672,19,196,215,1.299509,103.837
820673,35,213,248,1.299509,103.837
820674,12,118,130,1.299509,103.837
820675,0,32,32,1.299509,103.837
820676,36,50,86,1.299509,103.837
820677,92,43,135,1.299509,103.837
820678,36,72,108,1.299509,103.837
820679,30,79,109,1.299509,103.837
820682,28,6,34,1.299509,103.837
820684,0,13,13,1.299509,103.837
820688,58,186,244,1.299509,103.837
821101,365,198,563,1.39887,103.906288
821102,586,740,1326,1.398928,103.905917
821103,687,547,1234,1.397086,103.905583
821104,490,462,952,1.396871,103.905393
821105,584,380,964,1.397474,103.907424
821106,627,1213,1840,1.396765,103.908576
821107,346,427,773,1.39678,103.905734
821109,601,452,1053,1.394534,103.910229
821110,797,2354,3151,1.396123,103.909388
821120,787,181,968,1.394483,103.908363
821121,448,186,634,1.394079,103.90841
821122,1371,1105,2476,1.394098,103.909353
821126,1480,2417,3897,1.394191,103.911517
821128,934,457,1391,1.393522,103.912458
821160,495,1136,1631,1.395286,103.915619
821161,743,364,1107,1.395797,103.914904
821162,734,747,1481,1.396553,103.914213
821163,503,65,568,1.395545,103.914179
821165,1359,108,1467,1.395055,103.914852
821166,801,746,1547,1.394706,103.915588
821167,605,1507,2112,1.393893,103.91541
821168,808,45,853,1.393893,103.91541
821169,295,347,642,1.393037,103.914033
821170,645,1315,1960,1.393037,103.914033
821171,628,4193,4821,1.39451,103.912542
821172,598,1566,2164,1.395203,103.911672
821173,622,834,1456,1.396833,103.909531
821174,690,433,1123,1.39617,103.911217
821175,607,1951,2558,1.397376,103.90892
821176,995,715,1710,1.399031,103.908116
821195,335,1073,1408,1.402197,103.906323
821196,463,2461,2924,1.39922,103.90664
821197,383,103,486,1.399345,103.906412
821199,609,1235,1844,1.399726,103.905977
821201,608,711,1319,1.400391,103.903572
821202,1147,697,1844,1.400158,103.90346
821203,988,1243,2231,1.399628,103.903653
821204,1177,452,1629,1.398902,103.902842
821205,878,380,1258,1.399017,103.90309
821206,2416,1291,3707,1.400546,103.901646
821207,604,1051,1655,1.400546,103.901646
821208,447,2224,2671,1.400546,103.901646
821209,606,39,645,1.400176,103.900747
821210,571,221,792,1.399912,103.900145
821211,872,720,1592,1.401255,103.899553
821212,608,122,730,1.400855,103.898282
821213,1039,68,1107,1.400855,103.898282
821217,1123,376,1499,1.402488,103.895576
821220,0,3,3,1.388227,103.862336
821221,0,22,22,1.299509,103.837
821222,2,59,61,1.299509,103.837
821224,2,2,4,1.299509,103.837
821226,191,73,264,1.299509,103.837
821227,35,38,73,1.403564,103.89315
821231,11,4,15,1.299509,103.837
821232,5,6,11,1.299509,103.837
821233,1,13,14,1.299509,103.837
821256,464,591,1055,1.40602,103.89552
821258,606,506,1112,1.404209,103.895869
821259,737,608,1345,1.40425,103.895476
821260,347,781,1128,1.299509,103.837
821261,534,800,1334,1.404865,103.896133
821264,873,340,1213,1.405642,103.898437
821265,543,90,633,1.405712,103.898821
821266,622,685,1307,1.405495,103.898144
821267,272,650,922,1.403084,103.898637
821268,295,938,1233,1.403084,103.898637
821269,814,1710,2524,1.403084,103.898637
821270,443,562,1005,1.403084,103.898637
821271,720,452,1172,1.299444,103.858272
821272,601,39,640,1.403014,103.900384
821273,966,251,1217,1.403054,103.902472
821274,311,778,1089,1.403054,103.902472
821288,603,278,881,1.402527,103.90289
821289,641,1847,2488,1.402527,103.90289
821293,13,748,761,1.403408,103.905055
821295,87,88,175,1.403874,103.903974
821296,26,871,897,1.403408,103.905055
821298,15,57,72,1.4035755,103.9055695
821301,578,475,1053,1.403743,103.906084
821302,559,1556,2115,1.404475,103.90409
821303,526,1488,2014,1.403743,103.906084
821305,406,152,558,1.405033,103.907084
821306,633,375,1008,1.406609,103.9052
821308,1828,594,2422,1.406606,103.900515
821309,16,472,488,1.299509,103.837
821310,1464,229,1693,1.409017,103.901335
821311,14,618,632,1.299509,103.837
821312,1103,949,2052,1.411129,103.90039
821313,1110,396,1506,1.411719,103.901081
821314,696,371,1067,1.40716,103.896781
821315,423,175,598,1.408564,103.897533
821316,541,457,998,1.407995,103.896937
821321,1,6,7,1.299509,103.837
821323,0,6,6,1.299509,103.837
821325,0,70,70,1.299509,103.837
821326,1,0,1,1.299509,103.837
821327,2,0,2,1.299509,103.837
821405,0,24,24,1.299509,103.837
821406,7,62,69,1.299509,103.837
821407,3,0,3,1.299509,103.837
821408,0,3,3,1.299509,103.837
821601,344,1335,1679,1.402411,103.907231
821602,335,1124,1459,1.402411,103.907231
821603,537,118,655,1.405447,103.907563
821604,467,1515,1982,1.404524,103.907224
821612,490,936,1426,1.405511,103.908018
821613,322,44,366,1.405052,103.908565
821614,768,180,948,1.402865,103.910135
821615,624,21,645,1.402966,103.910372
821616,15,18,33,1.402303,103.91239
821617,428,506,934,1.402303,103.91239
821618,407,91,498,1.402303,103.91239
821619,449,1085,1534,1.402303,103.91239
821621,775,444,1219,1.400953,103.910472
821622,701,2724,3425,1.399459,103.911705
821623,392,195,587,1.399459,103.911705
821624,502,150,652,1.399459,103.911705
821632,204,55,259,1.404209,103.909872
821633,367,369,736,1.401361,103.913553
821635,651,546,1197,1.401016,103.914061
821636,501,167,668,1.400276,103.913944
821637,645,151,796,1.399634,103.914507
821638,775,999,1774,1.399965,103.914769
821640,67,183,250,1.39929,103.915743
821641,547,560,1107,1.398562,103.91692
821642,689,127,816,1.398251,103.916706
821647,344,257,601,1.398495,103.915532
821658,5,7,12,1.299509,103.837
821659,2,3,5,1.299509,103.837
821660,35,125,160,1.299509,103.837
821661,910,324,1234,1.299509,103.837
821662,556,217,773,1.401254,103.918444
821663,1694,619,2313,1.400392,103.917298
821664,1673,916,2589,1.399222,103.917588
821665,1261,633,1894,1.398746,103.918584
821666,1029,229,1258,1.402175,103.914967
821667,866,16,882,1.401613,103.914643
821668,862,335,1197,1.404982,103.912517
821669,762,113,875,1.404066,103.913674
821670,1121,726,1847,1.40596,103.91345
821671,1312,763,2075,1.405668,103.911994
821672,697,1784,2481,1.405668,103.911994
821673,403,49,452,1.407522,103.911093
821676,445,612,1057,1.404145,103.910694
821677,1200,352,1552,1.404732,103.909853
821678,453,960,1413,1.405894,103.909193
821679,664,656,1320,1.405894,103.909193
821682,14,33,47,1.403355,103.916269
821683,1,0,1,1.299509,103.837
821684,4,18,22,1.299509,103.837
822101,632,904,1536,1.398276,103.906568
822102,446,1238,1684,1.399207,103.905341
822103,902,372,1274,1.397838,103.904694
822104,555,712,1267,1.396493,103.905416
822105,672,985,1657,1.397269,103.906206
822106,403,1278,1681,1.397214,103.90811
822107,347,341,688,1.397352,103.907576
822109,216,81,297,1.395414,103.909921
822110,571,1863,2434,1.395862,103.909761
822120,409,456,865,1.394498,103.907974
822121,485,115,600,1.393892,103.909234
822122,733,711,1444,1.393892,103.909234
822126,574,745,1319,1.394273,103.9112
822128,367,619,986,1.393219,103.912769
822160,640,413,1053,1.395397,103.916126
822161,751,824,1575,1.395808,103.915339
822162,654,729,1383,1.396356,103.91468
822163,664,179,843,1.395659,103.913754
822165,893,118,1011,1.395148,103.914445
822166,642,263,905,1.394541,103.915146
822167,614,142,756,1.393893,103.91541
822168,332,41,373,1.394452,103.913993
822169,544,1284,1828,1.393037,103.914033
822170,351,566,917,1.393351,103.914695
822171,713,258,971,1.395055,103.912912
822172,1172,553,1725,1.39578,103.912121
822173,472,1729,2201,1.396488,103.909905
822174,449,313,762,1.396587,103.9109
822175,601,814,1415,1.397707,103.908513
822176,936,167,1103,1.398466,103.908585
822195,189,57,246,1.401246,103.906411
822196,297,844,1141,1.39896,103.906947
822197,582,117,699,1.400066,103.906531
822199,376,1858,2234,1.399966,103.90568
822201,656,977,1633,1.400185,103.904011
822202,732,614,1346,1.399083,103.904194
822203,1095,663,1758,1.397986,103.903626
822204,153,51,204,1.398608,103.903342
822206,3,129,132,1.400546,103.901646
822207,483,314,797,1.400546,103.901646
822208,726,979,1705,1.400546,103.901646
822209,957,1384,2341,1.400273,103.900634
822210,797,91,888,1.399068,103.900883
822211,840,542,1382,1.401118,103.89942
822212,953,33,986,1.400498,103.899244
822213,1549,904,2453,1.40045,103.898322
822217,1337,68,1405,1.402688,103.895393
822220,1,60,61,1.299509,103.837
822221,0,25,25,1.299509,103.837
822224,0,1,1,1.299509,103.837
822226,151,36,187,1.299509,103.837
822227,99,47,146,1.299509,103.837
822231,16,0,16,1.299509,103.837
822232,0,6,6,1.299509,103.837
822233,2,2,4,1.299509,103.837
822256,418,52,470,1.40602,103.89552
822258,327,703,1030,1.404865,103.896133
822259,512,283,795,1.404865,103.896133
822260,246,67,313,1.404865,103.896133
822261,475,252,727,1.405447,103.896808
822265,577,179,756,1.405495,103.898144
822266,450,1237,1687,1.405495,103.898144
822267,654,180,834,1.404437,103.898043
822268,336,153,489,1.403643,103.897389
822269,655,759,1414,1.403084,103.898637
822270,477,189,666,1.404083,103.899142
822271,452,533,985,1.404155,103.900593
822272,508,579,1087,1.403287,103.90025
822273,803,946,1749,1.40201,103.901791
822274,515,62,577,1.403054,103.902472
822288,433,412,845,1.402527,103.90289
822289,959,1803,2762,1.401196,103.903236
822301,205,309,514,1.403743,103.906084
822302,289,547,836,1.403743,103.906084
822303,321,591,912,1.403743,103.906084
822305,695,92,787,1.405244,103.906348
822306,504,85,589,1.405775,103.905935
822308,726,264,990,1.407668,103.899526
822309,6,160,166,1.407729,103.900087
822310,953,24,977,1.409471,103.900903
822311,24,651,675,1.299509,103.837
822312,1410,566,1976,1.411214,103.900633
822313,933,630,1563,1.410375,103.901289
822314,409,71,480,1.408564,103.897533
822315,679,192,871,1.408757,103.897355
822316,202,59,261,1.408564,103.897533
822323,0,9,9,1.299509,103.837
822406,4,2,6,1.299509,103.837
822408,0,8,8,1.299509,103.837
822409,0,1,1,1.299509,103.837
822601,384,782,1166,1.402189,103.907893
822602,641,1081,1722,1.402411,103.907231
822603,1117,142,1259,1.403171,103.908196
822604,699,607,1306,1.403912,103.90723
822612,532,244,776,1.405511,103.908018
822613,192,94,286,1.40425,103.908305
822614,453,570,1023,1.402865,103.910135
822615,647,407,1054,1.403755,103.909874
822616,23,388,411,1.402921,103.910795
822617,610,743,1353,1.402303,103.91239
822618,453,92,545,1.401454,103.912106
822619,777,604,1381,1.402894,103.911037
822621,558,220,778,1.401136,103.910352
822622,502,1996,2498,1.399459,103.911705
822623,433,2211,2644,1.399459,103.911705
822624,535,171,706,1.399459,103.911705
822632,282,81,363,1.40083,103.913163
822633,221,416,637,1.401075,103.913704
822635,510,189,699,1.400917,103.914124
822636,454,46,500,1.400418,103.913738
822637,739,214,953,1.399313,103.914814
822638,866,85,951,1.399861,103.915308
822640,66,125,191,1.399135,103.915982
822641,1053,843,1896,1.39881,103.916665
822642,615,182,797,1.398324,103.916358
822661,285,38,323,1.299509,103.837
822662,661,7,668,1.299509,103.837
822663,577,147,724,1.400244,103.917215
822664,609,135,744,1.39977,103.918188
822665,571,707,1278,1.402175,103.914967
822666,501,109,610,1.402175,103.914967
822667,172,50,222,1.402175,103.914967
822668,855,31,886,1.405392,103.913368
822669,1092,11,1103,1.405392,103.913368
822670,389,42,431,1.405392,103.913368
822671,615,92,707,1.405668,103.911994
822672,362,269,631,1.405668,103.911994
822673,253,80,333,1.405668,103.911994
822676,827,309,1136,1.405152,103.909558
822677,387,940,1327,1.405894,103.909193
822678,329,49,378,1.405894,103.909193
822679,167,99,266,1.405894,103.909193
822682,9,2,11,1.299509,103.837
822683,1,2,3,1.299509,103.837
822684,0,12,12,1.299509,103.837
823101,544,2851,3395,1.398181,103.906593
823102,609,3996,4605,1.398818,103.905014
823103,487,692,1179,1.397398,103.904525
823104,7,119,126,1.396668,103.905648
823105,968,129,1097,1.397623,103.905595
823106,504,712,1216,1.397554,103.907679
823107,758,238,996,1.397118,103.907897
823109,345,193,538,1.395182,103.909279
823110,643,1516,2159,1.395536,103.910105
823121,7,255,262,1.299509,103.837
823122,10,126,136,1.394614,103.909343
823126,527,167,694,1.393997,103.910688
823128,595,322,917,1.392555,103.912367
823167,524,80,604,1.394384,103.91476
823168,467,140,607,1.393896,103.913797
823169,358,67,425,1.393037,103.914033
823170,246,660,906,1.393037,103.914033
823171,791,221,1012,1.394751,103.91316
823172,912,293,1205,1.395621,103.91228
823173,560,1755,2315,1.396121,103.910412
823174,214,232,446,1.396956,103.910365
823175,650,997,1647,1.398045,103.908049
823176,384,83,467,1.398272,103.908824
823195,386,29,415,1.401073,103.906762
823196,640,718,1358,1.399299,103.907519
823199,501,651,1152,1.400575,103.905878
823201,207,37,244,1.399327,103.903734
823204,330,233,563,1.398027,103.903097
823207,441,436,877,1.400546,103.901646
823208,410,234,644,1.400546,103.901646
823209,1662,72,1734,1.399553,103.901007
823210,1095,266,1361,1.399248,103.901534
823211,690,243,933,1.401057,103.899
823213,1085,86,1171,1.400855,103.898282
823217,866,238,1104,1.402145,103.895639
823220,2,97,99,1.299509,103.837
823226,26,31,57,1.40348,103.893604
823232,0,8,8,1.299509,103.837
823256,295,31,326,1.40602,103.89552
823258,553,191,744,1.404865,103.896133
823259,593,15,608,1.404483,103.895687
823260,292,107,399,1.299509,103.837
823261,629,206,835,1.299509,103.837
823265,297,20,317,1.404952,103.898592
823266,523,239,762,1.40514,103.897568
823267,325,67,392,1.40427,103.898386
823268,458,367,825,1.403457,103.897846
823269,319,103,422,1.403084,103.898637
823270,450,115,565,1.404177,103.898748
823271,929,174,1103,1.403845,103.901032
823272,648,1309,1957,1.402881,103.900094
823273,972,2865,3837,1.402247,103.901371
823274,480,159,639,1.403054,103.902472
823288,810,79,889,1.40245,103.903703
823289,546,175,721,1.401644,103.903545
823301,291,129,420,1.403743,103.906084
823302,601,114,715,1.403743,103.906084
823303,331,336,667,1.403743,103.906084
823305,18,500,518,1.405033,103.907084
823306,883,275,1158,1.406299,103.905942
823308,2080,54,2134,1.408297,103.899442
823310,1405,756,2161,1.409364,103.90065
823312,570,214,784,1.410375,103.901289
823313,306,73,379,1.410375,103.901289
823314,10,343,353,1.407812,103.897885
823315,8,88,96,1.407943,103.896238
823316,531,140,671,1.408737,103.896631
823322,0,1,1,1.299509,103.837
823323,0,1,1,1.299509,103.837
823326,0,82,82,1.299509,103.837
823327,0,1,1,1.405548,103.895147
823406,5,13,18,1.299509,103.837
823408,0,12,12,1.299509,103.837
823409,0,1,1,1.417787,103.902383
823601,405,91,496,1.402606,103.908033
823602,462,591,1053,1.402411,103.907231
823603,337,289,626,1.403425,103.907878
823604,446,166,612,1.403635,103.907569
823612,540,882,1422,1.405511,103.908018
823613,363,177,540,1.404082,103.908573
823615,477,893,1370,1.402966,103.910372
823617,315,355,670,1.402303,103.91239
823618,517,135,652,1.401674,103.91183
823619,504,467,971,1.402575,103.910897
823622,387,194,581,1.399459,103.911705
823623,871,1970,2841,1.399459,103.911705
823624,766,188,954,1.399459,103.911705
823632,548,68,616,1.401,103.912963
823635,206,375,581,1.400623,103.914459
823637,1172,257,1429,1.399226,103.915073
823638,451,480,931,1.399785,103.915484
823641,462,83,545,1.398921,103.916458
823642,909,83,992,1.398556,103.916191
823658,2,0,2,1.299509,103.837
823659,0,1,1,1.401172,103.919194
823661,267,131,398,1.299509,103.837
823662,229,14,243,1.401321,103.918263
823663,356,87,443,1.399971,103.917463
823665,1284,605,1889,1.402175,103.914967
823669,14,76,90,1.299509,103.837
823670,653,234,887,1.405392,103.913368
823672,289,522,811,1.405668,103.911994
823673,689,5,694,1.407627,103.912406
823676,257,96,353,1.405315,103.910436
823677,203,45,248,1.405894,103.909193
823678,346,72,418,1.405907,103.909102
823679,381,46,427,1.405894,103.909193
823682,1,2,3,1.299509,103.837
823684,0,2,2,1.299509,103.837
824101,502,1210,1712,1.398727,103.906271
824102,330,139,469,1.398926,103.905542
824104,2,12,14,1.396881,103.905798
824105,241,41,282,1.396791,103.905217
824106,590,964,1554,1.397546,103.907234
824107,216,148,364,1.39672,103.908331
824109,181,129,310,1.39551,103.908885
824110,610,2495,3105,1.395298,103.910458
824126,453,493,946,1.393712,103.911087
824128,407,252,659,1.393006,103.911934
824167,610,134,744,1.394542,103.914562
824168,321,129,450,1.393749,103.913992
824170,7,71,78,1.394457,103.914613
824172,110,1297,1407,1.395108,103.911884
824173,647,807,1454,1.39585,103.910849
824174,341,167,508,1.397229,103.909924
824175,237,1361,1598,1.398379,103.907849
824176,517,77,594,1.397738,103.909498
824195,215,72,287,1.401523,103.906977
824196,458,221,679,1.399617,103.907241
824199,308,127,435,1.400438,103.906198
824201,510,206,716,1.399505,103.903178
824204,313,259,572,1.398236,103.902684
824207,438,69,507,1.400546,103.901646
824211,619,1572,2191,1.299444,103.858272
824217,842,421,1263,1.402334,103.895894
824226,0,10,10,1.299509,103.837
824233,0,7,7,1.299509,103.837
824256,67,89,156,1.40602,103.89552
824265,706,88,794,1.405003,103.898185
824266,428,188,616,1.405495,103.898144
824268,564,903,1467,1.403084,103.898637
824271,326,125,451,1.403505,103.900917
824272,515,1455,1970,1.402756,103.900488
824273,543,78,621,1.402623,103.901403
824274,525,208,733,1.403049,103.901685
824289,882,126,1008,1.401994,103.903694
824301,225,76,301,1.403743,103.906084
824302,262,53,315,1.403743,103.906084
824303,308,808,1116,1.403743,103.906084
824305,408,342,750,1.406105,103.906987
824306,849,218,1067,1.406471,103.906505
824316,500,236,736,1.408564,103.897533
824322,1,13,14,1.299509,103.837
824323,0,2,2,1.299509,103.837
824326,0,197,197,1.299509,103.837
824409,0,1,1,1.417787,103.902383
824601,229,159,388,1.402984,103.907767
824612,351,776,1127,1.404714,103.907621
824613,572,91,663,1.403739,103.908931
824617,654,375,1029,1.401649,103.912838
824618,255,193,448,1.401831,103.91148
824619,721,181,902,1.40214,103.911095
824622,338,8035,8373,1.399459,103.911705
824637,815,33,848,1.398895,103.915398
824642,374,23,397,1.398648,103.915781
824659,1,0,1,1.299509,103.837
824662,538,78,616,1.299509,103.837
824670,6,306,312,1.299509,103.837
824672,886,430,1316,1.407625,103.910927
824676,173,30,203,1.404958,103.910124
824677,352,33,385,1.405856,103.910352
824679,17,93,110,1.299509,103.837
824684,5,1,6,1.299509,103.837
825195,465,993,1458,1.401794,103.907165
828654,2660,3199,5859,1.410053,103.905744
828670,2254,1414,3668,1.415086,103.898993
828674,326,53,379,1.412225,103.898583
828679,108,411,519,1.398802,103.912785
828680,110,419,529,1.398942,103.913175
828681,66,33,99,1.399014,103.913112
828682,59,14,73,1.398987,103.912945
828683,61,160,221,1.399102,103.914478
828684,3,17,20,1.299509,103.837
828685,6,125,131,1.299509,103.837
828686,2,298,300,1.299509,103.837
828687,1,149,150,1.299509,103.837
828688,0,1,1,1.299509,103.837
828690,0,6,6,1.299509,103.837
828691,3,9,12,1.299509,103.837
828692,81,223,304,1.398629,103.912788
828693,52,433,485,1.398789,103.912875
828694,1150,735,1885,1.420827,103.91236
828699,221,29,250,1.401158,103.897959
828700,230,483,713,1.299509,103.837
828701,34,221,255,1.400765,103.897144
828709,34,6,40,1.299509,103.837
828710,220,784,1004,1.400741,103.908324
828711,140,440,580,1.400654,103.908443
828712,157,9,166,1.400146,103.908116
828713,270,9,279,1.400654,103.908443
828714,245,125,370,1.299509,103.837
828715,221,312,533,1.299509,103.837
828716,250,451,701,1.404772,103.910967
828719,464,619,1083,1.299509,103.837
828720,427,181,608,1.402954,103.903846
828721,486,238,724,1.404478,103.902719
828722,430,29,459,1.402954,103.903846
828723,820,25,845,1.402954,103.903846
828724,639,142,781,1.403336,103.9041
828725,42,209,251,1.299509,103.837
828726,8,31,39,1.40767,103.903334
828729,282,1310,1592,1.397198,103.913138
828730,686,42,728,1.397198,103.913138
828731,488,10,498,1.397198,103.913138
828732,468,10,478,1.397198,103.913138
828733,499,1111,1610,1.397198,103.913138
828734,66,4,70,1.299509,103.837
828735,0,37,37,1.299509,103.837
828736,5,2,7,1.299509,103.837
828737,1,2,3,1.299509,103.837
828738,14,4,18,1.299509,103.837
828739,519,620,1139,1.299509,103.837
828740,229,82,311,1.392293,103.912955
828741,308,60,368,1.392126,103.913401
828742,402,92,494,1.392126,103.913401
828743,391,575,966,1.299509,103.837
828744,399,320,719,1.392126,103.913401
828745,534,569,1103,1.392126,103.913401
828746,876,20,896,1.390826,103.912591
828747,366,125,491,1.390826,103.912591
828748,279,225,504,1.390826,103.912591
828749,468,407,875,1.391118,103.912628
828750,345,28,373,1.390826,103.912591
828751,631,442,1073,1.390826,103.912591
828753,47,452,499,1.391492,103.913676
828754,15,33,48,1.299509,103.837
828755,32,611,643,1.299509,103.837
828756,109,672,781,1.299509,103.837
828757,42,50,92,1.299509,103.837
828758,10,44,54,1.299509,103.837
828759,30,18,48,1.299509,103.837
828760,11,639,650,1.299509,103.837
828761,5858,61301,67159,1.406394,103.901997
828762,600,699,1299,1.402954,103.903846
828763,339,812,1151,1.403547,103.904187
828764,244,987,1231,1.401563,103.897719
828765,286,2,288,1.401563,103.897719
828766,311,0,311,1.401563,103.897719
828767,535,294,829,1.401563,103.897719
828768,604,1279,1883,1.401563,103.897719
828769,428,58,486,1.401563,103.897719
828770,218,86,304,1.401563,103.897719
828771,299,903,1202,1.401563,103.897719
828772,328,464,792,1.401854,103.898853
828773,209,704,913,1.299509,103.837
828774,159,37,196,1.299509,103.837
828775,271,4,275,1.299509,103.837
828776,285,84,369,1.401036,103.897509
828777,309,125,434,1.299509,103.837
828778,233,4,237,1.401036,103.897509
828779,243,224,467,1.405232,103.90006
828780,626,30,656,1.405232,103.90006
828781,498,82,580,1.405621,103.89943
828782,369,111,480,1.405232,103.90006
828783,781,81,862,1.405232,103.90006
828784,581,22,603,1.405232,103.90006
828785,648,286,934,1.405232,103.90006
828786,424,832,1256,1.405232,103.90006
828787,560,182,742,1.405232,103.90006
828788,391,114,505,1.405232,103.90006
828789,55,152,207,1.299509,103.837
828790,740,393,1133,1.401563,103.897719
828791,319,3,322,1.401563,103.897719
828792,155,1,156,1.400856,103.898282
828793,77,239,316,1.299509,103.837
828794,442,976,1418,1.299509,103.837
828795,366,236,602,1.39796,103.917664
828796,832,166,998,1.39796,103.917664
828797,591,545,1136,1.39796,103.917664
828798,429,15,444,1.39821,103.917575
828799,363,16,379,1.39796,103.917664
828800,328,74,402,1.39796,103.917664
828801,74,5,79,1.299509,103.837
828802,190,484,674,1.399054,103.918471
828809,1192,1101,2293,1.400629,103.904269
828810,83,161,244,1.299509,103.837
828811,116,194,310,1.392192,103.915163
828812,182,2204,2386,1.401264,103.901642
828814,297,1221,1518,1.399882,103.902302
828815,248,4122,4370,1.393473,103.913677
828816,993,1917,2910,1.400669,103.90428
828817,981,79,1060,1.401132,103.903982
828818,386,62,448,1.401193,103.904194
828819,374,484,858,1.400025,103.913058
828820,389,1270,1659,1.397198,103.913138
828821,605,189,794,1.397198,103.913138
828822,479,113,592,1.397198,103.913138
828823,259,112,371,1.397198,103.913138
828824,88,4273,4361,1.393176,103.915443
828825,257,396,653,1.39542,103.91737
828826,32,412,444,1.395276,103.91779
828830,366,256,622,1.405232,103.90006
828831,276,160,436,1.405232,103.90006
828832,212,102,314,1.405232,103.90006
828833,441,955,1396,1.40569,103.900275
828835,529,202,731,1.392382,103.916131
828836,398,809,1207,1.392986,103.917452
828837,68,193,261,1.394054,103.917072
828839,121,1129,1250,1.400532,103.909266
828840,1,11,12,1.299509,103.837
828841,0,8,8,1.299509,103.837
828842,6,6,12,1.299509,103.837
828843,31,17,48,1.299509,103.837
828844,206,619,825,1.406609,103.9052
828845,373,588,961,1.405297,103.90518
828848,240,785,1025,1.396421,103.912588
828849,45,759,804,1.392351,103.915066
828850,397,2173,2570,1.401021,103.909737
828851,36,55,91,1.40977,103.904703
828852,118,3107,3225,1.394319,103.916246
828853,605,3681,4286,1.399406,103.91642
828854,218,1410,1628,1.402059,103.912673
828855,656,3005,3661,1.405085,103.908588
828856,494,12791,13285,1.393673,103.91264
828857,563,6595,7158,1.396747,103.908859
828858,154,4376,4530,1.399345,103.905932
828859,7,19,26,1.415892,103.902128
828860,16,8,24,1.416676,103.906641
828861,56,63,119,1.412789,103.90658
828862,57,388,445,1.411865,103.900592
828863,148,2601,2749,1.408426,103.898532
828864,391,4265,4656,1.404493,103.897259
828865,137,21,158,1.404297,103.902307
828866,362,360,722,1.396986,103.911718
828867,143,1295,1438,1.394828,103.90904
828868,132,9455,9587,1.405158,103.901997
828869,346,236,582,1.399887,103.907469
828870,325,717,1042,1.402069,103.909443
828871,8,4,12,1.420661,103.908183
829168,390,72,462,1.420404,103.911061
829169,17,315,332,1.404395,103.906698
829314,11,7,18,1.406251,103.91431
829328,0,1,1,1.405957,103.914543
829330,0,15,15,1.406542,103.91453
829336,0,1,1,1.40566,103.914569
829481,9,11,20,1.419339,103.909643
829482,142,6,148,1.419087,103.909591
829483,1,1,2,1.299509,103.837
829484,17,47,64,1.418674,103.909514
829485,2,2,4,1.299509,103.837
829486,3,3,6,1.418621,103.909269
829487,2,1,3,1.299509,103.837
829488,1,0,1,1.418517,103.908304
829489,42,1,43,1.419662,103.908163
829490,10,2,12,1.418792,103.908651
829491,1,0,1,1.418767,103.908848
829492,7,3,10,1.41864,103.908897
829493,6,1,7,1.418743,103.909017
829494,4,0,4,1.418618,103.9094
829495,14,0,14,1.418783,103.909398
829496,3,0,3,1.418675,103.908701
829497,1,2,3,1.419016,103.909453
829498,22,0,22,1.419646,103.908837
829499,5,3,8,1.419514,103.908621
829500,110,0,110,1.419314,103.908475
829502,14,4,18,1.418935,103.90943
829504,5,0,5,1.418637,103.909143
829505,11,5,16,1.419028,103.908366
829506,0,2,2,1.418885,103.909547
829507,16,0,16,1.418729,103.909134
829508,26,4,30,1.418621,103.909269
829509,7,6,13,1.299509,103.837
829510,5,21,26,1.299509,103.837
829645,23,12,35,1.415164,103.904935
829646,59,33,92,1.415611,103.905373
829647,8,9,17,1.415611,103.905373
829649,11,0,11,1.415926,103.906041
829650,12,7,19,1.415536,103.905328
829651,12,9,21,1.415009,103.90499
829652,17,4,21,1.414918,103.90481
829653,1,4,5,1.414832,103.904684
829654,16,0,16,1.41465,103.904552
829655,8,0,8,1.414463,103.904449
829656,1,0,1,1.41444,103.90429
829657,2,0,2,1.418602,103.908313
829658,0,1,1,1.414229,103.904009
829659,9,1,10,1.414058,103.903886
829660,21,8,29,1.415621,103.905363
829661,40,4,44,1.415621,103.905363
829662,5,8,13,1.416175,103.905827
829663,12,13,25,1.415609,103.905349
829664,0,3,3,1.419119,103.909491
829665,1,6,7,1.415355,103.904785
829666,32,0,32,1.415609,103.905349
829667,1,4,5,1.415102,103.904522
829668,0,2,2,1.41432,103.904131
829669,0,2,2,1.41485,103.904218
829670,17,0,17,1.414634,103.903897
829671,20,1,21,1.414243,103.903468
829672,1,2,3,1.415609,103.905349
829673,2,0,2,1.414745,103.904026
829674,0,1,1,1.41527,103.904206
829675,1,0,1,1.41527,103.904206
829676,0,4,4,1.418729,103.909134
829677,10,1,11,1.41527,103.904206
829678,7,38,45,1.414629,103.903616
829680,0,2,2,1.415621,103.905363
829682,1,0,1,1.415572,103.905307
829684,3,0,3,1.415621,103.905363
829685,122,8,130,1.415387,103.903542
829686,0,10,10,1.416291,103.904812
829687,0,3,3,1.415591,103.9037
829688,3,1,4,1.41527,103.904206
829689,69,0,69,1.416291,103.904811
829691,1,1,2,1.416056,103.904973
829692,3,5,8,1.416878,103.905369
829693,26,2,28,1.415353,103.905057
829694,6,0,6,1.415677,103.904489
829695,2,0,2,1.416813,103.905202
829696,11,0,11,1.41558,103.904277
829697,8,0,8,1.415487,103.904205
829698,7,0,7,1.415703,103.904132
829699,3,0,3,1.41629,103.904811
829700,12,0,12,1.415892,103.90397
829701,3,0,3,1.415782,103.904037
829702,16,0,16,1.41611,103.903771
829703,1,0,1,1.416173,103.903869
829704,6,0,6,1.416228,103.903985
829705,7,0,7,1.41628,103.904074
829706,63,0,63,1.416309,103.904181
829707,16,0,16,1.416343,103.904303
829708,5,0,5,1.416392,103.904415
829709,1,0,1,1.416446,103.904495
829710,2,0,2,1.415643,103.904419
829711,11,2,13,1.416176,103.904617
829712,82,2,84,1.416065,103.904678
829713,20,36,56,1.415991,103.904736
829714,0,1,1,1.414902,103.90329
829715,0,1,1,1.414776,103.90319
829718,1,0,1,1.414947,103.902837
829722,0,2,2,1.416288,103.904535
829723,28,0,28,1.415638,103.903104
829724,7,0,7,1.415554,103.903079
829725,13,0,13,1.415453,103.90304
829726,12,0,12,1.415415,103.903019
829727,5,1,6,1.415344,103.902966
829728,4,0,4,1.416292,103.904812
829729,17,3,20,1.414552,103.903788
829730,1,2,3,1.415993,103.903912
829731,12,1,13,1.415425,103.90514
829732,2,0,2,1.414359,103.902886
829733,2,1,3,1.414423,103.903665
829734,3,0,3,1.417825,103.907378
829735,9,0,9,1.415161,103.903096
829736,111,0,111,1.415244,103.903122
829737,68,1,69,1.415317,103.903202
829738,40,10,50,1.415165,103.903347
829739,9,1,10,1.415122,103.903332
829740,9,0,9,1.415059,103.903279
829741,6,0,6,1.414952,103.903462
829742,2,2,4,1.415264,103.902873
829743,1,23,24,1.415128,103.903518
829744,2,6,8,1.415295,103.903724
829745,12,0,12,1.41541,103.903825
829746,8,10,18,1.415527,103.904019
829747,7,0,7,1.415574,103.903963
829748,2,1,3,1.415119,103.898972
829749,4,0,4,1.414986,103.903499
829750,113,0,113,1.415765,103.903789
829751,18,0,18,1.415862,103.90375
829752,41,0,41,1.415903,103.903695
829753,1,0,1,1.415969,103.903673
829754,1,0,1,1.416037,103.903592
829756,4,0,4,1.415698,103.903843
880001,264,2673,2937,1.299509,103.837
880002,41,1372,1413,1.299509,103.837
880003,11,0,11,1.299509,103.837
880004,11,722,733,1.32867175,103.853624
880005,103,266,369,1.3578345,103.870248
880007,1,3,4,1.41616,103.903496
880010,0,19,19,1.299509,103.837
880013,49,3684,3733,1.299509,103.837
880014,40,7261,7301,1.299509,103.837
880015,4,12,16,1.299509,103.837
881000,19,0,19,1.299509,103.837
881001,20,1382,1402,1.299509,103.837
881002,18,88,106,1.299509,103.837
881004,2,3,5,1.299509,103.837
881005,19,6,25,1.299509,103.837
881006,612,43,655,1.299509,103.837
881007,4,152,156,1.299509,103.837
881009,15,45,60,1.299509,103.837
881010,7,1,8,1.299509,103.837
881012,12535,13876,26411,1.299509,103.837
881013,11,5,16,1.299509,103.837
881016,20,133,153,1.299509,103.837
881017,2,3,5,1.299509,103.837
881019,34,48,82,1.299509,103.837
881020,12,100,112,1.299509,103.837
881022,106,12,118,1.299509,103.837
881023,21,398,419,1.299509,103.837
881024,26,389,415,1.299509,103.837
881025,1016,60515,61531,1.299509,103.837
881026,15,4214,4229,1.299509,103.837
881027,45,76,121,1.299509,103.837
881028,18,48,66,1.299509,103.837
881030,5,1,6,1.299509,103.837
881034,226,16,242,1.299509,103.837
881035,1902,161,2063,1.299509,103.837
881036,76,54,130,1.299509,103.837
881037,27,1310,1337,1.299509,103.837
881038,6,190,196,1.299509,103.837
881039,50,5,55,1.299509,103.837
881040,24,91,115,1.299509,103.837
881041,5,0,5,1.299509,103.837
881042,42,56,98,1.299509,103.837
881043,20,8,28,1.299509,103.837
881044,7,0,7,1.299509,103.837
881045,26,106,132,1.299509,103.837
881046,30,424,454,1.299509,103.837
881063,158,7,165,1.299509,103.837
881065,0,1,1,1.299509,103.837
881066,0,18,18,1.299509,103.837
881067,0,20,20,1.299509,103.837
881068,1,27,28,1.299509,103.837
881070,0,1,1,1.299509,103.837
881071,123,46,169,1.299509,103.837
881076,399,18726,19125,1.299509,103.837
881078,6,0,6,1.299509,103.837
881082,34,670,704,1.299509,103.837
881084,3,0,3,1.41566,103.903894
881085,281,132,413,1.299509,103.837
881086,107,168,275,1.299509,103.837
881088,150,8278,8428,1.299509,103.837
881095,171,13437,13608,1.357475,103.87076
881096,2,0,2,1.415441,103.90452
881098,136,86,222,1.299509,103.837
881100,35,500,535,1.299509,103.837
881101,3,0,3,1.299509,103.837
881102,5,27,32,1.299509,103.837
881103,8,12,20,1.299509,103.837
882000,28,0,28,1.299509,103.837
882001,35,8,43,1.299509,103.837
882003,0,11,11,1.299509,103.837
882004,9,214,223,1.299509,103.837
882006,2,2,4,1.299509,103.837
882008,38,51,89,1.299509,103.837
882009,4,6,10,1.299509,103.837
882010,63,138,201,1.299509,103.837
882015,0,13,13,1.299509,103.837
882016,54,456,510,1.299509,103.837
882017,154,24296,24450,1.299509,103.837
882018,62,2710,2772,1.299509,103.837
882019,2,25,27,1.299509,103.837
882021,78,326,404,1.299509,103.837
882022,8,2,10,1.299509,103.837
882023,4,216,220,1.299509,103.837
882024,0,1,1,1.299509,103.837
882025,12,4,16,1.299509,103.837
882026,110,114,224,1.299509,103.837
883000,3,93,96,1.299509,103.837
883002,0,7843,7843,1.299509,103.837
883003,1,208,209,1.299509,103.837
883008,0,45,45,1.299509,103.837
883009,14,707,721,1.299509,103.837
883011,3,29,32,1.299509,103.837
883012,0,1,1,1.299509,103.837
883013,2,4,6,1.299509,103.837
883016,43,989,1032,1.299509,103.837
884000,52,10,62,1.299509,103.837
884001,529,38656,39185,1.30346,103.856204
884002,223,4172,4395,1.299509,103.837
884003,55,5411,5466,1.299509,103.837
884004,55,8899,8954,1.299509,103.837
884005,42,233,275,1.299509,103.837
884006,37,1816,1853,1.299509,103.837
884008,2,3,5,1.299509,103.837
884009,10,809,819,1.299509,103.837
884010,5,76,81,1.299509,103.837
884011,8,801,809,1.299509,103.837
884012,22,55,77,1.299509,103.837
884016,11,234,245,1.299509,103.837
884021,2,26,28,1.299509,103.837
884022,23,634,657,1.299509,103.837
885001,3,5,8,1.299509,103.837
885004,15,11,26,1.299509,103.837
918104,310,20,330,1.382831,103.999541
918107,137,572,709,1.384206,103.999989
